protein-water,protein-carbon,hydrogen bond (long-range),pi-pi (long-range),disorder (long),K-Beta similarity,disorder (short),electrostatic (short-range),8-feature sum
-4,16,-4,-37,-35,-25,-12,8,-93
1,20,-5,-41,-15,-35,-24,19,-80
2,16,-19,-30,-5,-22,-19,11,-66
6,37,-15,-28,-8,-41,-23,7,-65
14,41,-1,-11,-9,-15,-27,32,24
7,36,-12,-18,1,-29,-25,17,-23
11,39,-14,-40,-4,-31,-27,11,-55
11,31,-11,-30,-13,-35,-27,6,-68
17,37,-2,2,-11,-14,-13,26,42
3,28,-14,-29,-17,-33,-29,9,-82
12,37,-8,-19,-15,-11,-29,10,-23
4,30,-16,-23,1,-22,-24,27,-23
9,34,0,-23,-7,-17,-33,24,-13
3,24,-13,-18,-11,-23,-14,21,-31
20,40,-2,-3,9,-17,-23,36,60
3,22,-15,-24,-17,-23,-19,20,-53
0,4,-12,-3,-25,-24,-23,20,-63
2,24,-13,-14,-21,-27,-16,19,-46
5,17,-11,-8,-16,-20,-22,29,-26
1,27,-10,-24,-11,-27,-21,19,-46
0,9,-12,-20,-12,-19,-11,8,-57
-2,18,-12,-36,-10,-22,-21,0,-85
-6,4,-17,-26,-27,-25,-21,9,-109
-12,16,-17,-33,-26,-25,-30,5,-122
12,18,-3,-22,2,-28,-16,24,-13
15,19,-9,-2,-19,-23,-17,17,-19
-2,6,-27,-15,-28,-26,-18,19,-91
-2,16,-13,-20,-9,-14,-28,21,-49
7,20,-6,-34,0,-17,-12,21,-21
-3,2,-2,-7,-3,-6,-4,1,-22
2,21,-6,-29,-3,-23,-20,25,-33
9,11,-9,-26,-8,-28,-18,10,-59
7,17,-7,-28,-14,-29,-22,13,-63
6,20,-3,-24,-4,-11,-12,28,0
4,22,-8,-32,-9,-33,-22,22,-56
-4,12,-18,-25,-12,-18,-19,15,-69
-16,11,-36,-45,-28,-23,-31,-9,-177
6,17,-14,-16,-13,-10,-18,17,-31
3,4,-10,-12,-4,-20,-21,5,-55
-19,12,-26,-44,-11,-14,-37,0,-139
4,3,-13,-20,-13,-6,-12,12,-45
-4,26,-23,-38,-12,-27,-30,6,-102
-2,7,1,-9,-7,-8,-6,7,-17
2,11,-3,-1,1,-3,0,-3,4
-2,2,0,-5,-4,-1,-2,-2,-14
2,11,0,-21,-30,5,-11,4,-40
-4,8,-2,-23,-26,9,-17,5,-50
9,34,-19,-23,-18,-32,-30,15,-64
-1,18,-14,-13,-7,-14,-35,18,-48
3,21,-14,-32,-23,-31,-18,17,-77
5,18,-16,-35,-14,-30,-27,10,-89
-2,23,-16,-36,-15,-19,-24,-2,-91
-13,15,-18,-39,-12,-3,-24,5,-89
-2,11,-20,-32,-11,-23,-25,-2,-104
-21,-4,-12,-30,-46,-21,-29,0,-163
-13,-9,-26,-35,-49,-31,-46,-30,-239
-15,0,-16,-39,-22,-30,-20,1,-141
-324,728,-527,-978,-214,-874,-315,282,-2222
-16,1,-10,-55,-72,-38,-20,17,-193
-9,-1,-22,-33,-19,-10,-21,-6,-121
21,24,-6,-113,-54,-115,-86,-15,-344
7,11,-7,-32,-1,-20,-17,29,-30
-5,-6,-2,-35,-22,-16,-6,15,-77
89,28,18,-6,-18,-74,-22,-4,11
13,93,-21,-83,-18,-45,11,53,3
21,24,-5,-108,-54,-114,-85,-13,-334
-8,2,-15,-31,-22,-29,-11,-9,-123
18,26,-5,-109,-49,-112,-84,-17,-332
-13,0,-50,-169,-125,-106,-92,-76,-631
17,25,-7,-115,-52,-114,-85,-16,-347
-23,-2,-13,-23,-20,-12,-19,0,-112
-5,13,-7,-22,-22,-7,-15,18,-47
160,143,70,-156,-82,-267,-154,-10,-296
-17,14,-17,-25,-7,-6,-5,-5,-68
-4,9,-4,-38,-17,-45,-19,-7,-125
8,20,-4,-27,-9,-25,-18,17,-38
6,21,-12,-36,-21,-33,-22,10,-87
7,33,-6,-19,-2,-25,-28,17,-23
1,7,-7,-14,-26,-14,-22,25,-50
2,0,-5,-6,-32,-27,-30,19,-79
6,23,-6,-15,-29,-26,-22,16,-53
-1,18,-10,-35,-10,-24,-21,19,-64
1,3,-2,-7,-7,-7,-4,-2,-25
-4,4,-2,-24,-5,-11,-10,3,-49
1,2,1,-5,-1,-3,-2,3,-4
-1,4,0,-5,-4,-3,-1,1,-9
2,2,-1,-4,-2,-1,1,-1,-4
1,7,-3,-10,-3,-4,-3,-3,-18
1,1,0,-5,-1,-2,-3,0,-9
4,2,1,-5,1,-1,-1,2,3
7,12,-7,-13,-10,-11,-24,22,-24
-4,2,-16,-34,-22,-23,-35,1,-131
-3,13,-18,-18,-11,-11,-14,3,-59
5,8,-15,-17,-16,-28,-21,0,-84
-3,10,-19,-33,-19,-26,-23,4,-109
-2,15,-28,-34,-12,-15,-22,-4,-102
-14,-2,-23,-39,-15,-18,-27,5,-133
-8,-5,-11,-40,-28,-19,-29,30,-110
-13,111,-42,-112,-12,-22,-54,-28,-172
13,25,-9,-7,-18,-34,-14,15,-29
-19,1,-25,-40,-26,-34,-30,-1,-174
-2,19,-20,-38,-18,-23,-24,-6,-112
-10,7,-17,-33,-17,-35,-17,15,-107
6,15,-6,-19,-16,-22,-19,5,-56
7,15,-9,-7,-21,-29,-25,16,-53
-18,20,-21,-41,-27,-38,-33,1,-157
9,20,-4,-4,-28,-30,-19,7,-49
15,8,-4,2,-10,5,-29,25,12
4,11,-4,-5,-23,-25,-22,15,-49
2,18,-8,-6,-21,-13,-15,17,-26
13,42,-6,-11,-9,-8,-24,19,16
10,18,-2,-11,-22,-31,-21,12,-47
4,6,-6,-24,-18,-28,-29,19,-76
-1,1,1,-6,-4,-5,-3,0,-17
-5,3,-22,-23,-16,-26,-31,10,-110
-9,6,-15,-22,-27,-20,-21,4,-104
-7,13,-17,-41,-9,-30,-36,-2,-129
0,18,-4,-22,-8,-11,-30,12,-45
-16,14,-10,-33,-5,-13,-29,9,-83
-17,0,-13,-24,-22,-11,-18,6,-99
-1,4,-18,-24,-12,-4,-24,11,-68
-8,4,-12,-30,-9,-20,-35,13,-97
9,22,1,-7,-15,-15,-32,13,-24
-3,17,-24,-34,-20,-15,-19,6,-92
-8,6,-21,-45,-14,-29,-22,8,-125
-15,14,-23,-32,-15,-21,-26,-7,-125
-11,2,-4,-24,-23,-18,-27,26,-79
-12,5,-13,-32,-25,-26,-21,4,-120
-13,3,-22,-34,-28,-24,-29,2,-145
-7,-1,-11,-30,-28,-17,-21,18,-97
-10,13,-8,-22,-6,-18,-22,17,-56
-10,14,-18,-27,-14,-19,-14,-1,-89
-9,25,-26,-35,-7,-11,-23,-5,-91
-7,18,-22,-34,-3,-12,-31,-14,-105
-6,23,-19,-38,-18,-31,-21,-1,-111
-12,18,-9,-25,1,-6,-12,12,-33
-7,16,-22,-38,-12,-25,-14,2,-100
5,28,-30,-38,-7,-29,-17,0,-88
1,25,-2,-28,11,2,-23,17,3
-1,7,-2,-20,-28,9,-15,5,-45
14,-2,-8,-43,-99,-63,-55,-36,-292
15,21,-12,-33,-7,-26,-25,15,-52
-12,3,-14,-36,-24,-23,-15,12,-109
-4,2,-2,-8,-2,7,-9,0,-16
65,106,-50,-234,-90,-192,-165,-35,-595
1,10,-3,-7,-40,-20,-25,25,-59
2,17,-10,-33,-8,-21,-18,20,-51
10,28,-11,-28,-21,-33,-19,9,-65
1,6,-8,-23,-8,-17,-21,19,-51
-6,14,-24,-31,-26,-32,-19,3,-121
-3,10,-23,-19,-29,-30,-21,16,-99
5,6,-5,-2,-31,-20,-25,22,-50
10,15,-5,-11,-22,-17,-13,17,-26
4,18,-4,-4,-36,-20,-25,20,-47
16,17,-2,6,-10,-5,-21,13,14
1,20,-4,-11,-28,-18,-22,17,-45
0,12,-13,-15,-7,-22,-36,21,-60
14,21,-11,-10,-19,-15,-13,14,-19
3,18,-9,-21,-25,-25,-19,16,-62
8,16,-7,-12,-11,-9,-27,20,-22
-7,14,-2,-20,-38,-13,-27,24,-69
-3,19,-5,-17,-7,-8,-35,29,-27
0,20,-5,-5,-24,-22,-25,20,-41
-17,13,-18,-41,-25,-37,-26,4,-147
2,18,-8,-37,-20,-34,-21,17,-83
12,28,-8,-23,3,-25,-13,6,-20
-1,1,-2,-7,-5,-6,-6,0,-26
9,15,-11,-29,-16,-29,-22,21,-62
7,20,-6,-31,0,-19,-13,20,-22
10,23,-13,-32,-9,-28,-25,8,-66
12,20,-12,-27,-13,-28,-22,10,-60
12,19,-8,-21,-6,-24,-14,20,-22
-2,-3,-2,-5,-2,-2,-4,2,-18
-15,24,-16,-65,-14,-35,-37,-6,-164
-69,16,-91,-204,-56,-104,-143,-84,-735
-2,14,-8,-7,-36,-14,-22,11,-64
4,32,-22,-36,-13,-33,-25,17,-76
6,9,-11,-7,-20,-15,-30,14,-54
109,173,49,-204,81,-88,-11,59,168
-2,3,-4,-9,-5,-4,-6,2,-25
2,3,-1,-9,-3,-7,-2,-3,-20
3,7,1,-5,-6,-6,-4,3,-7
3,17,-6,-10,-18,-25,-27,17,-49
-3,9,-14,-16,-19,-23,-21,4,-83
155,117,-9,-4,-156,-125,-71,-61,-154
1,3,1,-7,-4,-3,-3,-2,-14
0,6,-1,-4,2,-1,0,3,5
0,4,0,-6,0,-4,0,-1,-7
212,135,-24,16,-218,-148,-74,-132,-233
14,14,-4,-18,-6,-17,-25,20,-22
-2,17,-18,-15,-8,-16,-23,4,-61
91,56,42,-130,-16,-60,-39,54,-2
-2,17,-11,-26,-29,-30,-28,3,-106
3,23,-13,-17,-13,-18,-21,5,-51
-1,30,-31,-46,-7,-27,-19,-1,-102
0,5,-19,-29,-18,-23,-27,-3,-114
-12,12,-13,-25,-8,-16,-17,11,-68
-7,10,-14,-22,-5,-23,-22,14,-69
2,14,-2,-32,-18,-30,-17,4,-79
-16,15,-13,-29,-25,-32,-28,6,-122
-14,14,-10,-30,-39,-34,-32,9,-136
-9,16,-24,-71,-27,-31,-34,-2,-182
-16,16,-37,-75,-29,-46,-34,9,-212
4,5,7,-10,-36,-6,-16,7,-45
169,516,174,-56,40,65,-211,194,891
43,17,-24,-23,-53,-65,-34,-28,-167
0,5,16,-51,-105,-69,-26,8,-222
40,8,9,-4,-31,-42,-19,-7,-46
18,9,-3,-10,1,-21,-3,-2,-11
9,7,8,-41,-103,-75,-35,-5,-235
41,11,-3,-7,-21,-36,-7,-1,-23
32,-1,-2,-8,-2,-10,-8,9,10
-9,-1,-4,-19,-6,-9,-15,-7,-70
-13,-3,-9,-50,-41,-39,-21,11,-165
-2,19,8,-15,12,-10,-9,15,18
-6,-10,-10,-19,-9,-21,-25,-11,-111
-20,-5,-11,-44,-10,-15,-18,-1,-124
0,137,-64,-256,44,-155,-107,105,-296
21,20,-1,-49,-6,-69,-19,19,-84
-50,-25,-55,-83,-51,-58,-81,-30,-433
-28,11,-24,-53,-24,-38,-35,-9,-200
0,3,-14,-26,-10,-17,-9,-1,-74
-4,13,-7,-72,-76,-76,-41,-13,-276
-7,12,-24,-43,-12,-36,-33,-31,-174
-39,4,-34,-67,-9,-19,-49,-21,-234
-1,29,15,-21,1,-16,19,16,42
-11,-12,-8,-26,33,1,-12,10,-25
27,36,10,-39,0,-41,-25,66,34
-43,119,-6,-229,-85,-91,-83,53,-365
-15,-12,-13,-17,-19,-7,-22,-4,-109
18,128,-51,-217,-69,-172,-168,-82,-613
-54,-9,-48,-69,-23,-16,-38,-16,-273
-17,59,-14,-85,6,-19,-42,-25,-137
6,33,-22,-57,1,-49,-23,-9,-120
-7,-3,-2,-24,0,-11,-5,7,-45
-17,9,-2,-44,-26,-29,-11,-21,-141
4,3,-23,-22,-45,-36,-31,-35,-185
12,48,-2,-34,-21,-34,-23,15,-39
-26,5,-33,-70,-36,-44,-44,-29,-277
27,63,6,-24,-2,-18,0,-6,46
7,1,2,-37,-2,-22,-16,7,-60
1,19,-6,-27,-7,-26,-10,8,-48
-4,25,-12,-48,-33,-19,-14,-19,-124
4,5,-8,-19,-11,-23,-13,-8,-73
38,-3,-9,-38,-9,-65,-34,-20,-140
-11,-19,-13,-30,-5,7,1,-4,-74
14,32,3,-18,-15,-35,-8,1,-26
75,49,-84,-158,-165,-215,-133,-146,-777
1,-1,-20,-35,-16,-25,-4,-6,-106
190,159,18,-195,59,-159,-172,49,-51
-18,-3,-10,-27,-21,-19,-15,-3,-116
9,-9,-9,-53,-6,-36,-24,-6,-134
111,149,29,20,105,28,16,86,544
9,161,63,-114,122,100,-27,21,335
4,5,-8,-19,-11,-23,-13,-8,-73
26,63,-14,-103,-83,-118,-105,33,-301
-10,6,-12,-23,-14,-12,-17,1,-81
-15,-13,-30,-34,-22,-27,-32,-4,-177
54,10,-9,-25,-59,-74,-35,-49,-187
8,35,0,-30,7,-12,22,12,42
-28,-18,-13,-59,-17,-30,-61,6,-220
-11,13,-8,-83,-57,-56,-21,13,-210
-102,-29,-31,-181,-97,-51,-57,-4,-552
-11,6,-5,-24,-15,-17,-1,-12,-79
-3,14,-5,-15,-1,-2,2,-3,-13
-3,19,-4,-32,-14,-18,-7,-20,-79
-20,9,-43,-59,-50,-20,-40,-12,-235
-5,-12,-1,-17,-33,-9,-25,8,-94
28,23,11,-45,28,-21,-18,25,31
-6,15,-2,-4,-11,-10,-3,-10,-31
-25,43,-30,-43,-2,-30,-32,5,-114
-11,5,-19,-32,-11,-17,-39,-11,-135
-7,13,-29,-30,-2,-17,-23,-4,-99
-26,-15,-21,-40,-26,-18,-32,-9,-187
-14,14,-8,-15,-4,4,4,0,-19
-11,3,-5,-23,-5,0,-7,-8,-56
11,14,6,-61,-30,-62,-26,-9,-157
-33,1,-65,-83,-63,-54,-109,-15,-421
-36,-15,-39,-60,-21,-17,-43,-1,-232
0,-5,-13,-20,-21,-21,-15,-6,-101
10,-9,-11,-38,-15,-10,-29,12,-90
83,-15,-2,-17,-11,-51,-73,-12,-98
-17,1,-17,-36,-18,-25,-23,-5,-140
27,37,9,-39,1,-43,-27,67,32
-2,15,-10,-13,-12,-11,-13,-1,-47
1,13,-5,-29,-19,-31,-12,6,-76
1,2,-9,-23,-26,-27,-37,3,-116
6,13,-7,-27,-17,-26,-12,-5,-75
-5,1,-19,-16,-26,-23,-26,16,-98
-15,-1,-23,-39,-17,-17,-23,11,-124
0,-7,-2,-30,-26,-30,-20,-9,-124
4,25,-1,-35,-31,-43,-11,5,-87
10,24,-10,-31,-16,-27,-18,-1,-69
-5,12,-19,-37,-13,-18,-20,-16,-116
-3,-2,-5,-73,13,-33,-31,-7,-141
3,-7,-7,2,-13,-3,-12,-7,-44
45,55,-5,-20,12,-25,-32,13,43
88,27,2,-77,-16,-78,-77,-16,-147
-25,1,-36,-57,-36,-31,-66,-37,-287
9,49,-14,-100,-91,-85,-50,15,-267
26,42,-20,-85,-8,-59,-16,-14,-134
29,5,-13,-16,-9,-18,-33,11,-44
19,66,7,43,-22,30,-31,-15,97
24,38,13,37,-18,20,-14,-18,82
3,46,-7,18,-25,18,-35,-14,4
16,64,3,34,-26,26,-30,-15,72
6,50,-3,16,-24,18,-31,-15,17
86,61,-23,-59,-88,-141,-94,-12,-270
8,62,1,25,-32,18,-32,-18,32
19,68,4,37,-23,30,-33,-20,82
33,80,16,52,-36,47,-39,-25,128
22,67,6,38,-22,29,-35,-21,84
-8,4,-12,-19,-7,-18,-15,-9,-84
-24,2,-8,-56,-13,-18,-18,12,-123
26,28,-16,-18,-12,-33,-26,-3,-54
-55,24,-45,-94,-30,-44,-32,-11,-287
-9,32,-14,-47,-18,-21,-54,31,-100
88,50,26,6,-32,-80,-24,-10,24
-10,13,-21,-32,3,-26,-22,-10,-105
-14,4,-19,-32,-15,-22,-22,-1,-121
-13,8,-23,-37,-3,-28,-25,-7,-128
8,26,-5,-32,11,-16,-13,12,-9
1,6,-22,-23,-16,-24,-15,-8,-101
-15,16,-22,-37,1,-31,-21,-9,-118
5,19,-13,-32,-5,-23,-14,-5,-68
9,24,-13,-26,-5,-24,-20,-5,-60
5,24,-20,-34,2,-28,-10,-2,-63
0,1,-24,-29,-17,-17,-13,-10,-109
-11,13,-13,-41,-18,-23,-11,5,-99
-16,8,-16,-33,-21,-18,-22,10,-108
-2,27,-12,-44,-10,-26,-21,20,-68
-4,-1,-17,-26,-25,-33,-32,11,-127
-43,149,-93,-281,-50,-182,-82,14,-568
-31,41,-107,-183,-119,-126,-200,-22,-747
78,-51,34,-3,-184,-66,-87,6,-273
-37,-25,-103,-119,-120,-86,-123,-56,-669
-188,-78,-233,-542,-243,-227,-310,-105,-1926
-45,-46,-55,-118,-142,-120,-107,-47,-680
21,90,-64,-233,-36,-115,-83,73,-347
-80,2,-136,-282,-218,-152,-181,-46,-1093
-30,110,-83,-275,-110,-176,-113,-31,-708
-83,52,-116,-317,-140,-158,-155,-47,-964
-5,4,-10,-20,-28,-16,-24,27,-72
-10,0,-21,-14,-29,-8,-28,6,-104
-13,-17,-14,-32,-29,-12,-26,25,-118
7,37,-16,-54,40,-33,4,-2,-17
-107,159,-169,-381,-149,-204,-259,99,-1011
-15,134,-38,-111,-3,-25,-65,-20,-143
-3,7,-2,-9,-17,-14,-9,9,-38
-50,88,-8,-192,-8,-51,-43,-2,-266
-25,20,-29,-96,-36,-4,-36,33,-173
-2,5,-16,-53,-69,-54,-30,-12,-231
-53,-35,-102,-184,-211,-187,-217,-59,-1048
2,-3,-28,-62,-57,-65,-51,-37,-301
0,-8,-1,-21,-16,-15,-6,-12,-79
-13,-18,-29,-50,-24,-24,-31,7,-182
11,38,0,-42,13,-14,-16,36,26
11,27,-31,-62,-27,-55,-64,13,-188
-27,51,-90,-158,-72,-129,-137,-85,-647
13,9,-14,-89,-30,-59,-72,-20,-262
-12,6,-24,-33,-62,-43,-43,-30,-241
-29,-28,-55,-112,-66,-71,-94,-33,-488
-60,-16,-63,-130,-72,-52,-97,-42,-532
-21,22,-59,-87,-62,-64,-90,-29,-390
-33,-9,-54,-75,-84,-50,-78,-35,-418
-22,0,-24,-44,-27,-20,-34,-6,-177
-30,-11,-17,-50,-29,-21,-24,2,-180
-20,23,5,-55,-10,-38,-12,3,-104
-34,26,-68,-208,-93,-91,-115,-7,-590
-19,-3,-33,-111,-27,-78,-72,-48,-391
2,5,3,-30,-29,-21,-26,11,-85
-6,91,1,-68,-14,-38,19,57,42
6,27,-9,-6,5,-12,-21,2,-8
-120,-62,-124,-293,-202,-188,-207,-45,-1241
-5,26,-106,-182,-143,-145,-204,-99,-858
50,132,-12,-153,-34,-120,-77,-83,-297
49,36,-19,-52,16,-22,-26,14,-4
-35,24,-94,-232,-116,-146,-140,-87,-826
43,-23,14,16,5,-17,-51,50,37
-40,-23,-88,-369,-281,-292,-219,-79,-1391
78,33,30,-35,-77,-71,-75,17,-100
-4,-5,-51,-157,-213,-140,-143,-97,-810
-39,-9,-68,-84,-93,-62,-91,-39,-485
7,40,-12,-8,2,-3,-3,17,40
1,5,-10,-35,-19,-20,-18,-1,-97
2,23,-4,-43,-13,-29,-13,-10,-87
43,46,4,-49,11,-45,-22,-1,-13
12,2,-4,-5,-37,-30,-10,-15,-87
-11,3,-6,-10,-5,-4,-18,-18,-69
-6,7,-27,-59,-18,-27,-37,-1,-168
52,182,-33,-318,-59,-273,-129,104,-474
-79,-64,-59,-75,-85,-51,-108,-4,-525
-7,22,-7,-1,-13,-13,-15,-10,-44
33,11,12,2,17,-4,11,22,104
141,54,34,-165,18,-112,-73,-16,-119
-22,-8,-42,-67,-74,-65,-103,-14,-395
290,214,107,-259,-68,-332,-369,18,-399
-18,23,-16,-151,-175,-103,-98,58,-480
-27,-2,-16,-67,-45,-30,-31,-11,-229
11,22,-21,-41,-23,-34,-22,6,-102
51,67,1,-186,9,-102,-27,78,-109
-7,-3,-13,-61,-76,-51,-45,-22,-278
25,4,-69,-104,-78,-107,-66,-35,-430
2,63,-9,-36,-34,14,8,29,37
68,14,18,-103,-49,-115,-94,-25,-286
-3,29,-28,-49,-4,-44,-30,19,-110
-96,6,-116,-219,-89,-69,-117,-14,-714
-140,68,-171,-319,-156,-97,-175,-181,-1171
1,25,-34,-84,-48,-31,-32,12,-191
-27,22,-71,-166,-126,-129,-137,-60,-694
109,60,-22,-53,-142,-144,-102,-89,-383
11,75,-43,-167,-114,-121,-103,19,-443
-42,9,7,-113,-19,-49,28,83,-96
-35,40,-80,-196,-56,-132,-108,-60,-627
34,48,-9,-79,-86,-116,-81,-73,-362
4,26,-6,-30,-6,-27,-19,23,-35
-138,75,-151,-394,-245,-168,-176,33,-1164
-108,12,-51,-133,-69,-72,-67,-34,-522
-16,64,-84,-197,-203,-197,-176,-43,-852
-3,6,-23,-23,-23,-38,-36,-18,-158
-222,55,-383,-709,-506,-526,-528,-311,-3130
-77,-8,-94,-192,-142,-72,-108,-62,-755
-63,-10,-72,-190,-93,-96,-149,-87,-760
-23,-9,-45,-66,-60,-29,-55,-26,-313
-3,59,-18,-126,12,-78,-48,60,-142
7,35,1,-17,-14,-27,9,-4,-10
-38,-14,-38,-78,-64,-37,-74,-32,-375
-35,26,-55,-96,-91,-43,-54,5,-343
45,44,17,-46,28,-48,-33,22,29
-11,72,-67,-187,-106,-127,-129,-12,-567
58,101,-22,-133,-2,-120,-68,62,-124
-74,190,-78,-270,11,-72,-43,12,-324
-27,-17,-34,-77,-74,-43,-37,-23,-332
-37,-5,-47,-57,-35,-21,-60,-15,-277
-10,-19,-23,-77,-90,-52,-57,-22,-350
12,24,7,-37,-29,-49,-38,5,-105
-104,241,-117,-401,-27,-113,-163,-93,-777
-121,28,-140,-330,-231,-201,-237,-46,-1278
-16,19,-12,-52,-24,-31,-60,-19,-195
-15,13,-31,-44,-5,-10,-25,-14,-131
29,14,-5,-75,-55,-56,-50,-12,-210
5,0,-23,-45,-43,-40,-39,-50,-235
-12,189,-141,-394,-117,-161,-202,116,-722
460,973,51,-384,-9,-524,-1098,-26,-557
-76,-18,-69,-123,-103,-72,-140,-12,-613
-117,59,-147,-577,-355,-309,-344,-96,-1886
0,129,-95,-322,-221,-189,-160,40,-818
-90,10,-83,-221,-77,-107,-133,-54,-755
-68,-4,-93,-194,-67,-117,-125,-68,-736
-19,198,-62,-276,-108,-108,-306,-44,-725
-20,-6,-12,-34,-22,-35,-36,-14,-179
-11,6,-16,-24,-16,-22,-29,-9,-121
-131,6,-156,-343,-138,-99,-161,-8,-1030
-10,6,-7,-18,-14,-8,-8,-8,-67
-26,3,-68,-148,-119,-104,-121,-45,-628
4,44,7,-32,-47,-51,-34,-20,-129
-145,16,-160,-297,-165,-158,-178,-25,-1112
-109,169,-134,-379,-74,-183,-145,79,-776
-34,13,-35,-100,-70,-32,-59,-36,-353
-123,111,-220,-373,-60,-120,-150,-87,-1022
-6,10,-20,-66,-33,-51,-33,-13,-212
1,72,-40,-152,-90,-117,-115,-9,-450
71,29,-10,-45,-34,-118,-71,-16,-194
-19,7,-23,-55,-76,-34,-43,-12,-255
-36,-18,-36,-61,-41,-35,-38,-2,-267
-21,-3,-37,-101,-61,-47,-79,5,-344
-3,2,-12,-27,-39,-24,-21,4,-120
17,34,-1,-28,-4,-38,-35,14,-41
-39,-42,-39,-99,-127,-88,-77,25,-486
9,-14,9,-98,-27,-47,-53,47,-174
45,36,8,-39,-67,-25,-26,-12,-80
5,30,-1,-95,-70,-57,-44,4,-228
-93,-18,-87,-153,-94,-77,-142,-60,-724
54,80,-29,-215,8,-86,-120,-32,-340
94,139,-50,-328,-110,-289,-248,-4,-796
25,54,-38,-216,-75,-186,-111,-27,-574
42,78,-27,-226,-8,-104,-138,-24,-407
48,90,31,-130,32,-67,12,32,48
-121,107,-191,-433,-190,-151,-207,9,-1177
21,15,-26,-94,-99,-129,-80,-50,-442
-88,29,-98,-169,-133,-85,-138,-17,-699
-6,-10,-1,-32,-32,-26,-6,-2,-115
-30,-4,-7,-37,-19,-9,-28,0,-134
-20,-26,-26,-53,-91,-60,-41,-19,-336
-42,-23,-49,-131,-125,-75,-101,1,-545
-151,366,-101,-851,-307,-221,-207,182,-1290
-37,157,-68,-213,-108,-82,-131,4,-478
-7,5,-62,-104,-109,-94,-106,-60,-537
7,18,-33,-64,-102,-81,-96,-38,-389
99,20,25,-65,38,-29,-61,31,58
-36,66,-37,-175,-111,-100,-134,-108,-635
-89,4,-140,-315,-184,-92,-169,-94,-1079
12,26,-3,-12,-96,-89,-62,-33,-257
203,109,54,-181,-15,-235,-182,24,-223
255,214,62,-185,113,-210,-157,4,96
-176,-30,-147,-380,-134,-139,-199,-22,-1227
17,56,-50,-152,-20,-80,-30,-2,-261
-42,-16,-71,-100,-75,-64,-77,-48,-493
112,127,49,-135,-96,-222,-120,31,-254
-38,31,-42,-133,-64,-66,-57,10,-359
-68,12,-73,-164,-38,-59,-117,-17,-524
-114,-38,-321,-672,-474,-482,-551,-281,-2933
79,128,5,-67,-30,-45,14,22,106
44,81,-112,-221,-213,-252,-186,-196,-1055
31,251,72,61,26,94,-214,59,380
-7,44,-75,-248,-126,-179,-169,12,-748
-47,542,-53,-608,-178,-198,11,214,-317
-5,34,-25,-104,-38,-81,-22,10,-231
-3,21,-12,-37,-3,-29,-16,5,-74
-7,-10,-11,-32,-23,-32,-34,-19,-168
-45,-20,-55,-97,-71,-82,-98,-35,-503
-85,100,-83,-246,-108,-115,-114,-63,-714
11,10,-3,-19,-25,-27,-15,-16,-84
26,99,2,-122,-11,-79,-68,-45,-198
-23,34,-16,-47,-31,-19,-53,-11,-166
-41,-3,-46,-96,-61,-46,-59,14,-338
210,315,-44,-373,-143,-348,-234,-361,-978
19,90,-8,-117,-21,-84,-70,-58,-249
-18,-2,-9,-40,-16,-11,-8,10,-94
40,24,-59,-129,-146,-191,-128,-93,-682
-12,40,-26,-77,-50,-46,-52,-3,-226
-131,80,-146,-360,-199,-253,-255,-79,-1343
-28,-14,-36,-48,-18,-20,-45,-25,-234
90,208,27,-189,-13,-126,-106,126,17
15,-23,-9,-43,-40,-85,-22,-7,-214
-74,4,-72,-160,-67,-83,-90,-26,-568
14,23,-17,-70,-22,-48,-26,15,-131
-16,33,-29,-55,-6,-28,-36,-19,-156
50,15,-4,-84,-98,-131,-24,-27,-303
-93,52,-95,-278,-129,-137,-127,-98,-905
-9,8,-23,-58,-88,-63,-51,-56,-340
7,-22,13,-94,7,-45,-44,2,-176
9,30,-21,-80,-17,-56,-60,-11,-206
46,30,50,-11,0,-47,-30,7,45
83,22,-27,-15,-124,-108,-54,-57,-280
-87,-21,-73,-148,-95,-73,-128,-30,-655
-12,41,-47,-96,-97,-114,-89,-36,-450
-16,39,-51,-93,-90,-113,-75,-20,-419
-22,-4,-31,-49,-14,-25,-38,-6,-189
88,30,41,-100,-64,-127,-75,52,-155
-83,-34,-83,-122,-108,-82,-145,-23,-680
15,9,-10,-66,-85,-74,-54,-25,-290
-40,34,-87,-178,-129,-140,-116,-55,-711
153,187,26,-86,-9,-62,-2,-53,154
20,32,-18,-38,-24,-41,-50,-2,-121
114,86,77,14,0,-141,-49,83,184
33,11,11,2,18,-2,11,20,104
30,37,-4,-62,-102,-79,-67,-34,-281
-84,-33,-88,-135,-87,-63,-129,-18,-637
-89,14,-76,-136,-87,-64,-97,-46,-581
8,118,-41,-171,-19,-81,-85,-59,-330
-41,-16,-47,-94,-64,-46,-68,-8,-384
-89,-14,-70,-142,-95,-51,-109,1,-569
6,119,-38,-178,-22,-83,-87,-59,-342
9,10,-2,-26,-37,-39,-14,-24,-123
-25,-34,-65,-81,-125,-111,-121,-47,-609
31,19,6,-30,-10,-37,-3,26,2
20,21,-5,-115,-54,-118,-91,-14,-356
-17,28,-53,-70,-29,-43,-80,-26,-290
-45,-1,-74,-165,-128,-142,-163,-34,-752
-10,17,-14,-44,-2,-32,-44,13,-116
-101,39,-63,-160,7,-19,-68,-30,-395
35,38,4,-37,-3,-25,2,18,32
75,53,16,-81,9,-92,-39,-6,-65
10,11,4,-63,-34,-57,-29,-10,-168
22,272,-82,-702,-132,-267,-229,-85,-1203
29,-6,-57,-88,-169,-177,-130,-100,-698
76,55,24,-74,-1,-95,-44,-3,-62
-98,78,-173,-569,-287,-470,-397,-210,-2126
11,13,3,-61,-32,-62,-30,-12,-170
-5,-25,-55,-93,-129,-56,-60,-11,-434
63,59,-5,-41,-118,-83,-50,-47,-222
-18,68,-49,-172,-19,-45,-97,-51,-383
64,183,7,-107,37,-32,-34,-136,-18
-12,6,-26,-55,-9,-30,-40,-10,-176
30,16,9,-59,4,-57,-30,1,-86
-30,31,-28,-114,-57,-45,-52,40,-255
109,88,-10,-180,-93,-223,-77,-29,-415
-2,32,-10,-41,-13,-48,-37,-21,-140
50,109,-10,-67,-10,-43,-36,-75,-82
-35,1,-10,-58,-23,-25,-19,-9,-178
114,84,78,16,-1,-142,-50,78,177
144,42,21,-6,-67,-117,-69,-37,-89
20,25,-9,-112,-51,-112,-84,-11,-334
40,13,11,7,19,-1,11,22,122
-245,26,-267,-570,-359,-386,-512,-209,-2522
-99,-43,-95,-133,-101,-57,-127,-33,-688
45,3,2,-52,-23,-63,-52,13,-127
73,50,19,-84,-7,-103,-39,-3,-94
34,151,18,-104,58,-19,-25,-117,-4
3,8,-28,-40,-35,-22,-22,-38,-174
309,203,105,-43,89,-125,-187,183,534
-32,28,-86,-206,-83,-134,-88,-12,-613
-2,22,-15,-49,-23,-30,-32,-34,-163
1,5,8,-26,-6,-33,-6,4,-53
-99,-14,-74,-156,-83,-67,-125,-14,-632
-16,58,-29,-84,-35,-61,-54,5,-216
31,-10,-31,-119,-78,-132,-118,-25,-482
-4,37,-61,-73,-58,-84,-89,-35,-367
-35,29,-56,-109,-74,-91,-98,-52,-486
26,-19,-3,-42,-24,-76,-49,-36,-223
-25,38,-53,-100,-39,-30,-68,-39,-316
-7,11,-8,-25,-11,-11,-15,-4,-70
-4,4,-9,-21,-26,-18,-33,-10,-117
-21,20,-11,-41,-23,-6,-17,17,-82
166,136,43,-32,-111,-153,-103,9,-45
-10,20,-5,-46,-14,-11,7,25,-34
60,-12,12,-8,-40,-27,-44,42,-17
-39,-4,-64,-141,-97,-75,-86,-23,-529
1,3,-99,-184,-209,-184,-185,-116,-973
-29,-9,-23,-40,1,-10,-16,-2,-128
-16,29,-17,-140,7,-85,-68,41,-249
7,29,-27,-77,-86,-73,-79,-84,-390
-67,-31,-54,-103,-124,-66,-93,-6,-544
-6,8,-9,-44,-58,-44,-25,-13,-191
-29,-18,-84,-157,-156,-140,-160,-14,-758
-81,-43,-91,-151,-127,-99,-108,-20,-720
11,14,3,-32,-26,-37,-15,4,-78
-16,4,-16,-19,-34,-22,-33,-10,-146
-73,-12,-61,-131,-80,-37,-84,13,-465
-62,5,-59,-106,-43,-68,-90,-19,-442
4,55,-23,-145,-54,-117,-89,-90,-459
49,46,-42,-67,-76,-109,-82,-76,-357
173,-13,47,-133,101,-111,-55,38,47
-32,30,-73,-116,-75,-94,-120,-60,-540
-7,72,-2,-116,-2,-70,-12,18,-119
9,63,-20,-105,-113,-64,-24,83,-171
18,14,-22,-43,-57,-47,-38,-46,-221
-8,5,3,-19,-9,-3,-10,4,-37
164,280,18,-311,34,-247,-126,92,-96
-22,54,-36,-110,-8,-33,-26,4,-177
-41,12,-79,-149,-111,-123,-100,-70,-661
-55,13,-42,-142,-80,-69,-74,17,-432
29,22,22,-5,14,-5,8,14,99
-75,8,-88,-210,-54,-115,-128,-73,-735
-4,14,-36,-99,-95,-67,-52,10,-329
-11,-7,-17,-45,-41,-35,-20,-20,-196
36,71,-114,-221,-205,-291,-202,-188,-1114
3,29,-14,-38,0,-14,-7,-9,-50
10,17,-43,-122,-179,-142,-111,-27,-597
-6,-2,-2,-23,-6,-17,-6,-5,-67
19,153,-299,-678,-167,-494,-484,-352,-2302
17,48,-4,-58,-22,-55,-10,21,-63
-16,14,-7,-51,-23,-30,-18,12,-119
-103,-36,-88,-155,-121,-94,-147,-16,-760
-18,-1,-35,-47,-11,-27,-44,-24,-207
-56,-15,-65,-101,-108,-97,-151,-46,-639
26,7,-29,-75,-68,-111,-74,-69,-393
36,26,3,-11,-8,-29,-13,2,6
-72,-23,-128,-175,-166,-161,-175,-79,-979
-27,-18,-39,-59,-62,-32,-54,-16,-307
-37,-10,-29,-61,-56,-31,-49,-10,-283
-79,-41,-77,-122,-107,-53,-138,-23,-640
-2,16,-65,-123,-131,-73,-100,-23,-501
-1,8,-20,-27,-32,-31,-28,-8,-139
-82,-25,-92,-128,-95,-55,-134,-22,-633
-95,19,-48,-139,-59,-68,-53,-17,-460
-18,12,-24,-99,-98,-74,-71,-15,-387
-22,-1,-28,-121,-77,-50,-73,46,-326
104,141,93,-8,135,116,-3,40,618
-64,-28,-9,-174,-32,-99,-46,-23,-475
-55,6,-21,-137,-41,-78,-28,29,-325
41,57,49,-4,-56,0,-25,7,69
115,9,18,-76,52,-85,-68,3,-32
-45,-18,-38,-116,-42,-55,-57,-28,-399
-190,44,-209,-586,-308,-168,-197,2,-1612
17,27,-6,-14,0,-15,-1,2,10
-40,73,-49,-121,-40,-61,-60,37,-261
61,-13,-26,-42,-53,-86,-39,-41,-239
-20,11,-33,-108,-64,-48,-70,24,-308
-5,14,-82,-122,-147,-124,-95,-131,-692
-9,4,-9,-19,-15,-5,-15,1,-67
-6,16,-72,-177,-145,-167,-140,-126,-817
-55,14,-44,-141,-75,-70,-79,18,-432
20,41,14,-25,-13,-43,-36,0,-42
-48,70,-95,-239,-102,-116,-149,23,-656
4,104,-19,-74,-11,-27,-21,-11,-55
25,118,-57,-190,-108,-156,-140,-159,-667
-30,-18,-50,-58,-61,-56,-85,-31,-389
-14,3,-15,-110,-66,-80,-38,14,-306
6,23,-26,-74,-45,-70,-41,1,-226
-35,32,-30,-124,-46,-43,-54,-39,-339
61,151,10,-90,19,-34,-35,-121,-39
6,18,4,-74,-46,-80,-67,-3,-242
-25,3,-44,-117,-76,-58,-60,-20,-397
-10,-12,-18,-72,-57,-63,-81,-9,-322
4,-11,-24,-38,-77,-35,-16,4,-193
53,51,9,-97,-9,-106,-33,3,-129
-93,-24,-100,-154,-108,-60,-121,-9,-669
16,35,-39,-120,-42,-81,-49,-50,-330
-17,-10,-15,-39,-25,-13,-20,3,-136
-112,-11,-162,-263,-130,-116,-180,-70,-1044
10,11,-10,-58,-71,-82,-20,-27,-247
7,109,-48,-158,-93,-156,-107,32,-414
-10,6,-8,-26,-15,-18,-16,-4,-91
-82,67,-133,-250,-31,-90,-97,-122,-738
84,73,11,-25,-75,-131,-77,-8,-148
-46,13,-13,-127,-34,-72,-24,31,-272
-12,7,-15,-34,-40,-17,-24,2,-133
13,14,6,-63,-33,-56,-28,-10,-157
33,21,24,-7,17,-25,-26,14,51
-29,-5,-7,-114,-47,-104,-68,-36,-410
-11,1,-8,-12,-10,-9,-15,11,-53
-3,-9,-15,-96,-101,-92,-75,-41,-432
-23,2,-39,-123,-95,-76,-108,24,-438
73,21,28,-98,12,-91,-42,24,-73
54,40,-4,-60,-98,-129,-61,-60,-318
17,19,-19,-72,10,-53,-44,65,-77
11,20,1,-36,-15,-36,2,3,-50
-45,-7,-33,-98,-49,-61,-52,-31,-376
7,-8,-36,-109,-34,-79,-86,-2,-347
-6,32,2,-119,3,-61,-30,8,-171
75,47,19,-82,-2,-101,-45,-5,-94
-47,-16,-38,-91,-45,-55,-39,-4,-335
175,55,33,1,-19,-118,-77,-27,23
86,-19,53,-431,47,-330,-206,-65,-865
3,-12,7,-46,2,-28,-27,8,-93
-1,22,-21,-77,-60,-53,-70,-27,-287
-31,18,-19,-81,-39,-44,-55,-12,-263
-46,7,-74,-110,-80,-51,-94,-23,-471
-17,3,-44,-42,-16,-29,-38,-30,-213
-84,-20,-72,-144,-99,-61,-117,-4,-601
142,215,-14,-370,-208,-414,-242,-103,-994
-59,9,-60,-165,-48,-42,-76,-7,-448
-20,-22,-54,-107,-121,-110,-106,-38,-578
-19,-5,-13,-51,-24,-18,-20,-14,-164
-40,87,-7,-97,6,-20,-56,18,-109
-9,21,-21,-93,-74,-66,-49,-47,-338
-41,2,-107,-175,-140,-139,-129,-105,-834
-86,34,-61,-128,-59,-40,-70,-71,-481
15,77,2,-127,-85,-146,-111,-1,-376
-36,1,-107,-168,-149,-152,-185,-60,-856
-150,194,-242,-669,-344,-400,-425,39,-1997
66,56,16,-90,4,-100,-36,-7,-91
41,23,12,-60,-25,-83,-67,-1,-160
0,3,-12,-70,-69,-72,-38,4,-254
78,85,5,-50,-7,-107,-82,-40,-118
54,17,-20,-96,-105,-137,-96,-76,-459
68,26,3,-73,-35,-96,-59,-24,-190
23,25,-15,-68,-26,-61,-57,-33,-212
-33,34,-150,-386,-238,-299,-240,-65,-1377
-22,5,1,-18,-30,-14,-30,6,-102
-82,-32,-83,-132,-98,-59,-128,-13,-627
167,106,16,-72,-62,-206,-118,53,-116
12,14,9,2,-8,5,9,-2,41
-7,-2,-12,-89,-116,-82,-100,-38,-446
-15,0,-16,-77,-20,-39,-30,-4,-201
0,216,-155,-403,-216,-236,-238,-5,-1037
-40,5,-27,-151,-72,-115,-69,-3,-472
0,8,-34,-25,-26,-26,-50,-5,-158
-16,17,-5,-38,-15,-30,-16,-5,-108
28,80,-118,-228,-144,-224,-187,-165,-958
2,24,4,-50,-28,-51,-1,-11,-111
-93,-13,-79,-154,-98,-70,-137,3,-641
-55,-15,-63,-98,-113,-80,-113,-13,-550
17,58,26,-95,1,-76,-15,5,-79
-19,-14,-12,-39,-17,-37,-12,-26,-176
108,81,43,-51,-51,-147,-125,-51,-193
-32,-4,-26,-91,-111,-67,-104,-8,-443
-1,10,-26,-37,-21,-41,-25,27,-114
13,30,7,-22,-30,-25,-15,0,-42
-14,12,-24,-51,-28,-49,-27,-23,-204
112,32,30,-42,-33,-123,-38,-22,-84
-65,0,-56,-134,-77,-62,-85,0,-479
58,55,-4,-114,-80,-139,-53,-48,-325
34,20,-12,-34,-63,-50,-36,-36,-177
-39,10,-47,-70,-50,-10,-44,14,-236
34,12,-20,-40,-78,-81,-57,-10,-240
-6,8,0,-43,-20,-29,-6,17,-79
-21,-15,-32,-66,-31,-32,-42,8,-231
-4,0,-34,-52,-32,-46,-34,-19,-221
-77,-17,-87,-141,-85,-106,-147,-58,-718
25,17,-64,-72,-73,-94,-91,-56,-408
30,204,-105,-453,-3,-232,-170,100,-629
18,64,-20,-90,-72,-107,-43,0,-250
-50,56,-69,-138,-27,-71,-58,-51,-408
29,23,-64,-131,-158,-150,-137,-97,-685
-13,13,-54,-69,-46,-52,-79,-53,-353
-55,189,-116,-363,-76,-228,-107,-20,-776
-9,27,-10,-42,-2,-38,-22,-3,-99
-88,-10,-70,-146,-92,-68,-116,-5,-595
0,2,-10,-24,-28,-25,-29,5,-109
-6,52,-17,-143,-55,-88,-92,41,-308
221,58,-10,7,-92,-174,-115,-93,-198
4,-5,-30,-51,-39,-48,-58,-8,-235
1,94,-7,-122,-17,-85,-53,-40,-229
-4,7,-18,-34,-6,6,-26,-19,-94
22,78,-14,-141,-9,-97,-49,35,-175
-18,-18,-42,-66,-47,-39,-67,-33,-330
9,39,-12,-46,-44,-61,-27,35,-107
-106,-47,-99,-141,-115,-69,-131,-35,-743
25,212,-109,-470,-1,-226,-178,100,-647
66,51,26,-87,14,-61,-25,49,33
-114,-65,-103,-173,-127,-65,-144,-40,-831
-16,4,-36,-60,-61,-54,-29,-31,-283
-27,9,-38,-82,-91,-68,-84,-15,-396
-14,14,-15,-35,-21,-23,-39,-12,-145
-94,-45,-85,-150,-88,-50,-139,-16,-667
60,213,-49,-379,-366,-138,-242,121,-780
3,12,12,-33,-7,-35,-9,5,-52
-250,49,-145,-304,-208,-21,-135,-164,-1178
27,104,5,-98,-10,-54,-62,-13,-101
63,68,1,-121,-65,-156,-59,2,-267
-59,-54,-74,-103,-72,-18,-69,-10,-459
99,168,104,-71,39,-168,-21,154,304
36,27,18,-35,-23,-45,-29,9,-42
-3,-16,-33,-38,-46,-38,-54,-40,-268
216,162,41,-141,-108,-263,-155,65,-183
-78,-38,-101,-140,-129,-101,-144,-34,-765
26,10,-29,-104,-55,-117,-58,-17,-344
-117,89,-71,-191,-76,-8,-79,-65,-518
73,70,30,-72,41,-56,-10,21,97
75,57,19,-80,0,-103,-39,2,-69
143,99,16,-195,58,-141,-126,-17,-163
-7,-9,-11,-35,-41,-29,-25,-11,-168
145,219,-14,-369,-204,-414,-242,-102,-981
-51,35,-53,-238,-140,-154,-138,-24,-763
-60,4,-101,-177,-136,-128,-163,-33,-794
-31,12,-11,-69,-7,-13,-22,-13,-154
-39,-19,-52,-82,-92,-44,-77,-14,-419
66,41,-61,-255,-157,-210,-235,-137,-948
-56,-23,-35,-101,-52,-62,-40,6,-363
-20,53,-81,-153,-105,-89,-113,-34,-542
-10,-6,-12,-29,-14,-4,-6,-17,-98
-44,30,-27,-115,-42,-71,-80,-4,-353
12,16,18,-44,-72,-43,-55,32,-136
-79,66,-44,-136,-44,-29,-57,-23,-346
8,32,1,-58,-11,-34,-7,8,-61
-9,-2,-47,-210,-142,-195,-153,-42,-800
-7,21,-5,-22,-11,-7,-7,-7,-45
0,17,-19,-43,-25,-28,-34,-7,-139
-135,-24,-109,-243,-108,-60,-92,-66,-837
-5,23,-19,-29,-23,-7,-1,24,-37
-25,39,-101,-224,-232,-319,-273,-123,-1258
-65,323,-119,-450,-241,-225,-170,-16,-963
13,17,-21,-77,-83,-70,-50,-27,-298
-6,-4,-10,-35,-26,-14,-14,-1,-110
28,137,-16,-149,-37,-110,-67,-58,-272
-3,-5,-27,-50,-80,-51,-44,-29,-289
28,23,0,-14,9,13,-9,35,85
248,198,19,-209,-151,-378,-404,-16,-693
61,187,-124,-412,-354,-253,-347,-368,-1610
172,167,1,-342,-100,-378,-240,216,-504
104,166,-148,-394,-173,-438,-348,-126,-1357
98,44,-31,-171,-46,-183,-105,-27,-421
39,239,43,-192,38,-218,-34,236,151
142,28,66,-106,31,-114,-102,28,-27
372,255,97,-160,89,-228,-262,202,365
-20,9,-8,-64,-51,-61,-26,-13,-234
89,141,-7,-183,-90,-176,-94,-11,-331
54,13,7,-43,-19,-42,-26,15,-41
35,20,-5,-98,-30,-80,-61,13,-206
-20,39,-92,-331,-160,-168,-225,80,-877
-20,12,-21,-53,-50,-26,-40,-1,-199
-12,-1,-2,-40,2,-19,-3,-10,-85
10,27,-7,-73,-13,-48,-27,-5,-136
-3,54,-95,-184,-176,-108,-127,64,-575
24,14,-11,0,-14,-44,-36,36,-31
-70,15,-86,-169,-92,-56,-78,1,-535
-95,-106,-73,-426,-389,-408,-364,-186,-2047
-18,6,-19,-122,-50,-92,-64,-8,-367
-47,96,-77,-205,-38,-67,-58,68,-328
-54,35,-104,-263,-187,-154,-156,-69,-952
26,18,-17,-74,-99,-108,-83,-50,-387
-60,38,-73,-165,-100,-68,-91,15,-504
-81,-46,-42,-145,-120,-83,-119,55,-581
12,18,5,-10,-8,-8,-33,-6,-30
-19,0,-9,-52,-12,-19,-21,7,-125
-173,133,-95,-273,-110,-121,-150,-40,-829
65,42,-39,-144,-121,-153,-81,-21,-452
7,43,-16,-73,-12,-75,-32,-16,-174
30,128,-11,-113,-53,-94,-63,-59,-235
26,2,64,-457,26,-312,-183,-53,-887
-16,-12,-7,-30,-17,-15,-10,3,-104
-40,16,-71,-137,-132,-112,-117,-28,-621
10,38,-22,-53,-32,-46,-48,-58,-211
-90,49,-37,-149,-45,-54,-70,-1,-397
-17,4,-14,-37,10,-6,-5,27,-38
5,12,-6,-12,-15,-14,-23,-15,-68
-47,156,-95,-230,-31,-75,-35,55,-302
45,26,19,-73,32,-30,-37,4,-14
-27,3,-25,-97,-86,-77,-64,30,-343
-8,17,-17,-100,-70,-73,-84,-29,-364
-31,5,-42,-76,-76,-38,-61,-13,-332
128,56,14,-19,5,-113,-66,56,61
-38,-33,-12,-51,-65,-40,-55,-9,-303
21,40,5,-67,-6,-54,-45,17,-89
-12,14,-20,-33,-27,-15,-26,3,-116
31,-6,8,-53,-34,-56,-28,15,-123
-12,4,-10,-15,-12,-5,-11,-1,-62
25,15,-8,-15,3,-25,-9,-12,-26
-99,44,-69,-123,-77,-26,-69,-65,-484
-59,43,-37,-43,-39,4,-90,1,-220
-4,5,2,-17,-7,2,-12,-6,-37
-7,20,-5,-65,-18,-46,-25,17,-129
-1,18,2,-26,-17,-26,-12,-1,-63
104,97,17,25,-38,-24,25,-3,203
18,79,20,-99,4,-72,-18,-7,-75
-7,35,18,-45,-28,-47,-12,26,-60
5,47,19,-109,4,-73,-14,11,-110
13,54,-20,-61,-68,-33,-2,22,-95
13,57,5,-98,10,-69,-21,5,-98
-9,35,-33,-89,-101,-126,-94,-37,-454
19,8,-17,-37,-27,-48,-42,-10,-154
-31,-16,-27,-49,-36,-24,-24,24,-183
5,13,-10,-39,-32,-46,-18,12,-115
7,27,-23,-55,-39,-56,-54,-25,-218
-2,17,-29,-62,-58,-62,-77,-10,-283
-7,8,1,-20,-28,-15,-7,-1,-69
101,129,54,-354,-111,-328,-93,95,-507
-103,30,-70,-142,-73,-48,-57,-62,-525
-62,83,-83,-157,-39,25,-154,100,-287
-49,42,-33,-85,-31,-50,-46,-9,-261
-18,22,-54,-129,-89,-86,-97,-9,-460
18,5,9,-26,-26,-31,-14,3,-62
5,11,-8,-9,-20,-5,-32,16,-42
19,39,-1,-39,12,-48,-84,41,-61
14,64,27,-74,-1,-67,-11,0,-48
-16,-1,-13,-24,-30,-12,-23,23,-96
-49,40,-36,-27,-37,6,-83,7,-179
-22,-6,-24,-51,-60,-17,-44,-22,-246
-85,29,-104,-206,-52,-88,-55,-17,-578
-55,41,-36,-89,-39,-50,-51,-5,-284
19,18,-5,-67,-9,-42,-36,23,-99
-9,4,-11,-90,-57,-72,-38,13,-260
119,108,-37,-194,-97,-227,-144,-6,-478
-34,4,-45,-116,-81,1,-52,30,-293
43,112,-68,-185,-60,-123,-101,-21,-403
2,-11,-3,-58,-87,-54,-47,-18,-276
-10,140,-71,-205,-56,-139,-66,46,-361
26,20,-32,-86,-81,-89,-103,-25,-370
-36,52,-75,-153,-40,-85,-83,-5,-425
-49,36,-36,-86,-32,-40,-46,-8,-261
75,55,12,-79,8,-109,-34,-10,-82
-6,11,-6,-16,-9,3,-1,0,-24
-7,9,-13,-28,-20,-16,-21,0,-96
-87,-48,-79,-121,-94,-81,-117,-23,-650
6,-38,-34,-20,-62,-40,-58,13,-233
2,2,-17,-15,-36,-20,-41,-7,-132
48,28,25,-34,37,-35,-20,25,74
16,29,-1,-29,-22,-46,-37,-24,-114
-4,21,-15,-33,-29,-36,-26,-18,-140
35,38,-11,-113,-32,-95,-55,13,-220
1,122,-57,-122,-76,0,-110,161,-81
77,53,12,-87,-10,-112,-34,-8,-109
1,82,-23,-49,2,16,-91,60,-2
-56,22,-107,-209,-121,-126,-109,-50,-756
21,57,27,-94,11,-70,-18,4,-62
-15,44,-11,-72,-36,-31,-20,10,-131
-82,-35,-83,-130,-72,-43,-80,10,-515
81,49,14,-83,0,-95,-32,-2,-68
-24,15,-24,-59,-60,-28,-29,19,-190
18,34,6,-25,-22,-39,-34,-22,-84
23,58,-7,-148,-149,-181,-111,-104,-619
39,53,-6,-72,-29,-68,-41,7,-117
-18,-3,-10,-31,-16,-5,-9,-3,-95
7,-4,-42,-109,-50,-111,-92,-31,-432
18,13,-27,-70,-73,-82,-42,-22,-285
-184,14,-109,-212,-131,-7,-104,-101,-834
71,48,11,-84,4,-106,-35,-9,-100
-103,69,-66,-65,-64,9,-128,2,-346
17,-12,-65,-135,-92,-152,-138,-85,-662
147,95,54,-37,30,-73,-8,59,267
-62,21,-48,-124,-36,-32,-68,-21,-370
60,62,-76,-126,-180,-205,-145,-158,-768
58,-8,14,-11,-25,-19,-36,22,-5
-168,58,-211,-446,-241,-183,-246,30,-1407
-14,-22,-3,-83,-74,-23,6,2,-211
23,24,17,-8,-20,-38,-38,-11,-51
-18,24,-49,-123,-54,-75,-71,-8,-374
-16,-19,1,-36,-49,-45,-50,-7,-221
179,21,-28,-5,-69,-129,-83,-32,-146
20,32,12,-40,2,-29,-4,6,-1
-51,-30,-53,-64,-43,-22,-43,-31,-337
13,29,6,-53,-62,-57,-49,-55,-228
6,18,3,-29,-10,-28,-19,28,-31
-21,17,-14,-62,-23,-14,-14,2,-129
-40,140,95,-145,144,113,-18,-49,240
54,-14,15,-89,11,-82,-46,29,-122
18,29,4,-38,20,-48,-24,-16,-55
-35,-26,-20,-44,-28,-10,-30,2,-191
4,171,-146,-480,-303,-128,-302,173,-1011
-47,9,-81,-176,-134,-103,-118,-55,-705
-8,0,-32,-64,-58,-53,-57,-15,-287
41,40,-17,-173,-88,-195,-101,-34,-527
16,79,-141,-528,-271,-356,-264,-84,-1549
3,22,-28,-80,-52,-68,-62,-1,-266
-75,-48,-102,-282,-312,-264,-196,-98,-1377
-40,-16,-54,-103,-95,-73,-78,-1,-460
16,15,0,-13,-18,-29,-38,-25,-92
-15,5,-9,-24,-21,-7,-35,3,-103
-57,225,-78,-419,-135,-126,-182,-106,-878
163,94,-19,-176,-69,-217,-157,-77,-458
-14,15,-13,-41,-17,-14,-14,3,-95
34,33,-6,-74,-20,-51,-47,38,-93
139,109,9,-192,57,-149,-119,-15,-161
1,68,-18,-98,-26,-92,-68,16,-217
-1,6,-3,-20,-7,-10,-5,-11,-51
-4,1,-11,-42,-1,-28,-17,-5,-107
-141,25,-105,-333,-213,-140,-166,41,-1032
15,33,-15,-57,4,-68,-49,-40,-177
-28,36,-43,-106,-33,-67,-30,-3,-274
38,12,8,-68,13,-39,-32,21,-47
4,28,-5,-56,-38,-60,-17,-14,-158
18,8,5,-20,-51,-35,-15,-28,-118
-48,45,-45,-142,-80,-43,-114,41,-386
-8,10,-19,-47,-45,-40,-40,-19,-208
-70,-16,-78,-146,-69,-61,-120,-25,-585
84,74,42,-1,30,62,-24,25,292
10,24,-6,-6,0,28,27,9,86
-246,150,-268,-786,-429,-421,-358,-49,-2407
-10,118,-27,-93,-6,-24,-55,1,-96
-19,4,-26,-38,-19,31,-29,-2,-98
-13,6,-13,-15,-27,-30,-27,-5,-124
-29,-13,-19,-54,-39,-34,-21,-5,-214
5,18,-32,-103,-74,-111,-105,0,-402
11,51,-27,-151,-43,-127,-73,-30,-389
21,19,24,-69,-16,-47,-93,24,-137
18,119,-32,-222,12,-129,-72,32,-274
46,49,11,-21,-18,-14,-6,52,99
113,43,39,-39,-34,-114,-46,-11,-49
12,18,-2,-2,-26,-10,-9,-23,-42
12,18,-2,-2,-26,-10,-9,-23,-42
12,18,-2,-2,-26,-10,-9,-23,-42
-29,-23,-25,-38,-32,-25,-29,-6,-207
86,277,107,-239,45,-246,58,278,366
94,130,36,-57,13,-65,-62,57,146
-6,23,-57,-86,-66,-66,-87,-44,-389
-68,123,-91,-194,-87,-175,-100,66,-526
-18,-16,-20,-31,-36,-27,-21,2,-167
32,29,-10,-59,-23,-57,-67,-10,-165
-94,41,-58,-181,-54,-55,-80,10,-471
-79,25,-50,-116,-51,-23,-51,-61,-406
-85,51,-68,-137,-66,-25,-45,-33,-408
78,185,-19,-312,42,-246,-133,18,-387
-10,20,-38,-84,-18,-74,-67,-35,-306
-8,17,-7,-35,-55,-51,-36,-38,-213
-26,21,-46,-127,-43,-60,-63,-28,-372
-260,29,-368,-629,-348,-250,-281,-16,-2123
14,1,-6,-41,-56,-53,-50,13,-178
-76,35,-79,-197,-166,-128,-118,-28,-757
-10,22,-27,-88,-54,-47,-46,6,-244
-22,9,-51,-119,-39,-57,-120,1,-398
-24,4,-52,-127,-52,-47,-112,4,-406
-28,-9,-33,-95,-133,-82,-82,-9,-471
61,31,25,-116,-17,-116,-64,-14,-210
26,33,21,-21,1,-16,4,13,61
-69,149,-64,-149,46,-70,-88,9,-236
-24,7,-16,-39,-22,0,-27,10,-111
-6,44,-8,-56,-35,-15,-39,-35,-150
-126,-55,-108,-205,-120,-62,-167,13,-830
75,31,-19,-38,-64,-84,-36,-5,-140
-32,58,-78,-254,-172,-177,-178,-73,-906
41,56,9,-22,-22,-18,-2,33,75
114,16,37,-31,-23,-99,-71,-19,-76
-48,4,-45,-100,-50,-40,-42,6,-315
11,34,-5,-51,-10,-43,-28,14,-78
23,25,-7,-113,-56,-111,-86,-13,-338
-40,-3,-49,-87,-74,-50,-84,0,-387
70,60,13,-59,-18,-67,-2,-20,-23
37,26,-1,-106,-24,-85,-58,12,-199
165,-43,23,-191,-129,-301,-194,-12,-682
-88,8,-51,-139,-88,-46,-91,-37,-532
-18,-2,-24,-70,-43,-51,-54,-20,-282
-14,37,-35,-97,-100,-124,-93,-41,-467
3,22,3,-36,-10,-21,-21,15,-45
-12,10,-9,-31,-12,-5,-8,-14,-81
2,10,3,-48,-42,-47,-14,-6,-142
-23,33,-14,-91,-7,-50,-50,-11,-213
-9,5,-18,-67,-32,-57,-41,-17,-236
-39,39,-79,-257,-151,-171,-138,-64,-860
0,19,-16,-31,-11,-26,-10,-6,-81
-18,-20,-5,-33,-43,-37,-28,1,-183
41,26,28,-111,-18,-113,-56,7,-196
4,4,-5,-12,-13,-3,-8,-12,-45
-27,16,-51,-91,-59,-64,-74,-36,-386
-10,3,-9,-52,-9,-25,-38,5,-135
-6,39,-70,-193,-37,-111,-108,-23,-509
49,12,1,25,16,-15,-22,-12,54
40,-11,54,-457,37,-316,-198,-64,-915
179,171,-79,-240,-38,-309,-269,-113,-698
51,17,-39,-40,-67,-83,-51,-40,-252
-16,6,-36,-108,-102,-75,-77,-61,-469
-15,27,-24,-98,-109,-128,-88,-22,-457
6,70,-47,-155,-67,-132,-129,-5,-459
-7,36,-25,-98,-103,-127,-86,-37,-447
132,128,17,-117,-76,-207,-30,7,-146
-1,11,-4,-28,-14,-19,4,10,-41
-75,69,-31,-140,-60,-75,-47,20,-339
-8,37,-32,-87,-99,-124,-92,-39,-444
-113,-13,-136,-221,-104,-107,-156,-53,-903
-27,-21,-23,-43,-34,-27,-43,8,-210
38,-1,-46,-79,-162,-120,-108,-76,-554
-34,-37,-29,-79,-65,-21,-47,-3,-315
55,94,-3,-115,-8,-129,-57,15,-148
85,45,-6,-72,-114,-148,-51,-64,-325
9,3,-20,-54,-25,-65,-37,-31,-220
-13,32,-31,-95,-104,-123,-93,-35,-462
31,6,2,-30,-19,-48,-25,-5,-88
5,17,-22,-38,-9,-34,-28,-12,-121
2,-5,2,-34,-11,-23,-18,-2,-89
-28,21,-41,-53,-26,-5,-36,9,-159
-7,38,-32,-87,-98,-125,-92,-37,-440
-16,34,-32,-93,-102,-123,-93,-33,-458
-12,33,-29,-96,-108,-125,-92,-36,-465
5,10,-7,-27,-40,-49,-31,-19,-158
-10,32,-29,-93,-108,-125,-91,-35,-459
-13,33,-30,-95,-104,-123,-92,-36,-460
24,55,21,-114,-100,-105,-61,-84,-364
12,84,-6,-110,-22,-81,-56,-44,-223
37,28,1,-84,-58,-93,-67,-8,-244
53,47,-1,-95,7,-99,-37,0,-125
290,282,60,-262,-172,-317,-181,165,-135
-10,33,-31,-90,-102,-125,-94,-36,-455
-2,4,-8,-11,-3,0,-11,-9,-40
227,1125,165,-352,-568,-240,-521,678,514
35,67,21,-41,-47,-20,-12,29,32
-25,21,-17,-64,-28,-27,-36,4,-172
43,-26,60,-443,46,-302,-219,-63,-904
3,22,-28,-80,-52,-68,-62,-1,-266
-5,8,9,-31,-26,-37,-16,-8,-106
82,75,-58,-88,-163,-164,-74,-129,-519
-13,10,-21,-37,-39,-29,-28,3,-154
29,5,-17,-72,-20,-81,-59,-5,-220
-9,65,-29,-66,9,-17,-41,8,-80
-14,-7,-5,-44,-38,-27,-43,-23,-201
274,58,92,-179,26,-226,-92,100,53
618,133,78,-418,199,-402,-432,253,29
-10,-3,-5,-15,-40,-38,-8,15,-104
35,22,-17,-88,-20,-88,-43,-27,-226
14,17,-8,-94,-9,-61,-31,17,-155
-37,-8,-26,-138,-39,-99,-97,-43,-487
-65,-26,-2,-167,-33,-88,-53,-4,-438
-35,-13,-28,-132,-45,-105,-98,-36,-492
-35,-12,-20,-119,-46,-97,-94,-34,-457
-9,-14,-18,-42,-36,-30,-28,-20,-197
-56,-25,-12,-168,-22,-88,-59,-13,-443
-26,-26,-28,-32,-35,-22,-51,-7,-227
-18,7,10,-36,-19,-19,-5,5,-75
7,-19,-32,-61,-78,-84,-56,-30,-353
2,15,-6,-31,-23,-32,-29,7,-97
8,10,3,-32,27,-19,-11,4,-10
-6,9,-9,-34,-1,-9,-26,-1,-77
72,71,-22,-101,-15,-118,-87,-13,-213
2,11,-1,-24,-27,2,-10,5,-42
33,42,-12,-42,-26,-67,-50,-27,-149
-51,34,-56,-174,-32,-88,-66,-4,-437
0,-2,-13,-12,-21,-32,-18,-14,-112
-36,14,-43,-71,-43,-11,-39,13,-216
-42,-22,0,-158,-21,-98,-38,-5,-384
19,95,-9,-116,-16,-82,-68,-57,-234
36,19,-4,-43,-34,-58,-30,3,-111
-36,-10,-24,-117,-44,-98,-89,-40,-458
-7,16,-5,-23,-10,-1,-7,2,-35
-121,27,-116,-228,-145,-89,-193,27,-838
-13,-12,-10,-38,1,-12,-11,10,-85
21,93,-45,-239,-43,-130,-109,51,-401
-15,6,-15,-27,-2,-2,-4,-3,-62
-36,-5,-30,-52,-40,-22,-31,-3,-219
-73,0,-77,-167,-39,-83,-102,-51,-592
67,169,13,-91,34,-28,-37,-135,-8
-14,25,-11,-47,0,-22,-11,5,-75
-31,-18,-38,-59,-59,-54,-55,-18,-332
-44,208,136,-134,191,170,12,-22,517
3,15,-1,-8,5,-5,-3,-8,-2
-20,0,-19,-61,-12,-32,-25,6,-163
12,11,-8,-24,-1,-18,-24,2,-50
-34,-7,-57,-70,-52,-29,-59,-20,-328
20,102,-6,-124,-28,-92,-55,-42,-225
-6,5,-18,-22,-27,-15,-30,6,-107
-2,42,-2,-65,-39,-29,-10,19,-86
-18,11,-26,-55,-20,-39,-44,-11,-202
7,94,-8,-121,-17,-74,-52,-48,-219
28,7,-7,-20,-34,-53,-13,-7,-99
-20,-1,-14,-44,-20,-24,-21,-3,-147
-1,14,5,-31,10,-19,-1,12,-11
-31,2,-27,-83,-78,-78,-63,-26,-384
15,102,8,-123,-3,-86,-57,-27,-171
-27,9,-20,-50,-15,-33,-38,-20,-194
-12,2,-10,-29,6,-16,-6,0,-65
-13,111,-42,-112,-12,-22,-54,-28,-172
20,90,-9,-122,-21,-86,-72,-64,-264
92,-14,-13,-83,-48,-119,-60,12,-233
192,331,-18,-393,-320,-414,-427,-429,-1478
-34,-29,-42,-66,-72,-36,-72,29,-322
50,54,2,-89,15,-66,-92,-52,-178
41,34,34,-73,-21,-85,-24,18,-76
-112,-3,-81,-198,-94,-84,-132,-35,-739
32,29,2,-28,-17,-70,-39,-4,-95
47,31,15,-48,26,-48,-18,-20,-15
87,43,-18,-152,40,-86,-72,32,-126
5,59,-15,-63,-14,-31,-17,-41,-117
24,88,-7,-124,-18,-87,-68,-57,-249
-12,10,-23,-53,-7,-33,-20,-19,-157
-9,16,-12,-37,-14,-27,-16,-10,-109
-9,10,-15,-28,-10,-13,-18,-11,-94
7,2,-28,-61,-64,-86,-39,-34,-303
3,17,-17,-19,-24,-21,-22,-17,-100
-14,16,-8,-33,3,2,-1,7,-28
0,10,-7,-23,-14,-17,-7,-3,-61
79,15,-4,-107,-24,-112,-69,-4,-226
-124,110,-167,-479,-265,-229,-260,-85,-1499
-31,1,-25,-52,-35,-23,-33,3,-195
6,18,10,-51,-26,-49,-40,-11,-143
49,25,-29,-40,-37,-44,-50,6,-120
9,26,-40,-119,-172,-71,-84,-27,-478
-37,36,-38,-112,-39,-54,-45,-13,-302
-40,20,-28,-190,-145,-116,-64,25,-538
-22,-8,-67,-123,-48,-57,-76,-23,-424
-35,8,-13,-88,-57,-54,-31,-13,-283
-2,-5,-73,-134,-151,-120,-157,-62,-704
-35,-3,-29,-109,-84,-28,-63,30,-321
-3,22,-25,-67,-53,-38,-29,8,-185
-27,27,9,-79,-86,-25,-59,20,-220
5,34,-91,-150,-128,-155,-105,-72,-662
-117,-26,-129,-364,-278,-242,-178,-84,-1418
-8,17,-28,-251,-181,-123,-103,4,-673
5,32,-6,-17,-18,4,-12,-12,-24
40,25,41,-45,39,-24,-14,51,113
59,48,34,-51,-34,-82,-113,69,-70
-18,6,-14,-38,-22,-21,-24,3,-128
-10,8,-23,-61,-81,-56,-58,-52,-333
-12,-5,-5,-29,-29,-13,-20,10,-103
-1,75,-26,-158,-138,-104,-104,15,-441
-51,0,-72,-130,-92,-34,-98,0,-477
16,-5,3,-70,-13,4,-32,77,-20
-87,-10,-71,-156,-119,-61,-104,-21,-629
-15,38,-45,-98,-101,-71,-135,31,-396
0,65,-26,-169,-44,-125,-80,0,-379
109,94,22,-171,-183,-260,-136,-57,-582
28,48,8,-7,-6,-14,0,29,86
-8,4,-10,-30,-36,-24,-23,-12,-139
12,-3,-3,-23,-42,-48,-27,-17,-151
-70,101,-159,-300,-172,-156,-149,26,-879
-2,-13,-35,-98,-56,-57,-33,43,-251
-100,77,-181,-333,-80,-108,-178,-58,-961
-15,-14,-22,-57,-63,-35,-30,-1,-237
90,86,-16,-92,-67,-140,-91,24,-206
-36,0,-43,-97,-71,-9,-16,19,-253
7,-22,-20,-42,-49,-50,-22,-28,-226
-81,-44,-96,-164,-170,-134,-188,-29,-906
19,31,-20,-85,-93,-93,-72,-29,-342
84,89,-11,-86,-65,-129,-94,-55,-267
-139,-16,-116,-276,-250,-127,-204,32,-1096
11,5,-11,-33,-20,-31,-20,-17,-116
-17,14,-70,-110,-120,-85,-111,-71,-570
-73,14,-48,-160,-94,-72,-117,-51,-601
2,14,-3,-35,-55,-38,-15,-3,-133
-73,24,-110,-191,-114,-93,-137,-2,-696
-68,29,-55,-153,-79,-95,-74,-1,-496
-19,0,-31,-97,-79,-84,-69,1,-378
-6,14,-6,-7,-7,-14,-10,-8,-44
5,8,-26,-39,-37,-35,-34,-33,-191
-91,-52,-119,-162,-117,-82,-127,-28,-778
28,20,-40,-110,-115,-109,-119,-31,-476
36,32,-13,-64,-50,-94,-39,-4,-196
-34,-30,-30,-52,-63,-38,-60,-10,-317
19,18,-25,-26,-24,-19,-34,-9,-100
97,104,55,-92,-39,-10,-104,189,200
274,76,-10,-119,-148,-251,-211,-27,-416
-43,-17,-77,-136,-116,-127,-127,-70,-713
1,58,-38,-92,-62,-83,-62,-27,-305
62,78,29,1,-18,-41,-19,8,100
-14,99,-79,-268,-197,-217,-230,-106,-1012
1,31,-32,-117,-80,-97,-68,-58,-420
7,61,-13,-115,-45,-49,17,18,-119
13,63,-12,-131,-31,-88,-40,-2,-228
-3,13,-28,-52,-46,-29,-23,-26,-194
-90,26,-50,-113,-39,-44,-64,-13,-387
18,-37,-31,-54,-91,-88,-82,4,-361
-22,57,-11,-140,-100,-134,-82,50,-382
51,72,-22,-159,-22,-67,-98,52,-193
-10,43,-41,-132,-83,-68,-86,-7,-384
56,67,26,-10,-28,-69,-44,-10,-12
-34,-17,-42,-67,-85,-41,-92,-1,-379
-9,57,-14,-137,-85,-90,-96,38,-336
-94,11,-180,-337,-171,-227,-236,-165,-1399
10,-2,-31,-129,-102,-65,-94,-4,-417
-60,10,-134,-229,-217,-168,-223,-89,-1110
-30,-17,-10,-63,-37,-11,-22,10,-180
-89,110,-102,-168,-201,-102,-133,-36,-721
-82,-33,-103,-185,-193,-117,-157,-20,-890
118,-13,22,51,-82,-99,-48,-21,-72
-254,-61,-194,-454,-256,-150,-227,-103,-1699
34,0,-75,-143,-180,-207,-147,-104,-822
-83,-56,-91,-142,-121,-87,-106,-8,-694
-34,-15,-11,-42,-54,5,-27,13,-165
-49,4,-115,-187,-119,-108,-170,-50,-794
76,-28,8,-82,23,-94,-47,35,-109
-62,-12,-117,-242,-207,-201,-229,-108,-1178
60,64,4,-65,5,-63,-41,64,28
-86,-57,-155,-232,-263,-195,-267,-102,-1357
-51,25,-76,-332,-232,-284,-270,-162,-1382
36,53,-20,-77,-75,-139,-95,-4,-321
-71,-21,-84,-149,-84,-65,-109,-33,-616
-12,7,-3,-49,-17,-19,-10,6,-97
-21,96,-14,-142,-149,-28,-102,107,-253
-3,15,-25,-144,-97,-57,-68,-1,-380
-74,6,-87,-229,-179,-127,-122,-80,-892
-10,7,-37,-73,-107,-60,-53,-21,-354
-108,57,-199,-504,-224,-262,-299,-51,-1590
-17,96,-48,-224,-92,-129,-133,103,-444
-5,3,-32,-97,-84,-80,-38,-25,-358
-20,35,-25,-106,-78,-96,-69,7,-352
0,19,-13,-28,-15,-30,-5,-19,-91
-12,18,-36,-84,-96,-85,-92,-53,-440
38,-9,-62,-195,-126,-174,-132,-68,-728
7,70,-34,-128,-49,-61,-14,-1,-210
-67,7,-88,-197,-131,-84,-141,92,-609
-66,24,-88,-166,-53,-55,-81,-24,-509
257,292,15,-263,-180,-234,-336,-70,-519
-72,-82,-69,-127,-148,-27,-114,11,-628
61,15,24,-8,-12,-44,-46,27,17
-96,-9,-93,-209,-173,-103,-152,-39,-874
-22,65,-38,-167,-52,-102,-27,17,-326
-46,30,-94,-164,-113,-82,-118,15,-572
-19,2,-65,-139,-138,-89,-102,-23,-573
22,17,9,8,0,-4,17,-6,63
-23,9,-71,-112,-118,-52,-101,-12,-480
2,38,-33,-115,-50,-66,-97,-10,-331
-16,-8,-16,-15,-13,-6,-7,-9,-90
-19,5,-15,-60,-56,-50,-83,-17,-295
5,11,1,-26,-18,-40,-3,-1,-71
97,30,-10,-72,-20,-54,-57,3,-83
-7,-2,-49,-60,-73,-60,-84,-50,-385
-39,-17,-55,-148,-125,-87,-82,-23,-576
-25,28,-43,-134,-65,-66,-55,-2,-362
-163,-86,-363,-644,-435,-424,-488,-145,-2748
532,192,312,-45,389,-30,-115,296,1531
22,128,7,-129,-42,-119,9,9,-115
23,80,-15,-103,-60,-110,-105,-53,-343
-81,18,-103,-223,-125,-103,-94,-78,-789
-23,27,-31,-98,-50,-48,-55,-10,-288
-61,46,-92,-284,-142,-91,-100,106,-618
-2,55,-75,-195,-120,-122,-127,0,-586
-27,18,-41,-151,-94,-50,-68,-31,-444
45,102,34,-8,19,25,-116,32,133
17,7,-112,-468,-343,-407,-443,54,-1695
-2,17,13,-39,-18,2,-7,10,-24
-24,1,-26,-79,-83,-36,-46,-6,-299
147,66,-2,-188,-231,-251,-197,25,-631
-47,114,-89,-147,-67,1,-18,32,-221
-39,66,-93,-143,-99,-80,-81,-2,-471
144,47,57,108,-71,-99,-68,-65,53
74,102,22,-44,-65,-92,-42,58,13
-80,-39,-83,-132,-96,-56,-115,-6,-607
-24,0,-38,-65,-22,-44,-30,-41,-264
-4,29,-5,-32,-2,-24,-7,2,-43
-20,-7,-44,-123,-39,-90,-83,-41,-447
-63,-16,-95,-136,-111,-100,-129,-27,-677
-72,-12,-63,-157,-119,-73,-121,31,-586
77,156,-17,-149,-38,-104,-103,48,-130
63,47,9,18,-28,-15,-27,-4,63
-37,61,-38,-100,-33,5,-41,-15,-198
-34,-8,-65,-125,-88,-82,-113,-15,-530
-53,16,-117,-180,-145,-103,-147,-24,-753
11,40,0,-55,-19,-16,-11,13,-37
-10,-9,-10,-24,-20,-27,-26,-1,-127
-20,-8,-40,-60,-102,-70,-59,-5,-364
-35,2,-55,-134,-130,-96,-70,-22,-540
-17,-7,-11,-18,-12,-9,-14,-4,-92
67,61,5,-93,-105,-167,-97,-50,-379
-71,56,-40,-141,-46,-38,-71,-12,-363
22,20,-18,-117,18,-50,-87,54,-158
54,82,-42,-86,-26,-99,-87,-33,-237
-46,-45,-37,-69,-87,-45,-47,-12,-388
-8,30,-8,-98,-58,-103,-56,-36,-337
1,4,12,-35,-58,-57,-44,14,-163
9,13,-23,-118,-76,-74,-114,-3,-386
-70,22,-174,-459,-265,-335,-290,-100,-1671
16,-52,-40,-189,-210,-234,-164,-35,-908
-15,27,-19,-39,-94,-20,-44,-8,-212
-3,11,-34,-62,-80,-47,-64,-23,-302
5,-5,-15,-36,-16,-32,-31,-8,-138
-155,10,-215,-636,-587,-417,-438,-56,-2494
-21,-12,-12,-72,-76,-52,-56,-5,-306
-44,-50,-60,-104,-105,-83,-92,-7,-545
27,89,8,-132,-91,-215,-133,99,-348
66,7,-21,-68,-187,-191,-114,2,-506
-11,4,-42,-52,-73,-61,-78,-28,-341
-34,-11,-65,-88,-83,-63,-70,-3,-417
-45,-13,-66,-102,-94,-55,-75,-10,-460
804,387,327,177,387,-207,-272,340,1943
13,35,-57,-126,-32,-95,-91,-49,-402
25,57,-7,-105,6,-62,-62,-3,-151
-5,19,-19,-56,-23,-47,-35,-12,-178
118,106,32,-135,-100,-233,-140,91,-261
81,72,-3,-185,10,-125,-64,27,-187
163,479,-14,-453,91,-277,-127,210,72
29,98,-75,-305,-244,-303,-311,-30,-1141
14,21,-4,-17,-24,-36,-23,6,-63
-21,-5,-31,-83,-106,-50,-106,12,-390
-4,-2,-33,-40,-56,-58,-51,-42,-286
-46,-9,-51,-287,-295,-168,-226,126,-956
54,101,-23,-209,-102,-196,-110,-7,-492
-99,-11,-90,-153,-104,-57,-119,3,-630
-43,125,-135,-340,-173,-218,-189,-15,-988
110,84,-25,-185,-122,-238,-168,4,-540
169,194,-31,-348,-20,-283,-235,-33,-587
-17,28,-17,-73,-19,-7,-23,-10,-138
26,-6,-16,-82,-154,-67,-85,0,-384
28,20,-16,-80,-8,-41,-24,23,-98
30,69,-3,-106,-29,-82,-47,74,-94
18,73,-23,-88,-19,-76,-27,17,-125
1,-2,-14,-26,-21,-13,-20,-8,-103
-2,-35,-18,-79,-100,-58,-81,45,-328
16,-21,-18,-40,-51,-41,-18,-14,-187
262,152,29,-293,-7,-341,-255,35,-418
-15,2,-13,-49,-44,-30,-30,6,-173
32,18,-11,-26,-61,-33,-14,-14,-109
-20,25,-68,-97,-54,-83,-96,-53,-446
3,35,-18,-101,-101,-39,-46,49,-218
-68,169,-95,-565,-307,-312,-349,-190,-1717
13,-2,-44,-51,-69,-80,-59,-56,-348
-71,5,-77,-125,-96,-85,-139,-23,-611
12,15,-40,-71,-57,-63,-53,-29,-286
182,149,34,-155,-79,-219,-138,112,-114
-26,1,-44,-79,-58,-61,-50,-17,-334
38,41,9,-14,12,-18,6,10,84
-21,8,-12,-53,-12,-35,-17,-6,-148
7,25,-8,-15,-30,-4,6,1,-18
-7,41,-24,-59,-21,-33,-20,-20,-143
6,17,10,0,8,8,16,-3,62
-11,121,-94,-252,-157,-219,-246,1,-857
-48,-20,-52,-73,-56,-35,-79,-27,-390
2,14,-5,-10,1,5,2,-15,-6
16,33,5,-54,20,-20,-35,6,-29
-117,107,-151,-332,-186,-163,-163,-56,-1061
25,37,10,-30,-49,-45,-28,-31,-111
-13,3,-6,-20,-24,-6,-10,-4,-80
-109,-55,-99,-148,-108,-41,-101,-35,-696
43,34,48,0,15,-11,-45,63,147
-79,87,-61,-157,-26,-31,-58,-34,-359
-8,26,7,16,12,-15,-11,7,34
-42,-16,-68,-192,-34,-101,-111,12,-552
5,71,-22,-155,-32,-70,-82,26,-259
88,89,62,-97,-58,-161,-99,114,-62
117,116,77,-84,16,-121,-119,121,123
-17,12,-8,-79,-32,-44,-36,-20,-224
-29,227,-162,-328,-176,-251,-142,86,-775
-73,201,-105,-409,-97,-166,-96,28,-717
-24,3,-17,-86,-119,-102,-134,-12,-491
-37,-2,-10,-66,-41,-41,-47,-11,-255
304,147,110,-56,-67,-204,-64,120,290
-45,-15,-74,-86,-83,-48,-79,-18,-448
-28,-18,-51,-75,-96,-67,-67,-32,-434
-29,13,-39,-94,-95,-71,-62,-1,-378
-19,2,-26,-74,-31,-28,-27,4,-199
10,6,-29,-70,-29,-65,-34,-20,-231
-14,55,-19,-75,-61,-34,-94,62,-180
-60,8,-108,-231,-113,-122,-160,-59,-845
-73,-32,-92,-146,-77,-92,-106,-8,-626
-41,5,-55,-136,-147,-101,-126,-7,-608
-32,-11,-39,-63,-56,-40,-57,-6,-304
-21,-31,-33,-43,-49,-46,-60,-28,-311
1091,822,164,-1194,533,-996,-805,272,-113
-142,92,-120,-275,-78,-141,-102,-65,-831
7,40,-13,-41,-34,-40,-37,17,-101
-17,198,-158,-412,-227,-243,-231,-26,-1116
-32,7,-45,-150,-47,-54,-69,-4,-394
-59,-37,-49,-97,-115,-82,-109,26,-522
-139,71,-141,-320,-262,-153,-223,-48,-1215
-26,-6,-47,-74,-95,-58,-62,-32,-400
-7,7,-38,-56,-117,-75,-73,-50,-409
-24,43,-9,-125,-48,-66,-65,-15,-309
-12,-13,-13,-60,-59,-67,-60,-11,-295
-33,-12,-59,-76,-67,-62,-90,-31,-430
7,12,3,-11,-22,-17,-11,-20,-59
-42,-35,-73,-176,-111,-100,-97,-20,-654
37,43,-15,-43,-49,-60,-8,-14,-109
-86,-7,-115,-421,-295,-376,-305,-117,-1722
-23,20,-9,-73,-27,-50,-31,1,-192
-36,-8,-31,-96,-98,-73,-100,-21,-463
-35,10,-47,-123,-59,-66,-53,-27,-400
-1,63,-8,-103,-52,-50,-66,2,-215
-36,-35,-48,-97,-174,-113,-106,13,-596
80,23,35,-3,8,-68,-69,26,32
24,87,4,-86,-20,-61,-13,0,-65
-47,30,-88,-186,-134,-101,-113,-3,-642
39,53,2,-92,-55,-64,-112,40,-189
-2,52,-12,-32,-102,-61,-68,-3,-228
62,23,-1,-243,-105,-103,-149,12,-504
-26,53,-65,-182,-68,-68,-113,-57,-526
6,83,-10,-156,-84,-111,-100,-24,-396
-27,67,-52,-152,-88,6,-115,103,-258
-102,-27,-185,-272,-188,-170,-224,-122,-1290
3,5,-16,-53,-67,-48,-70,23,-223
4,28,-47,-99,-78,-78,-84,-44,-398
-29,-25,-40,-91,-51,-67,-35,-31,-369
-46,1,-53,-102,-66,-30,-45,16,-325
-76,37,-104,-346,-283,-247,-270,-39,-1328
-25,5,-30,-50,-16,-23,-10,-6,-155
23,55,-7,-44,-3,-30,-41,46,-1
-123,33,-156,-377,-290,-168,-233,-103,-1417
-88,-72,-100,-147,-117,-88,-140,-50,-802
-30,-18,-16,-55,-61,-19,-25,-4,-228
12,30,8,3,-13,1,-5,-26,10
79,7,11,1,-21,-66,-62,-5,-56
-25,-36,-71,-147,-146,-78,-107,-32,-642
-27,-6,-51,-56,-70,-35,-106,-36,-387
-12,-3,2,-55,-65,-23,-30,3,-183
-124,15,-140,-382,-246,-280,-257,-58,-1472
16,-34,-40,-88,-53,-67,-79,5,-340
-93,-25,-61,-198,-126,-80,-103,1,-685
-71,12,-81,-200,-132,-161,-155,-33,-821
-22,-7,-18,-71,-56,-26,-45,-5,-250
4,50,-25,-82,-17,-69,-22,-8,-169
67,81,27,-208,-336,-192,-225,-23,-809
19,17,-62,-72,-93,-100,-110,-83,-484
-37,3,-55,-133,-100,-84,-98,-43,-547
-33,-8,-22,-79,-70,-14,-46,-18,-290
-51,15,-76,-136,-115,-109,-115,-12,-599
-11,132,-67,-186,-68,-124,-95,39,-380
-32,-10,-27,-120,-120,-119,-103,-57,-588
0,45,-59,-94,-50,-81,-47,-42,-328
-16,6,-30,-29,-48,-28,-47,-12,-204
-9,10,-19,-70,-24,-50,-34,-7,-203
-21,14,-25,-34,-48,-46,-61,-37,-258
-16,11,-28,-93,-28,-21,-43,30,-188
5,53,-35,-140,-63,-98,-82,-10,-370
0,31,-19,-76,-96,-67,-58,-43,-328
5,46,-40,-70,-72,-89,-70,-42,-332
-4,4,14,-22,-14,-6,-17,9,-36
40,25,-2,-58,-69,-60,-38,-43,-205
-2,6,-8,-79,-47,-37,-48,-6,-221
45,87,-58,-235,-166,-169,-125,64,-557
-58,55,-72,-248,-89,-128,-132,-58,-730
-20,-4,-10,-45,-32,-26,-26,16,-147
180,251,35,-219,-128,-238,-151,79,-191
28,41,0,-13,-40,-49,-47,-37,-117
6,34,-12,-81,-130,-85,-53,3,-318
-47,-45,-38,-112,-73,-49,-74,-5,-443
-11,10,-17,-72,-53,-47,-48,-9,-247
-18,-14,-21,-53,-8,-18,-20,-15,-167
-59,-8,-83,-226,-184,-144,-177,-24,-905
-62,-22,-66,-298,-214,-207,-219,-68,-1156
-29,15,-34,-61,-45,-23,-24,3,-198
-17,45,-25,-105,-56,-74,-66,-26,-324
-14,-9,-10,-37,-24,-18,-6,0,-118
4,1,-7,-10,-35,-9,-9,-11,-76
-12,-11,-13,-9,-27,-12,-18,-12,-114
-33,-14,-54,-83,-93,-17,-52,27,-319
-1,17,-13,-27,-30,0,-7,9,-52
110,60,11,-77,-26,-100,-122,17,-127
-12,26,-34,-119,-28,-66,-9,-24,-266
-22,23,-18,-48,-42,-37,-42,-1,-187
-30,-4,-83,-108,-55,-4,-18,36,-266
-47,6,-33,-101,-56,-30,-49,-16,-326
22,244,-32,-207,-157,-160,-63,73,-280
-63,-65,-86,-137,-202,-91,-126,-29,-799
146,94,-41,-214,-150,-234,-207,25,-581
-4,3,-43,-75,-75,-41,-59,36,-258
-17,133,-36,-208,7,-127,-81,-38,-367
87,58,44,-29,-39,-4,-10,51,158
-161,-78,-169,-322,-256,-181,-268,-85,-1520
-147,63,-239,-582,-398,-394,-457,-177,-2331
-60,-19,-78,-244,-301,-132,-223,-69,-1126
-20,37,-68,-131,-59,-90,-99,25,-405
11,54,-1,-13,-24,-21,-6,23,23
87,64,19,-99,-17,-97,-86,88,-41
2,106,-93,-302,-205,-262,-194,54,-894
171,307,24,-146,51,-126,-70,172,383
145,339,37,-293,-136,-380,-196,-48,-532
51,135,-39,-339,23,-182,-164,41,-474
296,573,0,-492,-175,-519,-252,261,-308
121,95,-145,-465,-579,-600,-553,-537,-2663
357,501,-25,-586,-26,-568,-260,147,-460
571,216,130,-229,76,-405,-294,198,263
-77,29,-95,-429,-380,-254,-332,45,-1493
-105,-23,-101,-235,-151,-114,-132,47,-814
76,87,0,-192,-130,-126,-96,82,-299
60,85,0,-96,-101,-119,-76,-61,-308
62,205,-88,-326,-199,-281,-224,99,-752
-69,-3,-52,-175,-153,-101,-150,-7,-710
-34,136,-52,-254,-13,-115,-29,50,-311
322,193,25,-310,-14,-318,-193,266,-29
58,92,1,-112,-32,-150,-89,-81,-313
-291,22,-410,-844,-631,-545,-500,-301,-3500
338,89,43,-321,14,-322,-283,116,-326
119,159,-20,-234,-3,-198,-150,104,-223
81,59,-50,-348,-181,-234,-218,0,-891
-26,56,-44,-147,-97,-112,-140,-19,-529
178,260,44,-226,-304,-212,-137,-8,-405
39,98,21,-124,-26,-93,-88,114,-59
179,130,2,-132,-43,-149,-168,29,-152
-26,83,-7,-164,-82,-53,-68,-17,-334
113,77,-37,-235,-261,-249,-177,-109,-878
-32,97,-114,-254,-176,-216,-218,-55,-968
447,272,37,-186,-111,-333,-202,8,-68
-49,70,-24,-217,-122,-90,-164,70,-526
2,75,-24,-178,-116,-108,-80,89,-340
-314,278,-286,-869,-223,-167,-496,-443,-2520
17,71,7,-99,-40,-102,-87,48,-185
-95,167,-92,-246,-84,-159,-185,-165,-859
20,62,-151,-168,-329,-280,-193,-178,-1217
100,182,-69,-411,-106,-278,-206,-52,-840
137,259,-51,-141,6,-214,-160,-38,-202
-63,-9,-73,-168,-109,-91,-96,-35,-644
37,54,-12,-85,-44,-94,-61,-12,-217
-90,48,-109,-243,-110,-139,-173,-62,-878
-18,5,-10,-57,-42,-10,-22,-13,-167
130,126,12,-94,98,6,16,107,401
-107,-39,-180,-314,-295,-160,-342,43,-1394
125,44,1,-90,-136,-176,-90,-49,-371
-25,-6,-40,-86,-80,-49,-75,-10,-371
-40,-74,-46,-76,-96,-58,-74,-11,-475
-26,50,-15,-99,-43,-31,-82,26,-220
-4,-19,-31,-44,-45,-41,-46,-5,-235
-25,-24,-46,-91,-69,-58,-66,0,-379
24,27,-9,-17,3,-19,-6,-1,2
-50,-26,-85,-160,-109,-87,-73,-18,-608
-15,22,-37,-47,-101,-47,-49,-2,-276
-34,-30,-34,-58,-88,-34,-60,8,-330
-15,3,-21,-44,-13,-11,-25,2,-124
-71,-25,-116,-255,-210,-186,-186,-13,-1062
-16,70,-40,-107,-77,-84,-49,15,-288
-2,21,-20,-29,-5,-7,-35,6,-71
59,36,5,-64,-49,-110,-78,-24,-225
-19,-25,-17,-67,-98,-53,-42,-10,-331
22,26,-13,-42,-14,32,-20,46,37
44,86,-38,-226,-6,-114,-113,82,-285
23,16,3,-77,-2,-36,-32,46,-59
50,93,17,-124,-72,-159,-100,52,-243
-4,3,-6,-14,-27,-19,-18,5,-80
51,49,-17,4,-42,-48,-28,-20,-51
69,29,6,-8,2,-61,-90,36,-17
-9,7,-22,-24,-42,-7,-7,-15,-119
-28,-7,-43,-87,-47,-51,-53,5,-311
52,38,-52,-154,-158,-156,-122,2,-550
75,78,-32,-157,-177,-258,-214,-19,-704
15,31,-32,-111,-31,-81,-55,36,-228
-62,28,-58,-124,-71,-63,-72,-24,-446
-23,11,-33,-57,-38,-28,-23,-4,-195
142,113,85,-43,-9,-57,-76,90,245
51,102,-9,-212,-66,-188,-166,-2,-490
9,19,-2,-29,-6,-13,-21,-21,-64
-5,24,3,-132,-125,-82,-58,-24,-399
-26,-14,-40,-77,-46,-27,-45,-19,-294
-92,-38,-87,-178,-119,-129,-160,-23,-826
-3,9,-9,-17,3,-22,-11,-9,-59
10,50,-9,-120,-71,-78,-58,36,-240
-95,-3,-128,-235,-135,-107,-135,-23,-861
-68,-46,-58,-151,-98,-69,-111,11,-590
233,369,-56,-563,-471,-559,-732,-193,-1972
132,116,26,-99,-57,-121,-23,94,68
-2,45,-17,-81,-104,-74,-103,-29,-365
178,82,106,-34,74,-55,-16,121,456
-17,17,-13,-48,-12,-14,-28,-9,-124
-9,0,-13,-21,-27,-23,-15,0,-108
160,73,25,-89,-35,-134,-57,-25,-82
-14,-9,-37,-46,-66,-21,-52,-8,-253
-89,-44,-107,-199,-173,-115,-154,-37,-918
-54,-7,-117,-175,-146,-126,-147,-77,-849
-19,-13,-38,-59,-32,-31,-23,-19,-234
-13,11,-102,-190,-171,-162,-133,-84,-844
13,18,1,-81,-10,-95,-58,0,-212
-43,-33,-32,-68,-63,-36,-57,2,-330
-39,70,-78,-227,-96,-113,-122,2,-603
-41,-17,-70,-93,-72,-53,-92,-36,-474
-15,1,-6,-24,-9,4,-15,-5,-69
-22,-13,-22,-94,-70,-30,-47,-14,-312
137,157,44,-149,92,-144,-71,154,220
23,20,-2,-30,-48,-35,-30,-26,-128
-31,-6,-51,-136,-112,-63,-109,-27,-535
-30,-14,-42,-117,-166,-87,-114,-12,-582
1,15,5,-47,-16,-30,-10,-9,-91
15,91,-117,-206,-123,-203,-172,-172,-887
-30,-96,-123,-175,-284,-225,-204,-175,-1312
-19,-3,-80,-220,-124,-153,-155,-67,-821
15,41,-6,-130,-81,-108,-55,39,-285
-21,28,-55,-212,-258,-207,-223,-3,-951
7,27,-21,-34,-53,-47,-44,-6,-171
-16,1,-18,-68,-41,-13,-33,0,-188
-31,33,-52,-123,-81,-95,-100,-38,-487
9,31,-10,-20,-6,-6,24,12,34
-87,-42,-79,-219,-170,-109,-167,11,-862
-92,52,-137,-302,-137,-139,-187,-42,-984
-10,20,-58,-121,-45,-83,-62,-88,-447
-27,-15,-31,-33,-16,-11,-30,-3,-166
-70,-8,-83,-182,-168,-110,-137,8,-750
11,26,-5,-17,10,29,22,14,90
56,40,40,-96,-28,-88,-112,67,-121
156,58,31,-99,93,-99,-128,10,22
-25,38,-77,-183,-149,-138,-141,-36,-711
66,129,-1,-47,-23,-23,2,70,173
82,104,-66,-351,-138,-223,-199,25,-766
-124,40,-219,-499,-382,-445,-412,-178,-2219
91,31,28,-12,-36,-58,-22,4,26
-5,8,-7,-102,-65,-56,-19,66,-180
-19,27,-33,-73,-34,-47,-65,16,-228
-68,-8,-126,-160,-141,-85,-172,-18,-778
-39,3,-100,-154,-141,-126,-168,-72,-797
-11,-39,-22,-48,-84,-25,-58,47,-240
-28,61,-89,-207,-184,-144,-113,-51,-755
-40,13,-27,-97,-60,-33,-85,-28,-357
10,91,-41,-163,-33,-113,-88,9,-328
14,43,-2,-49,8,-7,-11,36,32
-9,7,-21,-31,-17,-5,-10,-20,-106
2,16,-25,-25,-60,-32,-77,57,-144
-22,39,-85,-200,-144,-77,-60,61,-488
-144,-86,-151,-325,-264,-156,-262,-67,-1455
181,-5,-11,-228,-247,-380,-292,-45,-1027
-20,0,-21,-81,-53,-46,-48,20,-249
-86,2,-85,-168,-184,-86,-158,-6,-771
61,52,14,-140,19,-116,-118,78,-150
30,108,9,-205,-3,-137,-137,120,-215
667,504,92,-366,-101,-695,-398,-58,-355
-24,7,-94,-110,-154,-94,-145,-51,-665
19,17,16,-2,7,-11,0,2,48
-21,15,-20,-28,-27,-33,-80,4,-190
-28,-6,-42,-51,-48,-42,-68,-9,-294
-154,-34,-301,-507,-446,-339,-474,-99,-2354
-193,-10,-224,-453,-349,-226,-394,-62,-1911
-169,28,-184,-482,-366,-283,-368,-73,-1897
-7,-12,0,-60,-46,-20,-43,38,-150
-7,-1,-24,-38,-42,-47,-30,-15,-204
76,100,46,-90,42,-14,44,38,242
-140,39,-196,-353,-59,-141,-170,-87,-1107
-63,36,-130,-240,-162,-173,-189,10,-911
-15,11,-30,-99,-145,-122,-99,-36,-535
-64,-24,-61,-131,-90,-52,-78,13,-487
-28,-5,-21,-55,-24,-27,-19,-8,-187
8,45,-26,-57,-39,-46,-31,1,-145
-14,37,-14,-72,-42,-30,-54,5,-184
-6,40,-20,-86,-60,-79,-31,11,-231
-38,46,-63,-145,-70,-116,-116,-43,-545
-45,-27,-25,-117,-159,-89,-77,-6,-545
23,34,-40,-107,-34,-97,-84,18,-287
-5,13,-21,-44,-35,-39,-39,-29,-199
-16,17,-29,-26,-11,-19,-40,-32,-156
-14,6,-17,-42,-46,-42,-41,-2,-198
26,23,-8,-23,-50,-77,-24,-8,-141
-6,-16,-43,-69,-88,-81,-73,-16,-392
127,105,38,15,43,-35,-16,86,363
13,12,-7,-12,-31,-29,-9,4,-59
-1,20,-18,-36,-24,-14,-10,-6,-89
25,109,-25,-254,-47,-120,-136,121,-327
-52,22,-65,-161,-77,-81,-110,-27,-551
-14,15,-27,-41,-20,-35,-29,11,-140
29,16,3,-58,-27,-73,-39,-7,-156
61,100,14,-67,-57,-77,-43,51,-18
12,-26,1,-53,-66,-80,-46,6,-252
-5,18,-7,-51,-38,-37,-28,-13,-161
5,-3,-41,-82,-89,-93,-75,-31,-409
3,-7,-46,-171,-121,-166,-118,-78,-704
-40,1,-50,-132,-101,-78,-100,-39,-539
-10,13,-44,-133,-53,-88,-60,-2,-377
81,49,-43,-99,-47,-135,-94,-54,-342
282,221,39,-181,-10,-270,-244,108,-55
-54,38,-31,-127,-33,-65,-44,-37,-353
-14,5,-26,-43,-26,-23,-39,-2,-168
-10,19,-33,-40,-23,-12,-29,-21,-149
-16,8,-2,-27,-34,-1,-11,5,-78
2,27,1,-30,-23,-20,0,23,-20
8,39,-12,-64,12,-37,-42,-23,-119
5,14,-30,-97,-82,-55,-81,-11,-337
64,126,-70,-220,-124,-212,-227,14,-649
-1,12,-35,-59,-76,-76,-68,-40,-343
-46,-7,-84,-153,-104,-91,-100,-4,-589
-22,81,-15,-187,-85,-102,-124,20,-434
-45,11,-69,-153,-114,-105,-151,-92,-718
-86,-22,-78,-175,-108,-87,-116,13,-659
-59,-4,-52,-211,-191,-137,-155,-48,-857
-32,9,-94,-232,-187,-243,-211,-49,-1039
-28,47,-26,-109,-48,-34,-28,5,-221
-159,195,-372,-737,-534,-617,-581,-239,-3044
-4,38,-77,-219,-112,-149,-173,-36,-732
303,209,38,-244,28,-253,-198,8,-109
-42,19,-80,-222,-32,-122,-118,-24,-621
-137,15,-209,-390,-229,-257,-324,-163,-1694
83,107,-85,-515,-346,-446,-432,-50,-1684
-2,27,-16,-80,-49,-82,4,-9,-207
77,131,-23,-61,-58,-96,-1,119,88
70,250,-21,-397,-136,-301,-253,240,-548
-33,99,-52,-181,-62,-81,-72,32,-350
1,12,-23,-39,-41,-41,-32,10,-153
-24,44,-23,-107,-135,-86,-73,-47,-451
-60,-15,-45,-103,-57,-60,-73,4,-409
-57,21,-49,-196,-99,-109,-114,-58,-661
27,41,-43,-138,-144,-107,-98,-67,-529
-15,11,10,-38,-36,-42,-17,12,-115
117,170,-13,-180,-62,-227,-143,42,-296
4,80,-54,-170,-94,-123,-133,-22,-512
73,3,21,-15,1,-78,-47,46,4
-17,36,-52,-163,-100,-152,-119,-34,-601
35,70,-2,-128,-23,-128,-73,15,-234
-37,-10,-61,-191,-140,-143,-126,-26,-734
-92,12,-75,-189,-98,-111,-133,17,-669
-70,34,-147,-286,-182,-170,-188,-72,-1081
-11,-1,11,-114,-55,-56,-24,7,-243
14,62,-19,-93,-44,-69,-59,11,-197
6,-2,-17,-54,-58,-71,-62,-23,-281
-17,-20,-42,-126,-126,-111,-93,-46,-581
-33,16,-133,-190,-182,-198,-226,-60,-1006
59,59,15,-35,-7,-56,-24,8,19
30,17,12,-26,16,-55,-12,36,18
106,30,15,-10,-75,-46,-55,46,11
-23,-16,-23,-109,-148,-86,-80,-34,-519
-10,16,-30,-67,-75,-70,-81,-14,-331
8,12,11,-17,-17,-17,-17,-2,-39
-13,7,-18,-33,-9,-19,-20,-8,-113
-103,46,-124,-292,-122,-158,-177,-69,-999
11,-21,-55,-117,-173,-131,-142,-89,-717
15,33,-31,-86,-45,-53,-65,8,-224
-4,21,-57,-113,-70,-95,-124,-68,-510
150,8,8,-88,-29,-135,-128,-3,-217
-13,112,-49,-225,-93,-169,-99,45,-491
-19,4,-26,-78,-57,-55,-53,17,-267
21,157,9,-196,-105,-130,-26,-36,-306
-6,10,-12,-37,-47,-40,-43,16,-159
-5,20,-131,-218,-150,-205,-199,-146,-1034
-19,22,-44,-133,-97,-90,-79,-41,-481
50,61,-7,-93,34,-75,-74,7,-97
-49,43,-41,-273,-160,-191,-190,45,-816
-47,91,-45,-137,-45,-52,-63,2,-296
5,44,-4,-68,-42,-73,-53,41,-150
-27,44,-120,-283,-225,-269,-259,-136,-1275
-73,30,-81,-191,-68,-82,-126,-47,-638
-23,-2,-48,-149,-179,-96,-108,-15,-620
14,136,-53,-235,-87,-83,-67,49,-326
-24,35,-84,-230,-144,-172,-118,-36,-773
-105,-53,-151,-306,-351,-286,-312,-116,-1680
-53,-54,-57,-116,-113,-71,-81,-19,-564
-69,81,-43,-144,-58,-59,-51,-24,-367
15,72,-4,-132,-10,-83,-82,24,-200
102,124,27,-132,0,-120,-104,104,1
105,173,-20,-148,-34,-122,-96,79,-63
-79,86,-77,-339,-208,-175,-148,34,-906
-20,-9,-55,-64,-104,-31,-81,-13,-377
6,22,-17,-106,-73,-92,-59,-32,-351
25,92,-2,-148,-71,-78,-100,62,-220
-2,16,-20,-55,-22,-40,-23,-7,-153
23,3,-24,-90,-125,-136,-85,-72,-506
-19,10,-36,-59,-32,-41,-36,-16,-229
-18,4,-7,-58,-19,-29,-21,-17,-165
-219,99,-138,-306,-194,-29,-163,-146,-1096
58,17,38,-8,-51,-51,-50,25,-22
-38,36,-57,-176,-79,-119,-113,-24,-570
-126,34,-73,-189,-80,-81,-84,-33,-632
41,54,-4,-80,16,-62,-46,19,-62
132,22,69,32,35,-83,-82,38,163
-39,44,-79,-258,-149,-169,-137,-65,-852
52,103,-85,-380,-208,-281,-261,57,-1003
113,55,70,7,-31,-4,-42,72,240
-49,17,-6,-174,-108,-72,-78,-20,-490
4,15,-31,-36,-30,-12,-4,33,-61
6,37,4,-50,-28,-39,-23,-7,-100
-20,-21,-29,-24,-60,-48,-46,-29,-277
-6,6,-37,-58,-165,-30,-62,49,-303
7,2,-23,-67,-46,-49,-74,-21,-271
-101,5,-141,-254,-158,-146,-108,-50,-953
12,83,-26,-43,-2,-7,14,12,43
-90,29,-76,-242,-213,-147,-208,16,-931
125,136,-64,-377,-101,-216,-233,100,-630
-25,11,-53,-110,-93,-88,-94,-53,-505
31,78,-37,-404,-140,-165,-218,33,-822
63,-47,-1,-23,-57,-71,-49,-12,-197
29,44,10,-128,-51,-130,-87,-14,-327
4,5,-1,-13,-23,27,-18,14,-5
31,43,-12,-60,-77,-70,-64,-21,-230
13,-47,-83,-300,-236,-188,-287,130,-998
-70,-30,-88,-184,-137,-102,-157,25,-743
-38,-8,-27,-91,-92,-64,-43,1,-362
21,20,-10,-144,-167,-146,-63,-22,-511
101,72,60,-58,28,-104,-104,41,36
-4,10,-16,-55,-53,-46,-50,-12,-226
21,-4,-28,-53,-105,-101,-65,-60,-395
-124,58,-188,-312,-173,-159,-221,-35,-1154
-31,122,-3,-257,-131,-84,-30,25,-389
110,127,24,-9,41,-45,44,44,336
-31,182,-265,-670,-381,-550,-586,34,-2267
-42,7,-38,-130,-99,-80,-76,-32,-490
-5,9,-3,-16,-29,-16,-15,-1,-76
10,-28,-54,-109,-64,-87,-70,-31,-433
-79,35,-89,-145,-80,-47,-138,16,-527
18,31,-35,-73,-67,-75,-46,-8,-255
-118,2,-138,-272,-237,-98,-178,8,-1031
-24,-3,-19,-78,-31,-29,-36,-21,-241
223,42,85,-64,111,-100,-16,84,365
-138,-99,-159,-327,-369,-196,-238,-43,-1569
33,4,18,-26,0,-46,-39,16,-40
162,166,58,-46,18,-144,-94,101,221
18,23,-39,-183,-126,-152,-149,-25,-633
35,49,-45,-197,-135,-172,-154,47,-572
-75,-50,-47,-130,-89,-45,-61,-26,-523
69,61,7,-105,-83,-124,-75,11,-239
2,28,-37,-128,-85,-109,-75,-70,-474
-35,18,-67,-119,-35,-69,-68,1,-374
-20,23,-55,-152,-113,-72,-81,58,-412
22,14,-10,-33,-18,-45,-15,-21,-106
-15,-17,-25,-131,-51,-48,-62,22,-327
-8,33,-19,-69,-53,-73,-72,-20,-281
68,46,18,-85,32,-100,-48,29,-40
56,34,5,-30,-16,-59,-50,33,-27
37,101,-23,-168,-48,-125,-88,-33,-347
-41,23,-69,-110,-73,-44,-56,25,-345
-1,4,-37,-90,-28,-52,-64,11,-257
10,37,-32,-143,-100,-115,-126,-6,-475
-35,26,-29,-115,-34,-53,-25,2,-263
-3,22,-17,-28,-41,-4,-4,-4,-79
0,12,-19,-81,-77,-63,-76,-25,-329
-110,-40,-154,-330,-224,-174,-260,-103,-1395
176,157,-13,-189,-23,-225,-198,-127,-442
-11,52,-23,-76,5,-30,-42,13,-112
20,19,-9,-39,-66,-52,-16,-5,-148
37,49,-10,-66,-22,-47,-31,47,-43
-39,-7,-79,-135,-140,-145,-141,-62,-748
-14,58,-31,-78,-34,-62,-60,9,-212
-4,65,-42,-88,-50,-82,-51,-13,-265
16,23,-31,-38,-29,-61,-31,-34,-185
-60,-53,-66,-152,-143,-140,-148,-29,-791
-100,-35,-80,-183,-136,-115,-135,-1,-785
-16,27,-32,-113,-71,-64,-79,-38,-386
-10,14,-13,-39,-45,-31,-35,-6,-165
-7,29,-34,-70,-15,-56,-61,16,-198
12,30,0,-30,-52,-32,-48,-3,-123
69,23,28,-53,13,-42,-49,39,28
13,18,-2,-56,-45,-53,-13,34,-104
0,25,-31,-17,-28,-21,-25,-18,-115
-57,-9,-56,-71,-88,-33,-79,-12,-405
-16,6,4,-96,-120,-76,-80,20,-358
-48,70,-34,-209,-68,-82,-117,-28,-516
-3,10,-19,-44,-5,-13,-29,19,-84
133,48,67,-8,55,-11,-46,96,334
-24,-29,-16,-67,-75,-37,-36,-15,-299
8,5,-10,-1,-18,-13,-5,-15,-49
-8,-2,-16,-35,-9,-20,-14,-6,-110
4,1,-10,-24,-19,-21,-3,-9,-81
2,18,-10,-89,-22,-52,-45,37,-161
11,43,3,-37,-8,-36,-18,7,-35
-8,5,-33,-59,-51,-25,-61,-4,-236
-9,26,-71,-223,-108,-145,-146,-1,-677
-26,-20,-3,-48,-48,-36,-21,37,-165
15,34,-6,-23,9,-14,6,7,28
-35,-18,-52,-85,-85,-81,-86,-14,-456
-1,-35,-29,-37,-32,-42,-68,17,-227
3,51,-20,-107,-53,-56,-84,25,-241
-42,-8,-44,-87,-34,-17,-29,-9,-270
-36,-41,-90,-144,-233,-161,-168,-114,-987
-22,-6,-32,-59,-52,-39,-36,-10,-256
-2,27,7,-59,-36,-51,-23,8,-129
32,-11,17,-41,-23,-72,-55,6,-147
-2,2,-2,-10,-4,1,0,-11,-26
14,15,-13,-37,-29,-42,-14,-13,-119
83,192,-30,-22,-17,3,72,74,355
-59,-30,-69,-103,-66,-40,-85,-14,-466
53,-29,8,-133,-3,-115,-61,47,-233
-21,-8,-29,-99,-59,-38,-30,-3,-287
-36,-17,-38,-120,-67,-54,-30,-36,-398
-11,18,-19,-67,-21,-34,-35,21,-148
-11,-8,-3,-42,-41,-35,-20,2,-158
-56,35,-110,-261,-191,-169,-200,-39,-991
-80,-18,-80,-134,-88,-86,-146,-23,-655
-21,16,-17,-75,-55,-50,-53,-4,-259
21,-12,-33,-13,-61,-32,-50,21,-159
3,-48,-36,-17,-69,-42,-58,18,-249
29,15,-15,-29,-70,-50,-37,1,-156
69,27,44,-19,26,-36,-57,-22,32
32,20,-9,-25,-54,-48,-46,-19,-149
-18,8,-13,-82,-67,-71,-43,-36,-322
24,31,17,0,8,6,7,4,97
-12,-6,-32,-79,-65,-39,-51,-11,-295
-47,22,-51,-137,-82,-83,-97,-2,-477
-29,34,-49,-162,-86,-71,-78,0,-441
-22,52,-21,-80,-119,-57,-97,-38,-382
-1,8,-50,-60,-71,-61,-65,-27,-327
-135,-46,-167,-331,-234,-151,-190,-77,-1331
3,14,-13,-26,-17,-16,-11,-24,-90
-52,-10,-48,-119,-92,-56,-111,-29,-517
-19,1,-36,-88,-20,-27,-36,-5,-230
6,-2,0,-45,-49,-51,-5,-6,-152
-14,-34,-64,-53,-77,-78,-82,-65,-467
43,61,-49,-104,-131,-121,-96,-6,-403
12,76,-34,-114,-125,-101,-62,-11,-359
6,15,-9,-61,-65,-83,-58,-26,-281
17,-41,-9,-43,-85,-126,-101,-80,-468
3,48,-18,-97,-24,-78,-43,-23,-232
155,95,89,54,-33,-73,-50,64,301
-8,33,-33,-132,-150,-128,-93,-28,-539
-46,-34,-56,-121,-32,-57,-93,13,-426
-13,27,-97,-96,-109,-104,-145,-9,-546
-13,23,-18,-40,-43,-27,-55,8,-165
-17,34,-26,-80,-60,-42,-58,-7,-256
-9,-10,-34,-71,-106,-52,-96,-18,-396
-58,30,-155,-281,-197,-142,-190,-31,-1024
4,-5,-5,-7,-51,-12,-28,3,-101
2,31,-9,-57,-56,-2,-49,23,-117
-145,-12,-146,-326,-315,-229,-307,4,-1476
-23,5,-38,-98,-144,-70,-57,0,-425
13,67,-11,-41,-38,-11,-20,9,-32
-62,8,-121,-206,-189,-136,-207,-61,-974
-85,-36,-79,-140,-110,-85,-151,-24,-710
-16,66,-44,-145,-32,-104,-62,-23,-360
-12,13,-32,-141,-118,-120,-112,-6,-528
66,89,-1,-242,-109,-218,-150,-2,-567
-55,38,-64,-150,-153,-67,-106,90,-467
19,66,-29,-153,-92,-174,-76,31,-408
-13,43,-17,-87,-14,-48,-46,-25,-207
-34,-1,-19,-50,-32,-27,-22,-10,-195
-62,-26,-69,-247,-168,-146,-175,-9,-902
-81,-27,-111,-160,-90,-89,-99,-57,-714
4,19,-20,-37,-28,-41,-33,-10,-146
-68,33,-31,-109,-37,-42,-46,1,-299
-40,-5,-58,-138,-87,-92,-92,-36,-548
86,26,-25,-109,-69,-121,-68,-68,-348
-6,-1,-5,-23,-26,-8,-4,-10,-83
5,-13,-13,-39,-6,-41,-38,-1,-146
-4,14,-10,-41,-18,-12,-15,0,-86
-32,-3,-8,-48,-15,-21,-12,7,-132
-80,-4,-73,-156,-73,-78,-92,-20,-576
-19,-10,-30,-80,-72,-60,-49,-34,-354
-33,113,-142,-381,-182,-212,-223,-43,-1103
-58,5,-88,-130,-142,-68,-138,21,-598
7,27,-44,-118,-33,-47,-20,23,-205
-33,-37,-34,-84,-78,-33,-49,-19,-367
1,4,-8,-20,-12,-14,-10,1,-58
0,6,1,-22,-3,-1,11,-2,-10
9,11,0,-12,1,6,18,11,44
-166,142,-303,-853,-537,-534,-552,-139,-2942
-40,46,-73,-270,-261,-208,-149,-63,-1018
35,13,-14,-36,-22,-57,-41,-22,-144
-26,-11,-2,-40,-22,3,-20,4,-114
-15,1,-31,-97,-112,-85,-84,5,-418
38,207,-45,-236,-155,-208,-56,35,-420
15,63,-7,-49,25,-25,-21,37,38
51,77,29,-68,-55,-72,-53,-7,-98
49,50,-11,-109,-108,-142,-83,-11,-365
45,139,-99,-325,-189,-319,-356,7,-1097
-120,120,-141,-363,-214,-198,-289,23,-1182
-35,12,-12,-120,-53,-75,-73,5,-351
-44,8,-104,-416,-193,-292,-310,-22,-1373
0,92,-32,-178,-198,-121,-122,152,-407
62,27,28,-15,-1,-48,-39,11,25
-52,-18,-45,-98,-134,-58,-86,0,-491
-13,1,-2,-51,-36,-32,-4,16,-121
17,33,-12,-21,-28,1,-27,-4,-41
-19,36,4,-73,-69,-48,-68,1,-236
-2,-7,-8,-15,-13,-10,-13,-7,-75
-112,-19,-92,-270,-183,-150,-125,-54,-1005
-95,-39,-123,-326,-288,-203,-280,-31,-1385
14,42,-29,-61,-19,-53,-28,-9,-143
79,78,25,-42,-89,-137,-88,-31,-205
22,201,-41,-244,-174,-105,-181,70,-452
48,93,-10,-103,-66,-60,-68,22,-144
-87,406,-241,-670,-88,-250,-202,100,-1032
-56,89,-74,-241,-144,-74,-165,-72,-737
41,166,-17,-179,19,-65,-89,19,-105
-18,62,-21,-177,-80,-139,-74,32,-415
-192,-12,-366,-768,-543,-592,-667,-361,-3501
-53,15,-107,-333,-270,-236,-188,-79,-1251
12,41,-67,-121,-73,-122,-41,62,-309
194,185,37,-321,-92,-316,-213,83,-443
-39,177,-132,-535,-60,-270,-296,44,-1111
26,48,-44,-175,-178,-163,-132,-64,-682
-7,172,-59,-291,-60,-151,-134,27,-503
142,173,59,-40,-5,-97,-118,-14,100
7,134,-44,-360,-186,-274,-135,54,-804
28,77,12,-119,9,-73,-53,-2,-121
-170,-80,-179,-448,-286,-190,-270,-32,-1655
119,177,-36,-396,-156,-331,-207,94,-736
-37,15,-101,-258,-214,-188,-173,-109,-1065
37,194,-95,-444,24,-216,-157,89,-568
-122,57,-166,-494,-303,-380,-302,-55,-1765
-129,-3,-100,-304,-178,-152,-140,-64,-1070
48,213,-43,-212,24,-122,-65,75,-82
66,282,-114,-508,-199,-344,-323,8,-1132
75,42,-20,-117,-34,-125,-154,8,-325
57,78,-60,-186,-181,-204,-148,24,-620
46,65,-37,-113,-118,-106,-85,36,-312
-71,125,-148,-520,-308,-338,-314,19,-1555
99,192,-64,-362,-193,-312,-208,119,-729
-125,-84,-211,-339,-271,-237,-267,-126,-1660
39,36,-22,-160,-155,-122,-102,6,-480
-39,99,-74,-372,-155,-243,-221,29,-976
155,166,-92,-370,-160,-378,-254,-6,-939
59,51,-44,-144,-133,-164,-89,-40,-504
-99,-2,-101,-227,-179,-128,-135,-32,-903
17,20,10,-10,5,-22,0,7,27
-45,3,-25,-104,-103,-75,-67,26,-390
-3,9,-11,-39,-24,9,-24,6,-77
40,78,11,-64,2,-73,-24,78,48
-36,11,-55,-131,-45,-92,-80,-7,-435
-8,12,-4,-28,6,-16,5,4,-29
77,32,-130,-299,-232,-343,-253,-170,-1318
141,105,55,-103,61,-71,-83,31,136
-9,-1,-21,-29,-29,-17,-30,-8,-144
-66,7,-90,-127,-93,-73,-139,-38,-619
-99,-38,-75,-144,-87,-88,-144,-36,-711
-64,32,-67,-145,-72,-70,-130,-14,-530
142,56,32,-3,-62,-140,-125,-95,-195
-108,12,-166,-391,-348,-261,-302,-58,-1622
-65,-62,-93,-125,-91,-84,-129,-60,-709
-64,-10,-76,-128,-81,-68,-108,-22,-557
-57,197,-95,-533,-299,-303,-263,-312,-1665
-25,51,-68,-158,-98,-76,-104,-53,-531
-71,99,-86,-253,-90,-127,-167,-50,-745
-131,18,-188,-333,-227,-166,-252,39,-1240
-9,62,-63,-194,-124,-89,-138,72,-483
-56,122,-106,-523,-391,-261,-255,262,-1208
-50,-12,-49,-155,-128,-102,-125,-102,-723
-92,30,-56,-223,-112,-125,-167,30,-715
-80,-53,-90,-142,-73,-80,-132,4,-646
57,9,28,-22,8,-65,-54,44,5
66,37,-1,12,5,-80,-50,37,26
-117,127,-163,-431,-266,-185,-260,15,-1280
-33,-26,-34,-59,-46,-27,-51,7,-269
-45,8,-78,-155,-102,-36,-118,-38,-564
-13,-8,-14,-49,-29,-11,-13,3,-134
108,409,1,-430,-253,-62,-608,698,-137
72,19,-18,-60,-66,-85,-42,-14,-194
-3,22,-16,-54,-62,-52,-50,-18,-233
81,99,-46,-336,-215,-301,-174,-13,-905
-25,24,-102,-184,-156,-82,-156,10,-671
-93,65,-165,-341,-265,-221,-268,-34,-1322
80,31,91,-112,-4,-88,-35,88,51
113,51,69,20,-71,-8,-48,45,171
-35,0,-45,-107,-69,-70,-84,-34,-444
-10,-19,-37,-69,-108,-62,-43,25,-323
40,16,9,-73,-5,-77,-56,4,-142
-51,-10,-26,-82,-52,-35,-49,-9,-314
0,12,-5,-34,3,-7,-12,8,-35
-130,-47,-180,-293,-249,-212,-273,-104,-1488
1,29,2,-29,-11,-15,-11,-3,-37
-175,129,-285,-569,-327,-284,-267,28,-1750
-71,85,-100,-246,-124,-87,-81,1,-623
15,30,-6,-34,-23,-38,-37,-26,-119
-23,7,-25,-78,-38,-45,-56,-1,-259
-30,-13,-39,-74,-106,-49,-66,-12,-389
188,49,34,45,-79,-134,-94,-35,-26
-27,4,-61,-126,-75,-68,-69,-7,-429
41,119,-17,-165,-29,-134,-112,24,-273
-13,34,-1,-49,1,-18,-12,20,-38
-67,55,-124,-294,-129,-142,-135,-24,-860
-50,-38,-42,-168,-138,-104,-124,-18,-682
-3,7,-11,-40,-26,-15,-22,22,-88
-7,7,-1,-24,-13,-12,-15,-3,-68
19,110,-31,-156,-13,-126,-123,67,-253
-101,-17,-158,-325,-85,-139,-171,-62,-1058
-128,69,-156,-305,-116,-155,-159,-63,-1013
-39,-3,-54,-136,-50,-136,-94,-66,-578
53,74,-112,-339,-92,-199,-208,-99,-922
-26,-8,-64,-44,-68,-21,-88,-23,-342
-37,6,-57,-71,-81,-36,-75,-5,-356
-47,-7,-68,-70,-111,-58,-105,-19,-485
240,62,-7,-58,-125,-193,-216,32,-265
-95,-5,-81,-214,-197,-173,-175,-91,-1031
-64,-25,-72,-162,-142,-105,-136,-37,-743
-61,-22,-99,-187,-223,-140,-141,-32,-905
-41,9,-66,-129,-134,-38,-92,-37,-528
12,52,-8,-75,-30,-65,-45,19,-140
32,57,-6,-81,-97,-88,-86,-9,-278
-3,17,-6,-116,-50,-92,-82,43,-289
-52,-10,-105,-137,-127,-80,-132,-20,-663
-34,-1,-36,-71,-55,-26,-49,30,-242
-131,385,-222,-870,-227,-447,-315,235,-1592
-120,-30,-155,-307,-175,-136,-156,-16,-1095
-12,20,-3,-55,-41,-34,-40,-6,-171
-27,2,-20,-42,-25,-18,-17,-10,-157
-52,12,-62,-110,-135,-68,-94,-4,-513
28,33,15,-22,-31,-42,-16,1,-34
-33,15,-47,-117,-87,-125,-94,-64,-552
-30,4,-90,-154,-123,-113,-86,-28,-620
-23,8,-12,-75,-64,-68,-82,48,-268
-15,4,-10,-25,-30,-13,-29,-7,-125
-35,-22,-42,-111,-137,-75,-61,0,-483
-20,6,-32,-104,-93,-90,-84,-25,-442
-261,-17,-280,-557,-397,-316,-478,-99,-2405
-1,20,-41,-65,-17,-36,-55,-19,-214
24,105,-14,-155,-128,-174,-89,-5,-436
-15,149,-108,-352,-155,-132,-158,74,-697
-26,2,-62,-79,-59,-60,-83,-10,-377
-31,-6,-22,-97,-117,-99,-63,59,-376
208,298,-105,-470,176,-230,-148,338,67
-19,10,-58,-204,-150,-169,-113,-58,-761
-5,0,-11,-20,-31,-5,-18,-5,-95
24,34,-32,-219,-133,-117,-162,67,-538
1,-4,-24,-127,-112,-82,-76,-5,-429
7,-17,-60,-92,-167,-161,-122,-74,-686
-14,0,-16,-36,-9,-20,-17,-10,-122
9,94,-1,-99,-26,-83,-61,27,-140
-25,-28,-24,-55,-57,-40,-40,-16,-285
-37,17,-38,-99,-75,-41,-32,-3,-308
-72,159,-156,-318,-110,-146,-165,-51,-859
-93,102,-58,-207,-44,-83,-60,24,-419
-33,11,-38,-128,-67,-64,-102,37,-384
-70,-56,-115,-150,-177,-130,-189,-10,-897
-14,-9,2,-46,-40,-47,-20,4,-170
43,46,-22,-106,-83,-100,-66,-13,-301
41,30,18,-36,-18,-45,-67,36,-41
-76,13,-89,-206,-59,-104,-141,-81,-743
-83,4,-101,-209,-62,-114,-130,-70,-765
-111,16,-134,-245,-60,-120,-152,-89,-895
48,54,18,-19,-16,-16,-4,51,116
-86,5,-97,-209,-63,-116,-130,-68,-764
-16,10,-1,-22,-31,-26,-11,-2,-99
-42,-28,-51,-152,-101,-76,-69,6,-513
-17,44,-55,-201,-154,-169,-153,-132,-837
23,35,3,-14,-30,-62,13,-11,-43
21,22,19,-6,-4,-6,25,17,88
13,12,-3,-12,-56,-29,-28,-1,-104
-25,-4,-51,-66,-63,-69,-65,-52,-395
-47,20,-38,-141,-106,-84,-96,-21,-513
-123,26,-290,-624,-432,-315,-481,-14,-2253
-44,192,-95,-221,-102,86,40,24,-120
7,23,-9,-23,-29,-12,-32,22,-53
-76,0,-65,-152,-66,-39,-86,-38,-522
6,51,-6,-91,-5,-51,-94,-18,-208
9,14,3,-20,-36,-21,6,-17,-62
-57,31,-55,-124,-58,-32,-34,-15,-344
-49,43,-144,-338,-115,-167,-147,-108,-1025
-4,11,-15,-26,-32,-21,-17,3,-101
22,-14,-6,-47,-76,-36,-73,23,-207
-28,12,-91,-172,-102,-125,-127,-42,-675
1,63,0,-50,-20,-4,8,14,12
155,20,8,-317,177,-131,-62,118,-32
-3,1,-24,-51,-35,-47,-63,2,-220
-78,12,-70,-236,-74,-79,-110,0,-635
-19,-11,-29,-59,-56,-40,-42,-26,-282
-19,-13,-29,-45,-39,-42,-48,-22,-257
-17,6,-22,-52,-33,-30,-38,-16,-202
54,35,29,1,-46,-35,-36,-44,-42
-19,-10,-75,-112,-83,-106,-84,-69,-558
25,45,-37,-69,-140,-107,-58,15,-326
-5,-6,-22,-97,-62,-79,-84,8,-347
23,37,-4,29,-42,7,-20,12,42
-34,-9,-53,-94,-44,-42,-51,-24,-351
-10,-3,3,-27,-22,-2,-29,-11,-101
0,28,6,-35,-23,-22,-3,17,-32
-36,3,-46,-117,-97,-83,-87,5,-458
25,16,23,-20,-57,-3,-14,27,-3
-79,-45,-83,-149,-92,-46,-89,41,-542
-28,105,-40,-174,-42,-37,-71,59,-228
53,35,16,1,-5,-27,-22,-4,47
-36,-5,-51,-130,-37,-67,-52,-14,-392
-22,18,-17,-64,-23,-30,-24,11,-151
-49,24,-19,-151,-39,-103,-106,-32,-475
-31,4,-59,-156,-38,-14,-32,-1,-327
-79,-12,-59,-191,-129,-119,-119,19,-689
-26,21,-42,-69,-26,-35,-54,14,-217
2,50,-23,-95,-66,-65,-76,34,-239
42,55,7,-83,-62,-104,-105,38,-212
22,28,-43,-122,-66,-111,-97,9,-380
-28,-1,-75,-171,-227,-147,-164,-52,-865
-16,74,-30,-165,-29,-109,-77,12,-340
-23,40,-51,-124,-64,-53,-86,-44,-405
-5,174,-84,-389,-324,-266,-254,4,-1144
127,202,25,-260,-88,-239,-184,129,-288
-46,68,-61,-268,-142,-163,-149,23,-738
-150,52,-185,-485,-350,-199,-332,71,-1578
8,52,-32,-138,-49,-71,-84,0,-314
-85,52,-77,-299,-202,-204,-111,114,-812
93,55,10,-80,-80,-100,-72,27,-147
118,79,30,-102,7,-78,-116,70,8
-24,-26,-39,-93,-108,-82,-94,-50,-516
63,78,-140,-500,-161,-422,-329,-85,-1496
37,99,-10,-129,-98,-169,-132,-40,-442
-9,88,-68,-155,-45,-76,-71,-9,-345
-54,-4,-77,-133,-65,-45,-59,-6,-443
107,90,27,-68,-68,-140,-136,22,-166
-14,87,-59,-100,-91,-58,-108,10,-333
-1,103,2,-125,-55,-107,-134,-6,-323
74,44,-16,-92,-69,-154,-128,-50,-391
-3,11,-34,-55,-173,-6,-78,64,-274
-22,-10,-64,-149,-141,-100,-154,-47,-687
-22,182,-97,-313,-115,-135,-185,-93,-778
-123,168,-147,-440,-133,-180,-216,-98,-1169
129,405,96,131,27,62,-276,-71,503
-15,153,-88,-334,-403,-304,-191,-10,-1192
21,-5,-51,-202,-141,-167,-140,-17,-702
-147,-33,-149,-375,-310,-211,-269,-10,-1504
137,-18,-4,-86,-62,-136,-151,64,-256
-18,101,-65,-270,-97,-103,-120,-17,-589
-119,96,-112,-377,-156,-101,-192,-148,-1109
-45,10,-33,-114,-121,-25,-88,16,-400
91,201,-50,-265,-225,-319,-256,44,-779
-96,54,-51,-161,-57,-57,-29,-10,-407
-10,29,-64,-194,-110,-141,-106,-88,-684
122,173,15,-233,-68,-238,-136,65,-300
-42,144,-125,-343,-227,-275,-231,-26,-1125
-28,-14,-44,-104,-83,-25,-45,34,-309
-64,132,-84,-317,-130,-248,-194,35,-870
-1,58,-38,-325,-277,-302,-250,109,-1026
11,34,-12,-106,-61,-65,-98,56,-241
-26,29,-28,-91,-61,-48,-41,12,-254
54,226,-28,-327,-99,-292,-209,-156,-831
-20,96,-102,-278,-260,-254,-244,-192,-1254
-22,116,-89,-484,-542,-380,-274,-17,-1692
-7,153,-57,-268,-131,-156,-187,-164,-817
66,122,-27,-174,-41,-132,-69,52,-203
-48,118,-7,-233,-90,-82,-53,66,-329
-20,25,-150,-329,-278,-271,-237,-74,-1334
115,117,-46,-121,-38,-124,-108,-2,-207
-36,66,-235,-359,-353,-374,-362,-229,-1882
229,114,65,-41,0,-96,-119,105,257
-31,56,-30,-152,-42,-125,-51,39,-336
-44,54,-89,-433,-238,-267,-210,19,-1208
-16,59,-41,-193,-167,-103,-70,94,-437
-198,-12,-342,-629,-514,-368,-477,-275,-2815
55,122,3,-136,-32,-77,-33,65,-33
35,53,-106,-171,-202,-215,-158,-49,-813
71,60,-24,-142,-79,-132,-165,-32,-443
135,60,13,-58,36,-116,-114,52,8
174,96,81,73,72,-20,-45,121,552
406,382,14,-372,-254,-391,-406,74,-547
-28,49,-74,-280,-166,-192,-180,-18,-889
-76,57,-98,-291,-215,-130,-217,-49,-1019
71,58,63,7,45,-2,3,49,294
28,18,-22,-75,-132,-101,-94,-6,-384
-48,5,-46,-100,-68,-59,-73,-36,-425
-48,-31,-89,-325,-430,-307,-259,-46,-1535
-57,-27,-16,-166,-26,-91,-55,-14,-452
3,-4,-42,-65,-71,-77,-58,-22,-336
19,24,-24,-61,-58,-76,-63,-27,-266
4,21,-20,-22,-24,-6,-14,16,-45
-7,-20,9,-34,-74,-43,-49,18,-200
-7,21,-24,-29,-7,-6,-15,-20,-87
-76,47,-78,-165,-30,-48,-6,-54,-410
-15,11,-15,-24,-36,-38,-35,-16,-168
-8,75,-45,-183,-53,-136,-129,-18,-497
-10,-17,-32,-98,-125,-76,-61,-14,-433
28,16,-74,-185,-167,-176,-155,2,-711
-65,-56,-57,-144,-135,-61,-106,-11,-635
-49,-48,-55,-124,-117,-75,-112,5,-575
12,21,-49,-99,-63,-46,-38,-13,-275
-42,0,-30,-105,-48,-46,-47,20,-298
-2,-5,-26,-76,-38,-59,-21,4,-223
-29,-11,-36,-79,-50,-71,-61,-28,-365
-13,3,-19,-28,-20,-15,-23,-2,-117
6,25,-84,-253,-106,-195,-143,-127,-877
-2,5,-36,-133,-79,-87,-106,51,-387
-28,136,-73,-229,-14,-7,-132,-111,-458
28,-10,-9,-95,-35,-68,-61,-6,-256
-39,169,-44,-390,-181,-298,-224,-115,-1122
-55,158,-41,-355,-169,-272,-226,-153,-1113
-18,16,2,-210,-217,-133,-106,80,-586
1,-21,-15,-22,-37,-17,-28,23,-116
-60,-57,-89,-228,-153,-160,-137,-49,-933
-56,1,-42,-184,-127,-48,-108,1,-563
7,3,-30,-93,-59,-62,-60,-48,-342
-96,41,-42,-136,-50,-11,-64,-68,-426
-12,3,4,-35,-23,1,-21,-15,-98
0,5,1,-30,-24,-11,-15,-3,-77
0,33,-29,-100,-61,-60,-52,-37,-306
-31,17,-68,-100,-63,-64,-89,-55,-453
-17,-5,-34,-87,-135,-103,-96,-15,-492
-24,7,-58,-93,-79,-74,-116,29,-408
-7,43,-50,-99,-101,-70,-91,-9,-384
34,26,29,-51,8,-62,-32,11,-37
48,97,-21,-164,22,-131,-81,53,-177
114,145,20,-15,10,-5,17,37,323
68,17,20,-12,-15,-70,-30,-15,-37
-30,-18,-11,-51,-54,-28,-28,1,-219
9,14,-68,-101,-202,-102,-106,-36,-592
7,67,-34,-76,-81,-46,-42,-16,-221
16,-4,2,-7,-15,-12,11,2,-7
102,86,31,-182,-515,147,-158,361,-128
-86,19,-48,-145,-84,-34,-60,-63,-501
188,236,75,-567,-131,-364,-132,269,-426
-14,4,-10,-30,-19,-17,-16,15,-87
-4,11,-2,-14,-34,-10,-15,2,-66
46,66,-13,-89,-1,-58,-31,35,-45
46,56,-27,-134,-152,-74,-101,15,-371
129,136,6,-198,-5,-244,-230,9,-397
-1,26,0,-85,-78,-71,-29,43,-195
-47,14,-106,-202,-113,-126,-184,-60,-824
-72,-11,-94,-151,-124,-119,-127,-39,-737
-6,-2,-48,-88,-87,-96,-87,-43,-457
-10,22,0,-40,-27,-25,-24,-8,-112
-24,-6,0,-30,-8,-9,-13,-1,-91
-13,-10,-38,-57,-55,-34,-49,-11,-267
94,4,-5,-33,-135,-109,-99,6,-277
-9,173,-17,-123,-69,-98,-118,30,-231
2,27,-7,-16,-8,-24,-1,10,-17
75,177,-18,-142,-54,-93,-44,9,-90
-20,-4,-12,-46,-57,-41,-34,-11,-225
-66,330,-237,-724,-340,-374,-325,24,-1712
-73,-1,-83,-148,-128,-89,-147,-22,-691
122,217,47,-193,14,-200,-82,-43,-118
5,-11,-29,-82,-33,-38,-46,0,-234
-15,29,-50,-171,-99,-125,-98,-32,-561
75,95,-49,-196,-79,-216,-99,-37,-506
-8,-4,-32,-67,-55,-50,-61,-30,-307
-53,-5,-30,-90,-70,-12,-33,6,-287
-122,50,-60,-181,-67,-37,-92,-50,-559
-11,-3,-7,-16,-14,-10,-14,-4,-79
-21,11,-40,-121,-145,-118,-91,-53,-578
-159,168,-239,-386,-312,21,-375,184,-1098
104,76,45,41,-34,-84,-56,4,96
-238,300,-331,-1266,-593,-486,-826,581,-2859
19,22,1,-20,-46,-49,-7,-2,-82
-76,55,-167,-301,-204,-234,-284,-158,-1369
-16,23,-18,-99,-84,-79,-57,-5,-335
-32,0,-32,-94,-98,-77,-83,-28,-444
27,39,11,-14,9,-8,17,31,112
-67,46,-102,-287,-164,-134,-167,25,-850
-26,6,-15,-77,-56,-47,-35,18,-232
-8,38,-54,-101,-75,-95,-64,-11,-370
10,65,-6,-123,-111,-157,-62,9,-375
-43,2,-42,-114,-66,-51,-79,-30,-423
-105,56,-177,-371,-124,-231,-244,-108,-1304
67,23,-2,-24,-65,-77,-37,-22,-137
5,110,19,-75,1,24,58,25,167
-28,-18,-21,-83,-91,-35,-75,-10,-361
-54,-17,-52,-121,-88,-98,-93,-48,-571
-25,-15,-32,-71,-105,-78,-79,-8,-413
-3,16,-58,-90,-74,-66,-102,8,-369
-22,-26,-29,-84,-81,-65,-28,-31,-366
2,8,-33,-100,-40,-79,-65,-19,-326
-8,35,18,-63,-38,-71,12,79,-36
2,50,-16,-57,3,-12,8,4,-18
-12,-29,-52,-60,-43,-13,-42,4,-247
-4,3,1,-5,-13,-8,-12,-3,-41
-32,-10,-51,-61,-96,-54,-83,-23,-410
-31,111,-63,-168,-61,-102,-109,19,-404
-4,10,-30,-82,-59,-39,-53,3,-254
32,39,-5,-60,-31,-11,-39,26,-49
129,96,88,12,40,-47,-37,45,326
15,30,-20,-79,-19,-63,-34,-38,-208
-22,22,-52,-113,-108,-119,-99,14,-477
-17,1,-50,-74,-65,-46,-56,23,-284
-3,8,-14,-17,-20,-15,-14,-21,-96
-42,-72,-72,-264,-276,-250,-280,-108,-1364
-17,52,-46,-147,-161,-25,-48,51,-341
7,72,-9,-74,-66,-95,-40,-10,-215
104,42,10,-70,-35,-55,-75,77,-2
-7,83,-29,-58,-18,-7,24,38,26
-10,11,-20,-17,-16,-18,-34,-7,-111
-17,-1,-21,-54,-84,-59,-63,-29,-328
-10,7,-29,-40,-48,-23,-33,24,-152
21,-20,-34,-79,-118,-109,-65,-41,-445
-19,21,-19,-70,-55,-46,-38,13,-213
-68,-1,-39,-152,-101,-88,-78,-33,-560
-13,25,-17,-44,-13,-17,-27,-19,-125
26,113,-85,-287,-222,-242,-232,-36,-965
-36,26,-104,-344,-370,-256,-232,60,-1256
-32,62,-70,-185,-113,-120,-113,-53,-624
-31,-22,-23,-47,-39,-26,-24,5,-207
-121,536,-355,-937,-639,-612,-752,64,-2816
64,1,9,-64,8,-71,-63,25,-91
0,8,4,-28,-34,-33,-36,4,-115
-24,12,-20,-46,-43,-27,-23,-4,-175
5,17,-18,-70,-128,-81,-102,-31,-408
-18,-26,-79,-134,-166,-124,-135,-73,-755
51,-5,-10,-69,-25,-92,-71,56,-165
29,56,-8,-122,-47,-123,-90,7,-298
4,34,-5,-38,-29,-10,-6,18,-32
11,-3,-6,-48,-46,-42,-21,-9,-164
0,29,-28,-111,-78,-95,-67,-44,-394
-29,18,-48,-126,-61,-82,-74,5,-397
-34,-2,-31,-101,-68,-72,-48,-20,-376
14,54,-27,-197,-10,-127,-97,0,-390
5,19,-11,-82,-63,-91,-69,17,-275
9,-5,-15,-53,-30,-62,-47,-14,-217
22,35,-20,-61,-60,-70,-68,5,-217
-24,16,-48,-75,-75,-43,-56,1,-304
43,48,-1,-29,-4,-61,-47,3,-48
63,40,43,20,-11,-37,-8,-4,106
-250,-10,-264,-624,-510,-362,-423,-158,-2601
-25,-15,-43,-88,-115,-69,-57,-25,-437
-39,10,-16,-74,-42,-36,-50,-9,-256
-53,142,-77,-361,-82,-104,-185,-73,-793
15,39,-55,-126,-47,-75,-69,12,-306
46,37,-44,-188,-144,-165,-118,-54,-630
-30,3,-29,-100,-42,-46,-59,8,-295
-15,30,-17,-103,-51,-61,-60,21,-256
-23,19,-29,-106,-34,-50,-59,2,-280
7,43,9,-67,-84,-67,-29,-27,-215
6,43,-21,-66,-113,-86,-46,11,-272
-12,-18,-3,-49,-94,-50,-32,-23,-281
10,117,-15,54,-10,19,-69,10,116
-456,20,-546,-1061,-539,-425,-752,-325,-4084
-72,18,-158,-401,-255,-288,-323,-21,-1500
-18,-8,-26,-81,-73,-10,-24,25,-215
-21,-7,-29,-25,-15,-6,-22,-15,-140
-49,-18,-56,-80,-68,-66,-70,-35,-442
-20,-6,-24,-45,-10,1,-20,-7,-131
-14,6,-38,-80,-62,-74,-74,-60,-396
-33,84,-64,-210,-165,-85,-118,73,-518
-12,-30,-58,-69,-105,-71,-72,-51,-468
-2,-16,-91,-159,-208,-136,-128,-58,-798
-183,35,-250,-495,-184,-195,-281,-36,-1589
-57,-4,-118,-220,-196,-139,-158,-47,-939
-67,-45,-64,-113,-67,-59,-82,-18,-515
-158,13,-206,-325,-253,-150,-253,-111,-1443
-9,51,-20,-78,-34,-71,-51,-6,-218
-8,47,-24,-97,-106,-80,-79,-30,-377
34,44,17,-58,-61,-43,-24,-13,-104
-5,-9,-63,-130,-105,-139,-118,-37,-606
-22,14,-55,-114,-71,-82,-82,1,-411
23,15,-5,-44,-26,-54,-19,10,-100
-1,5,-21,-60,-61,-55,-63,-4,-260
-32,-15,-35,-86,-48,-36,-40,27,-265
-69,-30,-86,-157,-109,-70,-131,-16,-668
-30,25,-61,-161,-65,-116,-102,-78,-588
120,95,-8,-71,-73,-142,-11,61,-29
79,96,-41,-243,-169,-273,-204,-5,-760
1,53,-41,-215,-79,-175,-102,-36,-594
-8,-5,-8,-36,-44,-45,-27,-5,-178
-55,16,-83,-123,-48,-52,-66,-12,-423
-130,36,-63,-201,-61,-61,-62,6,-536
3,35,1,-78,-40,-38,-4,10,-111
2,41,-15,-17,-20,15,-22,19,3
-15,-4,-25,-64,-64,-61,-40,-45,-318
-10,0,-24,-53,-53,-34,-46,26,-194
-30,29,-50,-111,-75,-8,-71,13,-303
-4,21,-25,-34,-70,-46,-40,-51,-249
-15,-21,-22,-43,-27,-7,-22,3,-154
-7,40,-27,-77,-69,-75,-67,-23,-305
-45,-25,-57,-52,-63,-29,-71,-11,-353
-53,16,-129,-265,-198,-238,-221,-152,-1240
-72,7,-108,-188,-91,-57,-127,-32,-668
-57,-50,-51,-108,-51,-43,-93,3,-450
93,78,-43,-171,-38,-137,-96,-47,-361
-4,9,-30,-48,-21,-29,-54,-24,-201
18,2,-27,-55,-66,-63,-69,-5,-265
-9,-11,-20,-40,-111,-10,-50,-6,-257
-21,28,-37,-155,-104,-122,-109,-27,-547
3,3,-16,-85,-75,-41,-67,-16,-294
-92,25,-105,-206,-107,-68,-124,-53,-730
-15,139,-98,-157,-154,-94,-276,67,-588
-17,-20,-3,-22,-32,-13,-32,-5,-144
22,35,-41,-101,-35,-62,-68,34,-216
10,26,-10,-64,-36,-66,-45,4,-181
23,27,-37,-187,-233,-76,-136,-33,-652
11,4,-1,-15,-34,-24,-8,4,-63
-28,-24,-19,-55,-47,-30,-32,-18,-253
-89,-22,-130,-301,-186,-157,-194,-22,-1101
-12,-16,-38,-123,-97,-135,-85,-30,-536
-36,48,-56,-125,-47,-56,-56,-5,-333
-32,-68,-60,-131,-154,-146,-137,-48,-776
-65,-54,-98,-195,-161,-163,-193,-63,-992
95,-55,-20,-138,30,-120,-83,30,-261
-18,-5,-33,-99,-86,-58,-86,-48,-433
27,52,-57,-169,-198,-202,-130,-53,-730
-11,49,-33,-153,-54,-62,-24,2,-286
-38,-27,-25,-69,-58,-31,-53,4,-297
-4,2,-8,-150,-89,-102,-91,35,-407
4,11,4,-13,-4,-15,-2,19,4
-89,-9,-156,-531,-324,-297,-279,8,-1677
-22,84,-49,-212,-43,-134,-137,28,-485
-28,71,-47,-213,-35,-141,-114,70,-437
-9,-11,-18,-46,-44,-47,-48,-27,-250
-14,-7,-10,-51,-48,-27,-58,-30,-245
-34,-11,-41,-80,-87,-39,-62,7,-347
-19,20,11,-56,-28,-7,-2,-33,-114
9,45,-5,-36,-26,-11,-24,11,-37
-19,62,-69,-186,-90,-92,-64,6,-452
3,-25,-25,-8,-27,-4,-18,-21,-125
2,25,-52,-127,-31,-108,-110,-34,-435
-14,2,-28,-33,-28,-35,-41,-12,-189
44,62,-18,-79,-49,-54,-40,70,-64
-15,0,15,-72,-28,-8,-6,12,-102
-42,-1,-59,-72,-43,-12,-89,-34,-352
-7,-19,2,-67,-146,-70,-113,-55,-475
25,16,13,-3,-7,-22,-13,21,30
-47,291,-225,-763,-547,-579,-560,-68,-2498
-11,-12,-18,-31,-37,-21,-30,-5,-165
13,50,-34,-143,-77,-97,-119,32,-375
70,287,-102,-450,-407,-308,-233,38,-1105
-7,34,-1,-32,0,-7,-14,1,-26
64,34,19,30,-13,-8,-39,34,121
20,101,-80,-253,-226,-136,-179,87,-666
43,81,-4,-67,12,-43,-8,23,37
-74,5,-73,-131,-98,-63,-133,-23,-590
-78,-13,-81,-148,-100,-87,-133,-15,-655
-77,-16,-76,-157,-97,-88,-135,-27,-673
-6,31,-50,-81,-44,-41,-51,-41,-283
-45,42,-53,-138,-45,-77,-101,-41,-458
-46,57,-51,-137,-46,-60,-111,-37,-431
-41,34,-29,-115,-90,-75,-110,-40,-466
-25,54,-24,-109,-65,-60,-131,-68,-428
-40,69,-26,-128,-81,-57,-124,-69,-456
-66,60,-53,-153,-57,-58,-45,4,-368
-101,-40,-143,-306,-247,-194,-265,-80,-1376
1,18,-53,-99,-98,-102,-90,-45,-468
10,74,-51,-128,-123,-87,-53,-16,-374
-17,9,-18,-80,-58,-43,-72,0,-279
-17,-10,-28,-45,-67,-31,-50,-70,-318
33,165,-26,-283,30,-192,-117,65,-325
-29,63,-38,-190,-138,-41,-103,17,-459
-30,15,-31,-44,-28,-38,-41,-41,-238
0,39,-23,-149,-103,-129,-124,-49,-538
-23,-16,-32,-104,-67,-39,-48,-22,-351
2,33,-24,-56,-43,-59,-47,-25,-219
-5,3,-111,-143,-95,-128,-137,-108,-724
-54,59,-37,-142,-38,-27,-58,5,-292
16,21,16,4,-39,-5,-1,8,20
-16,19,-41,-40,-94,-77,-41,-4,-294
-64,-17,-85,-222,-150,-122,-101,-53,-814
-35,18,-29,-98,-51,-90,-42,-11,-338
-4,45,-5,-84,-5,-31,-43,-6,-133
23,53,29,-7,19,-22,-4,28,119
6,18,-36,-96,-36,-82,-79,-32,-337
-76,0,-86,-224,-163,-142,-165,-16,-872
-72,-10,-44,-164,-122,-108,-82,-36,-638
34,12,14,3,17,-4,12,22,110
-29,-35,-81,-179,-84,-113,-124,-10,-655
-26,2,-13,-58,-41,-23,-25,7,-177
1,58,-77,-134,-115,-120,-102,-60,-549
-9,17,-18,-49,-20,-18,-25,-9,-131
-16,5,-16,-56,-22,-25,-34,-5,-169
-67,12,-68,-152,-96,-62,-139,-9,-581
-70,-4,-74,-118,-94,-73,-140,-16,-589
7,-25,4,-84,-10,-85,-55,13,-235
-139,-20,-155,-447,-317,-237,-292,-75,-1682
-11,5,-34,-64,-87,-63,-65,-26,-345
97,83,-19,-272,-179,-328,-190,-55,-863
55,79,-16,-120,-96,-180,-151,-54,-483
-13,42,-21,-100,-94,-63,-28,33,-244
-5,13,-27,-90,-42,-56,-77,-36,-320
-39,28,-46,-131,-66,-73,-55,6,-376
-49,106,-98,-258,-28,-88,-30,38,-407
5,27,-29,-15,-30,-32,-41,-23,-138
-5,-8,-23,-156,-148,-153,-112,-25,-630
-22,-21,-23,-30,-38,-22,-44,-15,-215
9,13,-45,-54,-86,-50,-79,-58,-350
-6,67,-40,-245,-195,-136,-107,162,-500
-36,142,-88,-218,-23,-47,-40,22,-288
15,6,-14,-73,-124,-45,-64,-12,-311
-53,112,-89,-284,-108,-134,-146,-102,-804
3,22,-19,-71,-96,-45,-34,4,-236
-54,49,-67,-253,-133,-142,-98,79,-619
-86,8,-76,-222,-225,-104,-169,-11,-885
5,-25,-5,-94,-83,-112,-82,-46,-442
16,25,-2,-28,-55,-24,-12,-15,-95
-8,67,-139,-329,-276,-299,-255,-179,-1418
-119,154,-147,-411,-99,-128,-202,-67,-1019
3,4,-14,-35,-20,-23,-29,-6,-120
45,114,32,-61,-58,-95,-45,60,-8
121,45,-53,-71,-184,-214,-114,-55,-525
-269,106,-383,-651,-271,-342,-407,-181,-2398
-126,58,-160,-470,-276,-258,-290,18,-1504
51,16,-40,-57,-110,-82,-92,-77,-391
45,188,-68,-261,-88,-231,-153,5,-563
-83,-11,-176,-335,-239,-220,-275,-104,-1443
-57,9,-61,-181,-63,-31,-96,67,-413
-133,-39,-117,-274,-265,-145,-170,-33,-1176
82,50,32,-121,-30,-105,-90,69,-113
-60,-48,-96,-188,-164,-138,-100,-57,-851
148,100,54,-91,-74,-166,-46,26,-49
6,47,-64,-275,-162,-186,-123,-25,-782
184,52,-115,-230,-245,-264,-122,-17,-757
78,-8,-20,-166,-74,-117,-205,56,-456
1,45,-17,-292,-157,-125,-116,196,-465
13,31,-14,-93,-15,-69,-51,32,-166
10,19,-37,-134,-105,-137,-110,-9,-503
-74,23,-73,-225,-204,-128,-198,-29,-908
11,102,18,-214,-29,-206,-93,177,-234
4,60,-27,-136,-121,-122,-120,0,-462
0,179,-53,-149,-65,-87,-37,79,-133
115,262,21,-261,37,-198,-90,58,-56
-125,-43,-184,-280,-205,-158,-230,-61,-1286
-34,18,-95,-332,-184,-209,-218,-53,-1107
10,47,-27,-99,-76,-63,-24,-12,-244
-3,9,-32,-61,-151,-111,-145,10,-484
-86,119,-72,-187,-35,-46,-55,-8,-370
-29,70,-127,-301,-141,-188,-167,-17,-900
88,22,9,-53,55,-73,-62,70,56
-5,59,-55,-181,-185,-192,-154,-12,-725
-9,13,-25,-60,-52,-40,-31,-12,-216
-16,15,-25,-69,-84,-20,-85,-19,-303
7,-12,-34,-143,-202,-174,-150,-125,-833
9,40,-9,-28,-36,-32,-51,11,-96
43,-31,-61,-293,-235,-265,-338,49,-1131
-196,18,-296,-542,-294,-209,-394,-46,-1959
165,247,99,-210,130,-41,-9,126,507
-253,144,-363,-912,-536,-616,-664,-53,-3253
268,391,48,-225,93,-108,-105,356,718
-29,13,-64,-162,-124,-103,-123,-13,-605
-33,21,-54,-135,-44,-72,-69,17,-369
-20,-15,-54,-121,-105,-48,-74,17,-420
18,23,-54,-120,-79,-105,-91,-28,-436
-11,81,-71,-250,-114,-197,-170,-137,-869
-3,54,-14,-128,-62,-107,-89,56,-293
-46,56,-84,-275,-54,-109,-178,-14,-704
2,47,-19,-167,-55,-82,-79,14,-339
-75,-39,-88,-177,-125,-120,-141,-29,-794
2,34,-29,-200,-188,-183,-130,-3,-697
-93,-26,-106,-197,-142,-96,-126,-12,-798
-54,25,-115,-218,-132,-119,-191,-33,-837
26,263,-53,-367,-161,-271,-268,-129,-960
60,81,-48,-282,-181,-239,-150,-4,-763
-15,81,-56,-179,-98,-173,-142,-4,-586
-2,135,-78,-241,-108,-187,-135,28,-588
-48,-20,-119,-272,-203,-187,-229,-64,-1142
144,67,-10,-178,-71,-153,-189,29,-361
85,88,-45,-324,-136,-321,-223,-13,-889
-37,47,-89,-204,-158,-87,-113,70,-571
-74,261,-126,-449,-94,-147,-252,-135,-1016
-65,96,-106,-271,-97,-162,-108,-8,-721
87,94,-33,-260,-44,-222,-134,8,-504
-56,59,-81,-317,-49,-163,-177,-5,-789
55,78,8,-47,30,-41,-14,-14,55
100,39,7,-179,-4,-105,-90,72,-160
-74,-37,-85,-146,-114,-91,-124,-36,-707
-94,-55,-92,-140,-115,-72,-128,-18,-714
-75,-37,-58,-125,-96,-59,-129,-17,-596
-77,-3,-65,-180,-165,-59,-146,6,-689
-40,-3,-32,-97,-97,-36,-68,1,-372
-89,-34,-87,-158,-104,-81,-141,-58,-752
73,111,53,-149,-136,-166,-59,76,-197
2,20,-33,-70,-63,-62,-39,-48,-293
-21,28,-9,-65,-54,-25,-36,5,-177
-15,2,-31,-42,-33,-30,-41,-15,-205
-50,-4,-42,-109,-75,-63,-75,-14,-432
-68,-16,-62,-148,-157,-75,-129,-1,-656
8,-18,-33,-48,-70,-94,-117,-29,-401
26,313,-173,-663,-376,-608,-471,65,-1887
-76,-22,-64,-231,-78,-132,-105,-59,-767
-47,35,-27,-125,-29,-51,-30,0,-274
55,10,40,-5,32,-35,-53,0,44
162,102,71,-18,35,-44,-58,61,311
-1,13,-12,-42,-35,-30,-31,17,-121
32,2,6,-29,-24,-65,-30,2,-106
244,29,60,-186,-5,-133,-19,115,105
-70,59,-35,-207,-68,-92,-51,13,-451
-65,-7,-87,-179,-104,-120,-142,-47,-751
-24,-9,-12,-37,-11,1,-12,1,-103
-64,11,-45,-190,-161,-136,-170,-18,-773
-10,-5,-10,-62,-57,-55,-36,4,-231
-19,34,-34,-71,-6,-38,-54,21,-167
-8,4,-39,-60,-40,-28,-36,11,-196
257,307,9,-394,-38,-344,-217,46,-374
-5,-6,-40,-70,-89,-86,-65,-44,-405
-17,75,-108,-375,-164,-287,-296,1,-1171
-36,4,-17,-73,-31,-24,-30,28,-179
-11,3,-11,-65,-38,-26,-38,32,-154
31,10,-32,-50,-50,-57,-43,-18,-209
22,-5,-34,-68,-49,-98,-83,-31,-346
-100,39,-154,-348,-252,-204,-246,-38,-1303
-7,9,-13,-35,-13,-23,-5,-4,-91
-23,-16,-14,-28,-32,-11,-1,13,-112
2,-18,-12,-18,-8,-5,-11,7,-63
-23,-19,-18,-48,-25,-34,-26,-24,-217
15,-27,18,3,4,-13,-33,15,-18
-95,-16,-100,-215,-188,-111,-147,-32,-904
2,92,-27,-164,-18,-73,5,39,-144
11,29,-8,-1,-5,-24,-13,15,4
12,1,5,-14,-31,-17,-13,7,-50
-8,33,-182,-618,-433,-555,-533,15,-2281
-6,7,-2,-27,-8,-27,-15,11,-67
-7,16,-15,-39,-29,-25,-18,-10,-127
-48,40,-93,-240,-183,-131,-191,-23,-869
-16,11,-14,-58,-15,-9,-38,9,-130
101,78,-17,-54,-24,-80,-80,10,-66
1,155,-103,-236,-140,-143,-103,70,-499
-36,-25,-37,-77,-179,-100,-138,-12,-604
-19,50,-8,-94,-112,-29,-109,36,-285
38,71,4,-61,-48,-116,-42,-13,-167
-60,61,-91,-268,-100,-71,-152,-84,-765
163,60,-27,-154,-305,-271,-126,-16,-676
111,101,10,-106,-15,-148,-115,8,-154
43,71,19,-31,-28,-46,-21,26,33
-21,-11,-42,-50,-61,-23,-59,-17,-284
34,133,29,-75,11,-93,24,115,178
-27,-2,-40,-95,-101,-83,-85,-44,-477
-77,-8,-91,-145,-85,-89,-151,-3,-649
-63,-27,-73,-112,-122,-83,-120,-44,-644
22,18,-4,-43,-36,-25,-46,-56,-170
53,41,12,-18,-5,-62,-50,2,-27
-26,114,-16,-131,-63,-91,-4,3,-214
-40,122,-80,-307,-87,-130,-149,-28,-699
-9,28,-42,-116,-132,-114,-97,-43,-525
-34,-8,-36,-82,-55,-51,-82,-29,-377
-12,12,-38,-72,-59,-92,-52,-11,-324
-49,173,-84,-341,-91,-107,-139,-44,-682
-38,97,-48,-157,-51,-69,-24,-11,-301
-8,60,-123,-501,-374,-455,-340,-48,-1789
-27,24,-24,-70,-46,-70,-64,-28,-305
-36,70,-41,-171,-63,-136,-57,27,-407
-57,36,-237,-481,-374,-420,-426,-167,-2126
-73,33,-73,-193,-104,-93,-91,10,-584
-2,-1,-26,-23,-55,-31,-33,-22,-193
-30,-22,-42,-102,-116,-49,-88,-8,-457
-92,-13,-111,-269,-252,-140,-163,11,-1029
-9,38,-37,-86,-10,-41,-65,54,-156
-64,-40,-98,-190,-278,-204,-148,-18,-1040
-55,-18,-84,-154,-122,-96,-125,6,-648
-87,7,-98,-210,-108,-123,-178,-23,-820
117,72,-86,-169,-265,-338,-269,-180,-1118
-23,-12,-47,-86,-92,-74,-76,-24,-434
59,68,6,-22,-17,-29,-55,9,19
0,-14,-19,-57,-89,-64,-55,-15,-313
6,24,-45,-119,-86,-46,-84,18,-332
-39,18,-10,-69,-39,-10,-35,4,-180
3,13,-67,-236,-177,-205,-149,-89,-907
3,4,-14,-40,-49,-43,-46,-17,-202
-7,15,-25,-60,-54,-14,-49,14,-180
-12,-21,-24,-51,-32,-26,-27,-25,-218
-19,8,-38,-99,-45,-53,-63,3,-306
9,39,-43,-122,-86,8,-72,72,-195
60,37,-19,-26,-108,-116,-108,-35,-315
15,-2,-40,-72,-66,-75,-61,-38,-339
-42,-7,-34,-148,-149,-98,-81,-48,-607
-62,-8,-138,-302,-404,-190,-265,20,-1349
35,47,21,-36,-18,-62,-37,-14,-64
-78,84,-105,-298,-216,-62,-202,-149,-1026
-10,6,-84,-162,-125,-132,-122,-70,-699
676,454,63,-292,8,-520,-169,61,281
-28,23,-49,-126,-73,-91,-101,-20,-465
-37,-14,-47,-117,-103,-104,-86,-22,-530
102,34,3,19,-98,-102,-78,-24,-144
-53,11,-79,-124,-89,-84,-117,-44,-579
5,-2,-16,-53,-63,-57,-43,-46,-275
-104,-85,-166,-266,-257,-148,-223,-88,-1337
-50,-30,-45,-68,-90,-80,-74,17,-420
-56,-24,-52,-106,-56,-63,-77,-15,-449
-28,-11,-26,-52,-31,-28,-39,-8,-223
16,72,-119,-392,-266,-351,-284,-96,-1420
-11,3,-37,-54,-49,-29,-61,10,-228
-24,47,-50,-84,6,0,-35,8,-132
-2,14,-22,-90,-70,-83,-52,-12,-317
-30,22,-24,-66,-53,-10,-14,6,-169
-16,37,-62,-99,-72,-70,-48,13,-317
-30,12,-55,-84,-150,-89,-108,-37,-541
-45,-24,-55,-105,-80,-82,-81,-25,-497
3,12,-53,-127,-126,-117,-98,-78,-584
-27,53,-59,-100,-63,-44,-57,-18,-315
-57,38,-98,-307,-187,-257,-199,-109,-1176
-14,4,-31,-52,-13,-27,-22,-35,-190
60,57,15,-30,-21,-43,-10,30,58
73,56,6,-109,9,-126,-54,0,-145
35,176,-113,-251,-133,-158,-155,83,-516
-29,-34,-47,-46,-41,-34,-71,-35,-337
29,31,-14,-59,-61,-85,-57,-24,-240
152,81,47,79,15,-79,-72,24,247
15,4,-10,-31,-3,-20,-12,-7,-64
-5,-19,-8,-26,-34,3,-27,10,-106
24,12,-8,-30,-34,-47,-36,-16,-135
-9,-10,-25,-19,-21,-24,-40,-8,-156
68,234,1,-478,-347,-379,-163,33,-1031
-163,-24,-176,-343,-210,-138,-306,-41,-1401
201,159,75,-42,-84,-138,-169,102,104
164,54,76,34,98,-11,-78,145,482
-8,20,-26,-68,-59,-19,-3,-14,-177
-122,36,-153,-274,-204,-106,-183,-38,-1044
-9,8,-32,-41,-23,-22,-29,-13,-161
-42,111,-51,-181,-31,-89,-56,1,-338
-21,84,-41,-241,-132,-145,-220,14,-702
-70,-19,-39,-96,-90,-32,-58,12,-392
-55,4,-76,-172,-61,-53,-60,22,-451
-35,-18,-42,-72,-59,-10,-59,28,-267
-48,1,-50,-101,-51,-45,-51,-5,-350
-15,51,-33,-114,-137,-105,-116,-57,-526
-100,-52,-91,-229,-184,-166,-169,-51,-1042
15,16,-129,-279,-128,-222,-187,-74,-988
4,30,-11,-60,-6,-59,-8,20,-90
-23,-5,-50,-112,-130,-74,-129,-13,-536
3,20,-23,-37,-65,-53,-66,-17,-238
-16,-6,-41,-69,-56,-50,-70,-16,-324
10,-3,-14,-59,-50,-72,-22,-18,-228
-49,-18,-41,-108,-70,-65,-66,2,-415
-154,99,-287,-662,-378,-348,-446,26,-2150
-46,23,-21,-69,-41,14,-24,-5,-169
4,-8,-85,-218,-158,-194,-158,-69,-886
-4,27,-58,-79,-73,-79,-89,-74,-429
62,84,-46,-258,3,-179,-235,66,-503
126,95,-61,-178,-91,-244,-243,127,-469
-80,23,-144,-341,-268,-182,-293,100,-1185
-18,-15,-52,-111,-97,-55,-104,27,-425
-48,-26,-61,-145,-70,-44,-101,2,-493
-19,8,-57,-74,-63,-82,-91,-25,-403
66,29,-45,-82,-130,-148,-119,-99,-528
49,16,11,-82,-63,-120,-47,11,-225
-104,18,-123,-242,-56,-118,-148,-86,-859
-69,19,-109,-207,-88,-118,-153,-98,-823
-3,57,-96,-194,-104,-166,-178,-73,-757
-7,19,14,-84,-100,-44,-66,28,-240
-14,29,-35,-100,-75,-60,-48,-2,-305
-21,2,-5,-63,-5,-30,-12,4,-130
-34,-2,-45,-68,-53,-41,-69,-27,-339
-9,-10,-22,-30,-40,-31,-44,-20,-206
-10,20,-17,-86,-37,-62,-32,-20,-244
-9,27,-43,-117,-40,-26,-39,4,-243
-12,25,-11,-74,-74,-69,-58,-18,-291
-58,7,-100,-182,-129,-81,-124,-10,-677
14,59,-9,-97,-25,-43,-41,46,-96
-105,47,-152,-473,-303,-280,-229,-115,-1610
49,553,-177,-923,-413,-584,-671,-542,-2708
-21,-10,-13,-48,-47,10,-44,-11,-184
-43,-36,-24,-73,-108,-67,-68,-20,-439
-39,-33,-110,-220,-320,-244,-314,-64,-1344
-82,117,-64,-249,-134,-182,-109,-15,-718
-13,26,-29,-52,9,-11,-6,-25,-101
52,59,10,-127,11,-76,-40,73,-38
-45,12,-30,-153,-62,-43,-67,-6,-394
-29,7,-15,-70,-115,-89,-78,3,-386
1,28,-10,-34,-36,-33,-42,-2,-128
5,20,-21,-61,11,-3,-41,8,-82
140,94,-4,-221,1,-217,-160,91,-276
-25,10,-24,-68,-44,-30,-38,-27,-246
-48,-15,-60,-148,-107,-148,-168,-41,-735
16,13,13,-19,-19,-14,-11,10,-11
-4,1,-62,-126,-170,-135,-125,-124,-745
-8,-28,-55,-144,-193,-202,-174,-96,-900
-104,-53,-86,-150,-120,-36,-137,28,-658
92,132,30,-61,-17,-92,-135,112,61
49,95,59,-39,-81,-77,-96,5,-85
33,102,-25,-83,-29,-52,-42,3,-93
6,12,-20,-77,-68,-91,-35,-3,-276
-49,55,-57,-265,-187,-175,-138,-1,-817
29,50,-25,-68,-98,-97,-120,-15,-344
-46,-10,-34,-79,-54,-27,-28,-11,-289
-17,14,-28,-42,-17,-7,-26,-5,-128
-65,445,-337,-1159,-1078,-813,-924,-234,-4165
-22,0,-12,-46,-11,-29,-17,-1,-138
8,5,-18,-20,-64,-32,-34,16,-139
-21,41,-48,-94,-69,-102,-92,-36,-421
25,13,-4,-36,-27,-52,-35,-9,-125
-51,72,-63,-139,-43,-52,-58,28,-306
-32,-12,-29,-145,-93,-100,-65,39,-437
-31,7,-29,-82,-46,-26,-34,-19,-260
-4,36,-57,-136,-120,-75,-51,-14,-421
-35,-4,-45,-88,-49,-42,-60,-35,-358
0,17,-8,-54,-40,-56,-42,-6,-189
-2,7,-20,-30,-11,-18,-29,0,-103
0,1,-43,-206,-221,-196,-144,-22,-831
16,17,-32,-64,-104,-85,-59,-11,-322
-36,40,-68,-157,-151,-103,-92,-35,-602
23,23,-40,-111,-92,-94,-105,-18,-414
-109,7,-147,-331,-195,-234,-244,-98,-1351
-30,22,-45,-70,-27,-25,-23,2,-196
-15,2,-51,-74,-72,-41,-58,-18,-327
-6,7,-15,-30,-33,-15,-19,14,-97
-90,35,-60,-153,-36,-44,-45,-58,-451
-4,-34,-129,-239,-183,-209,-236,-94,-1128
182,169,-38,-350,-124,-324,-161,-117,-763
-112,-6,-145,-248,-171,-78,-151,-46,-957
-120,169,-176,-369,-141,-116,-238,47,-944
40,59,3,-111,-17,-47,-29,11,-91
-53,13,-74,-175,-84,-74,-105,34,-518
-9,-8,-48,-75,-79,-45,-52,-18,-334
-97,-46,-130,-267,-161,-108,-170,6,-973
-13,-11,-36,-30,-68,-19,-46,-7,-230
16,90,-9,-96,-36,-58,-21,46,-68
-17,37,-6,-79,-8,-26,-48,1,-146
-14,26,-14,-62,-36,-29,-36,-13,-178
122,21,43,-57,-8,-85,-44,60,52
-58,143,-20,-332,-129,-162,-97,76,-579
12,45,-63,-140,-93,-132,-98,-61,-530
-16,20,-29,-84,-87,-54,-45,-22,-317
19,35,-14,-129,-155,-96,-68,-7,-415
-11,0,-45,-55,-73,-49,-79,-22,-334
-5,0,-34,-69,-50,-56,-49,-33,-296
-24,64,-18,-124,-201,-65,-109,37,-440
127,56,17,-188,34,-132,-107,159,-34
-70,-30,-45,-107,-106,-44,-64,-23,-489
-57,41,-97,-191,-85,-113,-146,-38,-686
-35,5,-21,-81,-38,-9,-74,2,-251
-1,-1,-31,-26,-23,-22,-24,-18,-146
-10,9,-23,-86,-88,-77,-65,-47,-387
17,19,-19,-45,-60,-58,-33,-4,-183
-44,-8,-70,-73,-73,-43,-71,-28,-410
-65,-39,-75,-85,-100,-41,-108,-19,-532
-55,-5,-57,-102,-56,-63,-98,-25,-461
-15,-6,-38,-65,-106,-53,-54,-7,-344
23,16,-29,-70,-18,-61,-42,-2,-183
-73,-74,-94,-122,-111,-75,-115,-54,-718
31,53,-14,-70,-77,-73,-56,-51,-257
-2,20,-28,-97,-13,-46,-58,-31,-255
-19,11,-19,-33,-12,-15,-39,-18,-144
0,10,-15,-15,-31,-31,-29,-11,-122
-1,-1,-64,-135,-127,-146,-92,-17,-583
42,41,-7,-59,-58,-87,-39,-54,-221
36,78,-36,-86,-8,-77,-51,-37,-181
-106,13,-128,-242,-150,-160,-172,-73,-1018
-5,13,-10,-31,-18,-5,-23,-12,-91
192,139,106,-80,14,-129,-141,96,197
14,26,-13,-57,-101,-86,-113,15,-315
-6,27,-28,-98,-84,-86,-66,-64,-405
-18,29,-73,-156,-94,-95,-95,-6,-508
45,28,-83,-102,-184,-145,-140,-95,-676
-68,-5,-67,-155,-90,-78,-115,-22,-600
-44,-1,-78,-130,-84,-61,-59,5,-452
-12,17,-25,-20,1,-1,-9,-18,-67
-9,7,-19,-50,-49,-16,-12,-42,-190
6,18,-3,-69,-22,-42,-16,6,-122
-46,3,-42,-170,-193,-131,-104,14,-669
122,76,46,-72,-11,-110,-76,53,28
168,84,52,22,10,-80,-43,76,289
0,19,-25,-87,-47,-68,-60,21,-247
83,14,-1,-52,-44,-121,-61,-29,-211
72,78,31,-60,19,-103,-104,-21,-88
8,27,-31,-107,-161,-144,-111,-81,-600
-11,150,-1,-26,1,70,-58,14,139
-14,14,-29,-52,-54,-77,-68,48,-232
-9,-2,-11,-18,-22,-10,-32,-26,-130
-14,2,-21,-24,-10,-10,-32,-15,-124
-62,-7,-72,-172,-95,-57,-56,57,-464
-18,42,-21,-61,-28,-25,-46,4,-153
-31,15,-44,-142,-32,-84,-92,-9,-419
-28,21,-27,-82,-54,-43,-33,1,-245
-14,29,-85,-153,-133,-161,-151,-77,-745
-74,73,-149,-222,-93,-129,-178,-29,-801
6,20,2,-44,-28,-35,8,-16,-87
-37,40,-33,-182,-147,-110,-154,-36,-659
5,0,2,-35,-47,-24,-11,27,-83
-9,8,-3,-36,-38,-25,-22,25,-100
-20,9,-10,-53,-12,-27,-16,-28,-157
-50,-32,-65,-116,-32,-60,-95,-42,-492
-17,-6,-22,-50,-30,-42,-42,-22,-231
-49,25,-19,-145,-92,-46,-86,-120,-532
408,287,-20,-508,-338,-725,-408,-75,-1379
8,20,-5,-52,-8,-31,-13,0,-81
-16,18,-25,-83,-22,-65,-45,-18,-256
-10,45,-9,-91,-1,-41,-39,-8,-154
-19,-38,7,-30,-62,-29,-27,7,-191
-12,5,-7,-23,-15,-18,4,-10,-76
-40,-28,-43,-62,-39,-25,-60,7,-290
31,7,-12,-26,-26,-66,-25,-28,-145
-40,-61,-64,-150,-131,-102,-160,45,-663
-18,18,-67,-149,-173,-106,-125,-57,-677
-21,2,-21,-65,-40,-31,-31,0,-207
58,38,-27,-55,-40,-59,-54,-3,-142
2,11,-27,-115,-77,-53,-75,-28,-362
-17,29,-32,-92,-40,-77,-92,-50,-371
74,44,20,-102,-58,-124,-48,34,-160
-19,26,2,-53,-60,-83,-71,-34,-292
0,11,-3,-19,-19,-1,-9,-4,-44
-9,73,-52,-127,-81,-93,-75,12,-352
22,35,-22,-128,-135,-169,-133,-29,-559
-2,4,-15,-68,-98,-43,-46,10,-258
-81,-22,-54,-143,-58,-54,-84,-21,-517
12,19,-34,-108,-43,-97,-95,-36,-382
-31,159,-38,-216,-157,-108,-90,30,-451
-9,-2,-14,-31,-29,-20,-16,5,-116
-2,6,2,-12,-4,-11,-5,7,-19
-73,-38,-114,-164,-93,-93,-158,-59,-792
-15,0,-16,-31,-38,-22,-18,-4,-144
-26,30,-29,-78,-99,-8,-61,-22,-293
-22,44,-26,-84,-88,-13,-51,-22,-262
-29,14,-34,-82,-70,-13,-65,-2,-281
-7,-2,-28,-69,-100,-3,-75,0,-284
0,0,-12,-89,-140,-60,-85,-7,-393
-6,26,-14,-54,-5,-12,-9,11,-63
-37,-19,-37,-103,-59,-39,-52,-17,-363
-1,20,-3,-99,-143,-67,-97,15,-375
-58,-59,-67,-142,-148,-97,-198,-19,-788
-42,-12,-43,-73,-61,-33,-80,-23,-367
-40,-25,-46,-100,-52,-58,-117,-18,-456
-33,-7,-86,-140,-88,-78,-84,-32,-548
4,20,9,0,-37,5,-13,9,-3
-52,-39,-89,-120,-207,-62,-127,97,-599
-114,87,-196,-553,-220,-303,-261,133,-1427
-20,15,-39,-99,-62,-51,-95,-60,-411
-37,-19,-19,-102,-166,-30,-58,99,-332
18,-3,5,-37,-59,-21,-30,-10,-137
-25,0,-32,-64,-64,-33,-40,0,-258
6,-32,-37,-53,-101,-60,-87,-28,-392
133,129,-21,-211,-87,-215,-155,-15,-442
-48,88,-104,-275,-152,-103,-157,-41,-792
-4,26,-31,-112,-83,-89,-91,-20,-404
11,46,-7,-36,-100,-25,-60,-49,-220
-9,23,-3,-44,-35,-26,-25,-5,-124
-15,5,-31,-33,-34,-9,-26,-8,-151
-7,22,-15,-101,-98,-68,-56,-6,-329
1,9,-29,-105,-67,-41,-81,34,-279
-7,-22,-45,-31,-84,-34,-61,-11,-295
-20,-28,-35,-46,-72,-34,-59,-13,-307
-29,25,-30,-79,-52,36,-40,46,-123
-6,46,-22,-88,-58,-23,-55,4,-202
1,7,-16,-41,-84,-63,-57,-28,-281
-14,57,10,-79,44,13,-86,63,8
22,26,-14,-91,-76,-114,-124,-62,-433
-31,40,-28,-88,-38,-24,-65,13,-221
-12,26,-24,-77,-93,-67,-71,17,-301
-21,64,-18,-136,-87,-24,-88,67,-243
-6,50,-26,-99,-93,-30,-75,41,-238
-9,11,-24,-78,-102,-70,-63,-46,-381
-64,-27,-75,-121,-62,-58,-116,-54,-577
2,11,-20,-27,-21,-33,-39,15,-112
5,9,-29,-34,-16,-21,-40,-8,-134
-24,-3,-41,-88,-82,-44,-56,-13,-351
-32,4,-45,-109,-66,-62,-63,-16,-389
-6,18,-14,-24,-1,-4,-10,-12,-53
-51,-7,-62,-126,-114,-53,-59,-1,-473
-22,22,-65,-103,-68,-44,-81,-45,-406
-40,4,-74,-115,-84,-57,-108,-47,-521
9,13,-62,-110,-98,-110,-126,-70,-554
-64,85,-144,-333,-222,-148,-228,89,-965
-111,28,-140,-421,-344,-188,-232,51,-1357
-158,13,-215,-457,-374,-185,-252,79,-1549
-16,15,-27,-62,-31,-33,-42,-9,-205
7,11,-12,-17,-36,-38,-35,-2,-122
-9,-6,-13,-30,-28,-21,-20,-12,-139
-18,-7,-11,-33,-34,-20,-19,-1,-143
-2,1,-1,-15,-18,-2,-3,1,-39
-5,88,6,-101,-29,-23,-52,63,-53
50,56,-13,-65,-40,-91,-63,26,-140
15,50,-5,-96,22,-74,-44,62,-70
-11,-1,-7,-39,-59,-26,-26,-1,-170
-14,-7,-15,-38,-58,-35,-31,-5,-203
-31,-13,-15,-55,-55,-23,-29,0,-221
-33,-6,-15,-88,-49,-43,-22,-12,-268
-42,76,-75,-120,-148,-63,-125,34,-463
-52,111,-83,-194,-182,-138,-213,7,-744
-11,-15,-25,-48,-56,-44,-57,-23,-279
-36,9,-52,-145,-65,-101,-88,-35,-513
-20,3,6,-47,-70,-29,-42,13,-186
2,16,-13,-28,-5,-12,-16,-9,-65
19,20,-6,-45,-13,-45,-23,-8,-101
8,22,-16,-8,-24,-16,-26,-29,-89
15,26,-24,-13,-32,-26,-23,-19,-96
41,46,11,-13,22,-19,-23,11,76
11,48,-29,-50,-21,-50,-29,-26,-146
11,48,-33,-77,-4,-35,-29,-25,-144
-23,-1,-6,-21,-22,-14,-30,7,-110
-27,-3,-21,-48,-32,-18,-47,-1,-197
-36,-1,-22,-23,-40,-3,-38,0,-163
-19,9,-25,-57,-19,-14,-38,-11,-174
-36,23,-49,-92,-36,-61,-55,-37,-343
-16,25,-40,-78,-16,-54,-49,-17,-245
-17,29,-37,-84,-25,-56,-61,-12,-263
8,21,-9,-30,-15,-26,-15,-6,-72
104,274,-150,-546,-297,-360,-338,97,-1216
-12,4,-7,-24,-19,-17,-17,-13,-105
6,7,-3,-26,-52,-39,-28,-2,-137
4,15,-18,-38,-15,-31,-26,3,-106
-12,12,-4,-39,-18,-26,-33,4,-116
4,-1,-18,-29,-8,-33,-28,-30,-143
3,10,-17,-29,-10,-36,-27,-17,-123
1,20,-14,-34,-16,-26,-32,-23,-124
8,14,-19,-61,-43,-55,-38,-11,-205
17,15,-3,-6,-4,-23,-10,-2,-16
4,3,1,2,-1,-1,2,2,12
0,15,-30,-71,-22,-52,-55,-13,-228
-7,2,-38,-77,-41,-61,-50,-22,-294
-24,11,-18,-56,-26,-46,-40,-12,-211
-19,30,-24,-63,-25,-32,-39,-14,-186
-15,16,-15,-64,-36,-39,-30,-5,-188
-17,20,-18,-65,-24,-35,-23,-1,-163
-14,23,-15,-60,-22,-29,-29,-3,-149
-13,15,-10,-50,-26,-28,-37,-6,-155
-14,14,-11,-49,-32,-31,-35,-7,-165
-11,23,-17,-62,-19,-34,-31,-2,-153
-40,-4,-54,-90,-27,-43,-48,-20,-326
-23,1,-23,-41,-27,-5,-30,-1,-149
-24,4,-37,-59,-41,-25,-45,29,-198
-3,16,-25,-45,-2,-6,-23,24,-64
-2,9,-39,-62,-62,-57,-43,-55,-311
-14,29,2,-56,-30,-37,-54,19,-141
-37,-7,-20,-36,-59,-34,-34,1,-226
10,20,-10,-24,-6,-21,-24,13,-42
10,20,-10,-24,-6,-21,-24,13,-42
7,27,-7,-31,-11,-31,-28,20,-54
12,18,-9,-32,-8,-29,-19,15,-52
10,18,-4,-24,-9,-26,-23,18,-40
8,23,-10,-33,-8,-27,-25,18,-54
12,18,-8,-20,-6,-22,-15,20,-21
7,11,-7,-32,-1,-20,-17,29,-30
12,18,-3,-22,2,-28,-16,24,-13
11,31,-7,-32,-19,-35,-16,19,-48
6,29,-11,-30,-22,-31,-19,18,-60
21,32,-6,-7,1,-20,-16,25,30
21,31,-6,-9,-3,-24,-18,26,18
5,36,-6,-15,-7,-18,-17,14,-8
22,37,4,2,-6,-18,-19,28,50
23,44,-1,1,0,-9,-18,37,77
15,39,-8,1,-1,-10,-19,28,45
19,36,-1,4,5,-3,-23,33,70
28,37,-2,5,2,-15,-16,34,73
1,14,-9,-15,-24,-22,-19,20,-54
2,24,-12,-6,-17,-20,-18,26,-21
3,24,-13,-17,-22,-20,-13,28,-30
-5,15,-18,-19,-26,-20,-23,29,-67
9,34,-2,-7,-15,-22,-20,38,15
-36,81,-52,-155,-44,-48,-50,-21,-325
7,-1,-31,-89,-45,-56,-58,-21,-294
-15,2,-10,-37,-21,-19,-15,14,-101
-3,11,-20,-38,-12,-32,-30,-7,-131
1,10,-3,-8,-40,-20,-25,22,-63
1,16,-5,-2,-28,-27,-25,26,-44
5,9,-3,-3,-22,-23,-23,17,-43
7,15,-12,-8,-24,-25,-23,12,-58
14,21,-3,-7,-16,-24,-18,17,-16
12,14,-1,-12,-16,-23,-26,7,-45
-1,15,-3,-4,-30,-16,-27,21,-45
12,17,-7,-8,-23,-23,-17,17,-32
11,14,-9,-4,-25,-21,-18,14,-38
7,15,-9,-10,-20,-25,-17,8,-51
6,14,-8,-3,-20,-15,-15,6,-35
-21,14,-21,-38,-24,-38,-32,3,-157
-27,16,-21,-42,-21,-30,-32,-5,-162
-4,23,-10,-13,-5,-8,-39,22,-34
-8,16,-9,-22,-11,-13,-34,25,-56
28,109,-39,-130,-165,-64,-80,20,-321
11,17,-9,-23,-13,-25,-4,6,-40
6,17,-14,-36,-16,-23,-17,17,-66
-7,-7,-15,-23,-24,-31,-33,8,-132
-4,47,-3,-122,-64,-68,-66,41,-239
-11,33,-31,-81,-12,-12,-17,35,-96
-1,-1,0,0,0,0,1,0,-1
-10,31,-16,-82,-2,2,-25,57,-45
-3,40,-29,-112,-6,-43,-36,44,-145
-3,34,-17,-83,-1,-6,-26,53,-49
-18,33,-19,-105,-64,-61,-46,69,-211
22,43,-22,-105,-37,-84,-56,-6,-245
7,38,-21,-96,-38,-70,-59,-4,-243
-5,25,-38,-115,-33,-81,-58,-2,-307
17,-8,-10,-41,-105,-85,-61,-20,-313
20,-11,-5,-47,-79,-80,-59,-8,-269
-18,-20,-37,-73,-53,-5,-33,13,-226
-11,18,-26,-66,-38,-17,-43,20,-163
-16,23,-40,-75,-48,-27,-42,10,-215
-5,16,-19,-78,-48,-36,-33,8,-195
-6,17,-15,-85,-43,-26,-24,16,-166
-39,-16,-31,-82,-74,-52,-47,2,-339
-16,-10,-19,-36,-45,-37,-39,-29,-231
-2,-2,-21,-25,-28,-28,-30,-30,-166
0,-2,-21,-29,-27,-22,-32,-28,-161
6,24,-19,-27,-24,-13,-16,-35,-104
907,402,547,524,486,248,-42,192,3264
910,406,513,490,492,256,-10,139,3196
896,454,492,534,500,213,-21,253,3321
952,556,705,308,724,390,-7,361,3989
-13,-3,-9,-50,-41,-39,-21,11,-165
-18,1,-15,-70,-29,-22,-16,8,-161
46,91,35,-47,-33,-48,-90,-34,-80
73,131,85,-14,-68,-57,-105,-11,34
24,133,3,-133,-106,-136,-121,-61,-397
-62,86,-281,-535,-557,-448,-475,-371,-2643
9,13,-8,-3,-42,-12,-15,-4,-62
-11,18,-28,-76,-42,-47,-77,-75,-338
18,20,-6,-81,-85,-79,-89,-75,-377
-8,12,-18,-33,-12,-12,-30,-15,-116
-15,6,-15,-32,-5,-10,-25,-20,-116
1,18,-12,-32,-15,-21,-29,-8,-98
10,8,-7,-3,-18,-24,-28,-6,-68
103,193,44,-60,-7,-39,-62,163,335
16,37,19,-27,-13,-1,-38,42,35
-1,14,-31,-50,-53,-35,-78,7,-227
69,63,35,-19,-3,-54,-4,23,110
-13,6,-2,-33,-25,-11,-16,-4,-98
-97,-37,-72,-175,-102,-31,-126,33,-607
-19,15,-18,-53,-44,-49,-28,25,-171
3,7,-1,0,-2,-4,-1,-3,-1
2,4,-1,0,-2,-3,-2,-1,-3
-92,0,-160,-318,-215,-177,-245,-80,-1287
-8,18,-25,-48,-27,3,-36,26,-97
-22,-9,-45,-69,-38,-34,-39,8,-248
41,44,17,-30,10,32,-28,44,130
54,33,29,-14,24,35,-30,28,159
47,47,14,-13,43,24,-42,36,156
-46,53,-68,-139,-108,-57,-92,35,-422
-24,6,-25,-61,-31,21,-55,22,-147
11,57,-45,-117,2,-84,-60,-90,-326
15,246,83,-428,-261,-14,-253,515,-97
5,2,-6,-28,-39,-40,-26,17,-115
6,16,-15,-49,-39,-14,-48,21,-122
-25,-10,-36,-38,-38,-15,-19,-12,-193
20,-16,-25,-71,-54,-57,-49,-12,-264
-5,0,-21,-32,-49,-38,-33,-2,-180
-50,-40,-82,-129,-145,-102,-126,-127,-801
-58,5,-72,-157,-116,-75,-122,-48,-643
-37,55,-75,-115,-40,-81,-93,-30,-416
-16,17,-17,-43,-27,-24,-23,-20,-153
-8,10,-26,-33,-19,-17,-32,-21,-146
-21,4,-13,-45,-17,-10,-16,-3,-121
2,14,-73,-145,-121,-76,-116,-12,-527
-13,34,-72,-80,-109,-100,-94,-66,-500
20,52,-47,-122,-127,-116,-65,-26,-431
31,21,-1,-51,-45,-61,-70,-5,-181
3,10,-31,-31,-43,-44,-52,-47,-235
-5,-6,-31,-39,-45,-37,-44,-30,-237
-16,27,-17,-13,-22,-13,-17,-19,-90
5,-1,-1,-7,-3,3,-12,14,-2
90,35,41,30,52,18,17,35,318
257,72,108,58,187,-36,47,105,798
24,-13,-12,-12,13,-19,-5,3,-21
10,-4,-14,-18,-17,-21,-18,-9,-91
23,47,-25,-102,-70,-131,-104,-56,-418
-63,-17,-101,-149,-77,-83,-140,-63,-693
-72,-17,-94,-168,-48,-87,-141,-68,-695
-18,5,-40,-51,-9,-14,-53,-32,-212
-23,5,-39,-37,-22,-23,-62,-20,-221
-108,27,-140,-257,-80,-128,-211,-99,-996
-129,-32,-172,-271,-130,-139,-252,-107,-1232
-22,1,-25,-45,-62,3,-66,26,-190
-17,1,-10,-29,11,-10,-20,-12,-86
-15,-2,-10,-47,-30,-34,-16,-8,-162
-62,26,-45,-156,-129,-63,-92,53,-468
-52,52,-28,-123,-83,-20,-78,39,-293
12,-24,-9,-46,-70,-8,-41,14,-172
79,45,-50,-182,-98,-220,-136,-135,-697
-3,23,-19,-23,11,-1,-12,-17,-41
-16,6,-22,-31,-31,-41,-28,0,-163
-30,6,-40,-52,-19,-14,-24,-18,-191
-44,-20,-41,-89,-87,-23,-103,27,-380
-29,-37,-37,-84,-101,-51,-133,32,-440
-27,-33,-34,-84,-98,-59,-127,28,-434
-36,67,-31,-145,-11,8,-86,89,-145
39,18,-14,-45,-63,-62,-28,44,-111
-86,30,-114,-244,-248,-152,-203,-16,-1033
-1,-84,14,-41,-111,-39,-55,15,-302
-24,48,-31,-181,-94,-106,-88,30,-446
-35,8,-54,-135,-123,-90,-78,0,-507
-4,-1,-16,3,-17,-3,-25,-8,-71
-2,-29,-36,-125,-107,-97,-113,-31,-540
-16,-3,-44,-98,-44,-46,-75,13,-313
-52,50,-45,-102,-72,-48,-64,-21,-354
15,-5,-30,-68,-103,-58,-66,-47,-362
-3,-6,-3,-7,-19,-1,-14,2,-51
-9,8,-16,-57,-102,-68,-73,-46,-363
-38,11,-17,-82,-58,-48,-26,-23,-281
-19,12,-37,-72,-37,-37,-53,-20,-263
-298,217,-620,-1341,-733,-644,-784,-210,-4413
-15,18,-26,-36,-32,-14,-26,-3,-134
-22,5,-26,-56,-17,-38,-45,-18,-217
9,122,-53,-168,-50,-74,-107,56,-265
-9,6,1,-10,-5,3,-11,1,-24
41,36,41,18,17,21,-41,48,181
-2,-6,-12,-29,-27,-40,-38,-32,-186
-18,-23,-49,-127,-61,-84,-77,-29,-468
0,-6,-39,-98,-98,-73,-88,-34,-436
-3,-14,-16,-38,-61,-35,-46,-12,-225
10,16,-8,-79,36,-53,-107,17,-168
71,48,9,-46,-56,-95,-29,16,-82
-103,-36,-98,-160,-112,-88,-121,15,-703
14,33,-16,-18,-16,-17,-25,16,-29
-17,33,-32,-59,-6,-36,-43,1,-159
9,38,-49,-113,-95,-97,-81,-23,-411
-3,21,-17,-87,-42,-36,-32,-3,-199
-7,15,-14,-67,14,-35,-37,-17,-148
-14,10,-16,-57,-55,-42,-44,-31,-249
73,129,86,-14,-59,-60,-107,-16,32
171,257,111,71,85,19,-91,40,663
-12,9,-9,-23,-8,-2,-23,2,-66
-160,280,-199,-545,-436,-240,-453,98,-1655
19,74,-49,-130,-32,-98,-71,-49,-336
45,127,8,-33,18,-24,30,54,225
242,68,107,65,160,-29,51,94,758
19,26,22,-51,-61,-39,-39,32,-91
-2,5,-30,-49,-107,-23,-52,16,-242
-3,16,-37,-100,-144,-103,-123,-66,-560
11,18,-7,-25,-7,-25,-22,19,-38
7,27,-7,-31,-11,-31,-28,20,-54
3,22,-13,-35,-21,-32,-18,11,-83
-7,21,-9,-34,-9,-23,-19,-9,-89
-6,14,-21,-35,-15,-16,-14,10,-83
16,-5,-1,-40,-108,-90,-59,-21,-308
-13,-12,-14,-52,-65,-37,-20,8,-205
-17,-5,12,-31,-31,-34,3,27,-76
-35,5,13,-56,-42,-59,3,21,-150
-13,63,-62,-293,-144,-208,-247,-67,-971
-25,31,-21,-92,-77,-96,-71,-4,-355
15,63,-101,-200,-146,-161,-138,-83,-751
23,23,18,3,-29,-11,-52,-23,-48
14,43,-9,-82,2,-89,-46,36,-131
-15,29,-11,-10,-14,-9,-18,-9,-57
-14,29,-10,-9,-11,-8,-18,-13,-54
-12,33,-14,-15,-15,-14,-15,-13,-65
13,-8,6,-17,-41,9,-48,59,-27
15,-7,6,-21,-42,19,-48,51,-27
7,4,5,-41,-29,-52,-16,-3,-125
-53,-9,-51,-185,-90,-70,-105,12,-551
-20,9,-37,-71,-34,-36,-36,-20,-245
-7,-14,-30,-79,-50,-49,-29,-30,-288
-94,-48,-114,-168,-179,-83,-120,-19,-825
-41,-7,-56,-177,-153,-76,-122,-13,-645
-12,-12,-107,-155,-182,-124,-159,-26,-777
-25,-2,-43,-63,-100,-54,-61,-36,-384
14,11,-16,-40,-38,-33,-11,-25,-138
-26,60,-124,-364,-237,-289,-252,-93,-1325
5,2,-5,-23,-35,-38,-36,7,-123
-16,26,-24,-73,-32,-45,-52,-26,-242
-20,21,-13,-59,-38,-43,-39,-6,-197
-15,18,-16,-57,-25,-38,-36,0,-169
-9,2,-20,-53,-31,-34,-42,0,-187
-8,42,0,-35,-6,-25,-21,6,-47
-61,-1,-156,-281,-285,-148,-200,-54,-1186
-12,13,-22,-67,-13,-8,-22,8,-123
60,129,1,-67,-2,-66,53,8,116
17,6,-30,-35,-99,-72,-67,-31,-311
1,35,-26,-108,-169,-85,-86,20,-418
-28,7,-13,-102,-57,-13,-42,-3,-251
-7,-12,-34,-48,-22,-23,-24,-19,-189
38,-3,-21,-26,-125,-38,-74,-6,-255
-50,9,-80,-176,-89,-75,-104,-46,-611
-55,109,-67,-137,-98,-39,-114,14,-387
-45,99,-67,-185,-101,-39,-82,-34,-454
-42,-65,-38,-147,-98,-77,-109,-42,-618
-14,-4,-16,-14,-18,-10,-18,-15,-109
18,12,-43,-122,-45,-117,-88,-58,-443
-26,5,-23,-50,-33,-31,-45,-37,-240
-16,8,-24,-53,-24,-21,-33,-22,-185
27,21,20,15,-9,4,25,6,109
-10,17,-35,-72,-73,-36,-68,-5,-282
-9,-10,-28,-99,-74,-62,-86,-17,-385
-25,-10,-44,-166,-81,-79,-71,3,-473
-12,-30,-18,-45,-128,-49,-75,-19,-376
-25,20,-52,-121,-70,-59,-70,8,-369
-13,52,-59,-162,-53,-67,-122,-6,-430
-58,39,-50,-88,-109,7,-76,40,-295
-53,69,-87,-149,-40,-21,-80,37,-324
4,31,-13,-44,-20,-41,-22,-4,-109
3,25,4,-32,-2,-8,10,12,12
-11,-25,-50,-197,-127,-172,-145,-27,-754
-35,-8,-23,-143,-218,-143,-115,-21,-706
-4,-42,-9,-61,-200,-74,-97,18,-469
-49,0,-45,-185,-83,-121,-101,-26,-610
-79,-38,-77,-188,-101,-74,-89,-50,-696
22,31,-30,-41,-128,-83,-91,-17,-337
51,24,-2,-59,-125,-93,-95,-35,-334
-34,-11,-27,-67,-98,-49,-40,2,-324
27,16,8,21,0,3,19,-9,85
-7,22,-13,-36,-7,-13,-7,-6,-67
1,25,-30,-63,-15,-39,-44,-13,-178
-23,23,-10,-62,-24,-40,-26,-12,-174
7,63,-42,-187,-59,-107,-47,4,-368
31,-2,-6,10,-32,-11,-19,-5,-34
23,19,-15,1,-34,-19,-2,-5,-32
0,-3,-35,-64,-97,-39,-61,-12,-311
20,5,-1,-25,-8,-40,-13,-10,-72
34,36,8,-41,7,-60,-48,-11,-75
-17,17,-9,-32,-34,-20,-22,-16,-133
-28,55,-31,-116,-31,-34,-30,-33,-248
-8,10,-14,-5,-13,-8,-12,40,-10
1,17,-20,-33,-31,-32,-41,-36,-175
-8,48,-25,-65,-49,11,-1,-16,-105
-7,-1,-27,-35,-50,-23,-46,3,-186
-25,-6,-25,-69,-69,-41,-38,-11,-284
-45,0,-71,-106,-52,-52,-101,-21,-448
-43,-9,-70,-143,-98,-48,-85,15,-481
42,57,-17,-105,-24,-91,-46,-29,-213
-63,118,-83,-162,-87,16,-60,51,-270
-53,16,-41,-127,-76,-20,-70,3,-368
-11,30,-7,-73,-113,-98,-105,-65,-442
26,94,13,-64,-55,-49,-101,-9,-145
14,0,-10,-13,-19,-3,-12,34,-9
2,-10,-25,-93,15,-19,-25,-5,-160
-3,24,-55,-60,-24,-25,-43,-65,-251
11,3,-22,-19,-44,-9,-19,-25,-124
26,34,-4,-68,-119,-63,-65,-27,-286
848,424,562,413,534,339,-50,269,3339
-27,5,-21,-52,-33,-22,-41,8,-183
-17,37,-49,-82,-44,-61,-64,-18,-298
32,67,-43,-106,-51,-99,-65,-10,-275
17,-18,-36,-72,-100,-83,-89,-62,-443
-70,-49,-65,-168,-127,-72,-124,-31,-706
-114,44,-179,-374,-191,-192,-230,5,-1231
-21,7,-66,-132,-90,-70,-91,-34,-497
1,25,-38,-112,-101,-59,-79,-36,-399
-20,23,-57,-126,-87,-28,-97,33,-359
2,-9,-17,-50,-88,-57,-66,-38,-323
15,4,-9,-24,-28,-41,-14,-9,-106
8,20,-4,-27,-3,-12,-12,30,0
-4,11,-14,-27,-14,-27,-22,28,-69
6,-1,-7,-22,-17,-8,-20,19,-50
-5,11,-13,-17,-9,-14,-34,9,-72
-5,-5,-29,-57,-54,-34,-55,-5,-244
61,26,-13,-71,-167,-65,-72,20,-281
-120,31,-115,-315,-117,-130,-173,0,-939
134,61,-62,-183,-97,-214,-198,-10,-569
27,41,14,23,-6,17,39,28,183
-37,4,-38,-95,-64,-41,-62,-15,-348
18,4,-48,-113,-187,-84,-104,-27,-541
1,64,-36,-131,-53,-72,-94,20,-301
-12,5,-4,-24,-2,2,-16,-10,-61
-8,4,-24,-23,-8,-7,-19,-27,-112
-9,12,-47,-113,-55,-62,-102,-87,-463
-7,32,0,-109,-21,-30,-21,14,-142
-10,-1,-25,-58,-54,-40,-23,-8,-219
-10,33,-64,-150,-88,-58,-89,119,-307
-10,33,-30,-81,-47,-28,-41,-20,-224
5,13,-46,-72,-113,-50,-59,-34,-356
1,43,-37,-62,-37,-48,-50,-13,-203
-54,-53,-84,-197,-199,-89,-144,-70,-890
-29,-17,-60,-110,-125,-39,-109,-58,-547
-38,13,-21,-79,-80,-29,-22,-11,-267
24,43,4,-17,-24,-3,3,51,81
8,50,5,-23,-40,4,-52,-71,-119
32,35,-88,-197,-218,-126,-107,38,-631
28,21,-24,-67,-21,-58,-30,-33,-184
-33,24,-19,-89,-107,-67,-59,24,-326
-5,-14,-45,-141,-57,-54,-89,3,-402
-7,16,-12,-43,-43,-25,-52,2,-164
11,13,-17,-35,-30,-25,-20,-13,-116
-17,9,-1,-23,-31,-25,-11,-2,-101
-49,-9,-64,-119,-110,-60,-65,12,-464
-8,-31,-47,-78,-52,-42,-68,22,-304
-43,2,-48,-140,-53,-58,-72,-19,-431
20,-12,-37,-100,-136,-140,-96,-47,-548
7,10,-1,1,-8,0,0,-9,0
-7,17,-1,-31,-21,7,-6,11,-31
-30,12,-31,-80,-83,-26,-57,0,-295
42,108,-6,-65,-84,-84,-95,-16,-200
13,187,-27,-219,-49,0,-13,1,-107
92,93,-15,-50,-120,-118,-10,20,-108
42,34,-24,-204,-175,-214,-156,-94,-791
57,19,-22,-44,-88,-102,-108,-23,-311
1,25,-29,-40,-115,-23,-51,-41,-273
-40,53,-93,-137,-90,-36,-90,14,-419
13,16,-56,-60,-109,-22,-39,-30,-287
-30,14,-26,-68,-41,-36,-54,-11,-252
-3,22,13,-3,-28,-4,13,6,16
-2,35,-34,-36,2,-19,-40,-15,-109
6,23,-24,-43,-11,-21,-39,-10,-119
-8,5,-9,-13,-17,3,-2,-2,-43
-21,0,-18,-52,-32,-54,-31,4,-204
-16,-7,-19,-48,-23,-45,-29,13,-174
-10,1,-15,-37,-41,-51,-16,15,-154
-17,42,-29,-80,-94,-10,-60,-20,-268
-36,78,-90,-277,-137,-208,-176,-98,-944
23,47,-67,-187,-124,-154,-165,39,-588
6,32,-36,-60,-75,-35,-88,10,-246
-27,5,-41,-82,-92,-73,-85,-26,-421
11,54,19,-23,-119,-43,-65,48,-118
-19,50,-15,-89,-75,-54,-85,43,-244
5,97,-76,-285,5,-131,-167,-37,-589
13,2,-17,-42,-65,-49,-42,-16,-216
-44,23,-58,-163,-143,-89,-115,1,-588
16,29,13,-50,-69,-42,-39,36,-106
-16,27,-10,-7,-15,-8,-14,-16,-59
-3,5,-23,-36,-25,-25,-45,-3,-155
101,203,-6,-227,201,92,26,-38,352
10,12,-25,-4,-34,4,-51,26,-62
7,9,-24,-17,-49,-13,-44,25,-106
28,35,-13,-36,5,-33,-10,-10,-34
-2,-49,-6,-48,-22,-11,-32,27,-143
-53,-29,-86,-177,-138,-121,-141,-54,-799
-69,-22,-75,-122,-104,-62,-110,14,-550
-17,22,-39,-91,-18,-39,-40,-16,-238
-56,11,-83,-142,-106,-72,-117,-55,-620
-23,-5,-78,-162,-110,-114,-116,-39,-647
15,25,-14,30,-49,-7,-37,26,-11
2,19,-12,-15,-29,-5,-22,8,-54
-16,7,-37,-62,-37,-46,-36,-22,-249
1,9,-24,-55,-36,-37,-37,-26,-205
0,23,-6,-39,-19,-18,-17,31,-45
-84,16,-121,-339,-246,-151,-159,-67,-1151
4,29,-12,-11,-15,-2,-42,34,-15
-43,12,-39,-117,-94,-28,-82,5,-386
-93,37,-89,-189,-136,-35,-81,5,-581
13,-15,1,-66,-48,-96,-72,-37,-320
37,60,14,-43,-26,-26,-12,57,61
-13,64,-26,-91,-121,-78,-162,0,-427
-17,15,-16,-29,-10,-8,-4,-7,-76
-27,175,-73,-228,-195,-69,-279,-17,-713
6,11,-35,-89,-79,-68,-83,-18,-355
-24,-3,-48,-94,-99,-44,-63,-30,-405
-19,43,-75,-304,-188,-212,-185,11,-929
0,49,10,-32,-37,12,-46,-52,-96
54,2,-22,-55,-145,-72,-103,-23,-364
-19,28,-64,-124,-49,-112,-117,-76,-533
-2,9,-38,-84,-48,-58,-39,-29,-289
70,125,41,-23,-21,11,-94,130,239
-10,20,-5,-23,4,-5,-15,28,-6
-57,-10,-46,-110,-85,-72,-81,1,-460
193,225,57,-11,-11,-27,-38,123,511
-52,36,-56,-117,-175,-101,-61,54,-472
-96,18,-137,-317,-223,-158,-175,61,-1027
-49,-37,-55,-93,-114,-53,-115,-1,-517
-30,1,-22,-25,-10,-1,-17,7,-97
816,371,501,440,416,308,-65,123,2910
-16,13,-55,-148,-210,-143,-123,-96,-778
-23,-7,-17,-45,-57,-21,-14,-14,-198
33,84,-41,-61,-81,-72,-74,-16,-228
234,154,130,-90,110,-182,-154,94,296
-86,-39,-81,-140,-106,-45,-103,40,-560
-52,-52,-73,-148,-141,-98,-132,2,-694
-1,73,-22,-106,0,-16,-58,42,-88
-99,-8,-179,-316,-407,-174,-263,-14,-1460
-25,2,-56,-114,-86,-67,-96,1,-441
71,109,-84,-139,-90,-141,-121,-65,-460
-1,13,-13,-18,-51,-31,-77,21,-157
3,29,-4,-12,-46,-26,-62,14,-104
55,160,0,-160,3,-86,-142,192,22
-8,-30,-76,-156,-143,-99,-102,12,-602
-8,45,-31,-127,-240,-93,-122,-10,-586
-94,62,-93,-188,-147,-58,-78,8,-588
-33,57,-52,-129,-143,-69,-103,-38,-510
-54,-37,-69,-138,-142,-97,-94,-26,-657
4,1,-11,-79,-99,-69,-59,-7,-319
36,20,3,2,-44,1,-60,24,-18
54,5,-22,-44,-30,27,-67,10,-67
5,-23,-12,-120,-65,-34,-81,-1,-331
-16,1,-41,-71,-33,-29,-44,-22,-255
27,6,-5,-4,-64,-38,-41,-16,-135
-6,9,-3,-75,-74,-60,-27,5,-231
-4,30,-23,-71,-123,-24,-61,-29,-305
-12,17,-38,-81,-91,-70,-63,-39,-377
-19,2,-86,-130,-169,-81,-123,0,-606
-11,55,-19,-90,-52,-49,-51,-13,-230
-18,-14,-15,-26,-31,-32,-21,1,-156
55,52,-85,-210,-171,-188,-155,-52,-754
538,111,403,328,-122,-61,-899,1085,1383
5,-4,-17,-67,-118,-63,-45,-11,-320
-28,15,-26,-77,-63,-34,-47,-2,-262
19,35,-44,-114,-64,-106,-80,-64,-418
887,518,651,322,595,371,-39,286,3591
29,24,-15,-73,-82,-89,-64,-16,-286
-22,78,-123,-284,-140,-137,-165,129,-664
11,15,-17,-41,-17,12,-5,16,-26
-138,22,-142,-384,-239,-122,-231,38,-1196
35,66,-71,-89,-176,-118,-105,-30,-488
36,-35,-55,-130,-164,-167,-154,-33,-702
-3,10,-9,-28,-33,-4,-21,-27,-115
-66,112,-42,-167,-81,25,-97,165,-151
9,26,-35,-50,-55,-48,-26,-26,-205
11,66,40,-69,-52,-101,21,-12,-96
-3,21,-37,-91,-84,-47,-83,8,-316
-29,16,-39,-66,-37,-38,-48,16,-225
51,97,-81,-205,-157,-138,-159,5,-587
47,51,-7,-121,2,-80,-108,32,-184
-1,53,-42,-120,-94,-117,-99,-57,-477
-83,-3,-67,-177,-50,-47,-103,-19,-549
-35,37,-78,-200,-88,-117,-118,-89,-688
6,43,-58,-151,-25,-93,-88,-60,-426
-11,-4,-27,-51,-12,-35,-31,-31,-202
-27,-3,-10,-49,-36,-12,-2,-3,-142
-17,44,-47,-94,-53,-38,-81,-6,-292
37,49,1,-28,-75,-74,-104,-40,-234
37,53,14,-59,-118,-93,-98,-75,-339
-25,-1,-45,-69,-95,-45,-58,-28,-366
-5,19,-35,-84,-103,-63,-58,-30,-359
66,115,33,-57,-40,-68,-87,-33,-71
-1,9,-40,-52,-58,-65,-54,-26,-287
-23,16,-51,-142,-89,-75,-132,-37,-533
7,14,-2,-30,-37,-13,-65,32,-94
2,-15,-13,-57,-97,-65,-45,-17,-307
6,35,-42,-124,-65,-106,-65,39,-322
-39,-4,-74,-141,-134,-115,-125,-44,-676
-39,-10,-40,-96,-90,-64,-103,-20,-462
-83,-25,-81,-170,-124,-116,-124,-1,-724
-8,-1,-33,-137,-95,-69,-102,25,-420
-173,40,-317,-685,-409,-311,-399,150,-2104
0,24,-12,-51,-15,-46,-39,-11,-150
-36,-18,-52,-48,-96,-32,-72,-24,-378
-203,312,-262,-1167,-773,-533,-706,348,-2984
-8,19,-20,-59,-37,0,-35,5,-135
22,-5,5,-43,-15,0,-27,33,-30
57,26,37,11,31,-35,-52,43,118
28,2,12,-48,9,-56,-54,42,-65
56,49,42,-35,-34,-59,-5,3,17
54,21,12,-17,-10,-57,-52,45,-4
93,82,8,-112,42,-81,-94,14,-48
4,10,-3,-35,-36,-11,-71,29,-113
12,14,-39,-59,-138,-68,-61,-61,-400
1,8,-22,-44,-34,-52,-42,-32,-217
23,35,-6,-65,-144,-88,-52,-32,-329
-41,41,-98,-173,-85,-98,-170,-48,-672
-4,7,-7,-17,-29,-20,3,-3,-70
-21,4,-61,-170,-110,-108,-91,4,-553
-14,7,-36,-66,-27,-31,-41,-15,-223
-6,1,-45,-64,-49,-36,-37,-25,-261
-18,-8,-20,-38,-39,-22,-26,-17,-188
35,-4,25,2,38,-10,-32,31,85
12,11,4,-40,-29,-26,-43,0,-111
5,-6,-28,-91,-71,-33,-77,15,-286
-38,40,-49,-97,-9,-26,-39,3,-215
36,41,-34,-131,-140,-45,-69,6,-336
-3,4,-10,-35,-27,-23,-15,-18,-127
9,-4,-18,-9,-13,-6,1,-9,-49
11,19,-10,-31,-72,-47,-50,-11,-191
7,16,-6,-9,-5,29,27,3,62
-1,22,7,-18,-7,-15,12,9,9
-6,3,-2,-21,-27,-2,-16,-4,-75
-33,-9,-30,-61,-34,-26,-45,-31,-269
-8,6,-35,-61,-94,-43,-69,-14,-318
-23,1,-40,-63,-99,-48,-50,-23,-345
-27,2,-41,-71,-40,-13,-29,-35,-254
-18,-10,-56,-70,-28,-22,-43,-33,-280
-1,45,3,-27,-46,-7,-51,-66,-150
48,3,-18,22,-46,-28,-26,0,-45
47,25,4,8,-32,-20,-16,6,22
-23,17,-31,-76,-99,-73,-61,-25,-371
1,18,1,-77,-89,-90,-51,4,-283
-7,24,-25,-118,-76,-66,-62,-27,-357
-25,10,-9,-52,-96,-65,-54,-18,-309
21,19,-13,-57,-58,-64,-46,-6,-204
-10,3,-7,-28,-15,-9,-19,-4,-89
2,-26,-27,-73,-68,-66,-58,-37,-353
56,89,-23,-175,10,-107,-91,44,-197
-55,59,-109,-328,-171,-191,-176,52,-919
5,51,-29,-79,-178,-24,-63,3,-314
32,17,32,9,-21,-37,-15,24,41
10,18,27,-7,-17,-37,-19,34,9
137,149,89,77,56,74,24,93,699
0,16,-14,-71,-36,-35,-34,-34,-208
16,-3,-29,-3,-48,-11,-53,4,-127
-1,-8,-7,-7,-26,-12,-20,-1,-82
5,8,-17,-35,-4,-27,-21,-25,-116
20,26,-9,-43,-22,-45,-26,-21,-120
-3,17,-17,-37,-30,-16,-23,-7,-116
-16,15,-31,-88,-69,-68,-78,-41,-376
-1,5,-31,-110,-103,-66,-94,-36,-436
19,-83,-96,-341,-352,-381,-365,36,-1563
6,38,-5,-77,-84,35,-72,67,-92
-44,108,-88,-207,-138,-70,-143,-40,-622
-95,23,-115,-325,-255,-131,-164,24,-1038
12,29,-1,11,-31,-31,-36,-12,-59
-27,12,-73,-118,-78,-72,-78,-55,-489
-38,6,-62,-98,-87,-72,-100,-67,-518
-77,-49,-77,-161,-169,-92,-131,2,-754
8,8,-40,-55,-40,-64,-79,-49,-311
62,10,-13,-36,-140,-91,-106,-33,-347
5,3,-27,-25,-31,-17,-21,-37,-150
32,59,19,-113,-157,-166,-132,11,-447
-51,-11,-70,-162,-111,-116,-132,-59,-712
14,-5,-21,-57,-111,-59,-64,-15,-318
-31,-20,-34,-65,-47,-41,-40,-28,-306
6,46,-17,-123,-32,-84,-55,-23,-282
-101,77,-188,-581,-418,-259,-327,173,-1624
-40,20,-42,-107,-73,-78,-58,-25,-403
36,89,-121,-396,-318,-333,-287,2,-1328
34,89,-113,-400,-318,-338,-287,-1,-1334
-15,12,-9,-36,0,-8,-20,5,-71
7,23,-8,-32,-44,-30,-18,-17,-119
14,9,-16,-33,-40,-32,-12,-28,-138
12,11,10,-25,-34,-35,-27,5,-83
2,81,-42,-149,-42,-82,-51,-12,-295
33,45,10,-54,-32,-59,-18,24,-51
-148,20,-111,-298,-125,-76,-177,-138,-1053
22,24,-32,-81,-74,-113,-65,-67,-386
51,39,-28,-99,-70,-114,-77,-42,-340
-9,20,-9,-49,-27,-44,-28,8,-138
-7,6,-16,-20,-10,-8,-26,4,-77
3,28,-15,-20,-74,-62,-44,-30,-214
85,37,-9,11,-57,-29,-7,-8,23
-13,67,-57,-105,-9,-42,-27,13,-173
-19,0,-55,-97,-99,-92,-78,-60,-500
3,1,-5,-6,-2,-8,-1,-2,-20
-9,21,-14,-51,-8,-47,-37,-2,-147
-14,41,-2,-4,-21,0,-42,3,-39
-1,22,-2,-38,-30,-46,-15,7,-103
0,22,-2,-39,-35,-47,-19,8,-112
-92,-27,-86,-159,-110,-46,-117,-5,-642
-74,-34,-97,-143,-110,-61,-125,3,-641
-79,-28,-49,-130,-94,-54,-116,0,-550
-98,-64,-79,-128,-109,-53,-128,-28,-687
-93,-43,-91,-129,-99,-71,-144,-15,-685
-88,-38,-84,-152,-108,-71,-125,-13,-679
-103,-32,-65,-151,-105,-67,-130,-8,-661
-89,-63,-88,-137,-145,-83,-140,-10,-755
64,83,-6,-119,-70,-131,-42,-10,-231
-58,-14,-81,-108,-71,-29,-67,-25,-453
5,21,-3,-70,-25,-65,-25,-2,-164
7,100,-21,-146,-31,-122,-54,-1,-268
-37,-16,-33,-50,-33,-34,-54,-22,-279
-26,19,-87,-212,-142,-188,-128,-113,-877
-11,-8,-12,-7,-12,-6,-15,-2,-73
-16,52,-17,-52,-57,-54,-35,24,-155
-39,28,-18,-47,-20,19,-49,3,-123
-9,55,-52,-109,-87,-113,-83,-28,-426
-14,40,-43,-96,-88,-109,-73,-25,-408
-4,57,-6,-97,-14,-44,-53,-25,-186
-13,8,-20,-25,-17,-7,-20,-3,-97
-10,8,-8,-39,-14,-21,-13,-2,-99
59,40,18,-35,8,-15,-30,23,68
-28,-18,-10,-47,-55,-52,-43,-12,-265
-42,11,-34,-150,-109,-60,-96,18,-462
9,-5,-25,-63,-45,-43,-39,-13,-224
-91,-42,-82,-135,-103,-73,-138,-16,-680
10,57,-18,-138,-51,-116,-85,-92,-433
-82,-42,-72,-118,-90,-61,-133,-19,-617
-63,2,-85,-136,-87,-61,-129,9,-550
-2,7,-1,-42,-27,-19,-8,-11,-103
115,86,78,14,3,-140,-48,81,189
-14,19,-7,-49,-10,-26,-38,18,-107
-125,16,-145,-322,-177,-144,-161,-43,-1101
-4,5,-22,-53,-77,-53,-42,15,-231
4,15,1,-32,-8,-26,-24,3,-67
-25,23,-78,-141,-95,-103,-122,-64,-605
-17,15,-84,-121,-106,-119,-124,-57,-613
-69,-37,-61,-124,-115,-92,-118,-25,-641
-87,-32,-100,-181,-103,-77,-114,-48,-742
-8,8,-9,-21,4,-5,-19,-3,-53
119,83,43,-171,-9,-138,-90,52,-111
85,68,61,-60,-2,-117,-37,24,22
-3,35,-20,-73,-56,-56,-55,-31,-259
37,61,-72,-191,-156,-214,-160,-33,-728
-16,-7,-16,-52,-47,-34,-20,14,-178
-53,-7,-51,-102,-75,-46,-82,-13,-429
-12,17,-22,-92,-84,-97,-79,-41,-410
57,25,11,-68,-18,-99,-42,28,-106
75,50,11,-89,-1,-106,-29,-6,-95
133,96,2,-135,-30,-127,-66,-9,-136
-34,-15,-24,-68,-38,-24,-34,-8,-245
37,87,-41,-108,-89,-36,1,112,-37
-12,9,-13,-53,-56,-58,-51,-17,-251
28,-7,-4,-49,4,-60,-32,11,-109
-48,19,-34,-90,-9,2,-66,-21,-247
77,51,12,-85,3,-104,-32,-8,-86
76,50,12,-90,-3,-105,-29,-7,-96
78,55,14,-81,6,-106,-37,-6,-77
21,22,-4,-112,-52,-113,-91,-15,-344
19,0,7,-48,-32,-53,-14,3,-118
-49,11,-66,-119,-82,-88,-74,-38,-505
0,7,-44,-67,-28,-38,-58,-39,-267
-90,22,-29,-127,-13,-39,-76,1,-351
5,1,0,-10,1,-4,-4,15,4
5,5,-8,-24,-26,-18,-10,2,-74
-19,-10,-3,-29,-28,-16,-17,-7,-129
-37,21,-28,-60,-20,-23,-48,-7,-202
6,27,-8,-18,-5,-20,-11,3,-26
-5,19,-17,-79,-44,-68,-44,5,-233
-31,14,-40,-140,-53,-97,-60,18,-389
87,71,43,10,29,65,-18,19,306
34,27,-13,-44,-23,-59,-48,-15,-141
-15,30,-23,-84,-37,-56,-66,-5,-256
-3,33,-67,-244,-114,-190,-126,-72,-783
15,-25,-43,-57,-74,-72,-72,-21,-349
-24,127,-61,-326,-6,-184,-187,39,-622
-34,22,-51,-107,-24,-26,-24,-17,-261
37,10,2,-30,0,-45,-32,6,-52
20,1,-2,-44,-31,-62,-19,-6,-143
-47,43,-45,-138,-79,-39,-115,43,-377
-19,9,-17,-30,-13,-15,-22,-12,-119
-56,61,-21,-172,-61,-75,-88,-33,-445
7,74,-16,-92,-25,-52,-23,10,-117
12,23,1,-23,15,-37,-18,-9,-36
-53,31,-42,-108,-39,-24,-31,-29,-295
-20,30,-4,-65,-95,-49,-44,7,-240
-24,53,-8,-87,12,-27,-1,7,-75
-13,60,-14,-87,2,-23,-17,-15,-107
-12,6,-16,-34,-21,-20,-24,-12,-133
12,12,-6,1,-19,-1,-11,11,-1
11,9,-6,-1,-20,-3,-10,8,-12
-34,2,-38,-50,-18,-18,-25,-18,-199
5,5,1,-14,-12,-16,-10,8,-33
-7,15,-26,-92,-91,-69,-63,12,-321
-124,22,-150,-256,-122,-115,-144,-49,-938
-18,59,-14,-123,-16,-59,-12,14,-169
-20,-20,-31,-40,-46,-20,-50,-3,-230
3,5,-1,-11,-15,-22,-6,8,-39
-126,-55,-108,-205,-120,-62,-167,13,-830
263,73,138,68,136,8,-59,51,678
-25,-5,-22,-44,-37,-18,-33,-15,-199
141,42,38,-110,46,-122,-114,-11,-90
17,30,1,1,-7,-8,-10,-8,16
-19,12,-25,-79,-91,-70,-62,-31,-365
105,146,71,-210,58,-70,-49,74,125
-93,32,-38,-118,-33,-57,-61,-15,-383
6,12,-34,-76,-48,-52,-58,-56,-306
7,13,-36,-75,-48,-53,-57,-56,-305
-52,56,-37,-127,-27,-84,-72,-1,-344
-4,24,-29,-99,-69,-64,-69,7,-303
7,114,-39,-176,-17,-77,-92,-55,-335
-1,13,8,-4,5,4,8,-2,31
-1,13,8,-4,5,4,8,-2,31
1,25,-25,-56,-29,-52,-60,-32,-228
1,24,-24,-60,-31,-54,-58,-31,-233
-36,154,-49,-190,-106,-78,-134,-3,-442
-32,138,-49,-191,-108,-86,-134,0,-462
133,108,23,49,-93,-138,-72,4,14
38,73,-26,-222,1,-103,-133,-22,-394
30,19,31,-109,-23,-111,-55,8,-210
26,21,27,-116,-17,-105,-58,3,-219
-19,18,-19,-73,-33,-19,-24,-30,-199
-61,54,-63,-223,-99,-49,-60,-90,-591
-29,15,-46,-69,-31,-48,-44,-6,-258
-52,44,-39,-87,-38,-47,-49,-6,-274
-53,43,-40,-88,-37,-48,-47,0,-270
-54,3,-24,-138,-43,-77,-33,29,-337
-100,3,-74,-139,-88,-64,-104,-55,-621
-103,9,-74,-144,-88,-64,-103,-52,-619
-1,6,-5,-14,-3,-8,1,-1,-25
-3,9,-8,-19,-3,-11,-7,-2,-44
-8,3,-1,-14,-5,-9,-10,2,-42
-4,4,-4,-7,0,-2,-5,1,-17
-1,5,-2,-10,-1,-7,-5,0,-21
-3,6,-2,-16,-2,-9,3,-3,-26
-2,6,-3,-4,-5,-5,-9,-8,-30
-2,6,-5,-13,-3,-9,-1,-1,-28
-2,8,-2,-14,-7,-11,-1,-5,-34
-7,3,-4,-14,-6,-7,-8,-6,-49
216,116,22,-58,-42,-216,-215,-76,-253
-106,18,-84,-171,-37,-75,-75,-44,-574
140,27,24,-4,-37,-96,-50,-31,-27
140,27,24,-4,-37,-96,-50,-31,-27
140,28,25,-9,-34,-92,-48,-33,-23
140,27,24,-4,-37,-96,-50,-31,-27
140,27,24,-4,-37,-96,-50,-31,-27
140,27,24,-4,-37,-96,-50,-31,-27
19,96,7,-117,-16,-85,-58,-37,-191
-39,17,-70,-155,-108,-100,-145,-7,-607
-12,32,-31,-108,-34,-61,-70,2,-282
34,12,14,3,17,-4,12,22,110
34,12,14,3,17,-4,12,22,110
34,12,14,3,17,-4,12,22,110
-45,2,-34,-76,-55,-50,-65,-29,-352
-36,-7,-22,-53,-42,-32,-45,-10,-247
-37,-4,-21,-47,-40,-30,-48,-12,-239
-1,3,-15,-69,-69,-69,-34,6,-248
0,1,-14,-68,-71,-71,-33,9,-247
-2,3,-19,-72,-73,-68,-41,5,-267
-1,3,-15,-69,-69,-69,-34,6,-248
84,37,-34,-132,-86,-172,-124,-83,-510
8,-6,-9,-15,-31,-20,-4,-10,-87
8,-6,-9,-15,-31,-20,-4,-10,-87
-5,3,0,-14,-8,-16,-10,-1,-51
-1,6,4,-9,-4,-7,2,4,-5
36,37,-18,-78,-113,-90,-87,-53,-366
42,67,-8,-126,-104,-175,-96,-52,-452
24,26,16,-23,6,-35,-21,-7,-14
8,3,-9,-21,-24,-44,-31,-22,-140
-7,-1,-19,-19,-19,-5,-20,-13,-103
-8,-22,-23,-25,-29,-12,-19,4,-134
-8,-22,-23,-25,-29,-12,-19,4,-134
2,-8,10,-74,-71,-20,10,30,-121
-17,2,-3,-21,-10,2,-5,-8,-60
-13,6,-17,-40,-23,-30,-23,-1,-141
16,194,-149,-388,-185,-216,-207,-14,-949
18,205,-147,-386,-179,-221,-207,-5,-922
111,85,77,13,3,-141,-50,82,180
113,84,77,14,4,-141,-51,83,183
14,52,1,-63,-66,-8,-68,87,-51
13,51,3,-63,-66,-7,-66,85,-50
12,55,-1,-67,-67,-2,-64,90,-44
-22,-9,-34,-138,-44,-103,-52,13,-389
-23,14,-28,-63,-30,-30,-15,5,-170
27,-1,-1,6,-37,-34,-6,-15,-61
21,-1,-1,-2,-32,-38,-11,-13,-77
-51,14,-34,-117,-55,-56,-73,-17,-389
-15,26,-21,-55,-37,-37,-50,-19,-208
52,18,-63,-99,-132,-147,-89,-119,-579
5,-20,-4,-8,-41,-32,-26,2,-124
-10,8,-15,-31,-10,-2,1,9,-50
61,178,-27,-342,45,-273,-140,12,-486
-108,72,-74,-156,-86,-33,-78,-71,-534
-27,-15,-18,-42,-24,-19,-29,-3,-177
-5,26,-11,-24,-9,-21,-17,3,-58
-8,27,-14,-2,-22,-15,-17,-12,-63
-35,-13,-28,-132,-45,-105,-98,-36,-492
14,17,-8,-94,-9,-61,-31,17,-155
-1,8,-7,-35,9,-4,9,14,-7
-13,-11,-7,-29,-5,-9,-13,2,-85
25,33,-19,-39,1,-1,18,69,87
-15,24,-39,-62,-29,-54,-50,-18,-243
-13,25,-40,-62,-31,-54,-51,-20,-246
-20,-8,-33,-64,-35,-36,-48,-2,-246
-20,-8,-33,-64,-35,-36,-48,-2,-246
-1,6,-1,-13,-4,-9,-3,0,-25
-55,16,-38,-127,-59,-66,-74,-21,-424
59,16,19,19,-14,-33,-22,3,47
-17,33,-4,-57,-10,-24,-16,-9,-104
41,56,9,-22,-22,-18,-2,33,75
6,18,-15,-21,-9,-20,-20,-21,-82
-4,42,1,-49,3,-30,-22,14,-45
-110,-44,-97,-160,-105,-82,-137,-23,-758
-30,5,-24,-74,-65,-47,-27,8,-254
-23,-8,-19,-31,-19,-11,-26,-5,-142
-92,-26,-87,-135,-97,-86,-146,-25,-694
13,30,-13,-43,-43,-61,-19,-3,-139
6,24,19,-18,-11,-10,-20,3,-7
6,24,19,-18,-11,-10,-20,3,-7
3,23,14,-17,-14,-5,-18,9,-5
6,24,19,-18,-11,-10,-20,3,-7
2,20,17,-21,-14,-7,-12,4,-11
2,20,17,-21,-14,-7,-12,4,-11
22,-5,-23,-97,-168,-46,-85,-37,-439
22,-5,-23,-97,-168,-46,-85,-37,-439
1,11,-8,-13,2,-3,-5,-5,-20
-8,-6,-19,-20,-30,-24,-25,-2,-134
0,-5,-12,-18,-34,-26,-33,-3,-131
0,-5,-12,-18,-34,-26,-33,-3,-131
34,-3,-1,-20,14,-20,-6,18,16
-41,-7,-54,-96,-79,-47,-70,2,-392
2,11,0,-21,-30,5,-11,4,-40
-1,6,1,-18,-26,11,-12,8,-31
-1,25,11,-45,-43,-38,-3,20,-74
-27,-33,-34,-84,-98,-59,-127,28,-434
-27,-33,-34,-84,-98,-59,-127,28,-434
-35,25,-33,-119,-125,-98,-60,-37,-482
-97,-24,-96,-146,-107,-71,-130,-35,-706
-69,-28,-66,-114,-112,-68,-118,-11,-586
-93,-48,-84,-143,-94,-77,-137,-39,-715
-16,-5,-16,-21,-16,-8,-22,-8,-112
-5,10,-16,-65,-12,-30,-34,2,-150
-9,6,-17,-68,-14,-34,-39,2,-173
4,9,-7,-12,-8,-21,-11,-6,-52
-20,62,-14,-88,-12,-32,-28,-7,-139
24,57,-21,-107,-75,-100,-89,16,-295
16,38,-11,-104,-35,-58,-99,37,-216
12,55,4,-134,-95,-76,-74,86,-222
2,42,-31,-92,-39,-20,-39,61,-116
-31,33,-8,-125,-105,-83,-79,113,-285
20,39,-10,-46,-20,-27,-14,35,-23
26,36,5,2,-22,-12,-17,56,74
5,1,-2,-12,-17,-24,-9,12,-46
4,2,-3,-12,-15,-23,-9,11,-45
-1,3,0,-3,-3,-3,-1,-1,-9
9,15,-7,2,-28,-17,-26,22,-30
10,12,-12,-8,-23,-23,-16,15,-45
12,17,-7,-8,-23,-23,-17,17,-32
7,17,-12,-2,-21,-14,-13,15,-23
-2,16,-9,-15,-8,-14,-34,27,-39
-4,18,-9,-17,-6,-10,-34,25,-37
-6,17,-11,-15,-8,-10,-35,23,-45
15,21,-12,-33,-7,-26,-25,15,-52
3,4,5,-4,-34,0,-10,2,-34
3,4,5,-4,-34,0,-10,2,-34
3,4,5,-4,-34,0,-10,2,-34
-36,-17,-59,-96,-55,-47,-69,-21,-400
-8,18,-3,-23,-18,-30,-36,-22,-122
-13,5,-21,-25,-28,-22,-49,-20,-173
0,3,-14,-26,-10,-17,-9,-1,-74
49,33,-64,-198,-166,-213,-157,-59,-775
-19,0,-22,-33,-12,-14,-11,-13,-124
-19,0,-22,-33,-12,-14,-11,-13,-124
38,27,38,-5,-13,-48,0,20,57
-15,50,-41,-182,-150,-97,-73,79,-429
22,26,-10,-6,-85,-45,-85,4,-179
6,19,-3,-48,-26,-73,-37,-22,-184
79,113,41,-26,-11,-59,-53,51,135
0,14,6,-11,10,-6,14,1,28
-4,25,-2,-27,-14,-14,-22,0,-58
-76,36,-46,-104,-47,-15,-50,-44,-346
12,30,-75,-167,-125,-150,-126,-36,-637
12,10,-5,-41,-57,-70,-49,10,-190
6,28,-89,-188,-170,-181,-133,-51,-778
52,23,-29,-62,-87,-126,-63,-73,-365
-4,21,-15,-33,-29,-36,-26,-18,-140
-369,1148,-635,-1267,-283,-1265,-360,392,-2639
-76,167,-107,-290,-34,-184,-105,42,-587
-4,13,-25,-31,-18,-16,-19,7,-93
44,22,-5,-29,-11,-44,-23,19,-27
43,25,-7,-33,-11,-44,-21,19,-29
-2,17,-18,-15,-8,-16,-23,4,-61
-11,-22,-28,-66,-109,-57,-77,-9,-379
-11,-22,-28,-66,-109,-57,-77,-9,-379
-1,29,15,-21,1,-16,19,16,42
11,-5,-8,-45,-99,-62,-55,-36,-299
0,5,16,-51,-105,-69,-26,8,-222
0,2,0,-1,-2,-2,0,-2,-5
-2,-17,0,-39,-41,-29,-27,-13,-168
0,55,-16,-23,-3,6,-48,-14,-43
1,54,-4,-21,-2,17,-37,-2,6
3,-9,-4,-42,-51,-32,-30,-22,-187
-7,4,-5,-17,-8,-8,5,-2,-38
67,22,16,-11,-2,-39,-13,26,66
-48,4,-45,-100,-50,-40,-42,6,-315
-7,5,-3,-11,-3,-8,-3,6,-24
0,0,0,0,0,0,0,0,0
-93,-17,-101,-169,-91,-91,-139,-43,-744
3,43,-21,-70,-27,-15,-37,32,-92
-4,13,-22,-54,-37,-52,-44,24,-176
4,22,-8,-32,-9,-33,-22,22,-56
-24,-25,-24,-64,-56,-51,-48,0,-292
349,213,141,-148,31,-339,-225,79,101
273,286,129,-228,26,-261,-192,189,222
-55,117,-49,-195,-56,-90,-67,-3,-398
-2,57,-33,-87,-55,-95,-78,-14,-307
-47,61,-30,-159,-71,-110,-96,-33,-485
23,67,-13,-52,-27,-87,-33,7,-115
-9,-6,-18,-39,-20,-34,-17,-14,-157
20,17,-14,-33,-23,-26,-18,-4,-81
17,42,-14,-25,-65,-60,-24,-2,-131
-22,2,-19,-42,-45,-9,-24,15,-144
16,37,6,-18,12,-18,-10,29,54
-11,13,-10,-52,-31,-16,-26,1,-132
-11,3,-11,-34,-20,-14,-18,-16,-121
-6,-1,-15,-21,-24,-21,-25,13,-100
-12,-4,-20,-41,-6,-14,-28,16,-109
-40,25,-51,-134,-141,-82,-105,-65,-593
201,60,66,11,142,-1,15,91,585
-12,8,-12,-40,-21,-29,-21,-19,-146
-1,41,-39,-161,-60,-87,-97,26,-378
-26,99,-42,-185,-48,-63,-46,38,-273
-26,92,-43,-221,-45,-121,-70,-22,-456
70,11,-64,-232,-113,-182,-187,-18,-715
4,12,-6,-22,-20,-8,-2,7,-35
-129,-81,-99,-281,-183,-101,-158,-22,-1054
124,110,-9,-105,-65,-157,-156,-5,-263
-9,45,-25,-122,-18,-72,-68,4,-265
12,9,-5,-37,-50,-26,-28,2,-123
36,22,-10,-52,-70,-82,-64,-23,-243
27,-12,-12,-90,-60,-34,-84,24,-241
-10,13,-12,-135,-87,-91,-89,3,-408
52,17,20,42,-42,-11,13,-26,65
21,-4,-26,-32,-61,-68,-69,-23,-262
22,59,-25,-23,-32,-31,-8,69,31
52,-20,-21,-121,-110,-83,-113,7,-409
-30,-2,-34,-98,-94,-29,-41,17,-311
-53,-36,-45,-414,-426,-275,-242,141,-1350
55,22,-25,-44,-130,-106,-69,-54,-351
22,10,-7,-62,-27,-71,-71,-5,-211
-3,-5,-10,-8,-9,15,-13,12,-21
-59,22,-39,-138,-67,-68,-55,-30,-434
15,17,-6,-25,-39,-40,-12,-14,-104
1,16,-60,-92,-57,-67,-76,-11,-346
-18,-16,-22,-45,-51,-41,-52,-9,-254
-74,-15,-61,-179,-89,-47,-78,-11,-554
4,-4,-54,-154,-110,-121,-108,-80,-627
180,156,76,-46,22,-44,13,75,432
-20,140,-49,-122,-31,-19,-111,74,-138
-16,10,-22,-99,-105,-61,-47,14,-326
48,134,-27,-95,-12,-49,17,-9,7
-30,-15,-22,-26,-7,16,-19,9,-94
52,27,-9,-56,-136,-101,-92,-38,-353
-10,-1,-13,-34,-23,-26,-33,-17,-157
-97,22,-96,-224,-183,-112,-160,65,-785
-1,35,-123,-315,-311,-324,-331,-93,-1463
5,25,-42,-61,-47,-47,-37,-23,-227
-24,-2,-37,-70,-21,-12,-47,24,-189
-6,25,-23,-63,-43,-47,-34,1,-190
-2,2,-25,-30,-47,-27,-38,13,-154
21,54,-29,-84,-179,-66,-62,-56,-401
-43,37,-31,-142,-46,-75,-77,-12,-389
-18,43,-46,-130,-84,-69,-54,-19,-377
-62,23,-51,-128,-97,-65,-77,-35,-492
-39,19,-24,-124,-40,-55,-59,-7,-329
-101,19,-125,-267,-138,-99,-169,-47,-927
-13,52,-69,-138,-63,-50,-58,46,-293
-1,43,-11,-59,-26,-36,-15,38,-67
-11,-33,-12,-48,-93,-3,-56,-2,-258
7,-17,-9,-10,-33,3,4,-6,-61
-30,16,-21,-84,-45,-46,-57,-12,-279
-13,7,-11,-29,-11,-19,-14,-2,-92
-20,39,-43,-130,-138,-1,-58,-25,-376
92,179,-34,-187,-169,-115,-217,-118,-569
-72,-8,-90,-121,-85,-65,-107,-41,-589
-140,159,-133,-488,-286,-167,-299,-216,-1570
7,-3,-31,-59,-65,-79,-46,-31,-307
-6,6,-31,-134,-58,-88,-67,-19,-397
152,302,-1,-295,-191,-153,-101,108,-179
-9,29,-25,-94,-146,-49,-75,-19,-388
-49,21,-44,-131,-110,-59,-104,-3,-479
107,35,71,-72,-14,-80,-83,47,11
-64,5,-93,-160,-144,-75,-138,2,-667
-66,-23,-97,-170,-185,-94,-144,-16,-795
-57,0,-94,-179,-153,-73,-134,-23,-713
-24,69,-55,-220,-127,-71,-71,22,-477
-14,26,-63,-138,-164,-74,-100,-56,-583
8,-23,-9,-49,-109,-39,-45,10,-256
-40,-2,-42,-126,-94,-37,-90,7,-424
-39,83,-75,-296,-213,-158,-148,69,-777
-69,-75,-91,-200,-228,-137,-128,-61,-989
-57,-86,-50,-188,-245,-154,-122,-57,-959
47,57,5,-23,6,-7,-28,0,57
-74,6,-75,-136,-85,-114,-104,-8,-590
-63,-12,-72,-189,-84,-94,-128,-1,-643
-12,-5,-9,-23,-55,-14,-26,3,-141
-12,12,-4,-30,-44,-11,-22,-5,-116
-48,-1,-40,-92,-43,-23,-47,-3,-297
31,99,-50,-244,-97,-179,-185,19,-606
-4,84,-231,-506,-537,-442,-427,-370,-2433
19,53,-46,-100,-91,-71,-79,15,-300
45,-8,13,-72,-29,-88,-61,34,-166
-27,5,-39,-89,-71,-67,-55,-26,-369
21,-3,-1,-45,-140,-52,-49,-36,-305
-30,28,-84,-199,-109,-164,-134,0,-692
-119,11,-91,-170,-53,-2,-9,-79,-512
-79,109,-95,-352,-195,-80,-96,33,-755
-44,-36,-44,-105,-106,-56,-60,-18,-469
-10,21,-4,-56,-22,-37,-37,-22,-167
-49,6,-38,-130,-57,-46,-64,30,-348
-20,8,-24,-82,-38,-41,-60,22,-235
-26,32,-31,-114,-45,-51,-82,17,-300
41,57,-35,-88,-60,-96,-92,-32,-305
10,26,-14,-78,-34,-80,-32,6,-196
-32,-4,-38,-72,-92,-38,-68,-25,-369
15,-55,-45,-217,-334,-206,-208,-82,-1132
-23,5,-26,-152,-61,-29,-89,0,-375
-99,-44,-66,-158,-127,-56,-112,-31,-693
-285,213,-405,-1149,-527,-577,-751,-434,-3915
-29,44,-51,-221,-263,-92,-133,-57,-802
-51,28,-68,-154,-124,-58,-123,6,-544
-32,-47,-48,-214,-182,-217,-133,-71,-944
-7,6,-9,-22,-14,-16,-31,-12,-105
-9,1,-19,-58,-41,-43,-48,-10,-227
-92,10,-101,-214,-77,-59,-102,-37,-672
-63,228,-127,-426,-335,-173,-327,194,-1029
-15,17,-29,-71,-127,-15,-69,-10,-319
-35,5,-3,-123,-113,-107,-82,-1,-459
-21,-22,-11,-84,-57,-77,-75,-21,-368
108,135,49,-26,-45,-48,-85,68,156
-52,7,-52,-82,-41,-20,-61,25,-276
-24,-10,-20,-45,-42,-55,-27,3,-220
-35,-34,-26,-83,-137,-71,-66,-3,-455
9,24,-25,-35,-9,-20,-28,0,-84
-6,-15,-32,-48,-113,-39,-66,23,-296
58,-21,3,-69,-110,-94,-58,7,-284
1,30,-23,-56,-45,-45,-35,12,-161
-3,4,-2,-25,-13,-19,-24,16,-66
9,45,-15,-34,-6,-34,-33,34,-34
168,189,121,70,-3,18,-89,14,488
89,127,-37,-80,-78,-23,45,-223,-180
-5,10,-2,-32,-11,-28,-22,-1,-91
-26,38,-38,-153,-112,-65,-63,-50,-469
-5,14,-12,-20,-20,-3,-7,5,-48
871,453,511,308,460,291,-24,298,3168
215,154,108,-54,-17,18,-97,117,444
198,151,109,-52,-12,38,-79,103,456
126,153,-54,-588,-521,-243,-395,138,-1384
-6,-36,-16,-30,-124,-46,-71,-22,-351
-11,-33,-12,-39,-122,-44,-68,-4,-333
-17,194,-149,-498,-191,-348,-259,216,-1052
-2,14,-19,-71,-175,-66,-97,-14,-430
14,423,-31,-628,-127,-222,-318,-50,-939
7,0,-31,-78,-49,-29,-41,-7,-228
-14,38,-4,-53,-5,-38,-11,18,-69
-21,-26,-24,-51,-43,-18,-31,-6,-220
15,22,-8,-81,-68,-36,-53,-20,-229
-43,39,-58,-133,-34,-53,-49,-11,-342
-8,18,-22,-61,-26,-19,-28,26,-120
-26,-3,-41,-57,-36,-4,-33,25,-175
-15,14,-54,-81,-105,-67,-67,-38,-413
38,7,6,-50,-39,-76,-28,27,-115
-1,-4,-10,-62,-40,-73,-31,-2,-223
7,21,-24,-130,-114,-100,-60,-55,-455
-27,5,-18,-63,-35,-11,-49,-15,-213
-26,26,-18,-111,-59,-91,-60,3,-336
-35,14,-21,-116,-76,-97,-44,-6,-381
-30,31,-39,-142,-49,-78,-53,7,-353
5,-8,-14,-39,-125,-77,-76,12,-322
-30,-30,-13,-62,-27,-27,-24,8,-205
39,57,-50,-174,-126,-160,-130,-100,-644
-52,114,-77,-199,-14,-86,-123,-28,-465
-52,-60,-88,-158,-248,-152,-185,-120,-1063
5,-71,-133,-291,-232,-278,-243,-109,-1352
15,-7,-14,-20,-36,-10,-19,-17,-108
12,11,-72,-198,-155,-102,-110,83,-531
-5,11,-9,-26,-31,-23,-26,3,-106
-3,10,-6,-20,-9,-9,-25,-11,-73
-109,89,-101,-432,-347,-138,-353,-215,-1606
-78,154,-126,-439,-329,-144,-330,-251,-1543
6,32,-25,-92,-93,-103,-71,-32,-378
-5,23,-25,-52,-127,-63,-96,13,-332
-44,55,-67,-180,-60,-68,-72,-5,-441
37,0,12,-62,2,-64,-26,-11,-112
-54,-11,-61,-188,-113,-53,-113,10,-583
30,-1,-13,-58,-28,-41,-30,-5,-146
-55,39,-67,-166,-118,-87,-125,-6,-585
-16,-6,-3,-35,-35,-14,-37,-3,-149
-31,-17,-27,-49,-48,-28,-49,-7,-256
2,12,-21,-118,-126,-115,-112,9,-469
17,28,-48,-77,-60,-104,-69,-73,-386
-20,13,-41,-63,-11,-28,-23,-17,-190
-12,-8,-9,-23,-18,-27,-31,8,-120
-13,0,-47,-69,-18,-40,-53,-37,-277
6,26,-18,-69,-36,-55,-51,32,-165
65,-13,12,2,3,-45,-9,13,28
-17,2,-2,-48,-29,-37,-40,4,-167
2,45,-50,-57,-61,-15,-73,58,-151
-29,98,-73,-162,-67,-130,-100,-113,-576
6,82,-34,-107,-146,-72,-101,125,-247
12,-8,-23,-43,-46,-43,-40,-13,-204
-12,-10,-11,-16,-30,-18,-14,-4,-115
-15,-15,-12,-14,-33,-23,-19,8,-123
39,64,-55,-115,0,-48,-1,2,-114
-90,155,-128,-447,-315,-133,-294,-227,-1479
-115,141,-117,-439,-328,-130,-348,-224,-1560
-235,5,-280,-536,-362,-218,-373,-26,-2025
-46,-24,-65,-154,-83,-99,-126,-41,-638
-8,32,-58,-143,-168,-52,-74,104,-367
-33,25,-37,-96,-60,-50,-59,4,-306
58,506,-67,-714,-391,-272,-308,528,-660
-83,68,-101,-221,-208,-71,-128,98,-646
-6,37,-23,-98,-25,-47,-50,-2,-214
-60,-2,-123,-267,-278,-130,-198,-62,-1120
-51,-20,-67,-171,-212,-84,-151,-36,-792
-15,26,-15,-13,-20,-17,-18,-14,-86
191,250,100,94,124,24,-73,-9,701
37,108,24,-43,-42,-32,-100,-48,-96
106,142,113,18,-16,-20,-90,-7,246
-3,1,-82,-95,-88,-9,-24,17,-283
-34,133,-61,-165,-40,-64,-73,34,-270
-27,3,-46,-101,-114,-83,-96,-39,-503
-58,70,-58,-151,-48,-43,-35,-13,-336
-10,-13,-9,-51,-83,-56,-43,5,-260
7,56,-42,-116,-26,-27,-50,63,-135
-13,9,-18,-25,-38,3,-35,12,-105
12,-2,-32,-63,-108,-96,-77,-47,-413
8,35,-17,-91,-25,-72,-44,-39,-245
-32,6,-30,-74,-65,-25,-17,30,-207
-14,17,-3,-44,-50,-15,-28,13,-124
16,17,-23,-61,-71,-75,-61,-12,-270
-4,12,-16,-69,-44,-42,-33,-7,-203
-5,17,-14,-77,-40,-28,-28,-5,-180
-5,10,-23,-80,-38,-38,-39,-3,-216
-27,-6,-21,-75,-64,-48,-57,3,-295
-26,11,-90,-138,-121,-92,-79,-73,-608
-27,-11,-104,-142,-122,-82,-94,-78,-660
-22,48,-14,-152,-123,-99,-102,16,-448
8,-8,-27,-50,-118,-61,-53,-26,-335
-15,37,10,-69,-11,-15,-3,-11,-77
-9,-32,-50,-168,-152,-159,-121,-3,-694
-16,10,-31,-100,-113,-59,-47,9,-347
-146,-24,-134,-228,-223,-116,-231,-32,-1134
-16,27,-39,-83,-89,-75,-80,-35,-390
9,-1,-30,-54,-137,-56,-55,-47,-371
845,454,543,245,496,190,-65,190,2898
-3,-7,-66,-150,-126,-185,-130,-82,-749
-23,11,-31,-52,-40,-25,-25,-2,-187
62,-3,29,-56,-67,-105,-28,-7,-175
-14,9,-34,-27,-14,-17,-23,-29,-149
-21,15,-17,-76,-39,-73,-36,7,-240
-20,-11,-28,-84,-120,-28,-51,3,-339
-31,8,-47,-127,-65,-57,-84,-18,-421
9,10,-17,-64,-112,-82,-56,-60,-372
25,54,14,-22,-34,2,-66,71,44
1,17,-21,-100,-93,-104,-93,-120,-513
31,46,-5,-31,-29,-29,-5,4,-18
-20,25,-33,-57,-36,-5,-61,14,-173
-7,-7,-19,-23,-29,-30,-19,6,-128
-18,10,-39,-14,-18,-47,-59,-40,-225
58,21,4,16,-13,4,-3,25,112
-54,-5,-30,-101,-39,23,-78,32,-252
-3,28,-25,-125,-120,-134,-100,-33,-512
-5,77,-29,-70,-6,-8,-73,28,-86
-6,32,-1,-90,-21,-38,-16,52,-88
45,53,26,-12,-71,-37,-12,41,33
-30,-21,-56,-113,-130,-105,-115,-49,-619
-42,27,-33,-144,-89,-72,-107,-27,-487
-26,-16,-77,-103,-39,-44,-58,-4,-367
1,6,-12,-21,-16,-14,-13,-4,-73
-60,-123,-105,-307,-331,-142,-226,155,-1139
-23,-33,9,-23,-40,13,-37,27,-107
-100,-53,-68,-178,-113,-109,-134,10,-745
44,95,14,-142,-201,-48,-123,136,-225
-10,-4,-46,-73,-74,-86,-55,-42,-390
-13,25,-17,-25,-30,-13,-24,-7,-104
-10,0,-16,-105,-64,-78,-36,14,-295
-37,82,-134,-354,-256,-318,-224,-110,-1351
-22,0,-35,-110,-198,-90,-73,-18,-546
-4,17,-1,-18,-11,1,-3,26,7
-79,75,-88,-219,-166,-72,-95,15,-629
-11,-24,-38,-94,-74,-65,-82,-12,-400
11,4,-28,-28,-40,-18,-16,-31,-146
153,59,76,55,82,-32,-87,36,342
81,15,-9,-69,-12,-88,-46,1,-127
93,26,31,14,49,-48,-55,44,154
-36,28,-101,-200,-153,-121,-160,-58,-801
41,21,23,-21,-16,-47,-24,1,-22
8,23,-29,-101,-33,-63,-94,10,-279
-101,-75,-170,-276,-175,-134,-183,-87,-1201
-2,13,-35,-48,-46,-72,-58,-65,-313
-94,-42,-103,-177,-136,-31,-90,44,-629
79,41,1,-88,-81,-73,-114,35,-200
-1,21,-45,-161,-38,-120,-87,-14,-445
-2,-5,6,-7,-12,-9,4,7,-18
139,149,-45,-200,-110,-197,-161,32,-393
107,22,38,2,-34,-28,-61,74,120
-42,-7,-44,-126,-109,-75,-102,1,-504
-20,-20,-25,-112,-107,-62,-80,-1,-427
-32,0,-47,-97,-81,-76,-91,-36,-460
-13,-12,-28,-99,-77,-51,-66,-29,-375
13,11,-32,-72,-50,-61,-42,7,-226
-22,37,-86,-172,-168,-163,-173,-62,-809
-6,-3,-9,-28,-19,-11,-8,-12,-96
-4,7,-36,-55,-14,-33,-49,-32,-216
25,65,-33,-107,-6,-64,-27,40,-107
16,68,-39,-167,-103,-131,-88,18,-426
-28,4,-43,-89,-102,-62,-84,18,-386
-27,-15,-26,-70,-110,-64,-101,4,-409
-56,-38,-28,-87,-91,-47,-57,13,-391
-13,3,-5,-26,-43,-8,-20,15,-97
32,8,6,-37,-35,-44,-26,21,-75
-32,-12,-40,-91,-55,-43,-41,-10,-324
-12,-27,-93,-226,-176,-143,-199,23,-853
-6,40,-25,-94,-62,-57,-72,28,-248
-19,-21,-25,-55,-42,-29,-31,-12,-234
-17,-16,-20,-73,-69,-50,-47,15,-277
-14,26,-23,-122,-64,-25,-15,-8,-245
42,-1,-5,-35,-43,-88,-53,-11,-194
-2,20,-16,-68,-12,-59,-44,-7,-188
-15,20,-26,-48,-8,-18,-37,-15,-147
-4,-6,2,-47,-58,-42,-22,-31,-208
-41,33,-63,-126,-62,-33,-65,99,-258
76,31,-31,-100,-59,-124,-119,-59,-385
22,-5,0,-70,-58,-59,-74,16,-228
-44,31,-52,-139,-29,-73,-68,-34,-408
-55,5,-29,-139,-88,-56,-51,-76,-489
-14,-22,-40,-109,-143,-54,-74,-6,-462
-16,-11,-36,-16,-23,-25,-46,-17,-190
35,60,-1,-118,-36,-54,-41,59,-96
-15,5,-32,-50,-32,-25,-37,-23,-209
-14,-1,-15,-38,-26,-29,-19,-1,-143
68,92,-2,-85,13,-82,-75,21,-50
29,26,5,-72,18,-38,-41,5,-68
29,59,-1,-82,-8,-30,-28,55,-6
-22,3,-19,-33,-35,-27,-39,9,-163
9,1,-36,-33,-81,-40,-40,-17,-237
-61,14,-78,-215,-160,-115,-130,-51,-796
422,203,199,240,-97,110,-13,-28,1036
-53,7,-56,-132,-68,-56,-34,22,-370
9,37,-7,-37,-24,-24,-20,30,-36
-15,-3,-8,-14,-8,-8,-14,5,-65
-12,2,-13,-12,-14,-14,-17,-2,-82
-13,-3,-49,-96,-37,-11,-82,58,-233
-4,4,-15,-32,-33,6,-26,3,-97
-29,-21,-47,-184,-104,-142,-113,-61,-701
7,12,-23,-53,-67,-20,-34,-17,-195
-9,19,-66,-131,-43,-72,-89,16,-375
-66,85,-18,-139,-51,-58,-48,7,-288
-68,43,-41,-146,-62,-84,-58,-15,-431
-46,20,-8,-45,-30,-19,-32,-1,-161
-39,-19,-33,-125,-101,-89,-92,-45,-543
-18,32,-49,-115,-56,-68,-97,-22,-393
-9,52,-42,-97,-45,-70,-65,-8,-284
17,44,11,-47,-3,-37,-38,30,-23
126,480,-42,-616,-30,-375,-231,282,-406
-4,16,-60,-141,-55,-110,-101,-35,-490
150,36,47,-33,-57,-122,-86,2,-63
13,38,21,-37,-61,3,-38,6,-55
-67,-25,-51,-118,-111,-72,-99,-53,-596
189,170,100,8,85,-82,-102,103,471
-30,-9,-42,-110,-37,-45,-59,26,-306
-107,-16,-110,-282,-167,-170,-147,-45,-1044
207,184,56,26,27,-106,-108,36,322
-228,252,-203,-803,-449,-437,-501,-269,-2638
14,27,1,-16,-34,-37,-38,44,-39
526,286,335,133,396,-209,-352,331,1446
-9,3,-9,-26,-8,-16,-20,5,-80
74,71,36,-38,-34,-92,-63,-15,-61
-18,-2,-30,-37,-61,-25,-21,-9,-203
-32,1,-70,-202,-123,-115,-143,-89,-773
-50,37,-123,-320,-280,-250,-232,-116,-1334
65,137,10,-74,-57,-81,-79,127,48
4,23,-19,-48,-50,-28,-31,-10,-159
22,17,-17,-32,-37,-36,-16,-24,-123
11,83,-46,-92,-46,-68,-132,46,-244
511,590,43,-451,-226,-303,-89,368,443
-71,-34,-48,-136,-134,-110,-70,16,-587
-4,170,-66,-432,-207,-307,-284,48,-1082
82,128,24,-83,5,-48,-89,82,101
-3,-1,-19,-65,-67,-47,-27,-23,-252
30,149,-152,-434,-415,-422,-283,-147,-1674
31,4,-30,-45,-138,-80,-87,-68,-413
20,27,10,-43,-78,-46,-12,37,-85
-6,2,6,-73,-51,-5,-50,65,-112
-108,43,-126,-302,-220,-144,-188,40,-1005
-10,-26,-27,-50,-119,-73,-82,-38,-425
5,-15,-33,-126,-86,-83,-125,-1,-464
-61,39,-59,-185,-127,-66,-74,81,-452
-12,-20,-43,-128,-90,-86,-84,-22,-485
7,23,-5,-59,-8,-17,-19,34,-44
-66,90,-84,-241,-127,-123,-95,51,-595
-55,-19,-78,-141,-125,-51,-90,29,-530
54,15,24,44,-44,-3,-3,-42,45
35,19,18,12,-36,-20,14,-25,17
40,19,18,19,-39,-13,6,-20,30
-20,-10,-31,-68,-55,-35,-50,10,-259
-85,81,-43,-133,-41,-62,-75,-18,-376
-16,9,-24,-41,-76,-29,-45,2,-220
-19,5,-64,-141,-175,-132,-116,-11,-653
-37,-29,-20,-95,-82,-71,-71,-17,-422
-13,12,-41,-90,-101,-114,-94,-49,-490
-29,25,-73,-202,-141,-124,-111,-55,-710
25,27,-14,-15,-48,-37,-33,-41,-136
-15,29,-35,-99,-17,-47,-93,25,-252
-113,-20,-137,-246,-146,-112,-183,-40,-997
-83,-52,-94,-190,-149,-83,-166,-57,-874
29,53,6,-30,-119,-83,-86,-11,-241
-11,29,-6,-49,-102,-57,-58,7,-247
-8,5,-24,-17,-25,-21,-58,-5,-153
30,126,-32,-69,-14,-11,-61,70,39
-95,34,-104,-227,-98,-82,-159,-48,-779
-94,-19,-110,-281,-284,-133,-209,-32,-1162
-8,1,-12,-23,-26,-24,-29,8,-113
-54,-40,-55,-133,-125,-52,-92,3,-548
-60,-20,-72,-127,-96,-31,-82,34,-454
2,33,-2,-52,-2,-36,-19,0,-76
16,11,-42,-70,-79,-56,-64,13,-271
-45,31,-52,-171,-44,-57,-74,19,-393
-171,-32,-117,-346,-238,-161,-194,16,-1243
-4,-12,-19,-75,-38,-29,-91,1,-267
2,30,-9,-34,3,5,6,-31,-28
91,9,47,3,-36,-40,19,53,146
-56,48,-43,-97,-187,-64,-66,54,-411
-94,47,-89,-154,-30,-56,-86,37,-425
-117,102,-32,-173,-60,-67,-38,38,-347
-87,51,-43,-122,-47,19,-51,-58,-338
-44,112,-53,-138,-22,-71,-73,25,-264
-124,30,-69,-163,-31,-71,-108,0,-536
-7,83,-49,-148,1,-70,-49,-11,-250
-40,9,-44,-84,-50,-55,-28,6,-286
-82,86,-39,-111,-49,-43,-63,15,-286
-79,87,-59,-132,-44,-26,-32,0,-285
-22,57,-5,-65,-5,-32,-16,16,-72
-59,88,-48,-123,-11,-19,-35,20,-187
-27,38,-21,-101,-25,-55,-32,-6,-229
-3,100,-28,-140,-35,-80,-39,-16,-241
-75,41,-39,-90,-20,-24,-48,-30,-285
-60,71,-69,-136,-32,-74,-70,12,-358
-90,54,-77,-158,-2,-19,-55,19,-328
-136,35,-72,-176,-46,-59,-90,-49,-593
-31,64,-40,-105,-18,-63,-45,10,-228
-141,42,-80,-203,-58,7,-72,-99,-604
-81,74,-43,-149,-85,-62,-65,-10,-421
2,145,-46,-210,-80,-182,-74,-16,-461
-17,46,-9,-69,-44,-50,-28,2,-169
-6,-1,-23,-59,-63,-70,-83,-37,-342
9,26,-20,-118,-182,-78,-99,-49,-511
-17,-8,-39,-44,-47,-26,-41,-20,-242
12,56,13,-28,37,17,26,33,166
-73,84,-65,-159,-51,-68,-75,-3,-410
-38,98,-13,-124,-27,-80,-56,13,-227
-22,-8,-24,-57,-69,-72,-54,-24,-330
-16,-35,-42,-75,-86,-62,-57,-17,-390
-80,2,-95,-171,-69,-52,-54,54,-465
-19,12,-43,-135,-57,-72,-70,25,-359
-40,10,-27,-100,-60,-11,-60,-1,-289
69,65,57,27,16,-17,-61,8,164
-8,51,-101,-201,-243,-74,-158,121,-613
-20,10,-47,-80,-75,-42,-73,18,-309
2,34,-25,-96,-124,-96,-83,-17,-405
-2,-27,-57,-188,-96,-163,-134,-48,-715
-27,101,-38,-129,6,-51,-23,-4,-165
29,13,8,-20,-6,-12,-11,14,15
24,25,6,-51,-10,-49,-32,22,-65
32,-24,10,-52,-5,-71,-34,34,-110
26,21,18,-5,18,-17,-44,29,46
-27,-14,-39,-72,-45,-45,-56,-10,-308
85,37,12,-16,-42,-94,-70,-49,-137
-2,25,-16,-29,-58,-11,-50,15,-126
-14,8,-29,-124,-105,-69,-52,-34,-419
76,31,24,-15,-46,-74,-28,-33,-65
28,29,28,-132,-28,-69,-81,42,-183
-5,5,-5,-29,-29,-26,-22,-23,-134
206,68,100,-16,7,-80,-88,102,299
-19,2,-36,-90,-49,-24,-31,-32,-279
11,8,-14,-108,-21,-64,-77,23,-242
-40,-12,-55,-146,-166,-73,-121,-27,-640
-6,8,-25,-120,-61,-47,-94,28,-317
0,24,-13,-100,-94,-97,-98,-60,-438
112,5,-15,-12,-28,-93,-60,-26,-117
73,45,31,44,-53,-10,14,-9,135
8,-16,-12,-48,-90,-83,-52,-35,-328
-54,-7,-22,-111,-69,-47,-47,2,-355
-3,-7,-18,-76,-41,-30,-37,34,-178
-25,3,-48,-123,-98,-70,-79,-8,-448
-37,0,-69,-112,-63,-62,-70,-18,-431
-73,-10,-70,-172,-129,-99,-135,21,-667
-45,25,-32,-166,-106,-63,-86,12,-461
-26,72,-87,-242,-123,-168,-138,-24,-736
27,30,2,-72,-105,-85,-39,4,-238
-4,30,-25,-144,-259,-131,-166,-48,-747
36,30,-17,-67,-59,-67,-61,-44,-249
-18,37,-21,-82,-16,-17,-50,4,-163
-81,208,15,-376,-32,34,-276,272,-236
72,-2,30,28,39,11,-26,39,191
5,43,-24,-68,-13,-49,-37,-7,-150
5,19,0,-51,17,-51,-36,13,-84
-134,80,-142,-368,-234,-210,-223,18,-1213
-22,11,-31,-78,-86,-57,-48,-38,-349
-17,10,-64,-133,-181,-104,-114,-51,-654
-33,6,-42,-117,-41,-45,-52,-8,-332
-11,-13,-73,-180,-156,-139,-148,-93,-813
27,54,-20,-76,-21,-55,-41,-62,-194
-80,-45,-104,-241,-223,-190,-191,-106,-1180
-23,-25,-38,-91,-98,-76,-84,-7,-442
-1,0,-7,-30,-35,-18,-10,1,-100
-43,81,-97,-188,-117,-81,-126,-27,-598
-21,14,-31,-63,-51,-12,-44,-16,-224
-48,-17,-83,-158,-116,-102,-103,-4,-631
-32,-18,-13,-70,-58,-35,-33,0,-259
141,85,36,-44,48,-101,-78,110,197
50,-8,-38,-178,-311,-259,-232,-153,-1129
-26,-24,-49,-62,-93,-76,-87,-34,-451
-29,29,-75,-176,-77,-101,-93,-7,-529
-66,11,-43,-202,-150,-57,-131,58,-580
-45,-6,-39,-90,-60,-31,-53,-1,-325
-63,-20,-44,-127,-118,-82,-79,24,-509
-92,-38,-64,-145,-135,-70,-95,37,-602
34,12,10,-1,-46,-60,-34,2,-83
-17,2,-25,-38,-26,-26,-17,5,-142
10,6,2,-10,1,8,4,8,29
-54,140,-100,-154,-76,-37,-141,-8,-430
-62,-32,-96,-157,-136,-121,-162,-62,-828
185,442,38,-590,-151,-474,-312,278,-584
25,58,10,-39,-53,-84,6,-7,-84
-17,0,0,-36,-13,-21,3,-6,-90
40,47,-24,-149,-35,-109,-81,8,-303
8,0,-11,-45,-63,-50,-29,-27,-217
30,71,25,-46,-79,-15,-39,35,-18
29,1,-28,-102,-165,-148,-104,11,-506
75,67,1,-25,-31,-63,-35,1,-10
8,68,5,-43,-35,-41,-9,47,0
-19,8,-15,-66,-26,-25,-19,-10,-172
15,62,-4,-62,14,-50,-46,3,-68
-5,51,-49,-180,-60,-109,-61,67,-346
6,62,-53,-245,-131,-156,-70,-23,-610
-4,-5,-8,-26,-13,-8,-7,10,-61
59,68,14,-98,-32,-96,-27,66,-46
48,87,22,-10,-42,-32,-96,-60,-83
54,129,62,-10,-15,-5,-98,-6,111
-20,67,-32,-207,-132,-18,-74,118,-298
-2,-21,-74,-169,-151,-91,-103,83,-528
-46,-3,-79,-72,-77,-41,-84,-23,-425
-43,-12,-63,-98,-114,-66,-50,-23,-469
-32,1,-51,-77,-79,-36,-59,-28,-361
-41,-27,-60,-186,-106,-136,-123,-75,-754
-1,2,-8,-12,-34,-11,-7,-4,-75
-19,29,-64,-150,-124,-148,-124,-31,-631
-46,-5,-106,-310,-215,-199,-165,-3,-1049
-57,-41,-72,-149,-124,-95,-118,-14,-670
24,48,-61,-158,-70,-146,-131,-22,-516
-23,10,-4,-44,-28,-29,-19,-34,-171
-46,24,-44,-95,-40,-45,-38,21,-263
-66,104,-62,-216,-91,-44,-107,48,-434
129,171,28,76,-58,61,57,86,550
-76,41,-46,-248,-248,-128,-162,-46,-913
-29,-19,-39,-74,-54,-46,-48,24,-285
-27,-19,-10,-77,-47,-35,-37,-1,-253
-55,8,-64,-83,-56,-27,-87,-17,-381
2,-1,-22,-51,-48,-26,-32,-2,-180
74,30,-4,-96,-10,-84,-73,23,-140
-3,4,-8,-44,-51,-50,-23,-39,-214
-9,67,-48,-143,-24,-73,-103,-36,-369
28,10,-36,-116,-176,-136,-99,-19,-544
-71,-8,-52,-171,-185,-101,-113,24,-677
-17,36,-27,-128,-69,-58,-73,-23,-359
48,45,14,-126,6,-114,-99,20,-206
-7,98,-21,-123,-49,-57,-47,12,-194
-25,-25,-35,-97,-93,-75,-103,-42,-495
66,82,-23,-183,-63,-170,-97,-13,-401
74,52,37,-26,37,-66,-77,37,68
86,77,62,43,19,-26,-14,3,250
-13,-3,-29,-64,-61,-32,-55,16,-241
-138,-41,-170,-333,-219,-158,-241,-23,-1323
-23,-1,-35,-43,-28,-18,-22,-7,-177
-47,-48,-38,-99,-79,-66,-65,-25,-467
-6,39,-14,-105,-45,-62,-78,-4,-275
-9,-54,-23,-149,-106,-118,-113,39,-533
-59,11,-79,-239,-130,-32,-96,76,-548
-12,17,-55,-201,-193,-85,-135,42,-622
148,-42,59,-47,-62,-85,-87,75,-41
65,113,-42,-154,-139,-103,-151,-64,-475
-6,11,-13,-36,-20,-22,-23,-24,-133
-12,6,-11,-38,-26,-29,-28,-17,-155
-22,17,-33,-127,-34,-22,-51,3,-269
-15,66,-32,-56,-30,2,-24,13,-76
-4,10,-10,-27,-5,19,-5,1,-21
10,-13,9,-11,-38,16,-45,56,-16
76,58,-44,-108,-127,-152,-112,-114,-523
-83,31,-173,-345,-299,-132,-196,-18,-1215
-9,109,-46,-183,-52,-7,-146,121,-213
-14,-19,-39,-73,-55,-38,-45,-14,-297
-6,13,-14,-82,-47,-29,-26,16,-175
-24,48,-35,-61,-23,1,4,39,-51
-12,48,-74,-113,-65,-48,-60,31,-293
-19,12,-79,-140,-70,-115,-123,-93,-627
104,21,19,-22,-26,-73,-82,47,-12
-3,9,-32,-62,-112,-60,-69,-38,-367
-11,45,-7,-90,-20,-43,-68,22,-172
27,57,-7,-36,-43,-7,-74,59,-24
-22,24,-19,-46,-39,-32,-57,-31,-222
-4,3,-17,-33,-3,-7,-20,-3,-84
26,40,0,-57,-26,-41,-37,1,-94
24,24,21,-103,-4,-52,-71,37,-124
-5,-14,2,-36,-46,-18,-59,6,-170
-12,-15,-35,-98,-63,-76,-73,-21,-393
142,66,70,78,-6,-63,-86,-1,200
94,67,33,-1,-13,-78,-63,12,51
-29,71,-42,-190,-49,-67,-70,81,-295
29,44,11,-26,-23,-23,-18,1,-5
-24,-11,-40,-59,-53,-35,-54,4,-272
-62,12,-70,-155,-113,-91,-119,49,-549
68,85,9,-61,-21,-48,-89,66,9
-6,-1,-12,-18,-67,-24,-26,33,-121
0,4,-11,-31,-68,-34,-29,12,-157
0,13,-23,-42,-67,-30,-37,-15,-201
12,8,-16,-29,-41,-26,-21,-1,-114
-13,3,-8,-51,-58,-18,-30,14,-161
-3,-3,-17,-24,-31,-24,-25,1,-126
12,27,-20,-32,-1,-13,-11,7,-31
83,57,-2,-81,3,-127,-101,51,-117
21,44,-5,-50,-25,-52,9,-20,-78
7,21,-3,-2,-18,0,-9,-13,-17
-72,40,-141,-304,-252,-158,-213,-35,-1135
-71,-2,-83,-199,-160,-68,-117,-51,-751
-57,-10,-58,-239,-139,-83,-128,-20,-734
-31,-3,-116,-291,-307,-241,-237,-97,-1323
-3,-2,-8,-36,-62,-39,-48,-14,-212
-19,27,-27,-66,-54,-28,-35,5,-197
-66,-33,-131,-275,-285,-168,-209,-61,-1228
14,12,-16,-37,-37,-31,-11,-25,-131
-3,-14,-15,-32,-64,-46,-20,-12,-206
-22,83,-16,-151,-113,-110,-98,-66,-493
-18,108,-116,-278,-188,-150,-177,45,-774
2,84,-76,-264,-233,-152,-184,72,-751
-19,-21,-58,-89,-145,-118,-120,-46,-616
-16,16,-11,-51,-36,-8,-23,2,-127
60,28,34,8,-1,-49,-37,62,105
-81,122,-167,-383,-271,-147,-243,105,-1065
59,23,-41,-131,-80,-176,-94,-52,-492
-33,4,-64,-109,-26,-36,-23,-36,-323
-28,22,-18,-86,-45,-48,-31,7,-227
12,66,-48,-163,1,-65,-49,47,-199
-10,6,-1,-59,-49,-62,-29,-15,-219
-53,-22,-65,-145,-139,-58,-107,27,-562
12,6,-40,-80,-42,-92,-90,-61,-387
38,162,-27,-75,-26,-72,-1,-14,-15
-65,-24,-73,-183,-113,-89,-130,-67,-744
-73,1,-53,-177,-52,-65,-101,-40,-560
90,97,7,-136,-42,-115,-97,16,-180
-26,-17,-39,-46,-29,-40,-41,-15,-253
10,34,-19,-77,-160,-65,-89,-4,-370
-52,1,-61,-126,-87,-78,-85,-44,-532
397,237,262,20,229,86,-1,123,1353
-12,10,-8,-19,-8,7,-43,13,-60
-35,6,-34,-146,-78,-42,-101,7,-423
897,402,531,345,530,262,-69,284,3182
-27,30,-57,-162,-100,-97,-103,17,-499
-494,-194,-381,-913,-1347,-723,-726,-362,-5140
1308,1987,1107,684,208,-924,-218,1280,5432
14,3,3,-29,-95,-49,-66,6,-213
-45,11,-113,-226,-222,-167,-210,-46,-1018
-27,17,-36,-64,-25,-16,-32,9,-174
23,44,2,6,14,29,35,22,175
11,13,-13,-25,-22,-29,-19,-31,-115
-45,-35,-30,-89,-132,-66,-69,6,-460
-32,141,-55,-219,-43,-76,-16,13,-287
-19,-6,-57,-47,-73,-64,-64,-3,-333
-28,-17,-47,-60,-70,-38,-78,-9,-347
-10,-51,-34,-106,-57,-110,-94,-14,-476
1,31,3,-7,-1,20,9,-8,48
-29,-18,-40,-60,-29,-19,-39,-32,-266
-14,-21,-41,-123,-134,-59,-72,-5,-469
-44,-14,-63,-103,-80,-55,-75,-42,-476
24,47,-1,-5,-16,1,-9,5,46
182,176,139,-157,-463,252,-158,362,333
-317,23,-396,-858,-551,-592,-684,-217,-3592
-49,-20,-48,-95,-140,-34,-77,17,-446
-20,-36,-69,-165,-193,-106,-93,-9,-691
-53,-19,-168,-283,-423,-176,-273,-25,-1420
-58,-61,-80,-123,-150,-113,-146,-38,-769
-104,-27,-115,-176,-106,-102,-149,-31,-810
-76,-33,-69,-130,-135,-59,-118,-17,-637
-111,61,-73,-169,-74,-94,-92,-17,-569
-17,4,-27,-100,-86,-94,-81,-32,-433
-85,-21,-86,-158,-144,-95,-133,-13,-735
-29,28,-64,-100,-43,-5,-21,-29,-263
-14,47,-47,-200,-78,-120,-102,-30,-544
-30,15,-33,-96,-39,-32,-36,6,-245
-28,16,-66,-151,-152,-35,-89,-20,-525
-21,-7,-20,-39,-36,-19,-42,1,-183
-26,158,-116,-362,-149,-177,-156,111,-717
-4,0,-42,-71,-98,-33,-54,-21,-323
12,64,-58,-229,-127,-192,-205,-25,-760
-61,-33,-90,-158,-136,-87,-139,15,-689
-71,-26,-91,-152,-116,-104,-130,-56,-746
-25,11,-66,-133,-121,-117,-123,-55,-629
15,32,9,-1,13,13,0,-12,69
-28,11,-38,-128,-73,-86,-88,0,-430
19,49,11,-83,-5,-9,-61,12,-67
-24,-14,-27,-31,-41,-19,-29,-4,-189
12,52,-16,-23,-34,-35,-24,-3,-71
-45,-28,-64,-169,-152,-128,-123,25,-684
-20,5,-49,-108,-12,-60,-34,-35,-313
54,112,-2,4,28,20,29,100,345
-158,149,-521,-1185,-910,-859,-972,-302,-4758
-13,47,-19,-103,-47,-89,-87,-1,-312
-1,142,-44,-258,-69,-153,-196,2,-577
-27,5,-34,-65,-51,-57,-39,-29,-297
27,-32,-40,-95,-142,-144,-125,-37,-588
-41,-47,-52,-99,-148,-89,-115,30,-561
-47,-10,-59,-58,-76,-17,-66,-24,-357
-22,20,-33,-98,-142,-61,-92,37,-391
-5,-25,-26,-76,-127,-52,-66,2,-375
-21,17,-52,-76,-77,-54,-73,-42,-378
-27,42,-67,-142,-105,-66,-102,-12,-479
-15,0,-61,-147,-107,-72,-106,34,-474
-28,-15,-30,-109,-88,-75,-84,6,-423
37,20,-13,-121,-66,-123,-101,14,-353
13,3,-23,-138,-207,-112,-125,-26,-615
12,80,-29,-109,-125,-91,-105,-34,-401
4,18,-11,-20,-65,-24,-38,-22,-158
-1,22,-44,-203,-74,-128,-138,-37,-603
46,-25,1,-82,-113,-176,-104,-9,-462
42,42,43,-5,-30,26,-8,9,119
-48,-14,-11,-78,-90,5,-26,9,-253
29,74,-89,-214,-273,-143,-206,-110,-932
4,4,-1,0,-2,-1,0,-3,1
248,637,141,-575,-237,-28,-429,423,180
-11,20,-62,-161,-138,-90,-99,68,-473
-18,22,-30,-94,-93,-54,-70,-24,-361
-22,12,-21,-55,-20,-22,-46,-14,-188
53,-30,-18,-111,-116,-122,-133,-8,-485
7,-11,-63,-125,-42,-83,-97,-2,-416
29,57,-34,-59,-126,-17,-49,-25,-224
-41,-16,-72,-153,-93,-103,-133,-36,-647
-42,-39,-70,-140,-120,-111,-131,-44,-697
26,10,-77,-223,-189,-139,-165,-19,-776
-11,2,-16,-34,-17,-24,-11,-3,-114
-3,4,-16,-42,-31,5,-30,-2,-115
-47,53,-77,-239,-34,-69,-104,8,-509
36,47,22,-37,-49,-32,-29,21,-21
22,75,-82,-228,-125,-227,-168,-48,-781
-35,40,-68,-151,-118,-84,-100,46,-470
34,0,-44,-153,-93,-85,-85,-12,-438
12,24,-22,-17,-14,-36,-28,-20,-101
7,46,4,-42,-31,-36,-10,9,-53
-12,-7,3,-25,31,24,-6,23,31
-8,-17,-12,-23,12,-8,1,11,-44
-9,-17,-11,-23,12,-9,1,14,-42
-19,20,-58,-132,-130,-117,-124,-44,-604
17,18,-25,-119,-96,-80,-45,-39,-369
2,42,-32,-157,-161,-169,-135,-14,-624
-18,-4,-36,-78,-55,-36,-41,-8,-276
118,114,78,65,47,52,19,61,554
138,68,-3,-117,-90,-146,-163,59,-254
4,6,-47,-115,-53,-112,-66,-49,-432
-4,16,-46,-46,-26,-33,-34,-55,-228
-66,-30,-86,-155,-112,-89,-116,-81,-735
57,57,-14,-204,-14,-159,-145,48,-374
15,31,-21,-56,-14,-42,-11,-34,-132
-14,-9,-31,-90,-65,-34,-42,-38,-323
34,-8,-29,-51,-143,-103,-80,-31,-411
-52,-19,-85,-156,-133,-95,-148,-35,-723
29,57,22,-110,-120,-43,-81,107,-139
81,40,-24,-108,-45,-115,-140,-3,-314
-5,20,-28,-75,-37,-39,-52,-8,-224
-8,4,-14,-47,-37,-51,-24,-30,-207
-45,-23,-56,-110,-87,-65,-90,-16,-492
-22,30,-109,-200,-31,-122,-111,-112,-677
-7,39,-26,-71,-21,-26,-15,11,-116
-38,-3,-42,-115,-87,-92,-78,-20,-475
-101,-3,-140,-261,-119,-123,-170,-29,-946
-32,43,-30,-93,-53,-26,-85,8,-268
27,-27,-13,-55,-54,-33,-71,31,-195
-19,69,-89,-136,-120,-100,-189,99,-485
-20,-17,-14,-36,-46,-13,-12,14,-144
-14,22,-23,-44,-54,-21,-26,-19,-179
4,9,-1,6,-27,-13,-25,15,-32
-70,-49,-92,-182,-115,-101,-134,-10,-753
6,12,-34,-103,-89,-66,-124,-47,-445
-46,82,-59,-98,-120,-16,-78,30,-305
-14,36,-18,-57,-47,-37,-26,-19,-182
-52,-15,-66,-166,-68,-89,-115,-30,-601
-32,52,-93,-229,-185,-56,-83,43,-583
183,89,149,41,77,-47,-25,62,529
-35,-2,-36,-115,-109,-98,-81,8,-468
-25,-4,-84,-210,-117,-168,-165,-55,-828
-14,3,-14,-66,-52,-52,-63,10,-248
1,19,7,-18,-37,20,-16,-5,-29
0,6,-17,-11,-14,-5,-20,-11,-72
3,210,-25,-13,-13,-62,18,120,238
-40,15,-51,-174,-94,-94,-74,38,-474
-54,-36,-57,-155,-162,-79,-109,-41,-693
1,17,-51,-179,-222,-220,-159,-52,-865
8,-21,-33,-70,-96,-41,-46,12,-287
-16,-1,-15,-56,-70,-25,-34,-13,-230
2,37,-14,-77,-19,-60,-45,11,-165
-44,-50,-56,-118,-107,-72,-105,1,-551
-41,-37,-52,-111,-89,-65,-97,-2,-494
-3,11,-18,-37,-30,-31,-34,0,-142
-1,25,-21,-47,-43,-15,-32,19,-115
36,21,-6,-93,-55,-37,-29,9,-154
-167,-23,-150,-342,-175,-127,-151,-39,-1174
-134,122,-144,-507,-306,-153,-263,241,-1144
-102,-66,-78,-444,-352,-209,-189,211,-1229
-84,-19,-51,-192,-169,-55,-124,-14,-708
-50,12,-49,-236,-200,-149,-187,160,-699
42,279,-161,-510,-249,-289,-346,357,-877
176,203,151,213,148,90,-5,55,1031
4,127,-13,-180,-22,-58,47,66,-29
-19,183,-72,-222,-99,-179,-162,-83,-653
-33,11,-43,-62,-21,-12,-33,7,-186
60,35,47,-12,-51,53,-5,65,192
-49,50,-69,-178,-17,-69,-94,4,-422
-4,-8,-47,-79,-144,-51,-73,-31,-437
-18,11,-2,-24,-32,-27,-9,-1,-102
-21,11,-28,-30,-36,-11,-21,-9,-145
-18,14,-10,-56,-53,-36,-37,1,-195
25,32,-5,-19,-3,-25,-3,-28,-26
121,117,75,13,9,-80,3,68,326
89,34,-51,-67,-74,-114,-99,-115,-397
-100,13,-174,-370,-301,-103,-195,-2,-1232
29,38,-23,-132,-86,-133,-61,-40,-408
-77,38,-65,-191,-113,-94,-116,-54,-672
62,56,45,-97,-33,-76,-70,33,-80
43,53,33,-122,-17,-62,-84,56,-100
2,-8,-4,-15,-26,-19,-30,14,-86
109,56,40,-1,1,-113,-97,4,-1
76,75,33,-37,50,-83,-101,52,65
9,-1,-41,-139,-110,-109,-128,-24,-543
-2,11,-23,-47,-43,-51,-36,-39,-230
-80,-12,-98,-187,-155,-125,-152,-34,-843
-30,9,-55,-91,-37,-41,-76,-16,-337
-141,-40,-151,-256,-181,-134,-187,-22,-1112
-4,12,-32,-80,-55,-30,-54,-10,-253
-86,-32,-134,-186,-170,-107,-182,-30,-927
-2,24,-23,-39,-20,-52,-50,-18,-180
-37,302,-123,-508,-413,-134,-425,7,-1331
-77,-32,-34,-154,-102,-92,-104,34,-561
-5,-6,-26,-69,-50,-44,-53,14,-239
0,-9,-4,-60,-69,-28,-51,-2,-223
-30,50,-45,-121,-50,-72,-52,25,-295
9,-15,-18,-118,-116,-112,-108,-60,-538
-14,0,-10,-33,-20,-19,-17,10,-103
-3,-10,-4,-14,-19,-15,-12,0,-77
43,-46,-19,-65,-125,-99,-104,-36,-451
-45,-13,-34,-91,-57,-55,-59,-37,-391
-31,27,-46,-143,-110,-78,-98,56,-423
-16,9,-39,-101,-39,-19,-63,1,-267
-48,-32,-74,-99,-69,-44,-88,-25,-479
25,86,-72,-214,2,-167,-165,28,-477
-83,-19,-68,-172,-59,-44,-105,-22,-572
12,0,-3,-83,-48,-68,-70,1,-259
-4,-2,-28,-31,-56,-31,-41,-12,-205
-96,-19,-113,-185,-101,-101,-121,-58,-794
14,17,-18,-17,-40,-25,-26,2,-93
-21,-21,-21,-62,-56,-32,-74,-11,-298
-31,-28,-76,-171,-109,-110,-112,-56,-693
14,70,-16,-69,-35,-24,1,38,-21
45,50,-9,-20,-4,-46,-5,-12,-1
-8,34,-25,-62,-29,-40,-5,-7,-142
-1,-9,-10,-14,-28,-23,-14,-2,-101
-47,20,-66,-164,-138,-60,-82,7,-530
12,19,-12,-62,-125,-54,-85,-16,-323
21,244,-50,-335,-408,-93,-232,85,-768
8,4,-2,-9,-34,-5,-4,1,-41
5,-9,-35,-35,-83,-70,-80,12,-295
-31,-22,-57,-102,-51,-52,-72,-29,-416
-41,-17,-38,-100,-93,-90,-82,-36,-497
-28,10,-69,-181,-76,-101,-126,-47,-618
47,88,-107,-370,-339,-327,-292,204,-1096
-32,-10,-50,-102,-69,-46,-75,-45,-429
-77,-21,-83,-162,-141,-101,-128,-31,-744
-78,-21,-90,-161,-96,-97,-114,-40,-697
-74,-5,-112,-174,-101,-103,-136,-47,-752
251,678,-17,-538,12,-429,-176,409,190
15,33,-18,-22,3,-25,-35,-3,-52
404,209,239,156,223,116,-52,98,1393
-83,-35,-83,-157,-140,-55,-123,5,-671
-77,-44,-87,-152,-121,-69,-112,-19,-681
-132,42,-107,-322,-190,-139,-233,-13,-1094
-52,19,-63,-180,-106,-80,-91,-57,-610
41,18,-26,-96,-171,-145,-158,-13,-550
-97,-16,-103,-164,-106,-72,-127,-19,-704
-77,-67,-64,-138,-149,-83,-140,31,-687
-93,-58,-73,-141,-117,-69,-111,2,-660
-103,-45,-96,-162,-130,-86,-151,32,-741
-72,-15,-104,-140,-126,-111,-144,18,-694
-20,8,-31,-62,-79,-42,-46,18,-254
-42,21,-25,-139,-190,-102,-117,35,-559
10,21,-16,-15,-55,-16,-35,19,-87
-11,-11,-25,-35,-46,-31,-32,-1,-192
9,-5,-7,-58,-82,-65,-44,-30,-282
-38,369,-188,-523,-417,-243,-497,40,-1497
-4,0,-15,-13,-37,-9,-31,-29,-138
50,91,-59,-158,-19,-130,-48,29,-244
-45,39,-39,-107,-25,-38,-22,-26,-263
18,68,31,-7,-5,12,-23,39,133
4,16,14,-56,-23,8,4,18,-15
59,56,47,-11,-26,-30,-10,46,131
0,17,-27,-134,-210,-109,-97,-18,-578
-7,26,-8,-5,-15,-9,-12,-18,-48
-12,25,-21,-16,-37,-16,-47,-2,-126
-12,-3,-16,-39,-77,-50,-48,-1,-246
-5,7,-20,-41,-59,-33,-32,6,-177
-7,8,-8,-20,-83,-33,-49,-12,-204
-7,1,-10,-33,-41,-31,-43,-39,-203
-25,8,-14,-44,-42,-31,-28,-10,-186
-6,14,-24,-25,-23,-23,-22,-26,-135
4,14,-12,-13,-17,-5,-17,-5,-51
-25,6,-36,-98,-93,-54,-75,-20,-395
-86,-50,-99,-133,-100,-66,-94,-3,-631
854,481,517,173,538,234,-60,183,2920
-31,35,-30,-68,-29,-29,-35,2,-185
2,40,-45,-81,-42,-54,-53,-40,-273
-31,47,-63,-237,-186,-188,-198,-5,-861
-27,142,-45,-182,-126,-147,-143,-52,-580
-83,64,-97,-149,-132,-37,-98,13,-519
8,35,-38,-89,-95,-55,-86,-56,-376
-15,35,-18,-96,-72,-30,-37,-80,-313
-65,5,-51,-202,-141,-138,-144,64,-672
-44,22,-43,-146,-97,-53,-70,-8,-439
-5,4,-66,-184,-271,-188,-213,-90,-1013
-67,81,-92,-331,-205,-176,-116,9,-897
51,61,32,-82,-5,-37,-53,71,38
13,23,-1,-97,-84,-34,3,40,-137
-3,98,-26,36,-17,9,-56,7,48
-12,-17,11,-55,-59,-37,-14,-5,-188
-44,38,-62,-146,-88,-56,-90,42,-406
17,26,-4,-69,-33,-22,-41,34,-92
50,92,-4,-30,22,-38,-10,39,121
-19,8,-49,-118,-65,-58,-84,-17,-402
4,7,-36,-85,-114,-63,-81,-40,-408
-17,-12,-23,-58,-50,-57,-41,-19,-277
0,4,-13,-14,1,-2,-10,-8,-42
-7,-31,-48,-112,-138,-112,-94,-50,-592
7,38,-4,-12,27,23,28,12,119
29,32,-49,-82,-84,-78,-79,-24,-335
-37,-3,-64,-146,-110,-44,-53,-35,-492
26,4,-83,-311,-272,-288,-249,-131,-1304
8,-20,-48,-95,-93,-43,-43,-21,-355
70,42,12,-66,25,-87,-65,48,-21
-14,-8,-12,-28,-15,-9,-30,-4,-120
-35,-1,-48,-61,-35,-44,-34,7,-251
-34,11,-39,-64,-24,-41,-17,4,-204
-28,-12,-34,-58,-21,-22,-38,19,-194
-23,0,-26,-75,-36,-77,-50,-28,-315
-5,19,-1,-48,-11,-11,-25,-7,-89
-2,-2,21,-112,-47,-80,-70,4,-288
-45,-40,-16,-84,-67,-66,-68,15,-371
0,-11,-18,-103,-86,-88,-78,-12,-396
12,19,-12,-30,-36,-25,3,1,-68
-29,-15,-70,-110,-114,-68,-96,-14,-516
-27,-12,-28,-80,-92,-54,-78,-32,-403
-10,11,-16,-77,-44,-44,-26,-8,-214
-30,12,-62,-86,-38,-35,-43,-6,-288
3,17,-22,-59,-82,-63,-56,-59,-321
-36,-22,-34,-130,-128,-60,-94,-28,-532
-15,10,-25,-41,-52,-39,-46,-34,-242
0,31,-67,-107,-53,-63,-72,10,-321
-29,-18,-39,-102,-77,-69,-72,-31,-437
12,89,-3,-191,-118,-134,-82,73,-354
-10,12,-44,-31,-70,-36,-74,-15,-268
10,19,-5,-22,-19,-22,-26,-27,-92
0,1,3,-17,-30,-11,-14,-12,-80
-64,-36,-88,-156,-166,-84,-122,104,-612
38,-10,-25,-93,-114,-149,-72,-61,-486
78,119,15,-91,-1,-49,-79,133,125
-15,-9,-56,-74,-109,-108,-119,-55,-545
-15,3,0,-58,-49,-40,-9,-5,-173
391,169,233,110,265,163,-24,86,1393
11,57,-28,-102,-98,-67,-65,66,-226
14,30,-23,-56,-48,-63,-23,-31,-200
-27,9,-60,-61,-70,-25,-82,-8,-324
-32,-1,-35,-75,-27,-43,-48,-3,-264
-1,52,-142,-572,-495,-452,-447,-82,-2139
20,34,-35,-16,-3,44,21,45,110
28,56,1,-185,-105,-193,-164,9,-553
182,181,39,-136,-99,-114,-57,13,9
-1,9,-52,-68,-50,-10,1,28,-143
11,69,36,-44,33,15,-65,32,87
-58,0,-54,-136,-88,-91,-94,-14,-535
-52,-12,-80,-213,-104,-95,-96,-8,-660
110,155,62,-141,-10,-129,-69,75,53
-36,14,-73,-124,-48,-76,-91,-2,-436
21,25,16,7,-55,-53,-48,7,-80
21,5,-17,-8,-81,-50,-42,-8,-180
-1,5,-21,-47,-51,-32,-50,-7,-204
-11,-9,-48,-65,-47,-26,-50,10,-246
-12,15,-22,-66,-47,-52,-69,-12,-265
-22,8,-9,-70,-45,-50,-48,-21,-257
16,14,4,-34,-68,-46,-57,16,-155
14,4,1,9,-87,-46,-41,-10,-156
30,11,5,5,-87,-56,-50,-2,-144
-12,-15,-46,-65,-21,-32,-38,-24,-253
-81,-33,-80,-175,-150,-118,-141,-50,-828
-86,-43,-69,-152,-143,-92,-129,-13,-727
-57,41,-104,-166,-73,-79,-127,10,-555
-88,-5,-108,-238,-167,-125,-148,-41,-920
-2,46,-37,-97,-35,-41,-36,-21,-223
76,283,-4,-310,-71,-226,-135,163,-224
43,-29,16,-17,-68,-82,-67,24,-180
10,49,-39,-154,-4,-61,-42,31,-210
-9,-3,-15,-11,-17,-6,-20,5,-76
-36,11,-70,-105,-47,-34,-69,-26,-376
0,26,-24,-179,-151,-143,-122,-63,-656
-1,14,-22,-64,-139,-49,-82,-24,-367
-10,11,-20,-155,-210,-144,-113,-38,-679
-10,46,-37,-102,-101,-14,-67,-10,-295
-113,-60,-103,-187,-124,-79,-114,8,-772
-74,3,-80,-152,-104,-86,-113,-4,-610
-19,25,-74,-321,-258,-260,-231,-57,-1195
5,-5,-20,-73,-74,-48,-48,38,-225
93,66,47,10,-37,-48,-36,36,131
-21,26,-11,-75,7,-37,-21,52,-80
72,22,-2,-35,-48,-88,-40,-29,-148
-104,-19,-85,-276,-187,-119,-119,-62,-971
-56,-49,-38,-144,-133,-83,-94,11,-586
-69,-26,-47,-153,-107,-80,-109,34,-557
-49,-32,-52,-110,-95,-63,-71,-35,-507
13,21,-52,-76,-112,-90,-87,-29,-412
-100,-36,-78,-177,-121,-117,-149,-28,-806
19,4,3,-5,-48,-28,-49,15,-89
12,89,17,-187,-44,-132,-73,2,-316
81,51,26,-68,-43,-99,-49,-2,-103
22,182,-59,-263,-104,-168,-67,38,-419
-95,6,-126,-331,-198,-181,-161,-6,-1092
-17,82,-13,-39,-51,-44,-118,-42,-242
-61,-22,-33,-298,-240,-164,-201,130,-889
7,10,-46,-71,-127,-97,-74,-39,-437
-30,-18,-38,-82,-91,-57,-93,-3,-412
37,140,-13,-88,-16,-57,-78,30,-45
-43,-14,-39,-95,-61,-42,-35,-6,-335
23,64,-8,-115,-48,-112,-110,49,-257
10,25,-44,-83,-56,-54,-51,2,-251
-23,25,-51,-99,-61,-63,-63,-11,-346
-69,-26,-42,-85,-80,-26,-60,6,-382
-3,13,-14,-14,4,-1,-18,-5,-38
-46,1,-54,-207,-120,-111,-96,73,-560
13,10,-15,-49,-118,-72,-51,-3,-285
-5,46,-13,-61,-21,-24,-12,1,-89
43,50,-32,-74,-107,-95,-89,43,-261
12,85,8,-91,-157,-155,-137,15,-420
-62,-7,-106,-252,-278,-142,-217,-27,-1091
-19,5,1,-49,-95,-20,-41,6,-212
-33,-5,-79,-126,-115,-106,-123,-33,-620
-50,-25,-79,-116,-101,-84,-107,-39,-601
-38,35,-29,-63,-25,-2,-55,11,-166
-32,-5,-64,-189,-219,-177,-149,19,-816
-73,35,-110,-218,-193,-118,-123,66,-734
-1,12,-65,-219,-269,-263,-212,8,-1009
-16,24,-62,-191,-205,-134,-154,90,-648
-8,42,-13,-111,-96,-34,-74,28,-266
73,24,25,-99,-23,-110,-63,4,-169
-59,-63,-74,-143,-144,-104,-150,18,-719
40,25,2,-46,-71,-61,-22,-3,-136
-20,6,-8,-44,-21,-13,-17,5,-112
-85,226,-125,-344,-69,-98,30,103,-362
-110,138,-126,-405,-216,-232,-252,-74,-1277
65,115,-11,-133,-99,-190,-144,-54,-451
-4,6,-10,-11,1,3,-7,-7,-29
1050,495,707,276,702,223,-23,395,3825
-7,-27,-52,-85,-198,-98,-100,-32,-599
-31,4,-37,-82,-24,-48,-65,-30,-313
-37,18,-37,-94,-47,-47,-51,27,-268
-36,27,-28,-96,-63,-49,-63,-5,-313
42,17,-49,-308,-170,-259,-224,-48,-999
-28,30,-76,-296,-225,-153,-222,15,-955
-26,12,-51,-97,-63,-24,-47,0,-296
7,90,-24,-134,-26,-56,19,-60,-184
53,23,-2,-29,-22,-67,-44,50,-38
27,60,-71,-199,-175,-216,-173,-55,-802
-62,8,-121,-329,-198,-265,-201,-119,-1287
-55,-1,-87,-140,-76,-78,-114,-40,-591
11,10,-7,-32,-59,-38,-37,7,-145
-72,17,-96,-236,-85,-91,-112,-37,-712
-9,-1,-6,-33,-32,-27,-11,1,-118
-11,1,-18,-57,-117,-62,-49,-7,-320
-23,22,-37,-73,-48,-27,-39,0,-225
176,64,9,88,-94,-26,32,-31,218
-13,7,-35,-58,-99,-73,-72,-17,-360
-100,9,-120,-225,-117,-45,-105,11,-692
-65,-41,-40,-96,-108,-56,-67,-34,-507
13,7,-25,-88,-138,-79,-113,-19,-442
-4,7,-40,-74,-69,-57,-51,-30,-318
14,17,-27,-41,-25,-11,-32,-38,-143
-19,-17,-32,-63,-59,-33,-23,-32,-278
-2,1,3,-49,-84,-45,-54,-2,-232
35,29,-18,-14,-71,-36,-32,-16,-123
-7,10,-19,-31,-40,-31,-29,-10,-157
-13,1,-10,-26,-12,-19,-11,3,-87
2,-2,-28,-66,-70,-54,-47,0,-265
29,-2,-10,-6,-59,-31,-44,-13,-136
-21,4,-16,-39,-53,-20,-22,-5,-172
8,-2,-21,-35,-86,-28,-60,-34,-258
-13,8,-20,-44,-33,-11,-19,-14,-146
-13,5,-13,-34,-10,-28,-21,17,-97
2,8,-64,-76,-102,-34,-42,-9,-317
-60,-5,-98,-190,-173,-130,-188,-101,-945
-26,2,-81,-171,-169,-128,-188,-92,-853
85,101,-20,-85,-30,-133,-114,48,-148
4,67,-95,-207,-84,-123,-148,-10,-596
-13,-2,-19,-31,-24,-22,-34,-16,-161
-24,-10,-35,-83,-71,-64,-56,-48,-391
-5,5,-24,-83,-87,-104,-83,-57,-438
25,95,0,-131,-83,-129,-59,36,-246
-8,-2,-40,-54,-89,-67,-97,-44,-401
-12,73,-36,-137,-23,-90,-37,26,-236
3,48,-41,-158,-69,-129,-65,-3,-414
-18,64,-46,-127,-5,-63,-30,-23,-248
19,46,7,-33,-1,-5,-30,15,18
-25,22,-62,-44,-59,-46,-71,-29,-314
-94,-22,-76,-173,-93,-80,-136,-16,-690
12,418,31,-354,-34,-290,-48,367,102
-29,0,-42,-121,-58,-44,-45,-11,-350
16,1,-31,-60,-99,-85,-44,-21,-323
-11,2,-49,-113,-113,-134,-125,-36,-579
29,2,-42,-43,-46,-34,-54,-54,-242
0,31,-23,-82,-107,-6,-41,13,-215
21,48,-71,-204,-120,-188,-133,-5,-652
-69,-32,-115,-148,-168,-79,-170,19,-762
-72,-22,-74,-151,-120,-48,-110,15,-582
-23,54,-37,-119,-55,-91,-68,-71,-410
4,-11,-25,-35,-45,-48,-49,-28,-237
-72,-58,-86,-131,-128,-84,-114,-37,-710
-98,-34,-98,-171,-124,-91,-133,-14,-763
-115,-53,-114,-170,-129,-72,-130,-25,-808
-39,-22,-81,-151,-158,-137,-133,-37,-758
-38,-4,-45,-143,-129,-104,-114,-59,-636
-2,5,-35,-138,-232,-108,-98,-9,-617
-1,269,-80,-367,-118,-95,-257,-154,-803
25,6,9,0,-30,-25,-23,9,-29
-45,2,-50,-89,-95,-83,-81,-44,-485
-9,-16,-32,-62,-51,-51,-60,-57,-338
-8,28,-47,-96,-74,-39,-68,-15,-319
-3,0,-8,-52,-42,-36,-27,6,-162
-52,7,-122,-159,-190,-112,-177,-51,-856
22,-4,-16,-69,-109,-31,-58,-44,-309
-29,-3,-23,-112,-109,-53,-87,12,-404
-45,-16,-59,-119,-125,-96,-116,22,-554
-84,-18,-68,-144,-110,-56,-104,23,-561
-102,-25,-79,-292,-302,-171,-189,26,-1134
-53,-34,-72,-170,-115,-99,-120,40,-623
-103,-35,-74,-164,-137,-99,-118,-21,-751
-71,-9,-80,-141,-78,-80,-135,-40,-634
-90,-39,-76,-162,-116,-75,-111,-7,-676
-88,-24,-85,-128,-66,-56,-100,-28,-575
-84,-85,-82,-134,-90,-74,-126,5,-670
-43,-40,-55,-134,-146,-107,-136,2,-659
-30,7,-31,-50,-37,-31,-41,-19,-232
1,23,-20,-35,-42,-21,-24,-16,-134
19,53,-2,-97,-175,-94,-101,-17,-414
-21,37,-9,-110,-110,-72,-65,-5,-355
-30,4,-53,-110,-103,-42,-80,13,-401
-8,12,-14,-10,-17,-6,-15,-13,-71
-5,16,-63,-147,-104,-138,-121,-56,-618
-8,4,8,-56,-113,-49,-68,-16,-298
-14,-20,-62,-82,-67,-61,-74,-38,-418
129,29,56,22,40,-50,-71,64,219
119,68,72,37,20,-53,-43,19,239
43,22,9,-12,-2,-42,-27,30,21
28,4,16,20,-41,-41,-21,15,-20
20,0,-1,-21,-25,-72,-44,-5,-148
32,11,17,-20,-33,-69,-30,25,-67
123,14,33,56,-95,-95,-55,-29,-48
37,40,11,-17,30,-1,-11,49,138
26,-12,21,-21,-13,-48,-40,14,-73
60,46,33,-33,47,-32,-34,14,101
57,33,43,-9,20,-40,-66,34,72
100,24,51,62,0,-38,-44,39,194
55,36,57,21,-20,-33,-72,-11,33
-35,1,-26,-114,-105,-45,-35,27,-332
5,1,-16,-58,-125,-25,-49,-5,-272
-42,26,-113,-326,-347,-157,-241,-15,-1215
-36,-37,-42,-98,-93,-46,-65,-32,-449
-5,8,-17,-22,-9,-7,-24,7,-69
-6,14,-14,-45,-8,-30,-13,-2,-104
-34,-21,-81,-137,-152,-139,-133,-52,-749
-12,3,-38,-57,-81,-22,-34,30,-211
7,17,-15,-47,-20,-25,-14,16,-81
65,31,25,13,-46,6,-21,58,131
-60,22,-62,-152,-114,-65,-106,-1,-538
-33,19,-43,-113,-65,-14,-75,42,-282
217,441,25,-536,67,-314,-194,341,47
-54,4,-104,-179,-202,-156,-221,-48,-960
-92,-29,-131,-184,-174,-82,-177,3,-866
-37,17,-30,-130,-94,-43,-84,36,-365
-80,-19,-122,-181,-201,-82,-164,9,-840
-16,31,5,-63,-53,12,-9,-2,-95
-31,4,-37,-130,-96,-60,-45,-28,-423
-35,-16,-33,-134,-98,-77,-65,-41,-499
-53,13,-48,-107,-5,-59,-60,10,-309
4,-4,-42,-84,-171,-107,-118,-28,-550
32,30,-6,-15,-75,-34,-79,-2,-149
-14,-20,-66,-116,-192,-123,-115,-34,-680
-11,-14,-14,-30,-39,-55,-47,-13,-223
112,72,101,81,23,45,-15,48,467
73,60,63,20,-19,-3,-26,63,231
-17,12,-15,-61,-65,-44,-42,-14,-246
-7,17,-21,-40,-39,-44,-43,-16,-193
1,6,-21,-35,-43,-39,-38,-39,-208
-7,-10,-50,-71,-82,-69,-70,-102,-461
-4,3,-12,-11,-13,-13,-18,-11,-79
-14,15,-33,-67,-21,-26,-41,38,-149
-13,11,-31,-63,-32,-24,-34,46,-140
-6,1,-26,-69,-33,-37,-56,50,-176
-20,43,-66,-249,-171,-105,-137,96,-609
-41,40,-74,-245,-154,-141,-145,-28,-788
-1,-5,-21,-38,-55,-26,-17,-8,-171
-31,2,-33,-115,-60,-37,-63,25,-312
-31,17,-56,-140,-146,-73,-118,-23,-570
-62,12,-67,-173,-73,-102,-103,10,-558
-38,30,-54,-190,-116,-146,-133,-11,-658
-64,-13,-88,-152,-135,-93,-134,-2,-681
76,70,23,43,12,-107,-85,60,92
40,53,37,-25,-7,-51,-50,65,62
-99,-24,-97,-144,-133,-80,-133,-13,-723
-102,-38,-98,-174,-126,-88,-137,-46,-809
-85,-1,-88,-156,-98,-74,-111,25,-588
-95,-36,-95,-167,-138,-90,-134,-19,-774
-98,-35,-86,-146,-124,-67,-119,-2,-677
-89,-23,-113,-178,-101,-71,-130,-7,-712
-33,-7,-46,-140,-106,-56,-34,-28,-450
-78,-26,-92,-157,-129,-113,-147,-62,-804
35,53,-24,-70,-24,-59,-57,32,-114
1,-10,-11,-21,-35,-19,-28,-7,-130
-11,6,-16,-14,-48,-23,-22,10,-118
4,22,-35,-81,-109,-92,-57,-33,-381
-121,-22,-135,-280,-318,-95,-201,35,-1137
-47,39,-54,-157,-71,-61,-99,-18,-468
-38,53,-65,-140,-49,-30,-79,-42,-390
12,55,-5,-118,-91,-29,-54,116,-114
-34,12,-53,-167,-122,-115,-100,31,-548
-28,-3,-28,-95,-67,-35,-56,7,-305
-10,18,-45,-114,-84,-78,-83,-28,-424
-59,-10,-27,-81,-86,-50,-58,9,-362
-22,14,-24,-64,-27,-37,-38,4,-194
9,123,-36,-160,-157,-73,-126,82,-338
90,69,16,-171,20,-135,-154,96,-169
-20,-5,-44,-69,-81,-60,-69,-20,-368
1,24,-39,-161,-113,-107,-80,12,-463
-29,-9,-15,-53,-53,-23,-22,12,-192
-12,26,-15,-74,-60,-71,-54,-18,-278
-33,3,-47,-81,-39,-46,-47,2,-288
-80,-31,-88,-133,-119,-84,-126,-20,-681
76,138,-148,-297,-156,-263,-204,-136,-990
-56,-22,-62,-181,-163,-83,-126,-52,-745
-35,-21,-39,-153,-178,-102,-109,72,-565
-47,67,-72,-224,-164,-83,-163,-72,-758
140,58,85,-3,19,-21,-67,-9,202
39,75,7,-44,-12,-45,15,11,46
-61,9,-73,-186,-79,-75,-95,-35,-595
-83,-3,-94,-224,-101,-65,-100,-36,-706
49,13,5,-14,-87,-69,-35,-12,-150
-61,4,-79,-221,-144,-131,-112,-28,-772
-217,-59,-252,-484,-417,-286,-454,-21,-2190
-14,-3,-9,-21,-9,-13,-13,-1,-83
-46,15,-33,-106,-59,-58,-43,14,-316
-16,7,-14,-25,-1,-2,-30,-4,-85
-17,-4,-21,-26,-29,-22,-28,-18,-165
-18,14,-4,-25,-28,-26,-10,2,-95
-20,14,-88,-228,-231,-197,-214,-102,-1066
8,30,-62,-102,-139,-99,-124,-111,-599
-49,-21,-69,-107,-63,-39,-91,-26,-465
-38,86,-92,-205,-43,-96,-93,32,-449
-40,4,-54,-221,-177,-139,-156,-15,-798
-38,6,-45,-179,-193,-131,-124,5,-699
-24,-4,-41,-196,-189,-122,-123,-19,-718
24,-33,-42,-95,-77,-101,-84,-54,-462
-14,0,-15,-42,-17,-24,-31,1,-142
19,17,-6,-56,-55,-69,-35,-21,-206
-2,12,-21,-36,-43,-41,-24,3,-152
28,86,-7,-94,-5,-50,-117,23,-136
13,7,-34,-99,-97,-121,-80,-23,-434
2,5,-31,-94,-102,-85,-85,-41,-431
9,-1,-40,-99,-139,-129,-98,-59,-556
-49,-29,-40,-142,-142,-81,-106,26,-563
26,90,-38,-124,25,-42,-31,78,-16
-17,-1,-59,-128,-100,-88,-121,-47,-561
-64,-9,-91,-187,-147,-133,-134,-60,-825
-3,-6,-49,-114,-166,-46,-97,-39,-520
-16,53,-71,-165,-132,-50,-64,28,-417
-21,29,-61,-168,-38,-53,-33,-28,-373
-12,15,-68,-129,-65,-65,-84,-35,-443
-77,-38,-74,-168,-118,-91,-156,-30,-752
-50,4,-81,-129,-107,-116,-131,-60,-670
-90,-23,-75,-151,-117,-85,-119,22,-638
-88,-31,-88,-143,-97,-85,-135,-31,-698
40,42,-40,-121,-132,-200,-146,-76,-633
-84,-64,-82,-150,-135,-84,-120,19,-700
14,21,-16,-19,-73,-25,-41,5,-134
9,35,-44,-112,-121,-146,-93,-67,-539
-45,-2,-33,-68,-55,-29,-33,-10,-275
-2,3,-4,-3,-48,-11,-22,6,-81
16,128,-56,-296,-92,-202,-159,43,-618
-15,7,-42,-108,-41,-70,-89,-3,-361
-9,-16,-19,-55,-46,-57,-72,1,-273
-22,9,-31,-90,-39,-29,-32,-16,-250
28,19,-62,-146,-250,-173,-197,-94,-875
46,29,-44,-141,-192,-184,-181,-87,-754
-5,11,-24,-57,-14,-35,-49,-28,-201
-23,-4,-21,-83,-50,-54,-43,14,-264
1,10,-15,-74,-43,-77,-59,-5,-262
-62,0,-87,-285,-195,-168,-217,-24,-1038
-12,5,-31,-70,-104,-36,-56,-20,-324
-18,-15,-16,-91,-84,-58,-42,-6,-330
-28,22,-32,-77,-48,-27,-56,-5,-251
-31,26,-40,-148,-93,-36,-90,-88,-500
-29,-20,-24,-117,-66,-23,-30,-69,-378
-11,6,-19,-49,-16,1,-10,-11,-109
-10,-9,-16,-32,-28,-6,-23,2,-122
156,102,66,31,62,26,-13,8,438
-7,18,-33,-93,-84,-60,-64,-29,-352
3,-21,-43,-87,-98,-58,-73,-33,-410
10,186,-59,-201,-111,-111,-33,47,-272
-13,7,3,-20,-11,5,0,12,-17
43,107,-8,-61,0,-19,34,68,164
27,30,-44,-76,-41,-74,-41,-49,-268
11,21,-1,-28,-26,-53,-18,-5,-99
-5,-6,4,-19,32,29,-1,25,59
-2,-19,-13,-23,15,-8,1,14,-35
0,-15,-12,-23,17,-7,0,14,-26
-13,-19,-48,-115,-136,-115,-104,-18,-568
-80,15,-79,-177,-130,-103,-127,15,-666
-40,-24,-64,-137,-49,-42,-92,4,-444
-78,-15,-71,-168,-109,-106,-130,-15,-692
-39,46,-71,-184,-105,-125,-144,-17,-639
-85,-38,-68,-142,-117,-83,-124,16,-641
-24,24,-37,-135,-106,-72,-104,23,-431
-37,25,-57,-183,-127,-153,-125,-8,-665
-104,-23,-95,-168,-112,-98,-142,-32,-774
-43,4,-40,-104,-90,-82,-116,15,-456
55,120,21,-49,-50,2,-100,150,149
56,77,0,-89,-87,-44,-68,121,-34
63,21,-4,-12,-24,-70,-36,-11,-73
98,32,35,52,-54,-74,-31,46,104
-70,5,-52,-153,-106,-96,-125,-8,-605
29,-24,-32,-155,-102,-175,-137,-43,-639
-278,-75,-328,-642,-425,-180,-424,84,-2268
-224,-81,-309,-546,-385,-201,-486,-7,-2239
-59,-42,-68,-151,-127,-117,-136,-51,-751
-51,-33,-77,-149,-125,-115,-148,-53,-751
-35,25,-33,-119,-125,-98,-60,-37,-482
-21,54,-84,-249,-149,-157,-238,0,-844
221,303,153,151,163,53,-52,34,1026
4,10,-10,-10,-32,-37,-8,1,-82
7,10,-2,-8,-21,-11,-17,-11,-53
35,20,2,-71,-11,-51,-38,-4,-118
-39,475,-99,-145,9,317,-219,277,576
59,533,-50,-76,82,332,-196,334,1018
-28,42,-10,-94,-109,-57,-60,9,-307
-3,22,-45,-120,-81,-61,-56,-36,-380
262,225,137,-45,47,-221,-191,180,394
-112,-82,-164,-372,-305,-243,-232,-88,-1598
-54,-11,-97,-119,-89,-67,-127,-23,-587
-112,195,-126,-456,-277,-140,-272,-280,-1468
-107,161,-163,-464,-309,-165,-310,-300,-1657
6,102,-41,-250,-162,-188,-176,-50,-759
-45,-5,-91,-170,-229,-93,-152,-14,-799
-66,-63,-86,-180,-269,-169,-177,-120,-1130
-119,-86,-117,-195,-161,-100,-160,1,-937
30,45,-19,-153,-55,-104,-61,21,-296
-2,70,-26,-148,-80,-101,-70,31,-326
4,38,-23,-70,-84,-73,-39,2,-245
-13,12,-36,-47,-30,-26,-39,-3,-182
-68,23,-74,-179,-103,-56,-80,-41,-578
297,264,192,225,224,143,5,160,1510
11,42,7,-42,1,-22,-9,12,0
580,507,99,-130,45,-273,-376,363,815
-19,106,-58,-106,14,3,11,31,-18
-42,203,-45,-132,31,3,85,42,145
-31,41,-111,-340,-410,-257,-295,-3,-1406
62,93,10,-92,2,-119,-80,37,-87
57,80,-7,-166,-47,-135,-90,14,-294
62,135,7,-161,-7,-90,-78,39,-93
115,-10,3,-57,-57,-134,-79,-46,-265
102,89,34,23,-14,-62,-53,48,167
-49,234,-125,-449,-282,-134,-283,-276,-1364
-16,8,-16,-30,-27,-2,-15,-5,-103
-101,44,-60,-153,-63,-15,-84,-58,-490
4,5,-56,-131,-46,-68,-79,-44,-415
-20,20,-27,-66,-82,-58,-38,14,-257
28,77,-111,-226,-52,-161,-147,-165,-757
8,59,-74,-181,-25,-90,-71,43,-331
-28,34,-1,-119,-83,-54,-96,-41,-388
157,230,115,67,65,12,-83,36,599
-67,-27,-101,-191,-178,-108,-163,-58,-893
6,22,-8,-41,-82,-34,-58,-20,-215
-54,72,-151,-349,-301,-312,-214,-37,-1346
-100,119,-144,-368,-257,-152,-187,59,-1030
-23,-29,-21,-108,-131,-75,-66,-43,-496
-34,-3,-43,-156,-113,-77,-154,19,-561
6,14,-19,-62,-54,-51,-76,18,-224
6,8,-56,-128,-181,-150,-115,-45,-661
39,38,-32,-141,-133,-130,-133,-55,-547
-29,5,-24,-100,-60,-34,-66,16,-292
-19,-2,-45,-88,-63,-41,-72,16,-314
66,49,31,-32,-8,-55,-21,-23,7
-17,25,-34,-60,-34,-24,-34,-25,-203
-9,5,-33,-46,-36,-26,-21,-18,-184
-74,13,-74,-155,-166,-128,-122,-81,-787
-12,13,-44,-122,-57,-37,-66,-14,-339
5,64,9,-59,-106,-42,-105,32,-202
-60,-37,-53,-144,-107,-60,-102,-21,-584
-23,12,-36,-59,-88,-49,-71,-5,-319
-12,1,-16,-49,-53,-17,-47,-6,-199
-65,-25,-65,-132,-77,-74,-102,9,-531
18,38,20,-59,-89,-77,-44,-32,-225
-34,8,-36,-107,-78,-53,-61,18,-343
-9,-5,12,-68,-104,-60,-30,-34,-298
17,34,0,-44,5,-10,-15,12,-1
-30,67,-67,-218,-245,-173,-175,-79,-920
13,2,-31,-97,-154,-73,-84,13,-411
-28,-16,-50,-86,-47,-26,-43,-33,-329
-79,19,-114,-250,-168,-116,-157,75,-790
-62,15,-81,-142,-128,-91,-99,-8,-596
-46,-17,-67,-130,-139,-100,-107,-29,-635
-45,8,-62,-139,-147,-83,-114,-24,-606
-20,63,-25,-165,-89,-109,-58,14,-389
19,38,-16,-67,-14,-49,-77,-11,-177
-29,34,-72,-97,-35,-16,-37,3,-249
-14,-11,-19,-16,-29,-22,-23,4,-130
-15,35,-55,-132,-62,-79,-75,-27,-410
149,160,-78,-290,-155,-370,-332,-97,-1013
28,-24,-2,-95,-115,-60,-70,-1,-339
-6,27,-6,-47,-106,-24,-55,7,-210
-22,16,-36,-70,4,4,-28,38,-94
-42,48,-60,-164,-101,-90,-122,-37,-568
-60,-3,-61,-133,-112,-64,-112,-34,-579
-36,6,-67,-105,-88,-78,-83,-47,-498
13,29,-50,-143,-39,-110,-111,66,-345
7,6,-5,-14,-23,-7,-13,-15,-64
-61,34,-82,-175,-108,-90,-84,-43,-609
117,110,27,-55,-30,-68,-133,3,-29
-34,21,-57,-145,-76,-57,-73,-5,-426
-13,5,-8,-35,-31,-17,-20,-1,-120
-46,-23,-55,-111,-97,-85,-91,-20,-528
57,234,-49,-177,38,-48,-17,148,186
-77,-24,-71,-160,-148,-118,-135,-9,-742
-38,-26,-36,-112,-129,-77,-96,25,-489
13,4,-3,-15,-26,-22,-12,-4,-65
-2,4,-45,-68,-101,-47,-71,-55,-385
29,19,11,25,-32,17,2,10,81
-25,2,-4,-71,-62,-34,-36,-43,-273
164,102,97,47,74,-64,-51,94,463
2,393,-148,-461,-27,-194,-56,160,-331
-55,-36,-60,-86,-94,-54,-48,-18,-451
23,126,-17,-111,-34,-67,-14,42,-52
-96,-22,-120,-266,-113,-190,-168,-50,-1025
-29,-20,-48,-89,-77,-49,-50,18,-344
-80,-18,-65,-135,-101,-51,-115,13,-552
-42,95,-102,-285,-275,-209,-194,-1,-1013
-26,6,-61,-71,-55,-42,-80,0,-329
-24,22,-25,-121,-139,-36,-113,13,-423
35,45,-28,-86,-193,-83,-48,-29,-387
-45,-15,-10,-107,-136,-60,-68,2,-439
14,95,-57,-250,-226,-262,-161,-62,-909
22,37,18,-30,-3,-35,-1,-2,6
16,13,14,-8,-26,-26,-6,-9,-32
-43,9,2,-101,-75,-7,-33,2,-246
397,265,161,-57,119,-58,-128,100,799
665,295,259,-2,181,-147,-227,134,1158
-70,-12,-123,-273,-174,-147,-181,-22,-1002
-12,-14,-16,-43,-55,-34,-52,-29,-255
-2,-3,-44,-116,-109,-60,-67,43,-358
12,82,-24,-39,9,1,38,23,102
-13,24,-39,-96,-65,-57,-54,-37,-337
-16,0,-14,-6,-10,0,-28,-8,-82
188,238,-4,-316,-81,-264,-199,-1,-439
3,-34,-26,-80,-54,-38,-46,16,-259
7,9,-13,-43,-52,-58,-35,-8,-193
22,16,-30,-49,-76,-50,-25,-14,-206
4,34,-34,-105,-64,-49,-89,19,-284
-21,-3,-23,-124,-42,-92,-96,-27,-428
-107,9,-176,-382,-273,-235,-314,-73,-1551
-28,42,-73,-203,-115,-81,-119,98,-479
23,59,-94,-222,-43,-147,-153,-114,-691
1,13,-30,-50,-59,-46,-55,-13,-239
-3,15,-27,-66,-35,-25,-47,48,-140
-32,37,-61,-167,-48,-47,-87,99,-306
4,18,-2,-24,-6,-13,-2,-11,-36
15,107,1,-130,-6,-41,-52,-41,-147
12,78,-34,-168,3,-100,-114,-42,-365
-48,28,-44,-128,-166,-85,-117,-87,-647
-13,25,-47,-176,-84,-159,-121,-13,-588
-13,20,-27,-55,-38,-32,-23,2,-166
-18,24,-55,-100,-47,-59,-52,-15,-322
12,10,-11,-8,-66,-44,-61,-8,-176
19,21,-6,-63,-89,-36,-45,-27,-226
-2,39,-13,-47,-57,-27,-49,33,-123
8,27,-3,-51,-24,-28,0,25,-46
-23,47,-23,-89,-106,15,-45,13,-211
44,41,11,-12,-76,-89,-58,17,-122
66,72,34,10,-25,-61,-52,26,70
49,37,9,-5,-34,-79,-56,8,-71
-25,-6,-9,-69,-45,-28,-34,-22,-238
-26,18,-16,-48,-48,-14,-38,8,-164
-31,19,-16,-70,-34,-1,-28,0,-161
-59,40,-97,-218,-156,-134,-120,3,-741
-57,18,-77,-236,-107,-97,-148,-20,-724
-25,99,-50,-261,-79,-107,-63,-41,-527
47,51,-32,-49,-3,-42,-32,-28,-88
-122,-35,-139,-262,-233,-96,-171,-7,-1065
-1,13,-23,-50,-60,-14,-71,-2,-208
-2,12,-35,-82,-98,-27,-50,-29,-311
-47,5,-47,-62,-39,-30,-39,-4,-263
-37,7,-35,-113,-70,-58,-85,-29,-420
-51,7,-48,-122,-91,-89,-76,-51,-521
-22,54,-61,-172,-188,-87,-117,-44,-637
30,59,-2,-159,-91,-77,-126,37,-329
-52,43,-90,-222,-170,-194,-181,-46,-912
-43,21,-40,-118,-130,-50,-87,-24,-471
4,19,-24,-41,-39,-49,-32,-23,-185
-49,-37,-76,-116,-143,-117,-130,-19,-687
-79,-49,-77,-142,-126,-80,-114,25,-642
-76,-34,-81,-149,-135,-99,-112,-26,-712
-17,26,-28,-66,-30,-45,-47,-20,-227
94,5,23,-50,34,-28,-58,58,78
46,38,32,-85,24,-55,-20,61,41
-101,0,-179,-344,-235,-152,-216,28,-1199
-25,-2,-45,-74,-104,-84,-98,-53,-485
-27,-4,-50,-169,-56,-154,-98,24,-534
-8,30,-17,-36,-16,11,0,-3,-39
-51,-19,-24,-147,-14,-96,-54,7,-398
-26,56,-50,-176,-71,-90,-102,-25,-484
-47,18,-36,-95,-45,-44,-59,16,-292
-16,14,-8,-83,-28,-8,-25,9,-145
5,67,-34,-149,-94,-118,-98,-90,-511
-10,16,-23,-45,-11,-14,-16,-3,-106
-14,20,-9,-33,-92,-53,-71,-3,-255
16,17,-3,-12,-16,-29,-51,-1,-79
-31,3,-23,-47,-32,-24,-16,-22,-192
153,32,49,24,-68,-136,-80,-37,-63
1,0,-113,-248,-260,-236,-220,-141,-1217
-1,9,-15,-26,-34,-53,-27,-9,-156
-61,67,-170,-438,-273,-340,-244,-183,-1642
-55,-21,-60,-149,-138,-132,-119,-24,-698
-13,18,-27,-113,-101,-95,-94,-10,-435
15,41,-6,-17,-21,-23,-12,18,-5
-44,-24,-35,-87,-53,-68,-50,-9,-370
-10,12,-27,-104,-93,-64,-70,-29,-385
-12,2,-42,-70,-68,-39,-59,-38,-326
-16,-6,-63,-153,-159,-95,-127,-34,-653
-145,-26,-134,-381,-241,-180,-231,-40,-1378
8,22,-14,-21,-11,-23,-17,7,-49
24,8,-49,-68,-78,-102,-70,-55,-390
-38,16,-76,-128,-78,-100,-69,-32,-505
-10,20,-33,-12,-22,-37,-40,-5,-139
-38,-10,-128,-190,-160,-194,-169,-50,-939
0,0,-11,-12,-32,-5,-17,-4,-81
-61,-11,-68,-129,-101,-63,-132,52,-513
-103,10,-116,-174,-82,-103,-142,-14,-724
-41,80,-110,-256,-272,-220,-221,65,-975
-96,-9,-99,-196,-138,-89,-119,-6,-752
-89,-12,-88,-155,-110,-30,-116,-20,-620
-50,5,-46,-62,-68,-31,-93,-13,-358
-30,22,-2,-125,-77,-43,-71,39,-287
-94,-48,-99,-146,-122,-72,-127,-5,-713
-9,45,-47,-151,-29,-92,-84,-24,-391
-24,-10,-20,-81,-101,-47,-48,-15,-346
-52,36,-43,-110,-31,-43,-46,23,-266
4,-7,-27,-68,-102,-84,-78,-45,-407
-23,8,-19,-55,-23,-32,-30,-7,-181
33,120,-31,-186,-75,-129,-82,11,-339
2,69,7,-142,-52,-78,-24,32,-186
-79,26,-109,-258,-74,-93,-121,-32,-740
13,84,-76,-244,-66,-149,-150,-53,-641
-22,-5,-60,-192,-132,-149,-120,-21,-701
-48,4,-76,-147,-211,-104,-159,30,-711
-61,29,-78,-184,-202,-72,-163,54,-677
-47,-32,-56,-145,-202,-115,-165,44,-718
-93,13,-91,-264,-243,-97,-169,-40,-984
-27,-15,-32,-75,-56,-56,-48,-12,-321
-1,56,-27,-152,-54,-92,-70,12,-328
-177,-30,-184,-332,-203,-163,-218,-121,-1428
-146,-36,-176,-326,-206,-161,-187,-93,-1331
-217,-53,-325,-764,-677,-610,-700,-355,-3701
-168,-15,-285,-573,-459,-447,-498,-129,-2574
-35,-6,-66,-180,-195,-137,-128,-77,-824
58,128,-40,-174,19,-109,-101,34,-185
24,136,-52,-116,37,-79,-56,100,-6
-17,28,-20,-47,-51,-26,-27,13,-147
-4,36,-50,-122,-72,-94,-95,-59,-460
-49,7,-42,-195,-141,-86,-126,53,-579
-18,8,-12,-41,-8,-1,-4,7,-69
-16,31,-54,-128,-126,-115,-80,-55,-543
-25,2,-50,-142,-76,-55,-56,29,-373
-55,-2,-59,-149,-112,-95,-93,-7,-572
99,120,-15,-203,-104,-182,-148,15,-418
-29,-14,-75,-115,-110,-91,-77,-28,-539
26,61,-122,-531,-92,-310,-246,6,-1208
-173,53,-248,-506,-337,-299,-327,-35,-1872
-35,63,4,-103,-43,-5,4,21,-94
6,53,-16,-101,-63,-126,-128,40,-335
-120,12,-135,-291,-143,-91,-68,146,-690
-92,47,-233,-421,-329,-285,-336,-189,-1838
24,37,-7,-47,-117,-64,-55,-25,-254
-23,4,2,-42,-13,-13,-13,-11,-109
128,13,52,-56,31,-100,-35,2,35
28,2,-1,-19,-74,-72,-35,-46,-217
22,19,0,-16,-49,-54,-18,-47,-143
17,11,-24,-27,-45,-38,-22,-49,-177
-7,10,-53,-83,-88,-93,-115,-18,-447
-9,12,-25,-35,-20,-24,-30,-19,-150
-13,-5,-16,-49,-23,-14,-18,12,-126
-233,158,-445,-1051,-656,-825,-810,-204,-4066
-18,-19,-52,-136,-118,-105,-118,-13,-579
-31,-7,-72,-171,-117,-81,-103,-28,-610
-74,-34,-82,-176,-172,-86,-130,-33,-787
-83,21,-115,-193,-189,-109,-183,-55,-906
-87,-13,-97,-169,-171,-89,-151,-20,-797
-7,16,-125,-149,-174,-123,-167,-52,-781
44,22,-7,-113,-43,-86,-60,-27,-270
-35,34,-21,-68,-91,-26,-51,7,-251
9,13,-8,-38,-26,-15,-21,-4,-90
-83,-4,-87,-143,-115,-93,-142,-44,-711
-50,7,-48,-113,-103,-101,-136,-35,-579
-48,24,-58,-145,-132,-136,-120,-22,-637
7,8,-63,-108,-105,-123,-127,-54,-565
-18,88,-48,-200,-58,-100,-55,25,-366
1,82,19,-358,-141,-173,-196,214,-552
-41,-21,-51,-135,-119,-97,-133,-16,-613
-2,9,-10,-55,-20,-18,-46,27,-115
-80,-27,-105,-153,-103,-106,-162,-33,-769
1,-3,-9,-22,-59,-64,-44,14,-186
-5,16,-34,-11,-32,-15,-32,-3,-116
66,151,-2,-114,-11,-89,-44,37,-6
-27,30,-88,-205,-195,-83,-155,-38,-761
-34,24,-57,-169,-70,-69,-62,-53,-490
-35,-37,-45,-138,-121,-81,-108,4,-561
74,16,22,-35,24,-46,-47,41,49
-22,-13,-49,-157,-234,-136,-142,-44,-797
-7,19,-28,-79,-45,-29,-4,38,-135
-1,3,-14,-33,-40,-40,-30,5,-150
1,16,-9,-12,-1,8,-3,28,28
34,42,5,-70,-81,-70,-55,10,-185
-1,22,-30,-98,-100,-70,-77,-14,-368
24,27,-19,-113,9,-82,-74,64,-164
1,26,-27,-91,-63,-66,-53,-7,-280
5,18,-37,-102,-57,-58,-67,-13,-311
19,24,-41,-79,-42,-58,-60,-16,-253
23,23,-23,-66,-59,-64,-42,10,-198
21,19,-2,-25,3,-14,-20,4,-14
13,23,-42,-77,-42,-48,-52,-9,-234
9,39,-21,-81,-45,-73,-51,-3,-226
6,35,-18,-44,-39,-43,-35,26,-112
29,47,-38,-92,-46,-85,-62,45,-202
15,48,-25,-96,-75,-54,-40,26,-201
11,23,-33,-94,-53,-58,-54,-2,-260
18,23,-19,-72,-50,-66,-46,-2,-214
-54,-29,-54,-176,-109,-85,-73,-1,-581
2,-5,-56,-116,-132,-142,-140,-72,-661
4,16,-45,-93,-88,-70,-87,-33,-396
-6,24,-13,-30,-25,-4,-11,-20,-85
40,46,9,-49,-5,-16,-52,4,-23
-33,21,-57,-109,-76,-25,-54,-1,-334
-7,29,-27,-86,-28,-53,-59,42,-189
-3,29,-34,-80,-37,-51,-63,42,-197
-9,29,-26,-78,-26,-38,-62,44,-166
0,9,9,-85,-56,-53,-86,71,-191
-2,26,-11,-112,-62,-64,-86,71,-240
5,34,-23,-52,-16,-25,-54,43,-88
11,29,-21,-59,-14,-23,-52,48,-81
-97,-25,-106,-190,-75,-49,-76,-40,-658
-106,-31,-86,-142,-94,-40,-106,37,-568
-37,-20,-80,-204,-112,-146,-163,5,-757
-29,5,-27,-109,-109,-47,-56,-9,-381
149,93,43,61,-35,-123,-65,30,153
111,31,68,47,-33,-84,-57,3,86
4,58,-30,-63,-46,-47,-72,-11,-207
-13,29,7,-43,-30,-8,-1,-34,-93
-18,46,-3,-50,-34,-5,-13,0,-77
-43,-25,-38,-84,-77,-36,-64,-31,-398
5,-26,-23,-89,-79,-34,-72,5,-313
-63,23,-102,-205,-151,-122,-181,-34,-835
-1,18,-9,-26,-44,19,-27,5,-65
14,62,-4,-9,-43,-6,-27,10,-3
8,36,-45,-78,-105,-50,-77,-11,-322
-5,28,-13,-28,-15,-2,13,-7,-29
-5,37,-12,-154,-121,-76,-112,9,-434
-35,-2,-59,-118,-98,-73,-72,-15,-472
-40,-16,-40,-113,-109,-72,-66,-14,-470
-8,10,-35,-89,-52,-62,-56,14,-278
56,566,53,-693,-202,-383,33,53,-517
-106,61,-143,-314,-261,-249,-265,-27,-1304
-92,33,-133,-317,-260,-272,-291,-47,-1379
-58,-26,-120,-196,-184,-70,-155,42,-767
63,77,-83,-121,-86,-80,-68,-67,-365
-49,15,-62,-136,-138,-74,-99,-12,-555
87,126,-21,-146,-66,-91,-25,32,-104
-33,-6,-74,-115,-130,-117,-139,-60,-674
-106,-51,-114,-164,-106,-85,-149,-27,-802
25,24,-62,-119,-123,-138,-121,-67,-581
-58,-40,-65,-96,-112,-99,-123,-41,-634
-113,-56,-104,-183,-103,-111,-147,-17,-834
-5,6,-78,-109,-147,-138,-143,-62,-676
-99,-21,-101,-210,-99,-108,-132,-8,-778
-55,485,-88,-504,-118,-154,16,251,-167
43,22,4,-51,-24,-35,-14,37,-18
28,0,-1,-46,-19,-41,-7,28,-58
-49,24,-56,-162,-192,-83,-92,-26,-636
194,65,46,-169,-29,-215,-212,61,-259
-24,-5,-48,-74,-34,-26,-50,-42,-303
-23,36,-71,-177,-166,-82,-101,-37,-621
35,17,0,-5,9,-29,9,6,42
244,435,14,-75,43,-31,-408,37,259
6,26,-42,-82,-96,-86,-72,-35,-381
-78,-53,-101,-168,-135,-95,-117,-50,-797
15,-2,-14,-59,-26,-49,-27,4,-158
-148,37,-162,-221,-154,-53,-186,-9,-896
-20,3,-22,-83,-58,-51,-54,9,-276
-43,-7,-17,-87,-65,-42,-75,14,-322
-13,5,2,-22,-17,-10,-8,3,-60
-14,-28,-3,-22,-67,-23,-23,13,-167
-27,5,-3,-48,-34,11,-2,8,-90
-20,-2,-3,-50,-45,-31,-16,23,-144
-24,5,2,-60,-42,-38,-40,-24,-221
-11,-16,-17,-45,-84,-45,-31,-16,-265
3,10,-2,-34,-25,-40,-5,-17,-110
146,415,-55,-416,-82,-202,-88,315,33
-24,-28,-27,-50,-59,-22,-41,-1,-252
21,141,-44,-281,-92,-192,-137,138,-446
107,67,18,-49,17,-66,-55,46,85
-290,214,-380,-1043,-590,-586,-652,-385,-3712
-78,-21,-204,-341,-357,-269,-299,-141,-1710
-1,24,-20,-86,-58,-58,-48,-2,-249
-19,-2,-42,-79,-49,-63,-79,-9,-342
-128,-70,-106,-201,-241,-140,-222,17,-1091
-68,-20,-93,-139,-101,-84,-104,2,-607
-6,13,-12,-27,-19,-17,-20,8,-80
0,-3,-12,-42,-8,-35,-20,0,-120
-41,-14,-57,-167,-104,-92,-89,64,-500
40,73,1,-137,-43,-41,-83,72,-118
-23,-21,-15,-53,-70,-8,-21,-2,-213
-8,26,-20,-59,-32,-41,-46,0,-180
-76,-32,-88,-147,-139,-117,-142,-41,-782
-28,2,-54,-88,-70,-86,-100,-49,-473
7,24,-5,-13,-29,-3,6,3,-10
-38,-35,-42,-99,-106,-49,-92,20,-441
-64,-59,-49,-145,-146,-91,-104,20,-638
-54,-14,-73,-141,-85,-112,-145,-59,-683
-78,-5,-95,-184,-112,-102,-136,-24,-736
-6,4,-8,-42,-27,-14,-17,-2,-112
-58,-15,-47,-122,-116,-77,-114,-23,-572
-37,24,-48,-121,-84,-80,-131,-20,-497
-81,-19,-93,-129,-79,-86,-132,-29,-648
-72,-19,-80,-148,-89,-86,-137,-39,-670
-40,-4,-33,-111,-98,-67,-121,-21,-495
-82,-5,-84,-138,-74,-70,-137,-18,-608
-41,-1,-44,-125,-102,-72,-119,-33,-537
0,0,-54,-99,-133,-52,-63,-44,-445
-45,-38,-82,-178,-179,-111,-150,-96,-879
-59,-17,-74,-154,-108,-111,-114,-27,-664
-82,-27,-88,-125,-136,-91,-131,3,-677
-40,7,-44,-173,-101,-132,-134,-58,-675
72,-17,32,6,10,-45,-49,13,22
6,-4,11,-1,-35,-23,1,-12,-57
29,-2,-15,-23,-24,-59,-38,-29,-161
3,13,1,-45,-28,-22,2,14,-62
-14,20,-10,-6,-22,-3,-16,-11,-62
14,37,-47,-102,-70,-72,-63,-52,-355
130,67,9,-34,14,-160,-125,3,-96
-1,11,-22,-55,-67,-55,-39,14,-214
-38,56,-65,-282,-252,-146,-206,-26,-959
-14,18,-9,-44,-37,-36,-28,3,-147
7,6,-24,-80,10,-45,-61,20,-167
-87,-56,-133,-141,-188,-84,-213,-31,-933
-88,-58,-98,-139,-142,-100,-125,1,-749
-14,21,-19,-75,-44,-37,-36,-3,-207
-74,-27,-59,-131,-113,-53,-90,5,-542
-6,3,-31,-92,-110,-71,-90,7,-390
-61,1,-57,-135,-98,-49,-87,19,-467
-7,16,-28,-67,-72,-47,-65,18,-252
-65,-17,-81,-196,-217,-111,-196,24,-859
-25,0,-54,-64,-60,-27,-32,-43,-305
-18,-33,-28,-52,-51,-13,-69,26,-238
-23,-13,-17,-39,-17,-18,-12,-13,-152
-79,-24,-141,-195,-141,-71,-181,-4,-836
-87,-21,-131,-144,-209,-90,-173,-36,-891
-63,-53,-117,-163,-190,-115,-198,-11,-910
-49,-40,-89,-132,-150,-127,-134,-48,-769
-47,-23,-67,-130,-89,-100,-107,-17,-580
-38,-25,-65,-105,-169,-70,-98,3,-567
-23,-16,-65,-150,-140,-87,-87,-40,-608
-34,32,-41,-137,-61,-37,-78,-4,-360
-48,-19,-56,-153,-96,-37,-76,-2,-487
-13,-3,-16,-122,-93,-69,-88,74,-330
-23,68,-87,-236,-184,-112,-118,-12,-704
0,2,-23,-27,-64,-20,-49,4,-177
-16,20,-40,-40,-41,-9,-72,-22,-220
-3,24,-12,0,0,-23,-17,32,1
-12,-18,-13,-15,-18,-14,-11,9,-92
-170,43,-157,-366,-97,-151,-161,128,-931
32,8,-50,-114,-131,-188,-155,3,-595
6,69,-4,-129,-109,-124,-143,39,-395
85,89,40,-78,-59,-109,-42,-12,-86
-39,-10,-22,-83,-61,-51,-60,8,-318
74,51,49,46,3,-37,-29,42,199
109,17,36,-36,47,-48,-53,68,140
17,39,-24,-97,-77,-82,-67,-1,-292
-13,36,-18,-116,-90,-37,-62,3,-297
-17,1,-21,-78,-49,-26,-62,21,-231
-10,-28,-67,-157,-165,-190,-147,-106,-870
-40,-15,-37,-133,-107,-66,-81,-5,-484
-54,-4,-56,-160,-98,-74,-100,1,-545
-23,13,-34,-89,-63,-70,-44,-14,-324
-54,-8,-60,-81,-99,-59,-106,-44,-511
15,15,12,8,-2,4,11,7,70
-32,11,-43,-100,-102,-61,-56,-2,-385
-63,-3,-92,-171,-133,-160,-145,-79,-846
-36,-47,-52,-124,-121,-110,-111,17,-584
-32,21,-46,-125,-65,-49,-77,24,-349
-41,49,-67,-153,-42,-58,-85,74,-323
89,279,-86,-220,60,-185,-97,52,-108
-99,74,-154,-381,-240,-237,-262,2,-1297
-7,7,-46,-82,-81,-77,-63,-39,-388
-28,11,-47,-96,-59,-20,-49,2,-286
-37,19,-66,-87,-70,-37,-66,-13,-357
713,273,331,-240,459,-229,-167,281,1421
4,1,-62,-104,-125,-115,-79,-59,-539
-32,12,-35,-110,-170,-71,-108,-69,-583
-8,18,-30,-63,-19,-39,-24,-8,-173
-117,-71,-95,-169,-165,-92,-154,-1,-864
-59,20,-83,-206,-180,-133,-175,-42,-858
71,129,84,-15,-69,-63,-104,-16,17
285,399,-22,-324,22,-194,-74,-95,-3
-8,21,-58,-134,-78,-48,-65,-15,-385
-3,36,-18,-104,-100,-77,-90,-33,-389
-20,-3,-18,-80,-77,-46,-42,-10,-296
-21,23,-5,-126,-81,-82,-49,-5,-346
-32,-25,-16,-82,-131,-48,-47,-16,-397
-138,-25,-153,-324,-257,-158,-211,-102,-1368
-31,-14,-17,-49,-48,-25,-30,-7,-221
-78,31,-43,-111,-76,-35,-82,55,-339
24,-1,-9,-55,-120,-45,-48,-25,-279
64,37,17,-57,-6,-51,-57,29,-24
-35,61,-32,-84,-9,-10,-46,8,-147
-35,60,-124,-439,-181,-302,-275,-69,-1365
-97,4,-126,-320,-229,-162,-216,-2,-1148
-41,25,-71,-127,-43,-54,-62,-9,-382
-6,16,-3,-42,-15,-14,-17,-23,-104
-45,82,-112,-185,-102,-90,-197,2,-647
-131,3,-169,-275,-170,-149,-234,-50,-1175
15,12,-16,-132,-46,-91,-89,2,-345
77,57,19,20,13,1,24,22,233
-92,-38,-95,-172,-101,-89,-112,-17,-716
83,58,-39,-84,19,-78,-70,33,-78
-5,46,-19,-82,-43,-47,-48,14,-184
-56,19,-54,-173,-151,-106,-119,5,-635
-34,-24,-30,-114,-60,-67,-76,-17,-422
-81,-25,-88,-133,-114,-80,-118,-20,-659
-3,15,-49,-99,-72,-75,-93,-24,-400
2,12,-4,-75,-129,-20,-79,-10,-303
-68,-18,-78,-140,-147,-67,-137,-7,-662
-18,2,10,-34,-32,-28,-16,15,-101
-42,26,-62,-155,-89,-52,-110,43,-441
-5,2,-19,-22,9,1,-16,-11,-61
-72,-39,-98,-139,-108,-60,-112,-12,-640
30,16,26,-36,-69,-33,-35,13,-88
-8,5,-18,-92,-69,-26,-62,32,-238
-43,1,-124,-185,-171,-153,-196,-99,-970
-50,-3,-117,-164,-171,-94,-173,-9,-781
-67,-75,-92,-126,-154,-111,-123,-27,-775
98,136,-28,-46,-89,-23,-8,1,41
-35,-6,-43,-131,-114,-39,-76,0,-444
25,150,-204,-622,-605,-584,-474,-214,-2528
17,47,-6,-55,-2,-82,-63,22,-122
-10,-15,-14,-93,-54,-53,-75,-11,-325
-12,-40,-53,-78,-75,-86,-54,-22,-420
-19,-12,-65,-98,-74,-86,-98,-36,-488
-2,13,-25,-68,-82,-54,-55,-9,-282
-52,10,-40,-142,-174,-101,-101,-30,-630
-23,-15,-16,-79,-47,-31,-22,-1,-234
-47,1,-39,-107,-63,-46,-45,-1,-347
-18,25,-26,-124,-135,-49,-82,-52,-461
86,60,-4,-97,-80,-83,-75,16,-177
-9,14,-17,-72,-166,-37,-95,-22,-404
2,-6,-2,-33,-15,-21,-11,29,-57
5,26,-49,-89,-81,-46,-53,-8,-295
-18,3,-75,-80,-77,-67,-89,-45,-448
-19,6,-8,-88,-140,-56,-86,-6,-397
-1,3,-4,-45,-30,-48,-19,-6,-150
-151,742,-308,-1046,-18,-240,-512,-359,-1892
-11,-12,4,-19,-19,-9,-14,-6,-86
3,-6,-2,-32,4,-20,-13,24,-42
-3,-1,9,-85,-78,-52,-23,49,-184
17,20,-61,-155,-272,-133,-174,-79,-837
-19,34,-61,-159,-95,-89,-122,-60,-571
-32,27,-52,-140,-126,-64,-84,-42,-513
-45,11,-43,-123,-115,-56,-53,-22,-446
38,25,-23,-83,-103,-117,-47,-52,-362
-41,23,-64,-158,-80,-99,-99,-2,-520
-22,-14,-57,-101,-86,-64,-63,-24,-431
34,33,25,1,15,-30,-46,64,96
89,38,40,-5,-19,-102,-75,15,-19
-14,25,-56,-283,-200,-244,-202,-17,-991
-60,-15,-56,-128,-60,-43,-59,1,-420
-34,34,-77,-151,-24,-47,-71,-35,-405
-34,9,-48,-104,-72,-46,-46,-30,-371
-6,4,-13,-110,-88,-92,-36,-8,-349
1,17,-19,-72,-66,-59,-45,-28,-271
-26,10,-92,-132,-128,-138,-126,-60,-692
-67,-55,-78,-166,-139,-113,-150,-54,-822
-89,-30,-86,-154,-119,-99,-119,-2,-698
2,17,-13,-46,-63,-30,-31,-31,-195
-29,64,12,-96,-53,-27,-22,69,-82
108,14,20,-1,2,-80,-51,-25,-13
74,9,-3,-46,-7,-62,-47,-10,-92
-12,-9,-9,-35,-55,-24,-46,-9,-199
-12,-10,-36,-46,-76,-48,-53,-24,-305
-18,12,-65,-203,-190,-140,-123,8,-719
81,86,29,-34,-30,-48,-110,92,66
70,47,54,26,-45,-28,-33,95,186
54,64,-46,-107,-175,-103,-107,-65,-485
421,139,238,-326,164,-346,-165,241,366
0,28,-34,-122,-110,-77,-84,-55,-454
-106,19,-155,-270,-182,-101,-144,-35,-974
-30,3,-48,-74,-50,-36,-48,-28,-311
-59,96,-34,-219,-98,-60,14,-110,-470
98,19,20,-73,-94,-85,-73,22,-166
-34,-24,-27,-102,-102,-50,-60,-5,-404
-87,13,-31,-121,-110,-120,-80,23,-513
-77,-7,-23,-154,-159,-130,-63,62,-551
-47,36,-21,-173,-126,-189,-87,4,-603
-12,20,-3,-61,-8,-44,-19,14,-113
34,11,-1,-23,-34,-42,-50,5,-100
-18,19,-40,-59,-43,-27,-48,-5,-221
-70,-37,-84,-158,-150,-95,-135,-15,-744
-25,7,-40,-100,-97,-81,-71,-22,-429
-26,15,-48,-116,-12,-73,-56,-37,-353
-11,-7,-14,-22,-47,-14,-18,1,-132
-17,1,-42,-93,-34,-72,-49,-9,-315
-12,-5,-5,-38,-28,-1,-21,12,-98
328,485,93,-126,145,-85,-76,395,1159
136,409,-139,-555,-192,-198,-274,213,-600
-3,11,-21,-40,-37,-63,-30,-8,-191
77,194,-29,-285,-74,-214,-123,-17,-471
-30,20,-37,-44,-24,-28,-33,-12,-188
-33,-8,-14,-136,-60,-59,-66,-5,-381
-75,-16,-82,-156,-91,-79,-131,-14,-644
-98,107,-212,-589,-353,-452,-412,-62,-2071
10,35,-8,-96,-118,-33,-64,-1,-275
31,50,15,-98,-68,-66,-82,2,-216
-19,-18,-23,-127,-89,-65,-64,6,-399
-4,15,14,-106,-91,-79,-66,-7,-324
26,33,-44,-154,-78,-129,-128,-7,-481
-3,31,-1,-55,-9,-29,-49,7,-108
-22,18,-4,-59,-45,3,-50,14,-145
-55,-17,-36,-72,-24,0,-29,10,-223
-6,21,-5,-15,23,2,5,4,29
-29,1,-40,-128,-106,-72,-98,-1,-473
-16,-11,-26,-79,-106,-54,-73,-37,-402
-45,70,-57,-132,-63,-64,-41,-11,-343
-8,15,-18,-55,-21,-23,-20,-17,-147
-13,16,-4,-51,-22,-18,-18,23,-87
-67,30,-71,-220,-150,-66,-115,-17,-676
-19,43,-67,-218,-152,-118,-135,-56,-722
-112,-6,-100,-213,-187,-110,-176,-33,-937
76,-16,-12,-36,-71,-100,-65,5,-219
-19,55,-18,-158,-95,-77,-57,64,-305
-55,-8,-74,-126,-104,-50,-84,1,-500
-75,-44,-86,-154,-110,-80,-112,-9,-670
-5,14,-23,-70,-86,-52,-35,5,-252
-4,13,-5,-11,-24,6,-6,7,-24
-39,21,-47,-84,-48,-23,-57,-9,-286
-59,-39,-37,-87,-102,-56,-55,-30,-465
-1,-6,-1,-9,-13,-10,-10,2,-48
11,5,-3,-10,-8,-22,-13,-4,-44
2,-9,-15,-55,-109,-26,-45,-22,-279
139,53,36,34,-43,-112,-50,-41,16
36,20,26,-19,1,-35,-23,16,22
22,72,-3,-45,-22,-85,-48,5,-104
-12,-6,-30,-59,-39,-33,-53,-5,-237
-12,-12,-34,-64,-46,-44,-55,-9,-276
1,17,-1,-5,-4,-8,-5,-9,-14
46,-21,-2,-57,-64,-55,-63,22,-194
6,47,-57,-174,-130,-151,-114,-71,-644
-93,-17,-101,-169,-91,-91,-139,-43,-744
-59,-5,-58,-135,-93,-42,-76,-4,-472
26,35,-9,-44,-28,-62,-45,48,-79
-6,2,-76,-160,-85,-151,-148,-73,-697
-73,-23,-57,-181,-194,-148,-167,-9,-852
-49,-49,-21,-100,-132,-70,-61,1,-481
-120,-2,-139,-261,-193,-128,-204,-33,-1080
-27,-13,-38,-71,-79,-37,-52,-10,-327
-32,0,-38,-106,-80,-54,-79,-31,-420
-19,17,-41,-86,-93,-71,-86,-61,-440
22,35,-16,-78,-69,-103,-60,-34,-303
9,27,12,-7,-13,-3,-11,11,25
41,38,0,-47,-9,-70,-60,-7,-114
40,14,13,-1,-47,-33,-35,-23,-72
-16,49,-5,-78,-26,-63,-41,14,-166
75,23,-43,-51,-145,-151,-128,-104,-524
138,35,43,-73,40,-71,-67,48,93
51,-8,3,-64,7,-51,-33,59,-36
103,19,56,-16,-6,-87,-21,16,64
72,22,4,-32,-13,-55,-13,16,1
-34,-8,-65,-274,-146,-128,-136,-11,-802
9,29,14,-73,-93,-33,-26,-10,-183
-6,5,-24,-30,-36,-17,-31,-20,-159
-37,5,-42,-61,-50,-36,-56,31,-246
42,74,-5,-76,-94,-69,-23,61,-90
-11,13,-33,-102,-64,-64,-51,-41,-353
58,25,-3,-42,41,0,-1,71,149
-43,47,-91,-206,-106,-109,-117,-4,-629
-303,71,-458,-805,-454,-407,-591,-295,-3242
-38,21,-9,-103,-22,-28,-46,22,-203
-31,6,-25,-131,-68,-68,-91,-31,-439
-118,111,-340,-734,-548,-492,-550,17,-2654
-49,-11,-45,-79,-65,-45,-75,-42,-411
38,101,3,-114,-65,-131,-99,9,-258
-7,-5,-37,-68,-67,-33,-59,-6,-282
34,-30,19,10,-82,-18,-16,-23,-106
-12,7,-53,-88,-170,-85,-112,-44,-557
-39,22,-46,-155,-193,-117,-125,-65,-718
-38,18,-126,-282,-291,-155,-177,-66,-1117
77,21,30,-37,-41,-85,-69,28,-76
-14,49,-82,-214,-94,-95,-130,-1,-581
-2,68,0,-97,-111,-52,-32,51,-175
69,97,49,-105,-39,-74,-51,63,9
-5,26,-18,-72,-65,-81,-50,-23,-288
20,3,-18,-13,-58,-37,-25,-10,-138
-7,-16,-16,-38,-48,-21,-35,3,-178
-6,-1,-15,-37,-41,-38,-19,9,-148
-22,22,-30,-46,-43,-20,-33,-11,-183
-17,10,-22,-60,-45,-12,-29,17,-158
-1,12,-25,-46,-62,-31,-32,-5,-190
-104,-30,-79,-207,-170,-69,-143,-48,-850
7,28,6,-15,-13,16,-6,31,54
-4,-14,-24,-52,-19,-35,-39,1,-186
-43,-19,-95,-141,-87,-97,-126,11,-597
-53,-4,-81,-157,-91,-98,-126,7,-603
30,93,-37,-205,-74,-192,-225,-48,-658
-21,17,-71,-154,-118,-118,-126,-12,-603
8,-2,3,-8,-14,-8,13,11,3
-26,16,-60,-114,-54,-65,-57,-51,-411
-18,58,-50,-154,-75,-126,-96,-31,-492
-31,-10,-54,-127,-94,-85,-112,-49,-562
8,9,-19,-23,-31,-33,-18,-4,-111
-11,2,-17,-48,-34,-56,-42,-52,-258
-27,34,-13,-51,-22,-13,-31,-1,-124
-95,77,-66,-162,-50,-50,-70,-6,-422
103,-13,49,-63,-44,-73,-85,7,-119
15,-59,-18,-92,-33,-28,-68,59,-224
79,56,-26,-37,-142,-75,-90,-28,-263
-98,5,-74,-118,-22,-29,-73,-40,-449
-93,123,-72,-167,-4,-47,-84,-9,-353
-142,72,-148,-390,-174,-138,-200,-22,-1142
14,115,-53,-373,-116,-207,-157,45,-732
80,142,-31,-281,-135,-211,-159,16,-579
-16,-19,-6,-69,-115,-62,-82,-1,-370
26,40,-5,-83,-114,-116,-87,-36,-375
-6,6,-26,-40,-44,-19,-50,17,-162
-18,5,-43,-76,-54,-33,-67,-48,-334
-42,-12,-35,-95,-109,-9,-48,14,-336
-24,7,-32,-62,-36,-16,-29,-11,-203
-70,-10,-76,-169,-121,-138,-136,-36,-756
-205,461,-328,-849,-290,-327,-270,198,-1610
-34,-5,-63,-165,-61,-73,-106,-48,-555
7,-10,-33,-76,-108,-99,-85,-53,-457
36,103,41,-103,19,-50,0,57,103
191,286,27,-401,-409,-264,-400,189,-781
120,60,-35,-162,-93,-189,-145,-12,-456
-22,-6,-35,-44,-45,-29,-60,-4,-245
-50,-20,-62,-151,-101,-34,-93,-11,-522
41,14,-43,-87,-190,-111,-95,-58,-529
-52,-25,-58,-156,-99,-92,-131,-1,-614
18,17,-25,-115,-224,-110,-111,-5,-555
-53,1,-43,-76,-60,-19,-31,-15,-296
-14,-18,-15,-31,0,-15,-32,5,-120
-11,-1,-14,-16,-12,-15,-7,-14,-90
-61,-15,-63,-72,-102,-46,-103,-37,-499
-105,-41,-88,-173,-139,-94,-148,-28,-816
-100,-26,-93,-159,-115,-91,-145,-19,-748
-91,-53,-78,-152,-127,-61,-114,-3,-679
-78,-17,-84,-151,-109,-77,-113,23,-606
-103,-26,-90,-151,-106,-67,-145,0,-688
-85,-61,-85,-121,-118,-74,-134,-1,-679
18,-6,-27,-100,-107,-92,-85,13,-386
-6,-11,-43,-118,-62,-116,-88,-12,-456
23,46,7,-87,-101,-70,-114,-27,-323
-36,19,-35,-157,-122,-77,-137,-55,-600
-13,-7,-61,-181,-120,-112,-106,-23,-623
25,82,-15,-157,-54,-140,-101,-41,-401
-34,20,-68,-198,-115,-145,-92,5,-627
-66,51,-44,-117,-39,-48,-39,-10,-312
-48,-15,-48,-215,-186,-135,-165,22,-790
-65,-7,-104,-277,-277,-234,-222,-52,-1238
-89,-10,-125,-216,-272,-177,-224,-26,-1139
-100,-26,-126,-247,-241,-184,-197,-42,-1163
-110,-26,-126,-252,-232,-164,-215,-63,-1188
-74,18,-123,-269,-169,-154,-179,-11,-961
-73,-17,-103,-242,-237,-166,-216,-20,-1074
-46,-24,-121,-221,-221,-152,-204,-26,-1015
-55,-27,-112,-197,-213,-150,-203,-35,-992
-104,50,-177,-558,-398,-314,-363,-13,-1877
-7,-11,-10,-17,-40,-12,-32,16,-113
-37,-19,-40,-73,-79,-42,-62,-11,-363
-20,5,-82,-128,-99,-107,-126,-45,-602
-107,-19,-116,-216,-98,-108,-148,-26,-838
-32,-14,-44,-168,-135,-100,-104,-37,-634
-24,30,-65,-142,-61,-93,-34,46,-343
-102,56,-63,-179,-80,-75,-91,-30,-564
-75,21,-36,-139,-22,-78,-52,-21,-402
42,167,-30,-294,-16,-172,-128,99,-332
-32,-22,-37,-104,-73,-61,-38,-38,-405
183,255,46,-231,121,-189,-142,180,223
167,191,-16,-153,-3,-233,-120,115,-52
-102,-2,-182,-343,-277,-220,-286,-120,-1532
-71,45,-104,-313,-243,-181,-226,-13,-1106
13,37,-39,-116,-42,-107,-82,-30,-366
-14,-45,-11,-94,-213,-117,-117,10,-601
-27,-18,-37,-96,-64,-44,-46,-12,-344
33,60,2,-12,8,4,33,13,141
-2,28,-10,-44,-24,-14,-53,1,-118
-18,7,-11,-54,-31,-39,-37,-2,-185
-78,6,-66,-128,-107,-54,-77,-47,-551
-33,10,-56,-127,-2,-57,-42,-28,-335
-26,-3,-50,-175,-10,-72,-36,-6,-378
20,12,-6,-21,-27,-36,-20,-9,-87
-48,-2,-52,-116,-49,-69,-66,-23,-425
-49,17,-30,-96,-21,-44,-48,-22,-293
-31,43,-49,-156,-54,-75,-73,-56,-451
-29,43,-58,-136,-52,-68,-47,-13,-360
-34,101,-56,-240,-111,-137,-94,22,-549
-57,16,-48,-124,-59,-68,-79,-37,-456
-5,15,1,-47,-20,-23,-31,25,-85
-17,-13,-19,-45,-22,-22,-27,-20,-185
128,141,91,73,61,79,21,67,661
-13,-51,-26,-77,-47,-91,-85,-16,-406
4,124,-43,-274,-319,-135,-196,148,-691
2,17,-6,-49,-59,-51,-19,1,-164
-3,26,-58,-52,-143,-57,-107,-41,-435
122,103,153,23,-83,-30,-46,5,247
-33,2,-62,-144,-139,-92,-81,-37,-586
-24,9,-95,-148,-111,-82,-91,-25,-567
1,27,-7,-12,-26,-19,-1,-9,-46
-5,42,-103,-149,-139,-125,-164,-121,-764
-54,25,-149,-355,-257,-300,-245,-118,-1453
-56,40,-47,-135,-97,-59,-90,-24,-468
-4,3,-20,-22,-26,-16,-28,-2,-115
-20,-6,-30,-32,-18,-2,-15,-23,-146
-12,22,-29,-78,-52,-43,-41,5,-228
1,11,-14,-34,-41,-10,-22,21,-88
-13,10,-11,-37,-20,2,-20,8,-81
-67,-16,-127,-174,-211,-154,-203,-57,-1009
174,87,70,40,-2,-21,-67,118,399
37,45,24,-10,-72,-51,-51,32,-46
-86,49,-108,-302,-46,-133,-167,-74,-867
35,32,-18,-39,-43,-12,-16,52,-9
-10,-4,-8,-36,-36,-23,-12,3,-126
-53,109,-105,-345,-231,-212,-174,-10,-1021
-104,126,-110,-351,-141,-148,-160,-73,-961
-63,2,-57,-222,-122,-109,-150,-43,-764
-43,138,-7,-179,-18,-73,-43,24,-201
-82,37,-41,-147,-51,-52,-39,12,-363
-77,21,-60,-133,-67,-63,-60,1,-438
-28,30,-39,-110,-98,-68,-56,-19,-388
-72,79,-82,-169,-6,-87,-70,-23,-430
-63,35,-43,-80,-39,-51,-54,-2,-297
-79,114,-45,-181,-20,-90,-87,-9,-397
-39,-13,-30,-45,-41,-34,-48,-8,-258
-44,20,-22,-63,-14,-2,-10,-16,-151
-47,108,-72,-359,-59,-350,-262,-110,-1151
11,50,7,-50,-145,-41,-93,40,-221
75,98,-12,-41,-117,-120,-80,51,-146
-56,-23,-56,-117,-114,-76,-86,-17,-545
3,-10,-14,-13,-49,-29,-23,-7,-142
-22,9,-48,-90,-88,-47,-74,-14,-374
-53,59,-14,-225,-236,-117,-150,-40,-776
21,112,-37,-235,-271,-207,-187,-69,-873
9,-2,-22,-19,4,-18,-34,16,-66
-1,16,-16,-67,10,-40,-38,1,-135
-23,25,-31,-89,-39,-41,-55,26,-227
-14,-8,-29,-39,-9,-11,-27,38,-99
9,-5,-18,-41,-68,-48,-46,-37,-254
-39,6,-26,-56,-75,-54,-42,7,-279
6,75,-45,-195,-242,-200,-155,-35,-791
-59,-39,-130,-239,-178,-158,-168,-80,-1051
-27,-12,-97,-296,-139,-195,-173,-46,-985
-30,-9,-42,-142,-159,-144,-130,-105,-761
-19,-4,-42,-80,-51,-54,-45,-13,-308
-4,-25,-22,-40,-63,-22,-15,9,-182
38,32,25,-9,23,-3,21,24,151
1,25,14,5,-11,22,-29,3,30
68,-12,1,-37,-24,-65,-27,-20,-116
181,357,76,-281,5,-218,-299,119,-60
64,27,6,-62,-7,-60,-56,10,-78
59,-33,2,-21,-49,-75,-61,-34,-212
55,36,10,-44,-39,-69,-23,-28,-102
27,-6,-24,-56,-65,-74,-63,-25,-286
-11,48,-37,-96,-34,-37,-33,-26,-226
-12,-3,-30,-84,-84,-49,-59,-26,-347
-3,-2,-32,-71,-96,-35,-88,-37,-364
-60,2,-88,-199,-140,-128,-106,-28,-747
-87,56,-186,-405,-294,-287,-282,-94,-1579
23,40,-18,-74,-45,-27,-79,-47,-227
3,21,-36,-97,-52,-48,-71,-38,-318
10,27,-22,-67,-77,-77,-41,-15,-262
-9,6,-14,-54,-64,-28,-28,17,-174
-17,7,-71,-198,-293,-98,-164,-6,-840
936,463,627,341,657,215,-124,305,3420
73,67,30,-42,15,-57,-50,39,75
8,28,6,-22,-5,-18,-19,-3,-25
-4,10,-19,-56,-86,-46,-57,5,-253
3,37,9,-52,-75,-14,-59,8,-143
-1,3,-16,-65,-136,-112,-88,-21,-436
-8,36,-46,-64,-46,-79,-72,-11,-290
-32,2,-40,-64,-65,-64,-65,-35,-363
-140,-24,-163,-304,-258,-190,-224,-107,-1410
-88,-33,-118,-287,-291,-158,-154,-93,-1222
-11,9,-31,-26,-85,-33,-78,27,-228
-48,43,-22,-175,-104,-92,-139,-17,-554
-67,30,-67,-191,-113,-105,-118,-14,-645
26,14,4,-5,-16,-17,-7,27,26
14,10,-2,-13,-26,-9,-19,15,-30
42,17,-10,-23,-24,-7,-16,39,18
-134,-112,-265,-413,-450,-300,-404,-175,-2253
-48,4,-37,-128,-78,-25,-73,49,-336
-28,-27,-26,-38,-50,-6,-41,7,-209
5,-16,-17,-27,-37,-44,-39,-2,-177
-19,-17,-96,-202,-247,-103,-136,22,-798
-26,-10,-26,-81,-99,-64,-72,-29,-407
-39,-11,-65,-122,-107,-71,-76,0,-491
-119,-39,-138,-205,-241,-154,-238,-20,-1154
-23,20,-46,-53,-52,-46,-21,-37,-258
-15,-8,2,-13,-17,-5,-7,4,-59
-145,114,-257,-567,-265,-227,-261,-71,-1679
5,-8,-20,-39,-56,-43,-18,1,-178
165,152,27,-187,-127,-217,-87,16,-258
-9,-17,-5,-26,-58,-30,-32,1,-176
-43,-11,-80,-114,-133,-62,-132,-16,-591
43,26,-3,-50,-29,-33,-51,-2,-99
155,48,0,-128,-54,-140,-194,71,-242
-3,23,8,-22,3,-7,10,23,35
53,19,-52,-260,-202,-269,-233,-78,-1022
29,24,-13,-28,-35,-45,-18,16,-70
-35,0,-32,-43,-37,-19,-54,25,-195
5,-1,-24,-2,-19,-18,-60,4,-115
-57,173,-99,-319,-166,-205,-140,106,-707
-91,-26,-87,-181,-178,-78,-121,-76,-838
-42,97,-56,-265,-200,-192,-156,-30,-844
-31,10,-86,-124,-132,-117,-172,-35,-687
-12,50,-37,-94,-32,-70,-47,-2,-244
118,78,14,-138,-52,-129,-91,89,-111
61,92,-23,-159,-93,-122,-103,-7,-354
402,153,149,-40,211,-272,-260,102,445
-25,41,-23,-105,-64,-54,-40,17,-253
-67,102,-121,-266,-103,-93,-133,11,-670
-35,78,-31,-186,-87,-89,-95,65,-380
2,47,-15,-104,-75,-105,-57,26,-281
-49,-40,-152,-201,-191,-100,-146,46,-833
-55,46,-68,-296,-339,-146,-195,84,-969
-4,-10,-33,-98,-93,-46,-68,10,-342
4,35,-11,-84,-77,-28,-48,47,-162
-5,13,10,-62,-32,-37,-35,8,-140
-24,37,-68,-141,-93,-46,-69,-54,-458
-16,41,-34,-93,-63,-35,-53,2,-251
-77,-26,-63,-121,-90,-72,-94,-14,-557
-38,2,-47,-140,-121,-102,-102,-13,-561
0,28,-21,-105,-172,-43,-77,-40,-430
-18,22,-31,-87,-51,-43,-57,-3,-268
-139,-22,-168,-303,-310,-140,-235,-41,-1358
-24,-8,-51,-60,-27,-13,-37,-12,-232
1,5,-6,-10,-15,-6,-7,1,-37
39,19,-16,-61,-24,-43,-54,28,-112
90,42,-2,-45,-82,-45,-66,12,-96
-61,-25,-59,-123,-154,-122,-121,-41,-706
-20,-3,-71,-230,-218,-205,-186,62,-871
-56,38,-94,-217,-231,-171,-141,15,-857
29,48,-40,-202,-202,-187,-171,-3,-728
-48,-27,-71,-214,-225,-162,-180,77,-850
-50,-8,-77,-196,-255,-131,-144,51,-810
74,69,51,-99,-59,-134,-90,101,-87
-30,38,-36,-147,-74,-76,-119,-28,-472
66,-29,-45,-105,-228,-204,-175,-83,-803
-12,1,-68,-111,-128,-61,-135,39,-475
-19,4,-27,-75,-69,-50,-50,-35,-321
19,11,-15,-35,-26,-58,-22,5,-121
71,65,22,23,-54,-93,-64,-45,-75
-21,6,-34,-161,-78,-127,-108,8,-515
-68,-41,-56,-166,-159,-122,-111,-22,-745
45,34,9,-32,-25,-50,-40,-16,-75
-42,-12,-56,-58,-65,-37,-91,2,-359
-44,-26,-42,-57,-77,-28,-71,5,-340
-44,4,-52,-63,-50,-41,-75,-31,-352
-73,-33,-92,-151,-105,-69,-129,-21,-673
-1,32,-18,-95,-97,-99,-87,-7,-372
-36,39,-71,-237,-221,-146,-169,-22,-863
16,-19,-32,-13,-85,-48,-72,-46,-299
38,21,-9,-2,-56,-75,-65,-21,-169
-14,13,-16,-29,-37,-30,-29,-1,-143
-3,-5,-19,-37,-19,-31,-40,8,-146
0,27,-12,-30,-6,-6,-12,-21,-60
-34,12,-55,-84,-54,-42,-46,6,-297
-13,-3,-175,-220,-346,-187,-268,-55,-1267
-124,-59,-154,-262,-304,-168,-261,-25,-1357
27,56,-18,-42,-68,-52,-37,-25,-159
-45,14,-49,-114,-96,-54,-74,-9,-427
-29,8,-20,-64,-87,-57,-31,34,-246
45,50,15,-30,-83,-66,-42,15,-96
28,36,0,-78,-64,-80,-66,1,-223
-15,9,-15,-44,-13,-29,-31,-23,-161
-24,0,-61,-148,-115,-102,-125,-41,-616
-127,-85,-219,-294,-221,-157,-234,-120,-1457
-35,-13,-64,-81,-73,-38,-89,-44,-437
-17,-13,-48,-68,-89,-54,-88,-36,-413
-24,19,-40,-168,-224,-100,-87,-36,-660
-14,16,-23,-66,-33,-51,-26,-2,-199
-2,67,2,-90,-52,-10,10,39,-36
-15,10,-35,-67,-93,-59,-86,26,-319
20,4,-15,14,-22,-16,-26,12,-29
28,10,-23,-73,-123,-89,-95,-44,-409
-90,-16,-100,-160,-136,-89,-141,-10,-742
-38,-11,-42,-64,-124,-45,-86,-7,-417
14,22,-13,-43,-14,-44,-11,-24,-113
-11,25,-17,-81,-104,-89,-82,-42,-401
33,-37,-25,-89,-100,-126,-50,-24,-418
-33,-6,-21,-53,-59,-33,-40,-30,-275
-40,70,-132,-256,-203,-155,-170,-25,-911
-177,-20,-223,-398,-242,-255,-357,-145,-1817
21,123,-42,-368,-204,-277,-214,1,-960
148,281,5,-129,4,-139,-124,130,176
272,283,48,-126,22,-200,-206,28,121
62,72,12,-111,-69,-146,-99,-13,-292
6,112,-20,-229,-56,-214,-132,89,-444
2,20,-21,-62,-41,16,-16,44,-58
-11,10,-24,-28,-45,-15,-27,15,-125
-17,36,-24,-108,-58,-51,-81,0,-303
-6,-3,-25,-57,-70,-42,-46,-15,-264
-32,32,-46,-106,-97,-84,-82,-1,-416
-13,-16,-27,-56,-112,-26,-48,-33,-331
53,139,-78,-253,-99,-163,-149,6,-544
122,167,11,-227,-267,-319,-364,-236,-1113
19,22,-10,-34,-49,-57,-32,-47,-188
41,4,-71,-141,-167,-110,-120,108,-456
3,21,-58,-145,-148,-102,-116,71,-474
-7,4,-82,-170,-149,-99,-121,40,-584
9,-35,-45,-118,-170,-72,-78,74,-435
-26,-27,-52,-162,-176,-93,-79,65,-550
-39,-17,-62,-162,-124,-57,-98,54,-505
54,26,-76,-194,-180,-217,-132,-49,-768
108,84,20,-62,63,-86,-72,38,93
141,65,59,53,19,-83,-82,55,227
81,24,41,-4,29,-30,-62,51,130
13,37,-13,-43,-7,-26,-15,0,-54
-32,-24,-31,-42,-80,-54,-87,1,-349
-10,5,-41,-84,-98,-40,-83,-16,-367
9,45,-16,-84,-37,-36,-41,39,-121
-7,13,-17,-25,-103,-32,-44,32,-183
-7,11,-12,-34,-22,-12,-27,-14,-117
62,1,11,-28,-43,-56,-57,27,-83
-20,3,-9,-33,-25,-19,-25,0,-128
-17,1,-20,-27,-12,-17,-17,-4,-113
-33,-34,-111,-219,-226,-136,-155,-66,-980
11,-10,0,-27,-57,-66,-8,-34,-191
75,76,75,21,-4,-12,-35,57,253
53,-2,10,-5,7,-9,-23,32,63
24,33,2,-77,-142,-46,-72,-11,-289
41,33,-5,-13,-7,0,10,0,59
5,4,-8,-45,-124,-81,-76,-6,-331
2,10,4,-11,-6,-3,-5,3,-6
17,-8,-46,-117,-170,-53,-59,29,-407
-41,24,-13,-89,-56,13,-72,100,-134
20,37,-38,-74,-37,-85,-69,-38,-284
-7,-13,-4,-74,-100,-53,-76,-1,-328
-1,17,-34,-63,-41,-69,-38,-29,-258
-17,-2,-15,-25,-15,-13,-8,7,-88
-35,35,-63,-122,-51,-84,-76,-15,-411
57,43,25,2,17,-40,-37,46,113
45,16,20,2,8,-62,-64,57,22
10,15,5,-27,-12,-34,-23,11,-55
-132,-69,-108,-216,-173,-110,-127,15,-920
14,24,-6,-22,3,-16,-4,6,-1
5,47,-2,-112,-99,-93,-45,-31,-330
-32,8,-89,-243,-163,-173,-170,-97,-959
-57,110,-86,-261,-226,-58,-154,151,-581
16,-2,-21,-62,-69,-54,-35,-9,-236
18,18,8,-6,5,-2,-1,-3,37
94,7,-5,1,-114,-122,-76,-50,-265
-1,6,2,-7,-7,-1,-9,5,-12
-4,-7,-7,-24,-22,-26,-19,-18,-127
-20,-5,-13,-42,-28,-30,-30,-20,-188
-19,-8,-32,-158,-35,-53,-99,33,-371
-45,1,-32,-102,-100,-8,-71,39,-318
-24,1,-23,-56,-20,-12,-29,-7,-170
-8,-12,-7,-10,-17,-7,-11,6,-66
-4,-5,0,-5,-17,-10,-4,4,-41
-8,-8,-18,-15,-14,-12,-8,-13,-96
32,-18,33,-46,-6,27,-30,45,37
75,126,1,-256,-92,-216,-174,-24,-560
-23,7,-19,-73,-79,-41,-59,21,-266
-37,-18,-40,-58,-45,-13,-45,-7,-263
0,-24,-20,-102,-155,-87,-80,-33,-501
-7,7,-8,-46,-20,-36,-31,-13,-154
-24,-14,0,-37,-44,-20,-24,-4,-167
-18,-13,-31,-30,-63,-25,-47,-9,-236
-24,13,-22,-59,-45,-2,-29,-14,-182
-51,28,-68,-141,-66,-71,-97,-40,-506
-32,-24,-39,-60,-51,-40,-26,-37,-309
63,126,-22,-290,-86,-200,-167,132,-444
120,54,54,15,14,-66,-59,57,189
-9,11,-26,-204,-174,-163,-177,26,-716
-32,16,-21,-68,-67,-53,-64,-29,-318
-28,1,-11,-46,-84,-76,-49,-13,-306
-21,25,-18,-83,-94,-69,-45,7,-298
-23,-3,-14,-40,-98,-35,-52,11,-254
-28,320,-141,-467,-142,-199,-161,280,-538
30,73,10,-114,-152,-76,-102,40,-291
4,19,-51,-53,-61,-45,-75,-17,-279
-12,21,-44,-66,-65,-71,-88,-39,-364
-33,-16,-36,-59,-85,-43,-79,-12,-363
-33,-12,-61,-87,-73,-70,-96,-16,-448
-35,3,-49,-82,-73,-55,-75,-33,-399
-16,7,-52,-111,-126,-70,-84,16,-436
-33,-4,-33,-41,-18,-30,-30,4,-185
-5,4,-18,-13,-85,-55,-93,9,-256
-25,21,-32,-60,-60,-56,-63,-12,-287
17,19,18,-12,-18,-42,-43,8,-53
-22,19,-60,-102,-60,-62,-77,-29,-393
187,28,-11,-132,-63,-140,-165,-5,-301
-17,23,-36,-76,-66,-38,-70,-41,-321
39,107,-11,-167,-79,-134,-135,72,-308
20,29,-3,-42,11,-43,-18,44,-2
-15,8,3,-24,-32,-29,-13,5,-97
-31,-12,-37,-67,-47,-35,-42,0,-271
58,40,19,1,13,-12,10,18,147
-44,12,-83,-137,-145,-101,-147,-27,-672
-22,53,-28,-194,-63,-129,-90,-30,-503
68,106,-49,-231,-94,-191,-164,-34,-589
-19,12,-23,-64,-26,-33,-52,2,-203
-48,95,-24,-334,-233,-220,-130,46,-848
140,40,66,43,17,-65,-81,20,180
-30,14,-67,-203,-141,-149,-130,-57,-763
-16,14,-18,-60,-46,-37,-25,-43,-231
-19,22,-23,-72,-19,-29,-58,-25,-223
17,85,-90,-221,-171,-222,-146,-112,-860
-15,35,-55,-103,-94,-99,-71,-19,-421
55,34,1,-85,-38,-95,-71,32,-167
18,-14,0,-36,-43,-73,-31,-11,-190
3,28,-10,-71,-44,-50,-27,26,-145
-45,-25,-67,-106,-62,-73,-106,-33,-517
-116,-45,-119,-242,-296,-116,-235,3,-1166
7,1,-8,-17,-30,-11,-12,4,-66
-112,14,-203,-368,-215,-271,-292,-203,-1650
19,111,-65,-259,-169,-238,-215,-150,-966
3,38,4,-83,27,-33,-12,61,5
11,25,-19,-108,-72,-46,-49,23,-235
42,41,-22,-109,-67,-85,-87,10,-277
-27,20,-30,-66,-109,-63,-82,-23,-380
-27,-11,-25,-38,-58,-29,-36,-18,-242
-10,4,-8,-18,-16,-10,-20,-6,-84
-3,3,-28,-45,-75,-51,-52,-7,-258
49,76,-41,-281,-137,-208,-142,-69,-753
12,20,-8,-18,-8,-21,-31,-25,-79
-17,22,-51,-69,-61,-68,-85,-1,-330
-59,17,-82,-264,-186,-180,-209,-62,-1025
24,95,-33,-138,-56,-104,-90,-23,-325
-8,36,-27,-75,-10,-39,-44,22,-145
-9,11,-10,-43,-36,-33,-26,-10,-156
-35,24,-33,-156,-132,-71,-108,-18,-529
-60,27,-64,-184,-58,-67,-67,4,-469
-25,25,-12,-118,-106,-107,-98,-10,-451
-45,16,-59,-147,-141,-51,-121,15,-533
51,41,31,-30,-32,-43,-21,-7,-10
1,4,-43,-127,-76,-138,-142,-52,-573
-50,-9,-44,-136,-106,-99,-101,-17,-562
135,-8,29,31,-25,-80,-76,-24,-18
-19,8,-15,-30,-20,-11,-17,1,-103
425,332,-338,-1135,-1547,-1477,-1001,-949,-5690
-12,43,-26,-125,-57,-125,-89,-48,-439
-79,-23,-90,-131,-80,-88,-129,-30,-650
-83,-18,-87,-165,-101,-85,-133,-42,-714
-74,-27,-50,-137,-92,-67,-127,-14,-588
-87,-24,-73,-143,-77,-50,-125,-9,-588
-101,-33,-89,-154,-95,-71,-150,-24,-717
6,65,-16,-115,-189,-94,-63,-12,-418
-19,4,-13,-47,-18,-30,-26,-16,-165
26,56,3,-53,-52,-80,-46,-15,-161
-55,35,-43,-87,-56,-37,-67,-4,-314
-33,49,-48,-152,-88,-68,-102,-13,-455
4,45,9,-39,-12,-38,3,34,6
-22,214,-31,-307,-72,-58,-140,89,-327
33,74,-6,-53,-84,-76,-60,43,-129
105,40,1,-164,-48,-128,-112,46,-260
-18,14,-35,-83,-29,-21,-23,21,-174
-38,-14,-52,-63,-64,-25,-65,-18,-339
0,2,-25,-38,-57,-33,-32,7,-176
33,24,-14,-106,4,-107,-52,-28,-246
-4,4,-3,-8,1,1,-9,-13,-31
30,26,-3,-31,-14,-61,-31,-7,-91
-14,8,-4,-24,-10,-11,-17,-11,-83
3,9,-22,-12,-32,-18,-24,-34,-130
-8,1,-5,-19,-18,-17,-16,0,-82
-17,-5,-17,-25,-17,-10,-17,1,-107
-15,-10,-18,-59,-39,-35,-32,-9,-217
-49,31,-66,-140,-61,-83,-80,13,-435
-53,5,-121,-212,-213,-117,-157,-6,-874
21,34,-12,-57,-6,-67,-63,13,-137
-50,-18,-75,-103,-119,-100,-125,-31,-621
-19,14,-1,-24,-29,-27,-10,2,-94
0,3,14,-35,-23,-51,-19,-2,-113
-9,-2,-7,-28,-9,-25,-24,-1,-105
-41,2,-29,-87,-57,-61,-52,-3,-328
-7,10,-10,-37,-9,-22,-7,-6,-88
-3,8,-7,-21,-13,-20,-8,-6,-70
-9,88,-94,-290,-217,-254,-198,-189,-1163
-172,12,-211,-389,-179,-223,-236,-93,-1491
-101,38,-183,-376,-159,-276,-242,-233,-1532
-91,115,-163,-392,-219,-247,-215,-176,-1388
19,16,5,-55,1,-38,-1,-4,-57
7,21,0,-26,-2,-28,-27,-10,-65
8,24,2,-28,-11,-12,-7,-3,-27
0,1,-8,-19,-7,-18,-15,-9,-75
0,1,1,-23,-7,-42,-38,-31,-139
-19,4,-16,-48,-43,-29,-25,40,-136
-18,18,-22,-37,-23,-33,-22,-8,-145
-16,12,-22,-43,-50,-22,-26,-4,-171
22,41,1,-12,-31,-5,-5,5,16
-137,260,-60,-280,-141,-112,-234,157,-547
-105,-27,-99,-164,-119,-96,-150,-18,-778
-87,-37,-109,-147,-93,-78,-137,-21,-709
-82,-23,-89,-139,-102,-64,-110,0,-609
-70,-33,-113,-159,-84,-79,-127,-29,-694
-94,-46,-96,-147,-91,-55,-115,-27,-671
-98,-38,-87,-151,-102,-66,-115,-24,-681
-93,-50,-84,-149,-88,-66,-119,-17,-666
-97,-51,-108,-161,-95,-69,-128,-26,-735
-108,-53,-103,-170,-105,-77,-136,-32,-784
-103,-38,-102,-164,-105,-78,-137,-45,-772
-106,-38,-119,-168,-113,-72,-138,-42,-796
-103,-43,-111,-157,-110,-73,-142,-44,-783
-68,-25,-86,-149,-96,-83,-122,-31,-660
2,13,-23,-15,-13,-18,-24,-17,-95
4,-9,-16,-20,-44,-29,-20,-11,-145
4,-8,-16,-18,-40,-28,-22,-12,-140
6,-16,-1,-4,-18,-9,-14,-8,-64
-26,4,-29,-65,-11,-39,-35,-5,-206
-23,-13,-34,-63,-59,-30,-32,6,-248
-31,49,-12,-108,-22,-42,-37,55,-148
-40,40,-89,-192,-88,-123,-131,-89,-712
-2,60,-34,-184,-143,-107,-145,-69,-624
-20,-6,-15,-22,-22,-11,-21,-2,-119
10,58,-34,-111,-42,-70,-73,29,-233
-20,1,-19,-77,-26,-11,-10,5,-157
-74,0,-77,-150,-96,-65,-121,-33,-616
-92,121,-50,-247,-91,-197,-114,-28,-698
7,27,0,-35,14,-27,-33,-18,-65
-21,12,-21,-21,-19,3,-24,11,-80
-27,24,-31,-29,-19,7,-35,26,-84
-40,-11,-20,-62,-41,-14,-41,7,-222
-11,15,-4,-19,-12,-8,-2,12,-29
13,13,-9,2,3,-4,7,42,67
-17,17,1,-68,-55,-55,-20,-6,-203
-48,69,-45,-48,-33,5,-85,30,-155
-7,10,-12,-15,-7,-15,-23,-10,-79
-37,-6,-63,-70,-97,-47,-83,-28,-431
-24,-17,-10,-26,-31,-4,-12,2,-122
-36,-15,-39,-75,-21,-7,-23,12,-204
8,3,-6,-20,-99,-18,-52,-6,-190
-25,-7,-54,-74,-96,-40,-103,-29,-428
-61,-47,-75,-124,-101,-78,-115,-43,-644
10,17,6,-30,1,-12,-16,0,-24
2,27,5,-42,-13,-41,-29,-6,-97
-35,2,-20,-29,-29,-4,-31,13,-133
-25,15,-23,-32,-22,-3,-36,1,-125
-53,71,-51,-60,-46,-5,-96,31,-209
-46,85,-43,-37,-18,19,-91,34,-97
-43,63,-41,-55,-32,-3,-80,22,-169
-56,61,-52,-58,-40,11,-103,21,-216
-50,117,-62,-49,-29,-2,-112,44,-143
-65,128,-75,-68,-23,36,-130,50,-147
-56,116,-59,-49,-36,28,-119,43,-132
-37,68,-56,-54,-32,7,-95,23,-176
-47,69,-47,-34,-32,24,-102,49,-120
-50,90,-57,-54,-34,1,-127,44,-187
-40,73,-38,-65,-21,-4,-82,23,-154
0,13,4,-17,-22,-11,-19,15,-37
-25,-35,-33,-81,-57,-20,-28,35,-244
-48,6,-50,-176,-53,-124,-152,7,-590
-20,52,-59,-168,-42,-89,-125,-11,-462
-35,-30,-31,-122,-80,-83,-108,-9,-498
-29,-19,-17,-55,-84,-13,-47,9,-255
-17,-6,-6,-27,-32,-2,-5,11,-84
-36,2,-34,-73,-14,-24,-49,-13,-241
5,8,0,4,-27,-15,-13,3,-35
6,-11,-10,-30,-8,-13,-18,2,-82
-6,0,-2,-29,-21,-26,-28,-12,-124
13,38,-50,-153,-11,-104,-119,-15,-401
-4,7,-17,-29,-34,-9,-21,-16,-123
1,11,-11,-33,-62,-44,-32,-20,-190
-16,-8,-19,-73,-112,-45,-74,7,-340
-25,-22,-18,-53,-43,-32,-32,-20,-245
32,4,-13,-46,-68,-59,-31,-16,-197
-36,-8,-14,-106,-128,-65,-72,7,-422
15,41,-28,-150,-79,-121,-154,8,-468
-24,-2,-4,-51,-27,-16,-16,-7,-147
11,19,4,-15,-29,-17,-21,-15,-63
-35,-28,-26,-82,-130,-67,-65,-5,-438
-74,-47,-64,-128,-115,-90,-117,-25,-660
18,11,1,17,4,6,10,9,76
-19,-14,-18,-48,-83,-24,-42,-3,-251
-5,3,-1,-12,-5,6,-18,-8,-40
-22,-6,-23,-49,-36,-13,-21,6,-164
-24,-6,-30,-31,-42,-2,-20,-25,-180
-19,-4,-13,-43,-17,-1,-19,-3,-119
-1,-4,-24,-29,-18,-19,-20,-29,-144
-26,-7,-32,-48,-55,-21,-27,3,-213
-29,0,-27,-56,-26,-16,-41,2,-193
4,15,-19,-71,-110,-32,-81,-10,-304
-4,16,-20,-46,-62,-29,-25,-15,-185
-5,7,-27,-33,-80,-26,-28,-23,-215
13,15,-14,-23,-56,-36,-29,-15,-145
-13,2,-6,-14,-11,-10,-11,8,-55
-24,11,-20,-41,-51,-9,-19,-12,-165
-70,-36,-86,-139,-119,-71,-110,-2,-633
-11,-22,1,-33,-9,-17,-27,5,-113
-13,11,-20,-48,2,2,-15,4,-77
-6,-22,-19,-43,-40,-25,-25,-8,-188
-7,-27,-17,-32,-33,-27,-17,-17,-177
8,9,-18,-31,-63,-40,-35,-7,-177
161,213,76,-87,73,-39,-32,158,523
-37,-30,-33,-106,-126,-55,-70,10,-447
-40,3,-29,-130,-88,-37,-70,-32,-423
-38,-8,-26,-104,-110,-50,-47,-3,-386
-20,-11,-27,-35,-28,-21,-33,-6,-181
-48,11,-80,-116,-73,-66,-80,-31,-483
-18,2,-41,-42,-45,-16,-32,-24,-216
8,-1,-7,-23,-28,-15,-1,11,-56
-80,-34,-61,-168,-139,-55,-89,-16,-642
-10,5,-11,-31,-39,-12,-23,1,-120
-11,1,-19,-30,-42,-17,-26,11,-133
-12,-6,-11,-21,-33,-22,-25,-9,-139
15,20,-3,-16,-22,-41,-19,9,-57
-14,16,9,-52,-57,-20,-17,-20,-155
-33,0,7,-45,-27,-6,9,23,-72
-46,-2,-11,-68,-84,-44,-63,5,-313
11,16,-13,-23,-17,-27,-28,-19,-100
-38,-11,-33,-92,-48,-35,-31,-22,-310
24,24,-1,-11,-25,-38,-30,-28,-85
-29,-13,-5,-57,-58,-46,-20,6,-222
-25,-3,-30,-45,-21,-15,-21,2,-158
-3,45,-10,-65,-25,-39,-10,44,-63
-8,-8,3,-28,-36,-11,-3,9,-82
-6,23,-5,-47,-27,-31,-19,4,-108
-15,8,-6,-70,-67,-62,-43,-12,-267
-33,-36,-75,-100,-90,-56,-91,-59,-540
2,-10,-13,-16,-29,-13,-10,-17,-106
-16,9,5,-8,-36,-1,-23,11,-59
-34,60,-96,-184,-102,-116,-149,-38,-659
-84,-23,-54,-198,-132,-110,-120,5,-716
-86,-6,-72,-180,-112,-113,-113,2,-680
-90,-11,-76,-178,-116,-108,-107,-2,-688
-13,4,-26,-31,-31,-29,-38,-10,-174
-84,-29,-63,-183,-125,-110,-116,-2,-712
2,6,5,-20,-13,-20,-4,-2,-46
2,8,3,-17,-11,-18,-2,-2,-37
2,8,3,-17,-11,-18,-2,-2,-37
3,9,0,-17,-9,-18,0,0,-32
-1,10,4,-18,-11,-22,-5,-3,-46
-2,16,2,-16,-11,-20,-8,-10,-49
4,12,3,-19,-3,-18,-5,4,-22
2,8,3,-17,-11,-18,-2,-2,-37
-7,10,3,-15,2,-10,2,12,-3
-6,9,4,-14,1,-11,1,13,-3
-7,13,6,-14,2,-10,-2,9,-3
-3,8,3,-14,1,-12,2,10,-5
-15,-4,-13,-32,-54,-20,-10,-14,-162
-5,12,-17,-52,-38,-32,-23,9,-146
-17,-18,-29,-42,-53,-40,-39,-9,-247
-9,8,-5,-41,-29,-14,-21,1,-110
3,17,-6,-23,-23,9,-12,-2,-37
-60,2,-98,-165,-154,-77,-148,-19,-719
1,-17,-6,-5,-46,-39,-31,-6,-149
-24,45,-68,-98,-36,-29,-63,-15,-288
-12,18,-22,-31,-31,-24,-26,-18,-146
-86,4,-66,-157,-136,-119,-134,-32,-726
-19,3,-13,-37,-16,-23,-19,7,-117
-23,-5,-34,-51,-27,-29,-43,-13,-225
-58,-7,-41,-129,-74,-88,-70,-15,-482
-4,12,-16,-39,2,8,-18,23,-32
-20,1,-35,-56,-34,-29,-40,-11,-224
16,23,-1,-1,-20,-16,1,-4,-2
-6,19,8,-29,-23,-34,1,2,-62
-11,12,-3,-27,8,3,0,-7,-25
0,6,5,-2,-9,0,0,7,7
-9,-12,-8,-22,-26,-18,-5,-2,-102
-36,-19,-31,-68,-95,-76,-56,-7,-388
-15,38,-50,-64,-69,-15,-37,10,-202
-23,13,-23,-42,-18,-11,-37,-3,-144
-6,21,-6,-32,-35,-41,-35,-13,-147
-8,-13,-19,-18,-30,-11,-23,-6,-128
60,41,41,-51,-24,-23,-37,47,54
-16,3,-22,-48,-59,-51,-50,-23,-266
-53,17,-48,-107,-49,-50,-45,8,-327
-14,-7,-12,-42,-57,-20,-38,-10,-200
-4,7,3,0,-6,-17,-18,-7,-42
-50,-32,-67,-68,-85,-1,-72,-9,-384
-15,8,-11,-58,-23,-16,-10,7,-118
-14,-4,-46,-90,-36,-30,-37,-29,-286
-25,-18,-40,-88,-48,-28,-41,-32,-320
-7,1,-18,-29,-20,-7,-16,6,-90
-39,33,-31,-117,-76,-38,-49,-30,-347
-29,29,-40,-118,-97,-57,-61,-36,-409
-26,19,-13,-65,-45,-22,4,-1,-149
-16,10,-7,-44,-34,-15,-14,-4,-124
-13,-5,-1,-38,-44,-25,-22,-5,-153
-12,-10,-13,-31,-27,-10,-7,-2,-112
-1,11,-11,-40,-16,-2,-27,21,-65
-13,2,-15,-36,-73,-45,-56,-28,-264
7,17,-4,-37,-48,-29,-2,5,-91
-1,5,-5,-24,-42,-9,3,-7,-80
-21,-9,-11,-51,-57,-34,-15,-22,-220
-13,0,-4,-16,-9,-13,-6,3,-58
-14,-5,-18,-56,-47,-43,-20,-15,-218
-27,-11,6,-47,-28,6,-1,12,-90
-22,3,-10,-32,-18,-10,-16,14,-91
0,13,-11,-17,-10,-8,-9,-1,-43
-7,10,-5,-17,-8,1,-7,-1,-34
-9,-1,-3,-31,-21,-18,-19,3,-99
-8,0,-7,-16,-19,-3,-7,4,-56
-11,28,8,-40,-15,-10,-5,7,-38
-15,19,-16,-40,2,-2,-1,-4,-57
2,15,3,-26,-29,-10,-9,7,-47
-6,8,-20,-48,-22,-48,-40,6,-170
6,13,11,-1,9,12,15,-3,62
-28,-1,-24,-39,-50,-10,-37,-10,-199
-38,-3,-30,-119,-102,-55,-70,-66,-483
-21,-22,-30,-63,-70,-31,-44,3,-278
-29,-22,-4,-60,-66,-45,-36,-32,-294
-32,-13,-23,-49,-41,10,-41,28,-161
-23,-7,-25,-50,-64,-49,-31,-1,-250
-25,29,-45,-97,-93,-27,-60,-6,-324
1,23,-19,-38,-24,-29,-33,-14,-133
2,50,-31,-82,-61,-71,-92,1,-284
-2,47,9,11,-16,-12,-7,-7,23
54,30,-4,-96,-12,-32,-63,22,-101
57,32,-8,-99,-10,-33,-56,17,-100
40,30,-21,-105,-16,-34,-55,13,-148
-10,22,-10,-43,-37,-27,-19,-5,-129
-42,-15,-16,-78,-83,-7,-18,-3,-262
-29,-20,-10,-50,-47,-34,-58,3,-245
-23,-9,-19,-68,-109,-50,-71,2,-347
-16,-11,-16,-30,-66,-28,-15,-14,-196
-20,-18,-8,-25,-47,-23,-18,-10,-169
-26,29,-1,-87,-45,-36,-13,-16,-195
-4,5,-20,-40,-26,2,-18,-14,-115
5,9,5,-29,-37,-32,-11,-14,-104
-17,13,-1,-23,-30,-27,-10,0,-95
-11,14,-15,-36,-57,-20,-44,-2,-171
-16,-21,-13,-29,-59,0,-20,-6,-164
-1,13,-6,-18,-52,-24,-10,3,-95
-15,3,-15,-37,-33,-17,-25,-6,-145
-11,-22,-2,-30,-8,-16,-33,2,-120
-21,-5,-6,-46,-17,-11,-19,17,-108
-27,-1,7,-28,-20,-7,-11,7,-80
-6,18,-11,-14,-22,-17,-9,-20,-81
-19,-28,-7,-34,-47,-25,-7,-1,-168
-7,8,2,-23,-15,-10,-4,1,-48
1,14,1,-9,-5,-1,8,8,17
6,37,0,-40,-110,-62,-55,-8,-232
-4,3,-18,-23,-20,-12,-23,-18,-115
-4,-16,-12,-7,-30,-25,-8,-9,-111
9,23,11,-38,-108,-68,-55,2,-224
-10,7,-12,-25,-31,-15,-18,-3,-107
-14,-6,4,-25,-12,-10,0,5,-58
-17,-7,-5,-28,-37,-23,0,5,-112
-31,13,-32,-58,-30,-27,-36,-19,-220
-30,-12,-3,-44,-35,-19,6,8,-129
-8,12,-1,-52,-50,-13,-4,-4,-120
2,0,12,-52,-91,-22,-4,2,-153
10,12,0,-16,-15,18,-10,12,11
9,14,1,-16,-13,0,-10,3,-12
-8,3,16,-3,-2,-4,5,11,18
-28,-6,-36,-48,-12,-25,-36,-18,-209
-33,-9,-46,-101,-74,-75,-88,18,-408
-27,6,-10,-39,-22,-16,-10,-7,-125
-22,-4,-12,-42,-20,-19,-16,-16,-151
7,-5,-16,-34,-21,-8,0,6,-71
7,49,53,-49,-58,-91,-11,99,-1
-34,-24,-21,-53,-44,-24,-33,-20,-253
-82,-22,-126,-267,-161,-161,-190,-58,-1067
-1,-13,-14,-22,-29,-27,-37,-3,-146
-35,-39,-37,-76,-78,-53,-45,-11,-374
-23,-3,-50,-60,-97,-45,-55,-40,-373
-5,0,-12,-28,-27,-1,-12,1,-84
-8,14,-23,-30,-55,-39,-45,-29,-215
4,14,-7,-27,-18,-7,-3,7,-37
-1,11,-10,-29,-26,-18,-5,3,-75
4,15,-9,-25,-18,-9,-2,7,-37
-1,4,-11,-25,-20,-12,1,5,-59
-2,16,-12,-31,-23,-13,-14,1,-78
2,12,-5,-23,-19,-8,0,10,-31
7,14,-6,-25,-18,-9,-1,7,-31
49,31,-15,-108,-15,-27,-54,23,-116
3,9,-8,-26,-19,-11,2,7,-43
35,34,-38,-230,-50,-69,-101,33,-386
5,12,-8,-26,-19,-10,0,7,-39
52,30,-14,-101,-17,-34,-59,14,-129
6,13,-6,-25,-21,-9,-2,7,-37
-114,-61,-94,-260,-206,-123,-148,-45,-1051
-116,-63,-96,-263,-211,-115,-146,-45,-1055
-208,-82,-167,-435,-301,-188,-249,-44,-1674
-110,-64,-95,-264,-213,-118,-157,-44,-1065
56,30,-12,-97,-10,-32,-58,20,-103
2,-1,-4,-30,4,-18,-11,30,-28
-47,-20,-41,-95,-86,-49,-28,36,-330
36,9,12,-40,-21,-37,-29,4,-66
-3,18,-1,-14,-11,3,-7,2,-13
-8,-9,-9,-13,-23,1,-13,8,-66
-5,11,-9,-16,-27,-13,-20,17,-62
-13,1,-2,-32,-5,-3,-3,-5,-62
-13,-5,-14,-15,-15,7,-4,7,-52
-14,3,-5,-17,-1,-1,-5,-11,-51
-12,-7,-6,-13,-18,-4,-21,-4,-85
3,4,0,-14,-11,-18,-11,3,-44
-1,-2,-7,-9,-32,-14,-7,4,-68
-4,28,-10,-19,-31,2,-9,1,-42
-18,41,-18,-72,-91,-48,-37,0,-243
-44,-18,-60,-109,-132,-65,-78,19,-487
-13,-6,-17,-75,-106,-42,-71,6,-324
-22,-10,-19,-71,-109,-53,-72,-2,-358
-6,8,-5,-12,-21,-13,-9,11,-47
-2,-8,-12,-29,10,-8,-20,-2,-71
2,8,9,1,1,7,8,-4,32
-4,11,-13,-9,-29,-5,-12,8,-53
-29,-10,-8,-54,-45,-37,-65,11,-237
85,18,64,15,4,6,50,81,323
-31,-15,-29,-75,-48,-14,-38,-2,-252
-1,-3,-19,-46,2,-30,-26,13,-110
18,52,3,-37,-40,-9,-31,-67,-111
-27,-12,-18,-68,-113,-50,-73,0,-361
-12,-18,-12,-33,-8,8,3,-5,-77
6,17,-8,-75,-140,2,-35,12,-221
2,16,1,-17,-8,4,-4,11,5
-28,-9,-17,-64,-113,-47,-67,1,-344
-16,-21,-28,-72,-106,-55,-72,-2,-372
-19,-24,-30,-69,-111,-52,-70,1,-374
16,26,22,-54,-59,-38,-40,37,-90
-38,-50,-30,-75,-85,-75,-69,-5,-427
-22,-13,-20,-49,-53,-18,-32,-16,-223
-5,-9,0,-38,-50,-28,-22,-4,-156
-4,29,-20,-60,-4,-11,-1,11,-60
-5,0,-26,-35,-31,-31,-34,-38,-200
0,2,-2,-6,2,-5,1,0,-8
-50,113,-103,-301,-207,-61,-159,104,-664
-3,8,-25,-35,-26,-26,-42,-20,-169
-1,10,-26,-37,-26,-27,-42,-20,-169
-1,-7,-18,-18,-41,-41,-41,-38,-205
-12,27,-47,-84,-53,-55,-46,24,-246
65,162,-2,-268,2,-198,-146,90,-295
48,12,-7,-104,17,-93,-72,52,-147
-42,108,-101,-232,-108,-128,-94,-126,-723
-22,15,0,-59,-65,-35,-23,27,-162
1,25,-28,-69,-58,-60,-53,-20,-262
-8,18,-24,-97,-92,-97,-55,26,-329
46,44,-7,-108,-106,-121,-134,-24,-410
-74,-42,-81,-179,-94,-98,-144,-60,-772
-10,-7,-10,-54,-86,-21,-39,0,-227
119,187,114,-112,7,-85,47,57,334
-42,22,-61,-150,-117,-107,-124,-42,-621
-70,-3,-67,-173,-79,-74,-105,45,-526
80,45,51,10,26,-48,-24,40,180
-6,69,-94,-233,-21,-94,-143,-72,-594
-52,7,-45,-100,-53,-51,-36,-27,-357
-34,-23,-41,-90,-88,-57,-54,-24,-411
-28,13,-40,-252,-104,-8,-32,83,-368
-37,-14,-69,-106,-97,-71,-86,-20,-500
-36,-3,-31,-151,-211,-115,-105,37,-615
-21,0,-14,-83,-71,-36,-47,18,-254
31,-54,-6,-188,-183,-174,-248,95,-727
48,49,7,13,2,-38,-30,-18,33
18,23,-68,-152,-88,-92,-42,28,-373
-183,14,-311,-713,-422,-360,-501,-90,-2566
222,134,31,-136,-42,-179,-120,96,6
71,27,20,-17,-88,-98,-42,-41,-168
-22,3,-18,-92,-63,-48,-44,-15,-299
-10,22,-32,-44,-63,-20,-67,0,-214
4,38,-58,-113,-216,-110,-131,-110,-696
-2,19,-26,-55,-20,-35,-51,-20,-190
30,19,-66,-98,-117,-115,-129,-59,-535
-52,6,-80,-112,-111,-71,-122,-33,-575
-68,-20,-69,-119,-98,-57,-120,-50,-601
-14,71,-28,-88,-94,-37,-92,-53,-335
-7,69,-7,-88,-124,-73,-107,-32,-369
-70,25,-84,-224,-97,-141,-152,-77,-820
-19,-2,-58,-119,-103,-96,-114,-41,-552
1,0,2,-19,-47,-10,-23,45,-51
2,31,-54,-80,-85,-58,-70,-9,-323
163,43,44,50,38,-74,-93,29,200
64,34,-20,-70,-72,-122,-52,-16,-254
139,56,-15,-3,-94,-125,-68,-54,-164
159,26,0,11,-53,-112,-71,-33,-73
157,54,-4,-49,-43,-139,-50,-39,-113
-16,16,-28,-69,-19,-26,-34,-24,-200
55,52,-15,-70,-37,-60,-58,14,-119
162,106,-29,-160,-4,-138,-109,29,-143
114,64,18,-18,-17,-104,-51,5,11
-32,164,-40,-58,21,76,-117,88,102
-56,17,-61,-149,-102,-87,-98,-16,-552
-71,160,-77,-577,-470,-285,-543,383,-1480
38,174,-34,-345,-74,-284,-144,78,-591
-367,70,-627,-1305,-754,-815,-939,-460,-5197
-35,36,-70,-148,-83,-34,-63,45,-352
1,3,-4,-32,-42,-39,-33,-18,-164
-33,23,-34,-81,-57,-63,-75,-14,-334
-24,16,-15,-97,-90,-60,-74,3,-341
-15,20,-26,-56,-29,-50,-42,-6,-204
39,61,3,-28,-8,-66,-41,-3,-43
2,4,-1,-62,-77,-96,-43,-28,-301
-50,30,-51,-108,-19,-48,-55,28,-273
-25,-1,-18,-31,-21,-22,-35,-17,-170
425,442,44,-548,-10,-359,-161,13,-154
-13,22,-23,-66,-32,-49,-33,-21,-215
-47,-28,-86,-183,-145,-104,-132,-27,-752
68,83,6,-155,-50,-113,-91,45,-207
-4,22,-22,-78,-33,-30,-22,2,-165
38,17,25,-11,54,-13,-15,12,107
-15,-5,-8,-29,-19,-16,-6,-7,-105
-11,6,-7,-21,-18,-12,-4,-10,-77
-5,80,-53,-147,-150,-106,-160,27,-514
-9,11,-21,-39,-12,-32,-19,-18,-139
-16,-3,-31,-46,-18,-3,-23,8,-132
63,127,-53,-313,-39,-200,-103,23,-495
-15,19,-19,-100,-35,-25,-36,-5,-216
-9,30,-15,-6,-18,-15,-15,-16,-64
-18,26,-14,-12,-17,-11,-14,-14,-74
-59,16,-55,-130,-22,-32,-73,-71,-426
-3,24,-56,-147,-112,-131,-87,-76,-588
-3,56,-37,-47,-14,-7,-63,-16,-131
-26,18,-37,-115,-83,-61,-83,-13,-400
-7,-10,-15,-20,-19,-3,-19,-9,-102
117,40,9,53,-36,-3,32,-25,187
1,18,-9,-4,-20,-13,-17,33,-11
-6,62,-40,-134,-130,-157,-157,20,-542
0,8,-12,-26,-14,-14,-16,-14,-88
19,95,-94,-122,-117,-129,-114,-84,-546
0,7,-1,-35,-25,-30,-19,-9,-112
25,90,-27,-262,-50,-218,-165,3,-604
-17,2,-10,-33,-12,-10,-10,-8,-98
26,16,-7,-4,-22,-24,-13,-17,-45
138,49,64,47,86,-30,-30,69,393
-15,251,-65,-311,-69,-110,-182,-20,-521
-97,-43,-137,-193,-177,-90,-169,-22,-928
-38,251,-125,-197,-39,27,-216,110,-227
-30,-3,-28,-107,-91,-61,-53,-17,-390
-25,-3,-25,-51,-15,6,-16,2,-127
-24,7,-15,-56,-30,-30,-31,-10,-189
-21,18,-38,-92,-40,-50,-33,-15,-271
-16,23,4,-111,-75,-75,-57,-27,-334
-4,7,2,-22,-14,-18,-7,9,-47
12,12,4,-34,-69,-40,-24,-2,-141
-26,-23,-13,-85,-59,-59,-52,-19,-336
-19,-17,-7,-27,-31,-18,-18,7,-130
-11,-7,-8,-64,-53,-66,-19,-29,-257
-5,-7,-11,-28,-38,-24,-29,-16,-158
-26,5,-15,-107,-93,-55,-74,-24,-389
51,119,4,8,22,56,87,29,376
-2,38,9,-55,-26,-16,0,-3,-55
-16,-1,-14,-33,-26,-24,-17,-4,-135
-86,162,-31,-312,-201,-150,-208,79,-747
-5,41,-12,-120,-91,-62,-94,-14,-357
-1,16,-30,-126,-93,-76,-62,-4,-376
-11,41,-46,-87,-72,-53,-84,-12,-324
61,64,23,-85,-44,-93,-26,8,-92
-35,8,-109,-199,-171,-179,-216,-108,-1009
-2,-10,11,-19,-42,-12,-10,2,-82
28,31,-14,-31,-31,-39,-10,-15,-81
-22,-20,-13,-29,-48,-12,-24,13,-155
-15,5,11,-17,-6,-4,7,5,-14
-8,43,-8,-27,-11,3,21,7,20
-3,17,-23,-107,-22,-73,-53,3,-261
-10,8,-15,-44,-30,-20,-19,0,-130
-14,0,-37,-41,-49,-16,-30,-20,-207
-26,10,-28,-51,-42,-18,-43,-9,-207
-15,-9,-17,-24,-21,-20,-26,8,-124
-23,-24,-25,-47,-53,-48,-31,-13,-264
-36,5,-2,-58,-41,-35,-14,-10,-191
7,19,13,6,6,-1,17,4,71
3,34,13,-66,-22,-51,8,28,-53
74,30,-11,-12,13,-21,-26,-10,37
-7,-14,-1,-38,-50,-26,-17,-6,-159
-2,-4,-6,0,-6,-3,-2,-1,-24
263,140,109,12,31,-120,-150,-20,265
99,65,33,-216,-9,-193,-91,31,-281
143,32,-4,-86,-128,-202,-114,48,-311
-53,3,-73,-185,-70,-119,-86,-25,-608
18,45,-15,-102,-38,-92,-65,5,-244
-31,4,-17,-60,-47,-26,-53,-21,-251
17,18,11,-17,3,-18,-30,5,-11
-69,54,-93,-243,-147,-162,-140,36,-764
63,16,21,-23,19,-10,-17,27,96
63,16,21,-23,19,-10,-17,27,96
63,16,21,-23,19,-10,-17,27,96
63,16,21,-23,19,-10,-17,27,96
63,16,21,-23,19,-10,-17,27,96
-62,-27,-55,-135,-77,-46,-63,-14,-479
-62,-27,-55,-135,-77,-46,-63,-14,-479
52,28,-11,-102,-12,-37,-56,20,-118
-2,4,-22,-14,-52,-16,-48,7,-143
-1,81,-64,-170,-105,-54,-126,93,-346
77,14,-2,-68,-109,-178,-102,-39,-407
180,94,23,-71,64,-27,-32,117,348
-27,1559,104,-1095,39,-617,-1893,1063,-867
89,116,-66,-69,-176,-134,-152,2,-390
32,22,-12,-101,-42,-82,-79,11,-251
-37,110,-96,-117,-145,-37,-109,36,-395
284,460,76,-722,-665,-599,-589,316,-1439
239,181,-288,-924,-1042,-1076,-959,-13,-3882
-210,242,-355,-578,-612,-191,-525,375,-1854
116,133,7,-106,-6,-131,-97,-20,-104
124,137,8,-99,3,-122,-96,-16,-61
-15,-10,-32,-100,-84,-48,-65,1,-353
58,126,-30,-251,-156,-213,-161,-52,-679
-1,18,-24,-77,-45,-55,-40,9,-215
0,6,-17,-57,-45,-22,-36,-8,-179
17,54,-43,-254,-42,-171,-147,-6,-592
123,149,37,-89,-69,-160,-46,60,5
61,90,-19,-108,12,-110,-85,30,-129
49,37,46,32,10,12,3,44,233
-38,56,-36,-115,-10,-56,1,12,-186
-76,-49,-78,-195,-112,-110,-128,-65,-813
-75,21,-69,-274,-256,-101,-209,12,-951
-181,-37,-170,-355,-295,-164,-306,-4,-1512
-121,-23,-170,-329,-298,-199,-235,-45,-1420
-2,12,2,-9,-2,15,-2,-7,7
-58,-37,-36,-109,-102,-55,-38,43,-392
-11,15,-44,-95,-55,-48,-58,9,-287
73,-5,28,-24,-12,-71,-55,6,-60
-37,8,-21,-81,-35,-44,-28,-17,-255
-36,-26,-13,-50,-43,-15,-32,-19,-234
-15,-4,8,-52,-105,-46,-74,-5,-293
-8,-13,-34,-71,-90,-65,-91,-19,-391
-106,15,-81,-326,-328,-127,-110,-30,-1093
0,-15,-6,-61,-104,-60,-42,-1,-289
34,-2,19,-14,-9,-49,-25,2,-44
-36,-13,-44,-125,-52,-57,-70,-30,-427
-73,-15,-51,-129,-65,-65,-68,-43,-509
-23,5,-31,-101,-69,-68,-57,-25,-369
-22,5,-36,-87,-50,-55,-57,-32,-334
-30,26,-45,-159,-104,-107,-76,-51,-546
-37,48,-33,-166,-47,-89,-66,16,-374
44,55,18,-8,-17,-6,-20,0,66
98,35,35,-3,26,-64,-79,27,75
-44,-5,-90,-177,-152,-129,-173,-131,-901
-25,25,-19,-56,-25,-47,-35,10,-172
-87,-127,-252,-403,-419,-284,-380,-143,-2095
42,64,-32,-122,-4,-120,-79,30,-221
94,115,-16,-153,-94,-168,-182,-61,-465
-15,28,-13,-38,-20,19,-8,-3,-50
-28,70,-75,-281,-139,-125,-157,-76,-811
-17,-7,-42,-53,-50,-26,-56,-18,-269
-26,10,-20,-83,-80,-29,-48,-19,-295
178,148,62,31,38,67,44,102,670
-66,-46,-79,-228,-242,-75,-94,52,-778
-60,-16,-61,-139,-84,-46,-57,11,-452
-39,-24,-40,-119,-63,-57,-64,27,-379
-55,-28,-45,-119,-79,-34,-78,19,-419
-140,-11,-132,-301,-190,-189,-212,-81,-1256
19,-4,-15,-153,-124,-134,-110,-7,-528
-116,-3,-209,-573,-484,-418,-445,-10,-2258
31,27,-6,-89,-10,-60,-28,26,-109
-18,101,-47,-134,-35,-61,-30,91,-133
10,9,8,-13,9,-12,-2,0,9
16,34,-27,-108,-125,-143,-91,-59,-503
8,9,-3,-12,-11,-17,-7,1,-32
-49,-20,-61,-156,-131,-97,-114,-25,-653
-1,25,11,-45,-43,-38,-3,20,-74
-115,95,-225,-554,-555,-435,-449,-328,-2566
45,11,11,-1,-53,9,-22,51,51
32,45,-43,-116,-44,-101,-86,-14,-327
111,7,4,-56,-75,-140,-65,-82,-296
17,34,-16,-34,-3,-4,25,54,73
13,61,-48,-122,-58,-114,-115,-9,-392
-378,-139,-375,-601,-413,-185,-428,-69,-2588
4,62,43,-75,-49,-89,-8,83,-29
-18,10,-22,-52,-20,-26,-32,-11,-171
77,34,22,-87,-75,-86,-86,67,-134
64,11,38,-71,-42,-98,-91,58,-131
53,58,21,-125,-48,-93,-76,28,-182
-57,-27,-79,-133,-107,-73,-93,6,-563
-20,9,-38,-98,-67,-50,-54,4,-314
-13,13,-42,-122,-99,-77,-95,-35,-470
-43,-46,-66,-180,-94,-130,-139,-35,-733
-52,-9,-96,-235,-166,-207,-135,-71,-971
9,3,-11,-24,-29,-15,-12,-12,-91
-39,3,-48,-58,-45,-38,-73,0,-298
8,-35,-32,-42,-77,-37,-58,4,-269
-13,17,-3,-27,-30,-16,-21,-7,-100
45,696,-161,-902,-465,-591,-304,205,-1477
11,34,-31,-88,-69,-52,-87,-12,-294
8,14,-8,-17,-31,-32,-18,-4,-88
8,4,-12,-14,-41,-23,-36,-3,-117
5,4,-13,-61,-68,-68,-31,3,-229
144,258,-15,-179,11,-93,-67,115,174
56,7,3,-45,-10,-73,-60,47,-75
161,217,90,66,23,-23,-120,45,459
9,15,-55,-70,-136,-85,-79,-6,-407
-17,-28,-23,-37,-41,-30,-43,6,-213
-22,-26,-21,-33,-35,-25,-41,5,-198
-60,0,-82,-136,-135,-78,-106,15,-582
-61,-1,-107,-162,-141,-97,-149,-47,-765
13,20,-7,-38,-31,-37,-25,8,-97
-23,35,-20,-126,-44,-55,-38,14,-257
-173,-68,-308,-599,-381,-309,-416,107,-2147
-93,-45,-77,-155,-109,-60,-121,10,-650
-61,-28,-96,-133,-121,-108,-142,-62,-751
-49,-31,-44,-146,-96,-55,-88,24,-485
-23,-13,-74,-207,-123,-126,-96,-43,-705
88,106,10,-208,5,-111,-52,87,-75
-13,23,-17,-117,-257,-102,-136,-19,-638
-57,41,-101,-295,-306,-123,-192,-2,-1035
3,39,-68,-190,-47,-133,-100,13,-483
-10,99,-25,-182,-119,-105,-33,16,-359
315,198,210,218,192,61,-48,181,1327
-13,53,-33,-134,-34,-73,-78,-34,-346
94,64,20,6,-81,-86,-69,-54,-106
36,38,8,-51,-7,-7,-45,23,-5
55,12,-22,-32,-11,-59,-55,4,-108
-3,111,-43,-276,-47,-155,-101,69,-445
942,500,620,272,636,278,-55,316,3509
-69,-6,-115,-165,-187,-111,-193,-3,-849
-99,-2,-82,-262,-137,-96,-91,13,-756
25,98,-68,-306,-170,-219,-171,-49,-860
12,50,-65,-195,-58,-106,-136,105,-393
24,9,-18,-142,-99,-109,-142,53,-424
10,19,-5,-20,-5,-9,-13,-8,-31
-23,117,-1,-208,-74,-104,-37,-45,-375
13,15,-4,-11,-25,-11,-9,-9,-41
92,85,52,-89,68,-56,-66,92,178
78,34,23,-82,18,-78,-70,17,-60
-19,-20,-40,-98,-106,-66,-75,-17,-441
56,33,5,-137,-83,-66,-38,46,-184
-37,-17,-51,-88,-128,-73,-135,-18,-547
-47,29,-76,-212,-92,-77,-98,-7,-580
29,32,0,-101,-102,-77,-72,-44,-335
-96,41,-84,-201,-132,-72,-120,-4,-668
-34,15,-38,-146,-135,-67,-57,-12,-474
-43,-8,-98,-146,-132,-107,-148,-33,-715
-46,-43,-65,-238,-221,-166,-154,-19,-952
4,1,-4,-32,-9,-27,-27,-12,-106
-28,23,-42,-61,-31,-31,-36,-18,-224
-380,341,-262,-962,-184,-132,-476,-315,-2370
-43,55,16,-232,-126,-75,-55,64,-396
68,-5,16,-206,-182,-165,-123,43,-554
14,16,-23,-93,-115,-46,-72,8,-311
31,128,8,-151,-9,-80,-59,94,-38
-21,-31,-69,-123,-95,-120,-120,-62,-641
-11,8,-4,-13,-6,-7,-14,-3,-50
-33,8,-15,-98,-88,-79,-64,7,-362
-17,19,-19,-48,-10,-33,-26,0,-134
45,176,15,-35,32,-21,34,69,315
-41,72,-18,-107,-27,-64,-64,8,-241
1113,685,731,13,408,133,-165,339,3257
53,29,0,-109,-168,-134,-99,48,-380
-15,120,-12,-179,-181,-51,-143,179,-282
130,187,-9,-122,-55,-57,-42,104,136
129,157,23,-64,-77,-20,-22,100,226
-71,80,-51,-192,-145,-21,-120,89,-431
5,1589,71,-1519,-82,-655,-1382,1007,-966
-14,49,-53,-116,-60,-77,-86,-26,-383
-10,-8,-17,-37,-18,-40,-32,-11,-173
38,40,16,4,-28,-24,2,-2,46
-26,-21,13,-56,-51,-33,-23,8,-189
42,38,40,-42,-28,-16,-51,64,47
0,24,-7,-95,-72,-37,-44,26,-205
9,14,7,-15,-15,-18,-31,-10,-59
-1,5,-16,-37,-42,-43,-31,-13,-178
53,48,-9,-109,-37,-117,-72,30,-213
-65,-25,-75,-170,-129,-93,-125,-34,-716
-74,-34,-52,-124,-94,-50,-94,-1,-523
6,6,-28,-39,-3,-8,-10,-16,-92
-12,14,-34,-112,-52,-48,-53,-1,-298
-62,17,-98,-295,-201,-143,-137,-28,-947
132,108,-6,-232,-47,-199,-145,-39,-428
24,55,-32,-67,-73,-26,-57,-14,-190
-50,-43,-68,-169,-179,-97,-153,-38,-797
-1292,644,-193,-1625,31,-367,-2135,423,-4514
-13,23,-46,-101,-53,-79,-59,-91,-419
83,31,-13,-84,-57,-89,-77,-68,-274
0,37,-97,-328,-315,-325,-253,-155,-1436
-46,17,-21,-106,-46,-10,-12,-11,-235
-8,149,-101,-290,-218,-72,-119,34,-625
-73,-30,-58,-167,-92,-126,-140,-59,-745
20,57,29,-70,39,-85,-91,45,-56
241,380,58,-179,-158,-69,31,139,443
45,37,43,-42,-34,-29,-53,59,26
-2,-6,-34,-90,-112,-79,-86,-28,-437
-25,18,-37,-47,-28,17,-34,62,-74
-439,752,-850,-2130,-1066,-1066,-1409,-503,-6711
-17,-21,-48,-58,-34,-40,-42,-31,-291
37,-4,-4,-59,14,-33,-19,11,-57
123,62,52,86,-31,-115,-95,-61,21
10,33,11,-54,-75,-52,-35,36,-126
80,116,7,-115,38,-67,-29,86,116
65,150,-39,-216,8,-135,-65,89,-143
-40,-21,-46,-119,-106,-68,-51,-31,-482
-36,-36,-43,-54,-63,-30,-52,0,-314
-4,-18,-31,-72,-101,-76,-62,-9,-373
306,782,41,-899,-54,-517,-262,565,-38
-33,40,-85,-201,-42,-116,-109,48,-498
5,29,-110,-167,-174,-161,-137,-162,-877
-25,20,-47,-102,-86,-54,-68,-36,-398
-47,154,-41,-243,-53,-100,17,109,-204
22,110,7,-144,-107,-113,-90,-83,-398
-11,0,-13,-30,-25,-10,-28,6,-111
22,36,-75,-90,-66,-103,-107,-88,-471
-1,23,1,-21,12,2,-8,18,26
-28,75,-21,-66,-25,-60,-62,-25,-212
-13,36,-27,-114,-90,-108,-94,-68,-478
-47,-10,-70,-159,-143,-115,-161,-17,-722
-22,148,-70,-283,-191,-160,-93,59,-612
12,97,-109,-236,-165,-212,-224,-84,-921
4,76,-80,-215,-146,-198,-195,-104,-858
-26,27,-34,-85,-5,-23,-43,39,-150
381,135,238,158,232,140,-37,132,1379
-61,73,-103,-210,-130,-71,-75,2,-575
-20,1,-33,-120,-129,-139,-123,-27,-590
132,72,38,46,-113,-146,-61,-15,-47
-91,53,-56,-135,-50,-5,-50,-77,-411
-87,37,-44,-136,-51,-21,-53,-55,-410
-24,58,-68,-157,-36,-50,-50,56,-271
-99,31,-70,-130,-67,12,-38,-55,-416
-119,63,-58,-164,-100,-56,-77,-61,-572
64,33,0,-106,-37,-104,-71,-56,-277
188,71,76,27,144,13,16,89,624
73,-4,-13,-116,-31,-68,-69,46,-182
42,63,-3,-60,-36,-54,-27,-59,-134
-12,-40,-59,-109,-136,-99,-116,12,-559
28,-15,-32,-131,-107,-74,-97,41,-387
125,122,14,-332,-126,-218,-203,23,-595
-160,61,-195,-470,-456,-195,-322,54,-1683
-91,13,-169,-315,-253,-240,-257,-116,-1428
26,55,-1,-56,-68,-88,-93,-64,-289
128,354,-44,-128,-57,-42,-355,67,-77
47,41,-20,-132,-61,-116,-121,9,-353
62,70,-26,-174,-99,-138,-145,18,-432
69,60,-12,-121,-89,-134,-131,12,-346
53,45,-17,-145,-86,-108,-114,29,-343
28,3,6,-44,-27,-49,-16,-17,-116
9,-26,-6,-61,-31,-62,-27,-4,-208
35,38,-29,-88,-102,-118,-122,4,-382
-63,-30,-70,-188,-81,-40,-97,-37,-606
-3,2,-27,-16,-21,-12,-21,-17,-115
-37,28,-64,-132,-68,-62,-88,-12,-435
-20,-11,-41,-82,-51,-50,-41,-10,-306
-25,-10,-1,-47,-32,-23,-16,15,-139
-66,-11,-90,-163,-145,-116,-135,-3,-729
51,65,2,-95,-1,-66,-52,111,15
-6,33,-18,-63,-5,-2,-52,39,-74
17,71,-102,-360,-198,-237,-286,-20,-1115
-9,12,-21,-46,-58,-39,-46,-27,-234
-35,-19,-46,-62,-70,-46,-55,-16,-349
-31,-6,-20,-97,-126,-63,-79,33,-389
-1,-3,-2,-40,-27,-40,-12,3,-122
-12,38,-56,-97,-42,-56,-61,-57,-343
-66,7,-108,-236,-143,-95,-107,-13,-761
-31,0,-39,-195,-141,-121,-107,-3,-637
-15,47,-18,-59,-28,-58,-33,3,-161
-15,32,-41,-174,-60,-80,-77,84,-331
157,32,8,-96,-34,-170,-75,-25,-203
-8,-1,-4,-32,-23,-6,-19,29,-64
-18,-8,-55,-88,-126,-104,-118,-43,-560
-45,10,-77,-244,-180,-193,-197,-29,-955
107,121,-48,-233,-160,-252,-203,-43,-711
-209,159,-114,-308,-158,-75,-158,-181,-1044
-28,14,-37,-140,-116,-77,-86,12,-458
4,89,-37,-123,-92,-132,-116,-23,-430
-35,115,-27,-152,-65,-114,14,31,-233
-56,5,-59,-204,-207,-131,-166,21,-797
-4,22,-3,-95,-130,1,-23,18,-214
-44,3,-86,-152,-122,-24,-72,-17,-514
1,188,15,-151,-3,41,91,-61,121
120,144,49,-278,-197,-77,-212,248,-203
-35,48,-105,-189,-152,-115,-96,-114,-758
-86,-9,-85,-176,-75,-50,-107,14,-574
14,15,-29,-80,-87,-86,-64,-36,-353
110,26,38,10,-50,-82,-39,-27,-14
7,32,-53,-182,-117,-167,-142,-51,-673
-64,-17,-107,-117,-160,-96,-176,-1,-738
-2,41,13,-32,15,-31,-10,30,24
-9,37,-37,-171,-118,-103,-118,63,-456
1,30,-23,-109,-81,-69,-58,46,-263
7,6,2,-3,-14,-17,0,6,-13
-179,32,-129,-368,-626,-244,-311,40,-1785
-104,3,-75,-245,-46,-59,-78,-14,-618
-21,10,-26,-132,-43,-67,-52,40,-291
-45,57,-53,-176,-8,-66,-88,-60,-439
-67,31,-179,-304,-123,-182,-232,-77,-1133
-16,9,-59,-218,-161,-55,-122,31,-591
-14,10,-29,-47,-40,-29,-60,4,-205
-50,23,-16,-139,-105,-57,-60,7,-397
-26,12,-15,-82,-84,-47,-78,15,-305
-1,24,-21,-28,-18,-26,-35,17,-88
-55,-2,-46,-165,-81,-47,-72,43,-425
-42,110,-97,-275,-137,-138,-101,58,-622
-48,32,-65,-146,-137,-68,-70,15,-487
-74,17,-44,-190,-200,-97,-160,5,-743
14,11,3,-23,-20,-27,-6,1,-47
-39,29,-25,-115,-106,-46,-33,6,-329
-66,30,-111,-300,-277,-138,-211,-46,-1119
-37,-6,-43,-64,-25,-3,-22,-33,-233
-23,33,-19,-76,-69,-59,-80,60,-233
51,108,29,-87,30,-81,-66,65,49
32,42,2,-43,-4,-9,-40,20,0
47,59,-62,-198,-142,-145,-158,-16,-615
-47,-12,-42,-80,-66,-43,-76,-10,-376
51,45,5,-97,-38,-136,-91,-22,-283
-42,0,-52,-148,-112,-84,-109,30,-517
-92,10,-129,-266,-192,-169,-221,-73,-1132
-30,10,-31,-79,-40,-29,-27,-1,-227
-34,2,-39,-94,-97,-55,-67,-7,-391
25,33,-11,-65,-103,-42,-52,1,-214
66,73,47,-14,9,-24,-59,3,101
20,-3,-17,-50,-117,-61,-59,-39,-326
39,58,-20,-36,-38,-56,-40,-31,-124
53,63,8,-76,-6,-99,-94,61,-90
-110,63,-98,-182,11,-41,-61,-16,-434
-97,82,-88,-159,9,-49,-54,-24,-380
-3,60,8,-91,-54,-39,-27,56,-90
9,13,-46,-90,11,-78,-68,4,-245
-7,-1,-11,-35,-35,-7,-6,8,-94
41,18,12,-83,18,-47,-44,19,-66
173,123,49,84,-15,-74,-74,30,296
-59,-26,-90,-173,-100,-90,-105,-3,-646
-35,38,-44,-170,-39,-86,-68,-13,-417
-1,56,-17,-46,2,3,-26,9,-20
-28,19,1,-76,-46,-46,-20,10,-186
0,43,-25,-60,-27,-29,-40,17,-121
53,122,-16,-102,-68,-128,-124,-57,-320
-38,-1,-101,-234,-168,-163,-157,22,-840
744,482,480,162,476,216,-33,214,2741
-3,12,-27,-28,-11,-17,-24,30,-68
102,92,9,-303,-85,-266,-111,197,-365
-91,602,23,-763,119,-76,51,-202,-337
-24,26,-14,-48,-5,8,-7,-6,-70
-65,-6,-81,-118,-64,-64,-85,-25,-508
-38,61,-43,-173,-86,-153,-139,27,-544
53,56,8,-85,0,-86,-64,7,-111
-33,16,-45,-68,-45,-48,-25,-1,-249
1,-16,-5,-1,-20,-14,-44,32,-67
-26,-5,-34,-39,-20,-4,-23,-1,-152
-2,55,-112,-161,-128,-107,-82,-129,-666
-18,73,-5,-17,-25,21,-64,20,-15
-9,3,-11,-11,-9,-14,-10,-6,-67
78,39,15,-61,4,-31,-47,28,25
73,70,60,56,29,-45,-67,70,246
-33,10,-26,-58,-81,-28,-57,5,-268
2,13,-18,-40,-48,-38,-40,-41,-210
12,19,-8,-33,-64,-55,-52,-1,-182
35,33,-25,-77,-93,-78,-68,-23,-296
-17,21,-61,-145,-88,-99,-102,38,-453
-188,-81,-254,-620,-537,-412,-380,-20,-2492
12,57,-49,-86,-69,-82,-59,-66,-342
-14,42,-53,-95,-84,-48,-78,-9,-339
-86,-30,-117,-467,-154,-205,-234,39,-1254
-112,-58,-139,-454,-135,-210,-243,-1,-1352
98,-10,-3,-245,-34,-206,-184,-10,-594
-98,374,-167,-510,-732,-253,-522,241,-1667
21,24,35,-15,-31,-27,0,58,65
-40,-32,-76,-148,-58,-73,-84,-39,-550
-37,11,-57,-171,-77,-107,-89,-70,-597
-26,-17,-90,-171,-236,-185,-184,-137,-1046
5,76,-31,-249,7,-126,-26,43,-301
-5,13,-23,-39,-19,-18,-30,-17,-138
2,30,-23,-55,-18,-46,-46,-17,-173
12,207,51,-157,-38,-154,43,156,120
33,95,-62,-209,-182,-154,-101,44,-536
17,33,-9,-103,-112,-29,-67,71,-199
-8,3,-44,-114,-78,-73,-61,-19,-394
10,53,-34,-206,-150,-98,-168,32,-561
7,16,-19,-56,-110,-31,-62,-15,-270
28,67,-1,-108,-93,-163,-68,59,-279
-24,10,-51,-81,-35,-36,-47,10,-254
81,9,-29,-185,-116,-183,-180,-29,-632
-35,36,-83,-152,-231,-103,-185,-16,-769
98,316,-22,-355,-86,-237,-286,-143,-715
32,139,-36,-269,-74,-167,-156,-108,-639
27,38,-51,-132,-106,-136,-126,-35,-521
134,-1,46,-11,-57,-87,-71,71,24
-3,24,-54,-189,-153,-130,-117,-42,-664
7,12,-32,-65,-51,-61,-64,-2,-256
-184,-62,-213,-363,-308,-177,-315,-89,-1711
-80,-44,-90,-183,-98,-107,-142,-57,-801
-9,47,-47,-180,-135,-183,-126,-55,-688
15,74,-1,-113,18,-63,-23,36,-57
14,30,-36,-185,-95,-184,-121,30,-547
-66,57,-70,-177,-136,-67,-92,67,-484
1,14,-33,-59,-51,-31,-41,-18,-218
11,27,-40,-33,-22,-41,-40,-10,-148
0,4,-3,-48,-29,-39,-18,-8,-141
3,32,-6,-74,-14,-29,-43,16,-115
-51,13,-85,-127,-100,-34,-108,-14,-506
5,14,-17,-52,-53,10,-30,-23,-146
-94,26,-170,-357,-319,-246,-277,-98,-1535
0,5,-9,-25,-47,3,-22,27,-68
-44,-6,-75,-165,-93,-81,-93,3,-554
-36,119,-73,-165,-79,-32,1,67,-198
-73,59,-90,-322,-158,-161,-150,42,-853
-26,168,-115,-361,-96,-175,-131,32,-704
-35,74,-48,-213,-107,-167,-72,21,-547
-101,-6,-143,-275,-154,-147,-133,-25,-984
40,76,-3,-60,25,-32,-51,-19,-24
-79,52,-44,-182,-6,-66,-32,-10,-367
11,10,-7,-7,-25,-18,-23,-16,-75
-40,20,-52,-156,-115,-60,-84,-6,-493
-29,55,-49,-128,-129,-96,-98,-23,-497
-100,-22,-93,-163,-135,-50,-152,28,-687
-9,27,-62,-149,-126,-131,-109,-78,-637
-98,-3,-163,-287,-151,-169,-221,-105,-1197
-148,37,-55,-220,-69,-77,-95,-39,-666
-19,1,18,-40,-40,-45,-25,-16,-166
-74,41,-54,-149,-86,-65,-78,-39,-504
1,66,-23,-128,-45,-81,-57,19,-248
-14,45,-66,-197,-70,-93,-47,-19,-461
31,31,-19,-138,-151,-144,-144,-73,-607
120,81,45,-63,-67,-109,-95,8,-80
1,18,-39,-58,-60,-51,-35,16,-208
-120,-53,-129,-256,-155,-158,-194,-38,-1103
-22,-16,-12,-136,-47,-76,-78,10,-377
-67,3,-109,-195,-93,-68,-151,-9,-689
-242,-66,-304,-578,-476,-366,-510,-122,-2664
-67,-31,-87,-151,-120,-53,-96,37,-568
399,195,199,-256,214,-221,-202,224,552
632,1051,314,-260,261,1322,1167,368,4855
-84,50,-52,-155,-39,-61,-49,3,-387
-134,105,-185,-327,-77,-85,-82,57,-728
42,75,-11,-66,24,-34,-48,-21,-39
59,56,10,-115,-68,-123,-107,-23,-311
-37,14,-8,-62,-42,-34,-12,19,-162
-55,-10,-105,-172,-117,-101,-171,-13,-744
53,1,-52,-102,-140,-121,-126,-56,-543
20,21,-18,-23,-17,-31,-14,-4,-66
-12,56,-15,-30,12,-7,-18,4,-10
-81,-7,-86,-171,-82,-66,-117,-32,-642
-156,27,-201,-355,-190,-177,-221,-77,-1350
27,67,1,-54,-4,-40,-16,-8,-27
30,83,-51,-183,-81,-97,-119,38,-380
-8,12,-12,-27,-13,-20,-19,-3,-90
-5,28,-29,-55,-42,-48,-55,-28,-234
-29,-6,-13,-42,-4,-29,-26,-24,-173
-9,16,-9,-51,-38,-35,-25,-9,-160
-34,44,-37,-107,-59,-91,-79,2,-361
27,26,10,-105,21,-146,-52,52,-167
26,30,-58,-96,-81,-109,-77,-54,-419
-29,58,-70,-245,-62,-72,-62,-20,-502
-118,-51,-120,-251,-128,-95,-185,-13,-961
-24,4,-49,-79,-73,-61,-64,-29,-375
-21,24,-54,-133,-56,-53,-55,-25,-373
-30,-5,-38,-97,-46,-55,-61,-4,-336
6,15,-16,-24,-32,-54,-24,-27,-156
-19,56,-41,-150,22,-36,-9,2,-175
-52,-33,-73,-131,-101,-110,-83,-39,-622
-17,3,-15,-37,-24,-13,-32,2,-133
314,336,96,33,-233,-205,-7,-79,255
21,24,2,-68,-14,-59,-20,-11,-125
4,-1,-9,-12,-20,-17,-2,-7,-64
183,129,58,-41,30,-102,-57,29,229
-511,-7,-528,-1144,-641,-487,-720,-86,-4124
-15,4,-24,-31,-5,-12,-24,-11,-118
-4,44,-56,-121,-147,-94,-78,-30,-486
-33,-8,-39,-103,-86,-56,-64,-32,-421
-48,-2,-31,-93,-66,-57,-71,-28,-396
62,181,2,-271,-24,-161,-41,-46,-298
11,254,-38,-383,-52,-167,-132,-103,-610
16,44,-1,-15,2,-32,-3,6,17
-59,25,-19,-124,-98,-4,-66,-93,-438
17,72,-68,-271,-171,-254,-237,-49,-961
-10,17,-19,-25,-7,-17,-19,11,-69
120,73,29,-45,21,-104,-71,11,34
-105,65,-56,-177,-48,-78,-77,-35,-511
0,18,-10,-31,-26,-23,-11,1,-82
-10,34,-31,-92,-103,-127,-92,-34,-455
-13,4,-4,-27,-22,-4,-24,8,-82
-71,115,-38,-186,-55,14,-20,-37,-278
-46,8,-28,-112,-111,-50,-60,22,-377
-52,-22,-55,-114,-74,-85,-91,-15,-508
0,10,-5,-59,-126,-77,-51,8,-300
-69,-23,-16,-150,-95,-34,-77,16,-448
-50,7,-105,-244,-188,-183,-245,-77,-1085
-58,46,-133,-389,-327,-252,-224,-46,-1383
529,252,255,138,253,-104,-99,195,1419
65,26,10,-39,-31,-87,-42,-16,-114
32,29,-25,-52,-19,-33,-1,-10,-79
4,19,-51,-77,-60,-67,-43,-27,-302
1,9,-39,-41,-51,-35,-50,-41,-247
-16,20,-17,-124,-122,-122,-91,-12,-484
20,10,9,-32,21,-26,-24,17,-5
-32,-46,-39,-96,-126,-52,-102,1,-492
1,-53,-21,-87,-57,-101,-90,-14,-422
-8,-31,-31,-97,-103,-116,-92,-22,-500
-53,-20,-37,-95,-66,-18,-76,7,-358
-18,4,-42,-107,-76,-75,-78,-31,-423
-32,-4,-39,-104,-59,-50,-56,-22,-366
-95,36,-121,-482,-342,-334,-292,-46,-1676
-4,0,-37,-62,-83,-48,-67,12,-289
16,183,-87,-446,-151,-254,-206,73,-872
-113,138,-213,-497,-184,-350,-340,-120,-1679
-165,-117,-205,-390,-285,-231,-298,-100,-1791
-111,-1,-231,-449,-309,-345,-335,-154,-1935
-63,25,-128,-418,-183,-281,-329,-80,-1457
62,123,-63,-273,-186,-257,-252,-46,-892
203,252,21,-398,-16,-283,-134,140,-215
179,106,55,-15,51,-107,-82,117,304
-24,28,-100,-190,-251,-207,-195,-124,-1063
-77,173,-110,-587,-322,-392,-232,22,-1525
-76,45,-153,-288,-222,-196,-270,38,-1122
-37,3,-51,-98,-91,-64,-63,5,-396
39,-31,-12,-47,-73,-82,-86,-22,-314
62,16,5,-74,6,-71,-32,-17,-105
5,82,-32,-102,-70,-70,-25,20,-192
-1,16,-2,-27,-23,-2,4,-11,-46
72,60,13,-53,-11,-67,-16,-12,-14
-41,6,-39,-139,-70,-53,-76,38,-374
127,596,-94,-606,-217,-353,-314,112,-749
-18,19,-9,-32,-68,-34,-59,60,-141
31,34,-63,-326,-186,-274,-232,23,-993
48,83,-22,-253,23,-187,-101,40,-369
303,441,299,86,-56,-179,-294,209,809
-34,14,-26,-90,-75,-59,-46,15,-301
-21,11,-34,-88,-80,-79,-51,-20,-362
35,478,-59,-702,-177,-159,-181,403,-362
29,26,-11,-52,-86,-102,-78,14,-260
-42,36,-47,-151,-58,-69,-111,31,-411
53,81,15,-9,-10,-100,-101,6,-65
-35,99,-52,-251,-117,-100,-183,-49,-688
-10,23,-22,-58,-34,-21,-29,-25,-176
-47,7,-27,-104,-71,-46,-55,4,-339
13,24,-33,-120,-127,-110,-57,-6,-416
-21,29,-81,-282,-135,-185,-146,-78,-899
56,141,5,-209,-22,-169,-137,-5,-340
46,53,-3,-105,29,-50,-94,83,-41
-42,-63,-50,-189,-203,-94,-140,70,-711
-28,-3,-73,-198,-134,-38,-87,69,-492
-38,24,-77,-253,-163,-143,-178,49,-779
27,29,12,-17,-61,-47,-27,-7,-91
68,116,-14,-129,-122,-211,-74,50,-316
-6,105,-74,-385,-208,-233,-176,-30,-1007
-24,27,-53,-106,-57,-76,-56,-69,-414
-38,110,-92,-324,-176,-177,-171,130,-738
-39,55,-84,-205,-231,-103,-142,-11,-760
-54,-60,-91,-125,-178,-84,-97,63,-626
-54,-4,-59,-160,-99,-103,-103,-35,-617
133,401,-8,-402,-30,-234,-99,230,-9
-16,68,-23,-190,-85,-70,-123,15,-424
-23,-46,-30,-94,-119,-127,-110,-13,-562
-28,4,-68,-135,-102,-101,-133,-53,-616
40,68,-54,-124,-100,-148,-101,-81,-500
-44,78,-78,-165,-96,-65,-53,-37,-460
-60,53,-30,-120,-19,-39,-47,-5,-267
-12,30,-18,-78,-39,-10,-4,3,-128
-5,32,-31,-122,-43,-50,-50,-13,-282
214,169,94,47,56,-30,-72,53,531
-17,16,-16,-74,-51,-28,-46,-7,-223
-64,-3,-83,-127,-118,-44,-98,-6,-543
-31,75,-61,-162,-71,-96,-81,-6,-433
18,98,-71,-282,-242,-110,-153,214,-528
-32,31,-41,-89,-25,-47,-45,-7,-255
-48,332,-177,-650,-281,-360,-328,154,-1358
0,16,-12,-54,-49,-26,-35,19,-141
38,0,-14,-115,-97,-126,-89,43,-360
-41,3,-79,-201,-189,-168,-150,-65,-890
-31,37,-78,-136,-97,-96,-83,-70,-554
1,60,-21,-152,-123,-116,-87,-59,-497
89,55,47,19,34,-50,-62,31,163
116,59,13,31,4,-129,-83,54,65
197,77,52,46,-19,-118,-90,50,195
75,25,3,-97,-68,-128,-57,-16,-263
62,36,32,-57,65,-40,-35,77,140
87,17,10,-38,-9,-78,-56,-2,-69
99,683,-198,-924,-458,-494,-363,238,-1417
-35,5,-21,-203,-152,-76,-94,80,-496
43,14,-9,8,-60,-63,-44,-2,-113
-31,-11,-82,-215,-145,-102,-130,45,-671
28,77,-100,-229,-148,-200,-172,21,-723
109,162,14,-227,-9,-216,-175,138,-204
13,28,1,-66,-25,-32,-21,11,-91
-25,-9,-27,-45,-41,-29,-30,-16,-222
-86,31,-89,-252,-124,-113,-148,-24,-805
-39,-4,-94,-190,-111,-165,-141,-42,-786
-27,22,-27,-84,-37,-41,-60,-28,-282
-17,14,-22,-69,-51,-33,-25,18,-185
28,58,-14,-59,-7,-54,-32,12,-68
-61,184,-53,-257,-9,-67,-123,32,-354
-14,-3,-17,-42,-47,-34,-15,-17,-189
-50,-79,-50,-155,-184,-91,-122,-66,-797
-42,-12,-65,-69,-77,-41,-78,-32,-416
-51,6,-110,-237,-174,-135,-192,-2,-895
-69,-39,-90,-238,-255,-173,-207,-30,-1101
-15,1,-31,-60,-41,-32,-45,-12,-235
31,204,-87,-359,-264,-301,-248,7,-1017
0,4,-12,-55,-109,-82,-76,-11,-341
4,-2,-9,-14,-11,-18,-15,-1,-66
-151,-31,-155,-425,-198,-138,-204,-15,-1317
-108,9,-197,-262,-163,-146,-245,24,-1088
-44,-44,-56,-67,-63,-47,-76,-12,-409
32,538,-194,-499,-151,-340,-280,149,-745
77,208,-97,-357,-15,-241,-106,168,-363
55,68,-13,-97,-124,-137,-88,19,-317
-53,-17,-96,-128,-121,-153,-162,-66,-796
-34,20,-13,-96,-85,-29,-76,23,-290
-67,78,-162,-320,-189,-179,-149,-89,-1077
-34,-5,-30,-112,-50,-49,-60,44,-296
-26,67,-60,-179,-162,-114,-109,-48,-631
-34,-4,-65,-181,-116,-138,-145,-38,-721
-89,92,-47,-151,-12,66,41,-25,-125
39,36,18,-20,-80,-91,-71,14,-155
37,16,13,1,16,-5,12,24,114
32,16,15,-1,16,-3,15,21,111
35,14,12,2,19,0,13,22,117
34,16,10,3,15,-2,10,23,109
-1,3,-4,-11,-8,-8,-15,-2,-46
-149,37,-284,-430,-220,-191,-258,-96,-1591
6,48,-42,-115,-56,-92,-64,-35,-350
-23,-15,-38,-88,-44,-29,-35,-27,-299
-156,-89,-182,-573,-546,-397,-444,-11,-2398
27,-3,-62,-94,-117,-91,-82,-68,-490
-45,-28,-51,-101,-86,-59,-89,-27,-486
90,29,6,-134,67,-73,-33,62,14
-23,-9,-47,-97,-123,-134,-133,-45,-611
-4,-19,-76,-146,-211,-158,-146,-9,-769
-8,6,5,-44,-42,-49,-36,47,-121
13,71,-63,-115,-171,-99,-84,-52,-500
-29,87,-43,-132,-15,-54,-61,15,-232
8,64,-31,-178,-79,-131,-137,41,-443
62,167,-12,-152,-35,-45,-15,11,-19
-3,34,-27,-125,-89,-98,-72,49,-331
1,6,-14,-22,-23,-19,-26,4,-93
-69,64,-63,-145,-86,-60,-111,-17,-487
-5,27,-23,-96,-70,-103,-100,-12,-382
154,-133,37,69,43,103,-40,193,426
30,-1,-8,-108,-32,-48,-47,68,-146
-20,46,-26,-74,-71,-44,-4,-38,-231
-27,13,-21,-69,-92,-41,-48,10,-275
24,148,17,-107,1,-32,26,85,162
-162,225,-249,-486,-143,-296,-258,-15,-1384
-58,3,-39,-168,-114,-103,-93,-6,-578
-16,6,-31,-125,-89,-92,-88,-31,-466
12,177,-54,-320,-127,-270,-216,-122,-920
-44,27,-32,-124,-9,16,-36,16,-186
-23,29,-37,-170,-129,-96,-130,30,-526
-30,34,-30,-73,-36,-76,-59,-40,-310
76,86,49,34,-15,2,1,80,313
109,94,69,79,13,54,-6,36,448
-9,34,-31,-140,-60,-48,-46,8,-292
-15,-2,-32,-70,-34,-64,-75,-26,-318
-28,-8,-20,-55,-76,-24,-47,-6,-264
7,26,-31,-49,-46,-60,-38,-32,-223
-24,3,-44,-83,-63,-49,-50,-36,-346
-29,-3,-41,-90,-81,-57,-79,21,-359
88,-11,13,-133,-78,-162,-160,22,-421
-15,-4,-18,-31,-12,-16,-17,-15,-128
-20,31,-28,-137,-68,-50,-55,-11,-338
-74,-13,-147,-220,-141,-143,-200,-106,-1044
9,36,-4,-17,-24,-4,10,-4,2
-31,25,-12,-100,-50,-26,-62,13,-243
-15,25,-31,-110,-83,-64,-75,15,-338
41,19,-26,-278,-31,-160,-145,28,-552
-21,66,-122,-192,-214,-178,-176,-104,-941
-97,158,-75,-325,-113,-85,-232,39,-730
121,56,6,-117,-44,-162,-94,-17,-251
5,23,-25,-108,-84,-96,-63,29,-319
-66,64,-61,-217,-156,-86,-75,-29,-626
138,39,-12,-86,-101,-178,-68,-92,-360
38,-1,-26,-165,-209,-191,-136,-34,-724
-17,57,-10,-74,-61,-30,-39,47,-127
-8,10,-57,-92,-98,-68,-86,-63,-462
-7,76,-71,-245,-186,-179,-260,106,-766
-38,76,-78,-250,-232,-108,-191,202,-619
61,49,23,-31,26,-11,-54,-5,58
-13,31,-42,-120,-69,-31,-75,-26,-345
45,20,-6,-37,-42,-59,-61,12,-128
-13,-1,-23,-58,-61,-42,-45,-29,-272
61,207,-44,-328,-215,-322,-241,42,-840
-46,31,-93,-220,-141,-91,-64,-70,-694
-17,18,-20,-86,-44,-78,-30,17,-240
-19,21,-45,-48,-5,-16,-37,1,-148
13,10,10,-15,-17,-29,-3,17,-14
-5,62,22,-111,-61,-99,6,67,-119
7,107,29,-117,-28,-116,7,108,-3
6,15,-18,-61,-16,-53,-31,-23,-181
-81,30,-114,-352,-211,-189,-210,67,-1060
-37,11,-31,-78,-50,-30,-38,10,-243
-48,-9,-73,-166,-97,-118,-121,-57,-689
28,49,-22,-91,-34,-93,-41,21,-183
81,101,-14,-87,-103,-151,-125,-20,-318
-18,14,-29,-76,-102,-64,-51,-9,-335
11,-48,-17,-148,-186,-147,-130,10,-655
-55,-9,-25,-83,-71,-34,-62,-9,-348
-13,-3,-25,-47,-21,-23,-39,-10,-181
24,22,40,-68,-20,-11,5,76,68
29,18,-36,-95,-27,-82,-109,-57,-359
-9,29,-93,-145,-104,-134,-149,-49,-654
-35,14,-11,-66,-55,4,-23,28,-144
-32,33,-43,-105,-38,-54,-78,-1,-318
-14,11,-20,-19,-11,-15,-31,-6,-105
-16,14,-20,-88,-85,-79,-79,-21,-374
-62,-12,-91,-160,-114,-111,-120,-49,-719
19,29,-41,-235,-189,-182,-138,-29,-766
-43,68,-70,-180,-26,-104,-49,-34,-438
51,20,-15,-70,-117,-78,-53,-6,-268
-433,95,-520,-1043,-616,-584,-745,-297,-4143
140,252,24,21,62,-41,51,198,707
49,18,-9,-63,-23,-84,-59,-51,-222
-32,28,-60,-167,-49,-114,-73,-12,-479
-8,18,-26,-56,-10,-38,-48,-25,-193
-95,-76,-108,-155,-143,-80,-133,-19,-809
-42,-14,-71,-104,-104,-87,-106,-55,-583
-36,10,-43,-95,-51,-44,-58,-16,-333
-13,-8,-40,-146,-116,-138,-119,7,-573
-37,-79,-48,-427,-365,-244,-215,166,-1249
-37,2,-79,-114,-76,-71,-120,-49,-544
4,144,-44,-177,-58,-87,2,35,-181
-9,-5,5,-21,-76,5,-37,25,-113
10,109,-80,-257,-242,-188,-202,74,-776
86,29,22,-5,-13,-79,-77,-8,-45
-27,42,-26,-73,-4,-15,-6,-5,-114
-8,5,-14,-96,-52,-8,-37,14,-196
-61,84,-41,-100,-21,-26,-52,31,-186
-22,0,-16,-60,-34,-41,-22,-7,-202
-87,-37,-93,-182,-111,-81,-126,-61,-778
10,-9,-28,-95,-157,-118,-106,-65,-568
-5,84,-84,-249,-178,-211,-202,20,-825
-7,23,-63,-157,-148,-136,-100,-50,-638
1,100,-101,-269,-95,-196,-192,-20,-772
-20,36,-36,-73,-52,-26,-51,17,-205
156,137,-7,-124,-3,-129,-93,111,48
-128,-54,-89,-275,-269,-184,-152,-4,-1155
-23,2,-35,-104,-72,-79,-56,-15,-382
-138,61,-314,-567,-366,-381,-436,-200,-2341
-56,89,-58,-144,-18,-67,-63,44,-273
3,15,-18,-23,-27,-10,-13,10,-63
-193,7,-255,-648,-483,-401,-411,-127,-2511
-5,16,-7,-32,-10,-2,-14,23,-31
-2,1,-4,-48,-26,-35,-28,-2,-144
12,27,-29,-80,-108,-29,-34,54,-187
-28,8,-57,-144,-115,-86,-56,14,-464
-86,5,-68,-270,-190,-212,-146,-28,-995
-40,72,-82,-168,-51,-75,-83,22,-405
-21,-12,-43,-88,-89,-63,-51,-44,-411
6,22,-55,-229,-118,-184,-118,-150,-826
4,101,-19,-91,-26,-96,-63,2,-188
45,39,-102,-166,-329,-166,-264,-101,-1044
41,58,-33,-112,-82,-124,-98,-49,-399
48,44,-30,-111,-142,-165,-121,-80,-557
-7,50,-31,-79,-43,-45,-42,9,-188
-67,209,-5,-216,-9,-78,111,142,87
448,344,109,-5,-140,-181,29,172,776
3,-4,-10,-57,-34,-21,-11,28,-106
-102,56,-154,-175,-105,-158,-169,-20,-827
23,54,3,-6,-29,-20,-51,46,20
74,94,19,-197,21,-46,-39,0,-74
7,82,-49,-147,-41,-73,-38,-37,-296
-228,356,-167,-771,-45,-43,-381,-220,-1499
7,34,-6,-21,-11,-4,6,-23,-18
-11,60,-37,-126,-95,-40,-85,34,-300
49,109,-30,-214,-36,-161,-170,-42,-495
4,10,-26,-52,-48,-21,-45,-1,-179
-27,41,-27,-102,-71,-33,-28,30,-217
39,71,-31,-44,-69,-10,-37,-28,-109
-25,-17,-54,-98,-82,-62,-70,2,-406
-77,152,-194,-655,-366,-395,-320,-117,-1972
101,-23,-8,-46,-49,-99,-55,-28,-207
-130,112,-94,-362,-165,-103,-179,-112,-1033
-38,-16,-81,-178,-126,-130,-158,-44,-771
103,49,21,-158,-49,-136,-87,108,-149
53,63,-23,-196,-68,-160,-118,-58,-507
-12,33,-25,-212,-160,-136,-124,-25,-661
-22,53,-97,-230,-116,-222,-193,-50,-877
60,52,-27,-116,-36,-101,-73,11,-230
-120,7,-103,-219,-114,-72,-111,9,-723
100,61,17,-155,41,-88,-44,133,65
53,11,-7,-72,-67,-90,-97,3,-266
46,9,-17,-81,-50,-102,-56,-37,-288
-43,-37,-123,-255,-237,-212,-225,-112,-1244
-31,27,-66,-138,-79,-74,-105,14,-452
-26,37,-56,-162,-67,-83,-108,6,-459
-32,0,-56,-57,-90,-26,-76,-8,-345
44,56,-26,-128,-76,-90,-123,25,-318
168,148,-22,-188,57,-166,-87,102,12
-86,-26,-81,-200,-140,-129,-117,-25,-804
41,68,-1,-52,-13,-54,-51,5,-57
13,0,-17,-18,-29,-31,-28,-15,-125
14,22,-31,-130,-55,-123,-77,-25,-405
-2,56,-40,-118,-79,-118,-93,-50,-444
-116,-17,-139,-277,-208,-148,-199,-8,-1112
-3,6,-47,-75,-49,-14,-57,-6,-245
2,21,8,-54,-75,-56,-42,38,-158
-43,-27,-45,-99,-63,-41,-73,-7,-398
23,57,-12,-83,-99,-96,-101,-42,-353
75,69,22,3,-18,-106,-78,-21,-54
-14,27,-7,-55,-9,-35,-18,2,-109
-1,10,-30,-53,-116,-75,-94,-24,-383
1,28,6,-46,-15,-34,1,6,-53
-108,149,-29,-306,-110,-189,23,86,-484
6,34,5,-32,-10,-20,-13,17,-13
-89,-6,-108,-163,-114,-109,-173,19,-743
-352,7,-451,-860,-560,-552,-762,-299,-3829
1,37,-12,-30,-1,-43,-35,3,-80
15,28,11,-30,-2,-12,-9,20,21
14,18,5,-23,-14,-17,-15,16,-16
4,52,-48,-118,-68,-78,-98,24,-330
-8,-11,-3,-55,-76,-3,-26,31,-151
-2,0,-40,-151,-125,-131,-115,-20,-584
-30,15,-57,-126,-122,-107,-80,-17,-524
-29,-10,-47,-114,-111,-85,-61,-30,-487
16,54,-10,-97,-80,-71,-88,-64,-340
33,53,-13,-66,3,-49,-48,52,-35
-52,16,-91,-251,-218,-196,-183,31,-944
-45,9,-98,-137,-134,-67,-86,-13,-571
-6,-9,-55,-159,15,-64,-70,-32,-380
24,56,7,-34,0,9,-11,49,100
-69,-9,-74,-126,-42,-52,-117,-13,-502
-16,21,-50,-98,-90,-61,-64,-17,-375
22,21,34,-55,-52,-62,11,-20,-101
17,37,2,-281,-167,-194,-172,8,-750
-155,-22,-222,-419,-314,-246,-288,-93,-1759
-23,-85,-77,-140,-177,-98,-171,39,-732
-7,63,-45,-183,-107,-132,-155,-47,-613
-9,-6,-29,-50,-36,-12,-18,12,-148
-24,80,-15,-158,-87,-91,-188,84,-399
6,55,56,-75,-45,-82,2,82,-1
15,50,-33,-130,-87,-84,-87,-29,-385
-48,13,-25,-102,-24,-15,-47,-34,-282
-100,-38,-94,-165,-104,-80,-119,-2,-702
-67,-39,-82,-138,-116,-100,-124,-31,-697
70,135,-88,-328,-195,-310,-205,-154,-1075
-43,-4,-24,-86,-72,-33,-51,43,-270
-1,39,-36,-83,-79,-80,-44,26,-258
-21,-16,-57,-135,-132,-103,-105,0,-569
-70,-7,-67,-192,-129,-133,-100,14,-684
12,142,-84,-313,-118,-226,-180,-7,-774
-71,5,-101,-206,-131,-123,-153,-53,-833
-98,-30,-98,-190,-150,-119,-182,-30,-897
-92,3,-67,-226,-154,-115,-118,-61,-830
-84,19,-92,-225,-146,-102,-155,-99,-884
-43,71,-128,-254,-132,-134,-193,-26,-839
-127,-37,-170,-218,-326,-158,-262,-14,-1312
112,112,-11,-220,-3,-146,-82,98,-140
38,71,11,-75,-18,-101,-104,82,-96
3,-13,-1,-49,-64,-26,-41,24,-167
-60,4,-49,-183,-196,-114,-114,68,-644
32,-10,-128,-332,-287,-297,-322,-42,-1386
-15,5,-26,-45,-58,-22,-30,-11,-202
-4,-6,-23,-44,-59,-32,-27,-24,-219
-89,-42,-83,-143,-133,-78,-127,-8,-703
2,22,-64,-131,-79,-143,-91,-72,-556
-30,-8,-16,-53,-51,7,-24,-1,-176
-11,41,-27,-23,-31,-18,-41,13,-97
31,112,-37,-145,-27,-114,-94,20,-254
30,25,-2,-39,-13,-25,-45,-4,-73
68,117,-45,-214,-72,-234,-138,-64,-582
53,99,-80,-265,-253,-233,-181,-46,-906
32,60,-12,-61,-100,-34,-73,12,-176
14,9,-15,-77,-64,-73,-53,-3,-262
-228,-115,-304,-551,-462,-284,-484,-73,-2501
-18,51,-67,-93,-103,-93,-129,-64,-516
-20,11,-67,-134,-78,-103,-91,-48,-530
105,49,-33,-181,-116,-185,-163,-95,-619
-102,11,-145,-320,-270,-139,-233,-48,-1246
-51,21,-56,-152,-93,-41,-68,51,-389
60,106,3,-150,-197,-225,-205,-87,-695
82,187,-24,-123,-130,-159,-188,-58,-413
70,24,48,-36,12,-70,-66,75,57
13,32,11,-12,-33,-28,-5,32,10
-57,17,-77,-181,-107,-103,-114,-58,-680
-14,95,-78,-149,-10,-86,-54,-31,-327
21,45,-38,-79,-66,-92,-75,-36,-320
0,-1,-6,-10,-10,-8,-6,1,-40
-23,17,-20,-50,-50,-29,-30,-16,-201
214,220,11,-307,-75,-372,-196,-17,-522
-38,44,-75,-197,-242,-76,-132,43,-673
28,121,-196,-418,-601,-466,-490,-407,-2429
-78,1,-56,-206,-67,-99,-129,68,-566
-53,45,-28,-178,-104,-49,-19,65,-321
23,9,-31,-54,-107,-76,-70,-55,-361
-33,25,-45,-104,-75,-64,-50,-16,-362
33,130,-20,-157,-38,-141,-110,44,-259
-31,-9,-32,-113,-105,-39,-59,14,-374
-46,-22,-41,-86,-79,-38,-57,-12,-381
-28,27,-13,-89,-58,-25,-57,-3,-246
22,131,-40,-258,-122,-161,-141,60,-509
3,18,21,-50,32,-17,10,46,63
-32,-21,-56,-114,-121,-126,-101,-50,-621
27,29,-28,-96,-113,-116,-96,-34,-427
14,38,12,-45,-54,-45,-40,40,-80
-2,21,-7,-42,-13,-50,-29,7,-115
30,-14,-11,-106,-24,-88,-72,10,-275
-55,15,-46,-123,-79,-71,-83,-11,-453
-25,-4,-30,-89,-33,-38,-66,-20,-305
-21,0,-42,-113,-137,-125,-85,-57,-580
-5,2,-11,-19,-23,-25,-27,-12,-120
12,35,-55,-286,-59,-181,-180,40,-674
-33,-17,-47,-55,-45,-21,-29,-26,-273
-203,-50,-323,-640,-501,-359,-520,-17,-2613
33,46,-9,-42,-61,-81,-44,-15,-173
-79,-10,-62,-154,-158,-63,-93,19,-600
-54,-2,-62,-149,-99,-135,-81,-23,-605
-19,47,-59,-194,-155,-107,-154,-106,-747
115,60,45,-120,40,-89,-85,123,89
-1,7,6,-45,-47,-35,-8,-27,-150
53,49,23,-93,-58,-10,-48,55,-29
12,8,5,-14,8,2,3,8,32
-121,18,-166,-391,-232,-259,-238,-15,-1404
-47,19,-67,-181,-140,-52,-100,-45,-613
-22,-3,-52,-61,-33,-31,-37,18,-221
104,-34,8,-59,-122,-141,-151,20,-375
189,263,87,-265,-69,-326,-171,89,-203
105,259,-10,-326,-105,-282,-178,70,-467
-131,159,-245,-510,-360,-241,-381,-192,-1901
56,53,50,45,10,6,5,55,280
-13,3,-53,-77,-85,-53,-58,-38,-374
4,1,-7,-18,-53,-2,-13,-4,-92
10,53,-80,-292,-93,-167,-132,44,-657
836,564,665,213,715,356,-64,249,3534
0,-11,-37,-116,-83,-72,-82,-35,-436
460,264,270,145,277,96,-10,77,1579
434,212,290,170,277,199,-11,131,1702
-3,5,-10,-3,-5,-6,-6,-13,-41
-14,0,-18,-47,-46,-9,-34,1,-167
28,108,-13,-3,1,32,74,-25,202
-34,6,-47,-129,-54,-81,-92,-44,-475
87,79,64,28,-13,28,8,50,331
63,46,23,-11,1,-15,-42,54,119
-60,-43,-62,-138,-117,-43,-87,17,-533
103,66,-24,-161,-183,-133,-169,71,-430
13,108,-90,-162,-152,-148,-108,-14,-553
-20,6,-35,-35,-32,-3,-16,26,-109
8,-16,-7,-80,-168,-56,-99,-24,-442
-1,23,-28,-252,-112,-78,-139,80,-507
-33,64,-14,-164,-47,-62,-85,47,-294
-40,36,-51,-150,-118,-117,-115,-21,-576
-15,103,-55,-250,-228,-133,-146,113,-611
6,8,-27,-70,-36,-62,-50,-53,-284
24,107,-3,-96,-34,-53,-44,1,-98
29,35,11,-50,-35,-104,-55,-4,-173
-1,25,-20,-181,-126,-150,-53,29,-477
-140,-71,-171,-328,-209,-212,-252,-103,-1486
28,58,-30,-80,-6,-61,-76,16,-151
-34,29,-42,-104,-74,-20,-58,-35,-338
-21,28,-49,-135,-126,-139,-111,-82,-635
-43,-23,-10,-62,-171,-99,-146,10,-544
-210,66,-317,-579,-355,-402,-468,-252,-2517
-14,41,-123,-320,-216,-275,-227,-76,-1210
-90,76,-54,-207,-104,-85,-118,68,-514
95,218,62,-104,-44,-103,9,-26,107
-106,106,-19,-319,-199,-248,-85,-208,-1078
47,103,29,-78,9,-93,-61,28,-16
72,47,-17,-95,-70,-150,-116,-40,-369
-23,111,-89,-248,-64,-141,-172,12,-614
-111,-22,-108,-272,-219,-157,-190,-39,-1118
349,326,141,-76,121,-152,-145,235,799
-47,134,-86,-305,-182,-180,-133,6,-793
176,187,-116,-426,-193,-371,-192,-155,-1090
24,80,-21,-156,-83,-184,-140,18,-462
110,207,35,-27,24,-22,-89,59,297
-43,16,-89,-233,-173,-179,-171,-76,-948
-7,16,-46,-73,-62,-17,-41,-3,-233
-38,-62,-60,-176,-130,-129,-84,-22,-701
-11,18,-56,-153,-134,-100,-114,-48,-598
-33,74,-47,-185,-90,-71,-116,35,-433
-6,34,-28,-82,-74,-77,-68,-32,-333
-3,1,-27,-62,-60,-64,-36,-21,-272
-181,-43,-221,-587,-359,-244,-344,-56,-2035
18,42,-14,-53,-52,-19,-24,60,-42
-19,52,-19,-97,-62,-40,-40,49,-176
31,27,-69,-141,-112,-182,-184,-23,-653
-146,144,-160,-383,-218,-194,-164,-33,-1154
-39,21,-41,-50,-41,-21,-24,-13,-208
32,14,-26,-102,-132,-54,-98,32,-334
35,22,6,-84,-120,-34,-104,40,-239
-28,-12,-5,-60,-49,-63,-29,0,-246
-11,-13,-9,-57,-4,-17,-25,13,-123
21,157,-74,-320,-12,-165,-140,56,-477
30,128,-57,-319,-220,-219,-263,-159,-1079
-452,-151,-456,-1324,-1103,-899,-919,-338,-5642
-17,-21,-12,-48,-33,-26,-14,23,-148
87,301,-66,-327,-24,-132,-79,211,-29
28,23,-43,-132,-2,-100,-76,1,-301
-6,33,-25,-40,-16,-36,-36,-17,-143
2,-12,-25,-71,-44,-76,-48,22,-252
-28,8,-38,-75,-88,-43,-77,-24,-365
-27,-6,4,-40,-38,-38,-12,-5,-162
-40,-12,-19,-103,-130,-59,-72,-11,-446
18,103,12,-120,-10,-104,-9,14,-96
82,58,0,-61,-95,-88,-83,-43,-230
40,110,49,-179,-56,-122,-30,-42,-230
-109,91,-115,-186,-107,-71,-203,63,-637
84,80,44,59,-62,1,-1,47,252
23,3,-15,-49,-83,-76,-45,-27,-269
-9,1,-10,-67,-143,-53,-104,-86,-471
20,10,-30,-40,-40,-34,-26,-3,-143
-69,4,-70,-179,-94,-102,-135,-54,-699
-24,28,-63,-110,-74,-67,-133,13,-430
-96,-2,-127,-333,-134,-138,-172,-76,-1078
-8,37,-59,-240,-60,-160,-106,-87,-683
4,22,-36,-65,-23,-27,-35,12,-148
141,120,113,-259,-557,144,-141,369,-70
28,32,-45,-77,-56,-65,-79,-36,-298
-43,35,-29,-94,-41,-20,-17,-16,-225
-113,4,-55,-256,-270,-34,-79,68,-735
-103,-43,-97,-150,-96,-62,-125,-8,-684
-24,21,-19,-54,-32,-1,-22,-1,-132
-52,-43,-73,-167,-149,-114,-134,-41,-773
-60,-24,-44,-124,-78,-42,-46,-20,-438
-9,-26,-16,-33,-68,-52,-40,-18,-262
17,12,-12,-35,-75,-63,-68,-31,-255
17,-2,-11,-38,-33,-44,-40,29,-122
7,85,-102,-258,-47,-174,-155,-160,-804
0,44,-30,-116,-129,-109,-121,-32,-493
-49,7,-61,-168,-169,-103,-163,-47,-753
-8,39,-33,-66,-30,-55,-63,-20,-236
-33,14,-60,-139,-149,-72,-114,-29,-582
-25,26,-55,-115,-133,-96,-102,-43,-543
-6,-10,-85,-196,-273,-225,-210,-45,-1050
10,125,-104,-255,-196,-260,-185,5,-860
-62,-39,-80,-166,-84,-66,-112,-13,-622
-64,-27,-74,-184,-130,-95,-131,25,-680
-31,7,-40,-77,-57,-50,-58,-9,-315
139,94,58,-19,42,-55,-38,95,316
-23,17,-47,-108,-86,-89,-62,-7,-405
-25,17,-46,-183,-99,-153,-82,-33,-604
-11,33,-19,-89,-26,-37,-39,12,-176
60,9,1,-37,-17,-44,-54,7,-75
10,18,2,-51,-35,-55,-9,40,-80
124,139,-79,-155,-24,-190,-89,16,-258
-2,63,-6,-115,-138,-114,-27,25,-314
-29,-12,-32,-93,-130,-78,-80,-2,-456
-40,-16,-42,-49,-38,-30,-37,-4,-256
5,29,-24,-22,4,-18,-11,-7,-44
46,44,-50,-126,-42,-78,-118,10,-314
-27,29,-12,-69,-15,-29,-29,-7,-159
17,135,-34,-70,-4,-38,-20,22,8
-153,138,-319,-956,-924,-470,-657,608,-2733
-15,51,-27,-67,-12,8,-92,43,-111
-166,2,-263,-639,-420,-349,-524,-4,-2363
-34,26,-56,-128,-36,-70,-99,-31,-428
175,46,29,-26,-65,-170,-148,-89,-248
-55,25,-78,-236,-131,-122,-130,-41,-768
-35,22,-45,-127,-72,-97,-116,-46,-516
-16,80,-14,-72,-94,-40,-97,-41,-294
-62,7,-84,-172,-154,-102,-130,-14,-711
-22,12,-36,-115,-79,-82,-65,-10,-397
-58,9,-125,-187,-81,-112,-165,-53,-772
99,31,31,-56,-20,-57,-44,2,-14
-40,-38,-59,-83,-88,-48,-89,-49,-494
-38,-37,-37,-94,-127,-76,-70,-21,-500
-121,-4,-82,-326,-267,-197,-142,3,-1136
-43,-38,-48,-154,-112,-90,-78,-2,-565
-1,8,-18,-60,-98,-38,-61,-29,-297
-86,11,-71,-238,-213,-141,-127,-5,-870
-28,27,-43,-58,-49,3,-12,14,-146
-399,-49,-373,-781,-565,-386,-577,-103,-3233
-317,15,-391,-794,-536,-427,-627,-191,-3268
-68,45,-64,-186,-171,-97,-97,73,-565
15,30,2,-34,-73,-45,-51,-15,-171
0,42,-7,-53,-31,-48,-33,-6,-136
-58,118,-48,-115,-41,-51,-57,-6,-258
-38,79,-28,-74,-50,-50,-5,-14,-180
-133,61,-94,-209,-54,-90,-94,12,-601
-128,134,-110,-241,-13,-76,-103,22,-515
-81,54,-58,-155,-19,-30,-82,-23,-394
-51,95,-17,-90,5,-15,-57,30,-100
-44,29,-68,-131,-86,-69,-53,-4,-426
-77,57,-50,-138,-52,-20,-60,-44,-384
-29,84,-69,-255,-63,-107,-122,36,-525
-4,6,-2,-12,-3,-10,0,1,-24
-12,-2,-38,-95,-122,-111,-81,-31,-492
-6,5,-30,-231,-199,-176,-136,21,-752
45,34,-12,-117,-50,-123,-90,-1,-314
-63,-9,-86,-104,-65,-48,-54,33,-396
-20,41,-35,-57,7,-26,-18,-18,-126
-37,-32,-42,-96,-97,-45,-70,-18,-437
-312,38,-331,-804,-515,-391,-510,-122,-2947
-64,-14,-66,-210,-128,-98,-150,9,-721
-59,27,-97,-172,-108,-91,-106,-62,-668
38,26,-25,-90,-30,-76,-63,5,-215
-50,-14,-54,-134,-132,-76,-115,-17,-592
-33,-30,-48,-59,-89,-92,-99,-61,-511
22,8,17,-7,-33,-43,-26,-11,-73
-221,146,-260,-748,-329,-439,-457,-115,-2423
75,214,-123,-471,-269,-401,-234,28,-1181
249,154,27,3,-134,-175,-156,62,30
-4,209,-316,-667,-429,-603,-503,-381,-2694
258,324,97,-519,-51,-246,-100,253,16
85,99,53,-11,2,-62,-68,93,191
19,234,-31,-249,-173,-168,-196,51,-513
32,135,-71,-330,-83,-232,-177,116,-610
-73,28,-59,-184,-85,-117,-99,-29,-618
25,36,4,-23,-26,-29,-33,8,-38
-74,62,-102,-345,-196,-66,-141,-126,-988
23,106,4,-160,-25,-78,-39,3,-166
569,347,256,-237,464,-94,-82,443,1666
89,158,-17,-318,-57,-259,-174,-56,-634
-40,74,-80,-395,-404,-372,-322,-84,-1623
-150,203,-216,-600,-284,-238,-270,-120,-1675
-11,0,-30,-52,-32,-45,-35,-24,-229
-18,109,-80,-216,-171,-33,-56,52,-413
-1,83,-37,-199,-102,-146,-60,48,-414
35,99,-7,-146,-55,-101,-76,99,-152
-2,31,1,-30,-6,-10,-13,-4,-33
17,44,-16,-31,-10,-19,3,1,-11
-8,-4,-49,-201,-189,-197,-135,-13,-796
30,110,-29,-86,-34,-47,-38,28,-66
4,8,-8,-196,-155,-124,-146,93,-524
-31,12,-52,-82,-65,-67,-78,-31,-394
-25,64,-88,-247,-118,-148,-150,6,-706
-25,43,-26,-110,-93,-80,-55,-24,-370
-8,33,-106,-165,-115,-143,-177,-102,-783
-71,-12,-83,-218,-48,-90,-111,-34,-667
-95,-17,-107,-238,-144,-125,-136,-25,-887
-73,40,-104,-238,-100,-130,-173,-39,-817
0,-1,-6,-51,-75,-61,-70,-13,-277
47,41,-18,-15,-53,-87,-29,-28,-142
13,-2,-36,-190,-229,-142,-129,-67,-782
-74,12,-93,-257,-90,-104,-147,-5,-758
46,257,-60,-154,3,27,-118,158,159
168,288,26,-140,-61,-106,-179,140,136
-5,8,-40,-98,-46,-77,-67,-11,-336
106,59,3,-15,-30,-106,-61,21,-23
97,110,16,-65,2,-98,-58,47,51
-253,628,-323,-1087,-200,-304,-584,-363,-2486
-57,38,-77,-158,-77,-50,-65,6,-440
-68,96,-49,-108,-61,-80,-81,-63,-414
-27,-4,-23,-65,-47,-44,-60,-31,-301
27,9,-17,-69,-66,-96,-54,-15,-281
-5,7,-15,-12,-10,-15,-24,-8,-82
13,64,-45,-179,-137,-151,-98,-100,-633
115,81,23,-112,33,-77,-75,39,27
-78,-18,-98,-211,-196,-113,-170,19,-865
-88,5,-100,-234,-218,-130,-189,17,-937
-80,-5,-90,-256,-189,-137,-177,4,-930
-66,111,-137,-422,-228,-208,-141,35,-1056
19,13,8,-11,-12,-8,-10,25,24
-32,-3,-71,-155,-119,-85,-101,-8,-574
10,-4,-25,-83,-44,-40,-33,8,-211
-1,133,-72,-271,-12,-181,-107,-18,-529
85,102,-27,-150,-5,-106,-101,79,-123
-1,5,-32,-67,-103,-63,-78,-13,-352
16,3,-30,-233,-263,-137,-137,39,-742
-13,21,-15,-56,-69,-15,-54,-25,-226
-77,-10,-108,-184,-146,-68,-146,-9,-748
48,39,26,-18,7,-19,-9,34,108
-41,121,-36,-207,-40,-120,-54,6,-371
253,113,119,-116,48,-136,-93,110,298
37,42,-10,-103,-15,-55,-80,58,-126
-58,38,-147,-310,-223,-215,-216,-52,-1183
-6,13,9,-72,-40,-44,-84,54,-170
16,28,-21,-55,-13,-34,-57,42,-94
5,35,-15,-60,-20,-36,-51,38,-104
1,34,-31,-64,-21,-37,-49,42,-125
-23,-15,-36,-120,-61,-27,-95,73,-304
82,43,-36,-229,-249,-288,-262,-12,-951
-30,-1,-24,-70,-47,-25,-33,-5,-235
-1,298,-23,-411,-143,-167,20,212,-215
-67,2,-89,-151,-75,-43,-126,-35,-584
-58,-18,-139,-179,-264,-174,-200,-104,-1136
195,173,5,-37,-13,-51,60,122,454
175,334,-27,-510,-268,-330,-400,-350,-1376
-34,16,-38,-76,-88,-13,-44,29,-248
-44,18,-21,-84,-46,-52,-58,5,-282
419,280,303,75,312,166,-20,145,1680
-35,-6,-47,-104,-72,-68,-89,-55,-476
22,78,-23,-81,-23,-48,-34,37,-72
-264,57,-316,-714,-302,-373,-448,-223,-2583
-74,70,-204,-509,-317,-428,-331,-124,-1917
-105,83,-201,-507,-396,-419,-385,-199,-2129
-220,9,-196,-538,-316,-317,-301,-71,-1950
-73,90,-100,-281,-75,-106,-174,-115,-834
-11,99,-117,-389,-250,-344,-266,-20,-1298
-44,96,-63,-261,-190,-126,-115,85,-618
-38,38,-44,-152,-68,-75,-59,-38,-436
51,166,-49,-253,-121,-186,-175,38,-529
-42,40,-101,-214,-187,-94,-134,98,-634
28,82,0,-78,-93,-114,-98,-62,-335
1,29,-34,-104,-33,-51,-34,0,-226
18,92,-5,-52,-4,-48,-10,53,44
-44,12,-134,-199,-121,-161,-208,-93,-948
-120,61,-171,-321,-162,-172,-231,-131,-1247
1,16,9,-66,-35,-55,-15,24,-121
-101,31,-144,-281,-85,-141,-167,-96,-984
-31,55,-19,-147,-44,-87,-63,42,-294
-85,-19,-121,-261,-175,-122,-185,-37,-1005
54,81,1,-57,-72,-11,-111,7,-108
-2,69,-76,-242,-177,-103,-121,98,-554
46,68,-18,-114,-77,-99,-49,15,-228
8,15,5,-10,-13,-9,9,13,18
-8,9,-18,-30,-43,-21,-43,-5,-159
-1,-17,-23,-45,-77,-56,-54,-20,-293
45,119,11,-65,8,-45,-38,48,83
-48,-23,-51,-94,-129,-84,-97,-51,-577
32,-28,-5,-81,-8,-73,-42,22,-183
-64,-32,-67,-89,-67,-44,-85,13,-435
-14,-2,-43,-89,-44,-48,-49,-18,-307
20,20,0,-41,-10,-32,-28,-2,-73
14,32,-7,-87,-50,-97,-35,78,-152
-48,-11,-12,-88,-81,-27,-31,-21,-319
-29,30,-75,-171,-241,-170,-141,-55,-852
-106,45,-187,-448,-317,-314,-307,-169,-1803
-4,89,-13,-111,-36,-35,-63,41,-132
-30,25,-23,-79,-85,-50,-51,-5,-298
50,80,-22,-171,18,-75,-102,-75,-297
17,52,-45,-185,-186,-178,-164,-125,-814
-88,-25,-84,-262,-236,-98,-162,13,-942
-39,-22,-62,-194,-190,-168,-177,-43,-895
134,118,31,-184,69,-57,-102,185,194
-84,41,-148,-246,-186,-158,-205,-62,-1048
-85,-52,-112,-151,-116,-56,-101,-42,-715
-30,47,-18,-138,-90,-120,-84,22,-411
60,10,23,5,-8,-23,-32,28,63
-4,6,-15,-43,-33,-37,-25,-28,-179
-30,-7,-38,-76,-43,-38,-63,-23,-318
-70,54,-112,-261,-137,-160,-130,-59,-875
-24,54,-105,-138,-105,-78,-145,-28,-569
-51,-17,-48,-137,-121,-40,-104,-28,-546
76,157,-14,-193,-111,-150,-138,147,-226
-6,29,-77,-182,-99,-155,-149,-113,-752
-34,-4,-90,-131,-106,-97,-109,-34,-605
35,51,40,-70,-2,-49,2,-37,-30
-81,20,-75,-231,-136,-113,-150,-73,-839
-58,96,-91,-237,-75,-104,-132,-9,-610
-36,4,-36,-53,-1,-5,-17,-19,-163
22,52,-1,-72,-31,-37,-22,53,-36
62,44,64,18,21,-9,10,36,246
-13,60,-64,-147,-121,-100,-96,-52,-533
-98,193,-152,-446,-267,-239,-283,15,-1277
53,39,-32,-124,-45,-66,-44,16,-203
-27,87,-82,-158,-108,-95,-68,-14,-465
-87,29,-109,-276,-196,-15,-155,-28,-837
-39,-6,-56,-163,-132,-83,-140,-38,-657
-35,-16,-55,-155,-113,-115,-98,-52,-639
-28,46,-38,-74,-1,-3,-15,-3,-116
-70,281,-96,-467,-53,-56,-246,-195,-902
-28,-40,-65,-110,-135,-119,-87,-62,-646
-16,31,-45,-89,-37,-80,-61,-3,-300
-28,-14,-38,-101,-87,-67,-46,-14,-395
32,45,-6,-74,-84,-31,-47,-19,-184
-7,-5,-13,-59,-57,-36,-41,-28,-246
13,58,-8,-90,-47,-33,-36,24,-119
-55,44,-111,-219,-215,-138,-162,-16,-872
42,63,-8,-73,-2,-34,-79,50,-41
-3,2,-17,-75,-36,-64,-44,43,-194
3,-2,-49,-99,-91,-96,-75,7,-402
-35,-14,-30,-113,-56,-80,-95,7,-416
-36,-24,-45,-129,-71,-76,-75,0,-456
-23,8,-26,-44,-19,-15,-19,-5,-143
-5,0,-23,-117,-132,-81,-98,-3,-459
-33,-15,-52,-94,-77,-63,-83,-42,-459
3,13,-5,-47,-48,-32,-24,-2,-142
-42,9,-40,-131,-70,-67,-56,-32,-429
-54,43,-63,-242,-157,-156,-116,42,-703
-79,12,-98,-262,-164,-80,-164,-19,-854
133,315,-56,-1067,-992,-942,-841,-963,-4413
65,344,-60,-421,-74,-242,-103,185,-306
-48,118,-101,-304,-212,-60,-162,107,-662
-29,-12,-62,-89,-59,-44,-74,-1,-370
-34,-11,-64,-95,-57,-48,-70,-2,-381
-6,35,7,-67,-5,-47,9,18,-56
-82,-5,-97,-181,-96,-59,-103,-12,-635
-49,2,-86,-191,-79,-91,-115,-35,-644
-21,-28,-18,-29,-78,-12,-19,-1,-206
-3,8,-13,-7,-8,-10,8,15,-10
-11,7,-6,-13,-9,-3,-14,-4,-53
-24,14,-22,-98,-72,-40,-35,31,-246
-42,16,-21,-134,-88,-60,-62,-19,-410
47,40,-16,-83,-71,-45,-21,46,-103
21,52,23,-106,-4,-35,-22,-11,-82
-43,-15,-38,-97,-45,-33,-50,23,-298
-70,5,-88,-201,-142,-98,-116,13,-697
-22,-28,-34,-84,-75,-63,-64,-12,-382
-73,-103,-51,-284,-308,-179,-212,78,-1132
-26,79,-83,-198,-208,-130,-130,14,-682
154,55,48,48,-64,-83,-45,0,113
40,5,-36,-32,-112,-79,-66,-64,-344
-28,120,-38,-230,-108,-123,-180,-127,-714
-88,36,-107,-230,-139,-96,-118,22,-720
-31,-3,-21,-39,-53,5,-30,8,-164
28,96,38,-72,13,-105,0,102,100
6,58,-64,-102,-105,-51,-33,41,-250
0,3,-22,-45,-60,-38,-12,-34,-208
-60,55,-81,-240,-142,-104,-186,5,-753
-3,-4,-25,-76,-29,-68,-68,-14,-287
-73,64,-60,-215,-43,-48,-62,-40,-477
21,27,-7,-62,-50,-79,-55,-10,-215
-51,22,-64,-155,-45,-72,-111,-41,-517
-87,22,-29,-126,-91,-63,-56,6,-424
-24,14,-38,-78,-58,-42,-44,-74,-344
43,41,-15,-72,-7,-47,-27,18,-66
46,44,-62,-233,-239,-234,-207,-52,-937
31,105,-98,-247,-167,-257,-196,-90,-919
-39,6,-66,-193,-146,-124,-127,-40,-729
-53,115,-31,-163,-109,-64,-34,64,-275
-19,-7,-19,-50,-65,-27,-47,-2,-236
9,40,-18,-58,-101,-62,-64,21,-233
15,49,-19,-67,-77,-48,-69,44,-172
-2,6,-6,-13,-18,-6,-14,13,-40
0,8,-1,-19,-27,-15,-17,-3,-74
-56,2,-82,-211,-229,-135,-157,38,-830
-14,21,-21,-46,-50,-8,-40,11,-147
-119,8,-188,-395,-205,-205,-231,-46,-1381
-7,8,-25,-49,-34,-27,-28,-13,-175
-21,47,-37,-114,-52,-46,-82,-24,-329
10,21,-8,-94,-45,-74,-30,6,-214
-112,-50,-104,-143,-110,-47,-112,4,-674
-88,-25,-96,-168,-113,-83,-143,-30,-746
-77,-2,-118,-306,-295,-147,-161,28,-1078
-73,28,-76,-173,-133,-76,-106,-69,-678
-29,112,-36,-194,-71,-85,-26,14,-315
-153,29,-187,-323,-82,-114,-149,-21,-1000
-14,26,-33,-97,12,-33,-24,-19,-182
-1,12,-50,-121,-36,-85,-86,-4,-371
-427,178,-647,-1316,-875,-691,-890,-239,-4907
111,85,73,18,4,-143,-52,82,178
39,30,0,2,-39,-20,-22,18,8
-34,29,-60,-190,-99,-116,-118,-47,-635
128,248,71,-63,-55,-108,24,17,262
124,-21,40,19,7,-88,-52,25,54
94,-23,72,-56,64,-95,-41,16,31
-126,165,-86,-319,-5,-2,-106,-99,-578
79,52,9,-29,14,-54,-37,58,92
-39,47,-63,-126,-30,-36,-35,-31,-313
-46,-9,-60,-181,-111,-110,-145,-2,-664
-29,-19,-61,-181,-119,-103,-140,-34,-686
-29,-19,-41,-108,-70,-55,-28,-37,-387
49,-54,-8,-171,-52,-34,-31,75,-226
58,52,26,-4,-52,-136,-41,26,-71
16,35,-31,-56,-128,-129,-97,-68,-458
-22,10,-45,-99,-49,-76,-65,-50,-396
-41,152,-112,-311,7,-179,-121,93,-512
17,31,-14,-76,-6,-67,-24,-11,-150
9,100,-90,-386,-211,-290,-256,-138,-1262
60,36,17,-1,-17,-15,-37,-1,42
-3,12,-21,-24,-17,-37,-26,-19,-135
5,6,-21,-42,-69,-39,-23,7,-176
3,20,-11,-29,-13,1,15,3,-11
-21,-22,-20,-26,-22,-5,-27,-2,-145
233,232,108,97,139,-17,-117,193,868
8,1,-9,-64,-64,-42,-47,-6,-223
-13,34,-11,-73,-30,-58,-8,-8,-167
0,17,-21,-38,-37,-43,-30,-13,-165
219,70,124,144,174,66,-26,148,919
57,69,-17,-73,-104,-102,-129,-8,-307
-4,9,8,-12,-19,1,-9,10,-16
4,23,-2,-28,-38,-12,-13,20,-46
-39,43,-30,-83,-28,-18,-23,3,-175
-55,-56,-59,-66,-104,-70,-90,-16,-516
54,72,9,-78,-64,-74,-49,-5,-135
27,12,-16,-48,-32,-21,-33,20,-91
-10,17,-4,-66,-68,-47,-45,-22,-245
18,-2,-21,-78,-72,-87,-85,37,-290
35,42,-5,-84,-18,-82,-86,21,-177
61,45,-7,-178,-31,-154,-102,6,-360
47,94,-35,-277,-85,-239,-186,-103,-784
-41,-28,-83,-99,-104,-69,-98,-35,-557
-26,26,-110,-190,-166,-130,-153,-59,-808
51,43,12,-94,3,-83,-82,15,-135
239,227,111,-158,179,-154,-132,208,520
26,33,6,-47,-51,-58,-23,-26,-140
-2,111,-58,-179,-81,-140,-68,-3,-420
-99,-33,-71,-141,-118,-50,-131,0,-643
-92,-41,-62,-139,-106,-73,-142,-30,-685
-90,-20,-100,-137,-89,-76,-147,-14,-673
-88,-10,-76,-138,-93,-75,-142,-15,-637
-67,-22,-75,-129,-89,-45,-122,17,-532
-72,-1,-84,-128,-99,-80,-157,-18,-639
39,30,-30,-77,-67,-99,-66,-54,-324
-77,-45,-86,-134,-92,-47,-108,-9,-598
-26,3,-30,-86,-70,-47,-55,-33,-344
17,61,-20,-82,-69,-86,-68,10,-237
97,30,67,-90,64,-88,-75,46,51
30,54,4,-148,-43,-88,-81,0,-272
-162,323,-178,-640,-117,-211,-345,-199,-1529
-54,2,-64,-152,-113,-90,-94,-9,-574
-40,-2,-80,-184,-101,-95,-92,-24,-618
240,405,39,-200,190,-194,-218,310,572
-31,2,-21,-41,-17,-12,-19,-2,-141
-8,54,-64,-148,-54,-40,-35,-31,-326
17,24,13,-2,8,-2,22,4,84
-102,318,-193,-648,-200,-412,-212,97,-1352
45,31,-26,-53,-89,-105,-83,-37,-317
86,34,43,-19,-30,-23,-69,22,44
-5,-14,2,-36,-46,-18,-59,6,-170
-18,-17,-7,-35,-56,-39,-37,11,-198
47,51,41,31,8,-23,-16,31,170
-38,55,-52,-322,-145,-156,-202,58,-802
25,-3,-11,-35,-32,-17,-39,3,-109
-24,93,-3,-114,12,-58,10,36,-48
-26,94,8,-141,9,-77,21,53,-59
-3,71,-15,-113,5,-65,-16,-18,-154
7,44,16,-42,-29,-48,-38,30,-60
12,2,78,6,78,2,15,78,271
-32,34,-29,-182,-170,-83,-96,75,-483
276,236,52,-122,9,-159,-103,235,424
16,17,3,-15,-66,-39,-21,21,-84
-6,33,-77,-137,-123,-141,-116,-53,-620
-16,45,-7,-131,-118,-62,-85,76,-298
28,37,-7,-48,4,-40,-15,3,-38
179,116,33,-202,0,-213,-156,86,-157
-36,-37,-17,-90,-100,-56,-90,-1,-427
50,79,6,-118,-11,-103,-87,2,-182
-64,-25,-88,-142,-121,-105,-119,-34,-698
35,6,0,-31,-20,-58,-46,-26,-140
57,225,-73,-371,-201,-167,-156,98,-588
58,61,-21,-67,-77,-101,-106,10,-243
71,672,-293,-1170,-829,-933,-927,-55,-3464
-10,11,-128,-157,-205,-146,-170,-96,-901
-27,-14,-34,-102,-88,-81,-71,-22,-439
-98,-18,-79,-165,-138,-85,-95,52,-626
-122,-19,-102,-215,-97,-113,-126,-5,-799
-34,-2,-27,-89,-69,-58,-52,47,-284
63,54,-1,-35,-14,-72,-34,-23,-62
-23,-6,-21,-71,-40,-26,-49,18,-218
371,328,-76,-804,-484,-808,-417,81,-1809
23,23,42,-7,-25,-47,-24,41,26
-54,65,-51,-170,-71,-105,-59,-44,-489
1,-3,7,-64,-26,5,-25,30,-75
-2,29,-23,-60,-48,-22,-80,14,-192
74,59,24,-14,-11,-67,-54,2,13
8,21,-24,-62,-64,-58,-31,-29,-239
188,208,41,-258,75,-177,-141,203,139
-6,48,-19,-118,-25,-78,-49,13,-234
27,34,-29,-75,3,-68,-33,41,-100
-59,-55,-61,-95,-63,-44,-77,-20,-474
38,157,-99,-437,-119,-137,-173,-56,-826
-51,54,-84,-169,-43,-36,-56,-65,-450
0,34,-20,-84,-69,-68,-40,-26,-273
16,47,-28,-94,-58,-58,-63,-24,-262
-5,18,-8,-26,-1,-6,-9,24,-13
-76,-20,-99,-182,-120,-113,-152,-25,-787
-100,-46,-100,-176,-127,-68,-100,5,-712
5,1,-11,-19,-42,-24,-25,-14,-129
-24,21,-8,-89,-63,-53,-60,10,-266
-44,2,-79,-145,-155,-139,-148,-80,-788
37,60,3,-33,-10,-52,-38,-55,-88
16,23,-65,-120,-66,-48,-57,-34,-351
-16,-5,-8,-20,-37,-19,-23,-1,-129
-77,-21,-56,-139,-141,-72,-89,14,-581
-1,8,2,-26,-15,-10,-7,-13,-62
-69,26,-75,-137,-58,-35,-73,3,-418
25,11,3,9,-17,-8,-7,-12,4
40,44,8,4,13,30,-25,32,146
-122,12,-160,-315,-196,-219,-269,-82,-1351
61,12,16,-6,-72,-40,-37,-4,-70
-294,-57,-326,-647,-394,-224,-445,69,-2318
-189,47,-245,-697,-449,-455,-499,56,-2431
-17,6,-38,-165,-102,-130,-93,-18,-557
9,10,-61,-113,-104,-105,-122,-18,-504
17,15,10,-76,-53,-35,-25,38,-109
-15,-5,-28,-47,-71,-49,-31,-10,-256
-42,23,-63,-156,-84,-64,-35,43,-378
453,557,-136,-756,107,-524,-436,162,-573
66,18,12,10,-37,-81,-66,14,-64
-49,59,-60,-127,-36,-41,-63,1,-316
-78,17,-52,-110,-61,-22,-21,-50,-377
-19,1,-18,-39,-23,-11,-25,-26,-160
-64,99,-34,-112,-42,-72,-67,25,-267
-2,85,-31,-79,-13,-87,-48,3,-172
-49,13,-7,-62,-31,-17,-29,-22,-204
132,-1,21,-83,64,-75,-85,69,42
-37,54,-25,-53,-21,-36,-26,13,-131
3,15,-7,-10,3,-11,-1,1,-7
14,3,-11,-43,-47,-55,-19,-5,-163
-80,1,-124,-254,-225,-211,-220,-44,-1157
-43,-7,-56,-115,-122,-59,-100,-28,-530
28,20,10,9,-26,4,-5,10,50
-41,16,-9,-114,-34,-14,-22,3,-215
78,76,-6,-23,-28,-82,-45,2,-28
28,76,10,-104,24,-52,-108,20,-106
-54,36,-42,-170,-91,-78,-102,-51,-552
-4,-17,-48,-85,-120,-39,-64,-16,-393
28,68,-53,-144,-18,-66,-46,60,-171
51,71,-33,-115,-17,-79,-72,11,-183
35,59,-4,-25,-16,-5,-20,5,29
-76,-14,-104,-181,-166,-108,-134,-15,-798
-53,12,-105,-212,-152,-118,-125,-23,-776
-85,-14,-103,-264,-152,-96,-126,16,-824
-55,3,-69,-158,-84,-30,-99,58,-434
-11,18,-51,-94,-60,-50,-53,-34,-335
-81,-20,-150,-233,-174,-114,-173,-2,-947
31,77,-39,-111,-111,-138,-108,-89,-488
-9,130,-113,-341,-315,-191,-262,69,-1032
46,20,9,-25,35,-12,-2,28,99
-5,1,6,-9,-11,-1,14,13,8
6,12,-5,-13,-2,3,7,10,18
-47,-32,-62,-192,-128,-131,-121,22,-691
-52,9,-75,-166,-110,-106,-137,-46,-683
-49,-18,-41,-133,-82,-47,-105,41,-434
24,42,-17,-99,-27,-88,-45,0,-210
-64,16,-104,-295,-218,-246,-220,-44,-1175
41,105,-60,-275,-173,-201,-215,-78,-856
-62,54,-90,-304,-143,-157,-130,12,-820
-2,0,4,-47,-19,-24,-27,5,-110
-41,17,-82,-137,-80,-68,-77,-27,-495
-11,-9,-12,-28,-33,-24,-26,6,-137
-54,-41,-62,-135,-82,-13,-56,24,-419
-6,2,-7,-45,-18,-39,-9,16,-106
-10,21,-45,-131,-88,-108,-100,-40,-501
19,38,4,2,-14,5,-17,-5,32
-104,47,-151,-352,-237,-150,-203,-11,-1161
-22,7,-17,-96,-52,-40,-16,-9,-245
28,6,-9,-66,18,-50,-20,-6,-99
-91,-13,-92,-184,-64,-77,-110,-22,-653
14,48,-28,-153,-116,-156,-132,-10,-533
-36,-35,-31,-89,-89,-81,-84,-21,-466
-7,-13,2,-33,-38,-38,1,6,-120
-51,20,-14,-99,-78,-43,-57,-32,-354
-21,-5,-26,-41,-36,-1,-29,13,-146
23,27,1,-84,-139,-116,-152,4,-436
-38,-2,-23,-49,-1,-32,-27,6,-166
-8,27,-38,-37,-22,-22,-51,-3,-154
6,15,-17,-97,-156,-68,-86,36,-367
-26,3,-35,-112,-48,-45,-68,30,-301
-27,-17,-15,-39,-41,-26,-43,-10,-218
-7,-3,-8,-34,-6,-20,-11,-13,-102
-14,22,-5,-70,-63,-53,0,-31,-214
-29,-9,-28,-70,-81,-27,-59,10,-293
0,11,-36,-83,-132,-80,-99,-35,-454
-1,22,-13,-32,-13,-18,-29,-21,-105
-8,37,-72,-112,-73,-118,-142,-94,-582
3,-41,-98,-135,-196,-165,-176,-74,-882
-7,14,-43,-65,-70,-60,-50,16,-265
-57,0,-69,-192,-60,-92,-111,19,-562
109,58,21,-194,-104,-172,-94,-14,-390
-7,50,-17,-75,-56,-12,-23,21,-119
-15,-21,-24,-123,-83,-106,-89,-43,-504
-14,76,-43,-154,-64,-112,-60,-67,-438
-47,28,-75,-128,-60,-58,-83,-50,-473
18,11,-3,-55,-47,-37,-37,34,-116
13,16,-12,-46,-45,-49,-29,-10,-162
-48,118,-23,-106,21,-30,-35,5,-98
-87,-45,-104,-143,-114,-63,-138,-16,-710
-12,5,-4,-9,8,0,-30,18,-24
24,16,-9,-124,-17,-111,-50,-13,-284
-3,-9,-18,-48,-71,-47,-52,-8,-256
-3,2,-4,-26,1,-13,-1,1,-43
-30,6,-30,-81,-67,-75,-60,-27,-364
-8,-4,-19,-44,-32,-41,-81,-2,-231
42,12,-40,-58,-52,-87,-59,-53,-295
-59,13,-108,-199,-164,-96,-139,7,-745
50,25,-12,-103,-15,-93,-75,-21,-244
-55,-6,-21,-69,-95,-49,-61,24,-332
11,5,-27,-58,-50,-50,-99,68,-200
32,22,15,-2,-22,-22,-1,16,38
-22,-4,-10,-21,-25,-5,-24,13,-98
7,63,33,-105,-57,-104,3,85,-75
133,20,55,-29,-23,-116,-43,91,88
50,11,-1,-49,-35,-45,-74,21,-122
-19,-12,-28,-81,-41,-36,-59,-29,-305
62,37,9,-33,6,-37,-31,50,63
111,55,14,-78,-80,-91,-59,-2,-130
-10,13,-30,-67,-52,-60,-44,-19,-269
-13,23,-81,-148,-95,-127,-129,-92,-662
28,86,-9,-77,6,-51,-38,74,19
130,31,34,-3,-17,-86,-87,63,65
26,53,-31,-62,-48,-57,-74,-8,-201
-33,-17,-53,-110,-63,-50,-51,-18,-395
-18,-6,-32,-118,-76,-70,-71,17,-374
-5,4,-13,-22,-23,-23,-13,-11,-106
42,6,7,-38,-137,-105,-88,21,-292
5,13,-32,-55,-165,-76,-47,2,-355
-39,56,-81,-177,-72,-110,-113,-8,-544
-6,13,-25,-30,-23,-33,-42,-14,-160
-8,7,-16,-21,-13,-12,-25,10,-78
2,76,-51,-197,-90,-104,-125,44,-445
-22,56,-23,-198,-3,-4,-100,65,-229
-32,9,-26,-73,-49,-57,-43,-6,-277
-77,66,-59,-168,-37,-74,-62,-58,-469
17,50,-73,-170,-84,-167,-136,-62,-625
-6,12,-4,-16,-32,-10,-20,-1,-77
187,36,45,34,-75,-128,-77,-6,16
4,-9,-41,-142,-133,-123,-112,-37,-593
-11,-8,-40,-113,-102,-104,-85,-18,-481
-12,-8,-2,-42,-44,-28,-24,-4,-164
-16,-2,-29,-150,-51,-42,-83,-13,-386
18,6,-13,-91,-86,-23,-56,-9,-254
-105,6,-105,-289,-180,-140,-191,53,-951
-9,-2,-14,-27,-24,-15,-30,-30,-151
-57,-14,-67,-119,-118,-50,-88,-62,-575
-54,71,-108,-309,-319,-134,-190,-9,-1052
-49,-25,-66,-85,-126,-61,-98,-21,-531
-13,-23,-30,-66,-88,-72,-67,-9,-368
-19,122,-71,-297,-175,-226,-174,-15,-855
2,17,-4,-55,-67,-47,-30,2,-182
19,21,-16,-29,-26,-38,-26,-35,-130
1,-5,-46,-111,-52,-99,-89,-30,-431
3,3,-36,-62,-34,-27,-40,-33,-226
-8,-21,-15,-81,-71,-44,-68,35,-273
-2,10,-8,-35,-36,-37,-25,1,-132
-16,-4,-22,-68,-79,-55,-57,-26,-327
15,12,-14,-30,-40,-30,-12,-20,-119
-18,12,-1,-24,-30,-26,-10,0,-97
-25,281,-141,-643,-352,-327,-485,-10,-1702
44,41,-30,-126,-39,-119,-52,-40,-321
-36,-42,-23,-106,-117,-63,-70,-11,-468
-14,-19,-73,-150,-157,-96,-104,-72,-685
45,85,-41,-180,-79,-137,-132,26,-413
-51,-30,-28,-128,-82,-62,-63,-1,-445
-21,15,-51,-135,-120,-36,-82,72,-358
-11,32,-20,-102,-125,-61,-100,88,-299
-19,194,-87,-237,-66,-132,-49,125,-271
35,32,9,-131,-86,-89,-70,-23,-323
22,16,-37,-291,-174,-217,-200,26,-855
-149,10,-121,-349,-213,-139,-244,169,-1036
0,51,-49,-105,-42,-70,-45,7,-253
32,54,-37,-60,-56,-104,-65,-13,-249
-28,-1,-15,-76,-95,-36,-56,-5,-312
-1,-2,-54,-179,-129,-83,-143,62,-529
-6,-4,-28,-58,-81,-35,-68,-20,-300
-17,-24,2,-52,-47,-40,-69,18,-229
90,74,-72,-235,-117,-226,-191,-72,-749
-41,2,-69,-156,-91,-83,-94,-45,-577
-28,37,-62,-159,-83,-32,-60,4,-383
60,-33,1,-116,-119,-132,-164,35,-468
-16,-14,-39,-86,-54,-50,-57,-11,-327
-15,-7,-22,-27,-44,-26,-21,-12,-174
1,-6,-43,-58,-52,-52,-68,-37,-315
-56,-16,-39,-139,-119,-93,-81,-11,-554
-51,-34,-48,-118,-135,-87,-77,-12,-562
-13,-10,-18,-37,-36,-32,-22,-2,-170
-64,-11,-106,-166,-133,-86,-142,-27,-735
12,48,-2,-38,-10,-18,-27,11,-24
2,26,-74,-143,-207,-170,-185,-140,-891
-8,8,-23,-95,-53,-51,-31,-23,-276
-20,6,-47,-106,-61,-74,-55,-43,-400
21,73,-70,-194,-90,-112,-90,28,-434
92,69,18,-134,-57,-135,-160,10,-297
14,201,-67,-277,7,-181,-80,57,-326
-18,9,-5,-27,-16,-6,-21,1,-83
-4,0,-8,-31,-22,-22,-14,1,-100
-24,43,-97,-233,-170,-196,-137,-81,-895
59,18,-70,-179,-240,-241,-170,-137,-960
22,148,-6,-146,-62,-95,-74,90,-123
1,-37,14,-52,1,-10,-13,28,-68
-32,22,-82,-263,-127,-167,-185,-50,-884
123,162,-19,45,72,-180,-69,167,301
33,110,-80,-248,-103,-245,-214,-151,-898
33,47,-33,-105,-59,-116,-76,-80,-389
-38,-9,-57,-104,-157,-101,-94,-26,-586
-1,25,-55,-189,-154,-204,-126,-80,-784
-26,-16,-41,-88,-87,-49,-66,8,-365
-90,125,-89,-248,-57,-126,-108,4,-589
531,439,417,22,423,291,-64,205,2264
121,55,5,-56,-12,-82,-67,93,57
-12,3,-27,-38,-26,-29,-18,-25,-172
79,99,0,-74,-46,-145,-112,14,-185
-6,24,-20,-38,-32,-32,-39,-5,-148
20,65,-3,-47,4,-20,-42,38,15
4,27,-16,-64,10,-27,-15,0,-81
-15,9,-17,-48,-13,-6,-36,-26,-152
-39,-12,-32,-112,-87,-81,-60,-4,-427
-7,71,15,-78,-9,-22,26,-10,-14
-84,-10,-75,-161,-195,-84,-195,7,-797
-20,3,-59,-113,-89,-87,-112,-43,-520
-10,-6,-77,-111,-114,-108,-113,-62,-601
67,94,21,-51,-59,-54,24,67,109
13,54,-111,-203,-124,-201,-131,-99,-802
-6,18,-9,-17,-4,-12,-17,-6,-53
-54,67,-40,-318,-105,-193,-86,-64,-793
-11,55,-56,-162,-141,-157,-142,-63,-677
-17,18,-47,-119,-67,-76,-71,-16,-395
-22,26,-17,-62,2,-38,-29,9,-131
0,9,-6,-13,-22,-25,-15,-12,-84
-11,10,-27,-111,-4,-64,-37,-14,-258
-13,-22,-14,-23,-13,-2,-11,5,-93
72,24,26,-44,-54,-59,-24,24,-35
1,148,-94,-266,-35,-178,-103,-53,-580
78,67,-68,-141,-130,-201,-124,14,-505
-19,2,-26,-43,-27,-45,-56,-3,-217
-4,20,-6,-100,9,-49,-22,7,-145
82,36,-38,-234,-203,-239,-170,-26,-792
-50,-2,-85,-111,-77,-84,-118,-40,-567
136,130,-85,-327,-140,-296,-241,-94,-917
3,20,-16,-73,-40,-32,-28,6,-160
5,37,-9,-75,-59,-47,-49,13,-184
-7,26,-8,-78,-80,-66,-71,-12,-296
-113,1,-209,-377,-249,-215,-264,-167,-1593
-24,19,-41,-69,-16,-37,-56,-2,-226
38,11,-62,-119,-73,-151,-95,-107,-558
-13,47,6,-44,-1,-23,-22,-3,-53
-49,59,-76,-252,-132,-203,-109,-57,-819
-15,16,-24,-58,-54,-72,-34,-38,-279
164,265,38,-263,33,-156,-115,246,212
150,387,-61,-404,-34,-266,-195,230,-193
-62,54,-104,-283,-169,-212,-217,17,-976
-22,28,-27,-78,-22,-61,-85,9,-258
294,401,-7,-327,-99,-460,-289,213,-274
58,53,-31,-65,-87,-140,-126,-43,-381
-35,553,-202,-1120,-610,-732,-673,439,-2380
-49,124,-152,-251,-92,-141,-155,-15,-731
46,204,-37,-424,-266,-357,-195,-193,-1222
2,-1,-10,-67,-44,-63,-26,-11,-220
118,246,-52,-380,14,-193,-111,115,-243
-104,43,-78,-182,-40,-52,-89,-5,-507
-18,-19,-39,-45,-37,-25,-45,-29,-257
-32,151,-29,-209,-48,-123,-86,25,-351
-5,16,-6,-84,-69,-59,-58,0,-265
-27,8,-13,-48,-47,-36,-22,7,-178
-28,24,-31,-99,-35,-64,-40,-6,-279
-17,-9,-13,-39,-1,-21,-16,-5,-121
-58,164,-102,-588,-350,-296,-522,325,-1427
79,38,-4,-121,-43,-131,-74,-4,-260
100,138,83,33,8,-31,-90,19,260
148,114,-40,-179,-22,-133,-93,75,-130
-13,8,-13,-41,-23,-30,-14,7,-119
-14,135,-35,-159,-45,-105,-32,43,-212
45,87,-18,-116,-45,-69,-52,-63,-231
46,57,-11,-124,-77,-84,-90,42,-241
-203,-75,-204,-394,-300,-184,-290,-101,-1751
33,54,9,-36,-14,-54,-44,-2,-54
-8,24,-48,-156,-106,-105,-133,18,-514
46,274,-76,-390,-154,-364,-201,97,-768
-3,11,-48,-147,-136,-160,-103,-78,-664
-82,28,-166,-304,-360,-169,-275,-38,-1366
188,90,22,-153,-54,-214,-176,-30,-327
-81,8,-105,-191,-218,-149,-208,-36,-980
-37,-5,-72,-116,-131,-68,-99,5,-523
-41,-14,-47,-100,-97,-98,-120,2,-515
128,50,-19,-126,-72,-173,-89,-34,-335
-95,64,-70,-182,-61,-81,-60,10,-475
-100,37,-45,-134,-78,-58,-67,-2,-447
-7,-10,-28,-26,-31,-11,-14,-16,-143
76,27,4,-63,-66,-148,-103,-33,-306
0,47,-2,-39,-27,-41,-7,-7,-76
0,26,-50,-175,-105,-92,-99,52,-443
-59,129,-181,-470,-151,-338,-278,-79,-1427
-24,66,-84,-259,-163,-260,-251,13,-962
-41,120,-155,-335,-156,-167,-158,-11,-903
-2,-3,6,-31,-8,-28,-14,11,-69
-66,-2,-71,-178,-91,-84,-107,26,-573
125,41,-10,-94,-16,-159,-87,25,-175
-8,35,-31,-176,-97,-100,-63,2,-438
40,2,-1,-32,-62,-67,-43,-46,-209
-129,76,-224,-593,-336,-340,-372,-43,-1961
-140,-71,-136,-268,-197,-145,-232,-57,-1246
80,75,-9,-132,-115,-146,-148,-9,-404
11,13,2,-24,-26,-23,-23,-1,-71
123,126,18,-107,-39,-171,-134,13,-171
-6,-17,-30,-48,-68,-66,-45,-19,-299
41,45,-22,-93,-129,-120,-117,-62,-457
-8,6,-66,-143,-126,-168,-131,-45,-681
47,66,26,-42,-10,-63,-24,39,39
-11,22,-45,-72,-47,-60,-51,-38,-302
-87,-5,-82,-151,-105,-36,-106,0,-572
-54,40,-72,-192,-48,-66,-85,-80,-557
46,131,-29,-197,-166,-183,-190,-182,-770
28,97,-24,-273,-199,-229,-173,-50,-823
10,89,-10,-155,-78,-156,-87,12,-375
85,39,35,-77,-63,-113,-71,18,-147
13,16,-14,-55,-46,-48,-33,-27,-194
-4,1,-42,-189,-83,-94,-127,47,-491
37,46,26,-9,-20,-67,-16,-27,-30
1,22,-7,-32,-31,-34,-26,4,-103
-25,38,-34,-140,-102,-56,-80,6,-393
28,137,-119,-555,-254,-487,-434,-130,-1814
-86,84,-54,-179,-67,-66,-13,30,-351
-96,31,-120,-249,-130,-127,-154,-95,-940
-64,68,-41,-223,-257,-137,-167,-67,-888
-1,-7,-91,-124,-166,-112,-141,-87,-729
27,54,-19,-42,-30,-78,-48,-45,-181
-41,126,-57,-203,-83,-64,-8,21,-309
19,5,-35,-63,-141,-91,-75,-51,-432
-6,37,-12,-100,-82,-90,-88,-7,-348
317,261,214,13,206,186,-38,153,1312
38,116,-71,-378,-200,-286,-205,2,-984
-71,156,-92,-352,-100,-107,-145,-21,-732
-43,22,-41,-121,-135,-58,-82,-25,-483
-35,51,-8,-106,-28,-2,-74,81,-121
39,65,-180,-297,-187,-305,-291,-280,-1436
-7,42,-53,-111,-78,-116,-66,-62,-451
27,21,-9,-99,-93,-109,-92,-21,-375
233,120,1,-36,-4,-197,-137,-14,-34
-34,26,-72,-304,-261,-237,-182,80,-984
-82,80,-30,-120,-15,-53,-53,-12,-285
-32,36,-61,-172,-46,-75,-104,-20,-474
-4,43,-46,-115,-94,-65,-67,0,-348
-54,10,-53,-132,-148,-124,-151,-25,-677
-42,12,-36,-107,-57,-53,-52,2,-333
-87,15,-183,-437,-230,-137,-177,52,-1184
65,100,40,-72,12,-81,-63,96,97
-156,40,-178,-340,-220,-171,-263,-92,-1380
-2,50,-22,-164,-96,-146,-97,-61,-538
-7,25,-17,-79,-46,-31,-28,17,-166
-4,16,-12,-73,-45,-36,-19,1,-172
-5,18,-13,-78,-42,-37,-30,-5,-192
-38,16,-54,-88,-60,-67,-66,7,-350
-36,8,-43,-86,-53,-34,-62,2,-304
-9,2,-12,-22,-12,-7,-10,-2,-72
-26,-10,-22,-38,-12,-18,-29,-14,-169
-24,-19,-18,-22,-26,-8,-19,-6,-142
-17,14,-14,-20,-5,-21,-12,7,-68
-24,3,-18,-33,-15,-14,-9,-14,-124
-27,-9,-16,-28,-24,-18,-20,-1,-143
-25,-18,-15,-14,-19,3,-17,-5,-110
-24,22,-17,-26,-14,-10,-25,5,-89
-18,-8,-13,-28,-17,-7,-16,-11,-118
-17,-1,-18,-40,-16,-23,-24,-15,-154
-141,-72,-149,-259,-251,-154,-196,-25,-1247
-79,102,-46,-156,-74,-83,-64,-2,-402
-84,-7,-100,-189,-110,-83,-108,-74,-755
63,5,-24,-131,-155,-176,-109,-21,-548
-29,-3,-17,-64,-7,-43,-35,-5,-203
-49,177,-106,-331,-31,-144,-70,76,-478
72,75,-7,-159,-71,-131,-108,-8,-337
147,57,24,-93,30,-126,-95,18,-38
60,183,11,-106,-47,-44,-1,10,66
-29,-11,-59,-186,-144,-152,-108,-35,-724
-11,47,-18,-71,2,-37,-32,10,-110
9,-29,-72,-117,-124,-128,-124,-32,-617
-62,13,-55,-157,-78,-78,-62,-22,-501
103,129,28,-127,-86,-138,-143,79,-155
91,99,59,27,25,47,14,68,430
1,31,-13,-65,8,-53,-32,2,-121
-20,-26,-47,-86,-102,-41,-95,-10,-427
-25,-18,-50,-100,-85,-82,-66,-50,-476
-8,36,-27,-169,-76,-135,-163,69,-473
-116,51,-233,-599,-386,-405,-375,-85,-2148
-15,29,-49,-65,-49,-21,-6,22,-154
-10,-4,-10,-16,-16,-10,-14,-1,-81
1,15,-8,-84,-108,-87,-81,1,-351
-9,-6,-15,-30,-24,-15,-17,-12,-128
-24,127,-173,-281,-217,-235,-237,-37,-1077
-12,20,7,-58,-15,-81,-68,63,-144
-81,55,-56,-186,-29,-51,-36,-3,-387
20,-13,18,-60,-2,13,-31,93,38
31,55,-27,-152,32,-98,-70,3,-226
-79,171,-118,-318,-80,-183,-133,36,-704
-56,136,-65,-220,-46,-152,-81,42,-442
4,12,-6,-59,-35,-5,-80,66,-103
39,25,1,-60,-1,-46,-41,10,-73
8,10,-4,-58,-13,-60,-42,-11,-170
38,64,-32,-126,-46,-136,-85,-53,-376
-9,-1,-21,-47,-39,-34,-44,-18,-213
-66,-44,-89,-210,-149,-123,-175,17,-839
-72,40,-37,-116,-52,-53,-49,-3,-342
10,7,-13,-45,-23,-51,-24,1,-138
-17,19,-35,-61,-36,-46,-47,-27,-250
-40,1,-35,-74,-54,-43,-39,-35,-319
-24,17,-37,-96,-44,-95,-63,-39,-381
-78,21,-70,-151,-108,-67,-102,-7,-562
5,22,5,-60,-9,-21,-4,16,-46
-105,50,-41,-144,-77,-48,-86,-13,-464
10,50,-38,-141,-87,-140,-59,-37,-442
74,114,-26,-188,-42,-147,-86,16,-285
-14,2,-34,-76,-44,-33,-66,25,-240
149,113,68,-172,48,-164,-33,-4,5
-59,54,-57,-151,-26,-72,-71,30,-352
17,-4,-48,-127,-137,-90,-69,-87,-545
3,-4,-45,-39,-115,-76,-98,-50,-424
-4,63,-30,-278,-95,-209,-116,-60,-729
-56,64,-65,-208,-72,-141,-84,44,-518
-15,-2,-24,-41,-24,-6,-19,3,-128
5,-5,-15,-80,-33,-59,-38,-3,-228
-25,6,-42,-89,-54,-61,-72,-45,-382
106,388,-99,-617,-196,-402,-271,159,-932
-55,-15,-64,-107,-93,-60,-71,-24,-489
-4,0,-11,-26,1,-10,-23,37,-36
-6,5,-6,13,2,9,-21,17,13
6,21,1,7,-9,-2,-16,3,11
25,26,14,19,7,10,-21,24,104
41,34,8,39,22,9,-19,25,159
30,39,3,44,8,2,-29,21,118
8,15,1,15,-12,-1,-12,4,18
20,28,4,25,4,8,-26,9,72
-2,10,-2,-1,-22,-21,-20,-3,-61
25,19,-9,20,-3,4,-21,14,49
29,42,12,36,9,2,-22,15,123
17,33,17,35,7,6,-25,21,111
46,55,23,67,36,27,-34,17,237
8,10,0,7,-4,-7,-12,9,11
22,27,14,15,-2,3,-8,17,88
39,39,16,30,20,12,-12,26,170
17,22,19,18,10,11,-25,20,92
3,38,-2,-16,12,-8,-37,39,29
-2,41,3,-17,1,-22,-48,42,-2
13,62,-6,-56,8,-21,-20,43,23
-15,64,-15,-87,26,-48,-74,54,-95
-28,-8,-31,-55,-39,-31,-29,34,-187
68,66,-54,-76,-209,-158,-167,-103,-633
-4,9,-7,-53,-24,-18,-22,8,-111
38,18,-35,-166,-90,-209,-140,-75,-659
36,41,-27,-214,-87,-212,-121,30,-554
-8,26,-103,-209,-165,-214,-165,-123,-961
22,-24,-37,-59,-47,-73,-73,8,-283
-110,50,-64,-176,-36,-65,-88,-32,-521
-64,-4,-77,-175,-109,-55,-67,-12,-563
6,17,2,17,-8,-3,-7,1,25
1,146,-3,-133,-24,-51,-55,37,-82
-17,-22,-66,-173,-194,-177,-145,-128,-922
-112,111,-147,-360,-173,-210,-188,-24,-1103
-76,46,-97,-289,-41,-130,-99,-7,-693
-4,136,-19,-160,17,-40,-24,12,-82
-37,39,-46,-122,-47,-64,-39,-18,-334
-22,2,-29,-42,-18,-23,-33,-8,-173
59,10,23,-66,-4,-59,-54,35,-56
-29,21,-47,-129,-101,-104,-82,17,-454
-40,-33,-57,-99,-124,-79,-109,4,-537
-5,-10,-33,-53,-26,-36,-61,-9,-233
36,40,1,-38,10,-44,-28,-6,-29
-32,98,-66,-236,-61,-141,-151,15,-574
-9,30,-37,-114,-41,-23,-23,-20,-237
-82,51,-62,-113,-47,-20,-33,-29,-335
-50,-15,-21,-115,-70,-58,-61,-7,-397
77,92,41,-118,-26,-114,-3,19,-32
-4,9,11,-35,-10,-27,-11,-5,-72
-57,-19,-41,-101,-91,-64,-70,-62,-505
-10,49,9,-10,6,-30,-46,51,19
-45,65,-28,-114,-2,-28,-63,-1,-216
82,59,15,-34,6,-73,-53,-37,-35
9,49,-52,-190,-227,-69,-121,2,-599
-60,4,-84,-156,-85,-69,-97,-51,-598
19,76,8,-37,-67,-60,-97,-25,-183
106,34,31,-41,-35,-119,-37,-29,-90
89,95,16,-79,-43,-122,-35,17,-62
44,9,-1,-132,-65,-129,-51,-20,-345
-34,-38,-45,-128,-73,-58,-65,-34,-475
19,33,13,25,1,2,-22,13,84
-47,70,-71,-245,-116,-146,-143,5,-693
72,295,-62,-511,-103,-230,-131,110,-560
-125,2,-110,-323,-140,-91,-152,-4,-943
-15,-36,-68,-198,-124,-155,-134,-39,-769
-121,428,-207,-650,-26,-190,-242,-118,-1126
9,15,0,-33,4,-27,-18,-2,-52
-28,-3,-39,-81,-69,-87,-80,-24,-411
4,38,-21,-84,-31,-25,-51,-14,-184
133,71,21,-80,3,-45,-26,92,169
-7,-8,-15,-20,-34,-24,-21,-3,-132
16,13,7,-49,-75,-48,-55,21,-170
-322,35,-364,-492,-336,-54,-420,137,-1816
-2,20,-1,-56,1,-46,-23,8,-99
15,17,-4,-29,-26,-38,-38,4,-99
13,13,-28,-112,-72,-83,-56,-13,-338
-70,71,-54,-115,-14,-21,-41,-22,-266
-58,-44,-59,-137,-113,-71,-116,0,-598
-25,7,-10,-76,-46,-48,-26,-1,-225
14,55,37,-62,30,-12,-31,31,62
-18,-14,-15,-52,-41,0,-23,13,-150
-86,71,-52,-179,-55,-47,-77,0,-425
122,91,-10,-172,10,-122,-66,17,-130
-7,4,-5,-17,-8,-8,5,-2,-38
37,36,-61,-132,-87,-137,-108,-49,-501
-41,-6,-90,-149,-89,-117,-121,-66,-679
-25,8,-37,-154,-160,-92,-106,59,-507
-157,77,-199,-444,-298,-123,-238,20,-1362
12,28,18,-22,-4,-37,-14,-11,-30
16,30,1,-30,-39,-42,-38,-60,-162
64,97,-16,-160,-20,-182,-110,-1,-328
-43,96,-22,-177,-18,-70,-86,-29,-349
-62,-35,-53,-109,-83,-60,-94,6,-490
-122,33,-52,-142,-63,-67,-48,-50,-511
9,17,-19,-61,-60,-50,-60,0,-224
13,-2,-46,-90,-174,-166,-115,-107,-687
-43,14,-24,-111,-45,-57,-63,4,-325
-12,3,-8,-59,-32,-38,-19,-13,-178
-108,9,-137,-217,-147,-115,-182,-42,-939
19,87,-12,-109,-84,-125,-80,-50,-354
-86,6,-136,-211,-136,-119,-188,-38,-908
-31,7,-71,-187,-156,-115,-117,-25,-695
13,9,-45,-104,-96,-116,-76,-33,-448
-81,14,-69,-157,-56,-48,-79,2,-474
-45,-20,-29,-61,-52,-42,-34,-2,-285
-53,0,-21,-138,-40,-76,-24,27,-325
60,11,12,2,4,-66,-38,3,-12
14,56,-12,-68,50,-30,-19,25,16
-19,14,-24,-67,-28,-12,-49,7,-178
7,3,-31,-44,-51,-67,-33,-53,-269
-63,0,-78,-142,-186,-87,-166,53,-669
38,27,-12,-99,22,-76,-81,-33,-214
8,30,-78,-176,-138,-162,-124,-100,-740
1,28,-21,-44,-3,-31,-21,-7,-98
7,60,-23,-127,-53,-78,-76,-18,-308
-11,81,-26,-135,-79,-161,-68,-39,-438
-42,-38,-51,-114,-106,-82,-88,-19,-540
14,54,-29,-110,-106,-58,-55,-7,-297
-25,14,-26,-52,-23,-23,-22,-29,-186
-6,160,-79,-281,-103,-158,-109,8,-568
40,107,-31,-139,-31,-117,-40,40,-171
-77,21,-38,-135,-78,-87,-61,-20,-475
-96,9,-129,-226,-142,-126,-173,-16,-899
-21,-1,-28,-44,-42,-45,-48,-40,-269
-58,157,-124,-393,-202,-237,-229,47,-1039
-61,-3,-67,-170,-55,-53,-73,-24,-506
50,96,-51,-146,-26,-127,-82,-52,-338
-25,-18,-68,-143,-130,-160,-114,-49,-707
-19,20,-40,-102,-78,-80,-44,25,-318
-23,6,-10,-49,-23,-23,-26,-4,-152
7,23,-12,-24,14,3,1,-13,-1
-23,127,-48,-139,-30,-32,-8,29,-124
-30,27,-48,-163,-110,-101,-63,-34,-522
-90,-27,-92,-150,-73,-64,-122,0,-618
-47,265,-158,-718,-266,-430,-340,104,-1590
-60,-1,-84,-190,-109,-118,-117,-64,-743
-61,65,-166,-382,-207,-251,-274,13,-1263
-60,0,-76,-135,-80,-72,-99,-35,-557
14,194,-6,-168,-28,-80,-11,98,13
-28,76,-77,-244,-87,-163,-98,-13,-634
-58,0,-44,-117,-75,-27,-44,20,-345
-3,20,-8,-17,3,-25,-12,10,-32
-8,-5,-22,-27,-29,-25,-35,-8,-159
-6,-6,-11,-35,-34,-40,-29,1,-160
-63,72,-36,-140,-63,-13,-6,13,-236
60,33,-21,-76,-76,-126,-68,-18,-292
-5,7,-15,-22,-8,-2,-7,13,-39
-6,32,-22,-110,-99,-104,-60,-30,-399
-1,18,-2,-19,-5,-9,1,18,1
-289,-122,-282,-488,-339,-197,-376,-55,-2148
-473,98,-597,-1512,-761,-336,-612,262,-3931
-41,-28,-39,-131,-100,-97,-66,-27,-529
-44,48,-32,-91,-1,-3,-35,-19,-177
115,154,-31,-119,-295,-253,-171,-113,-713
-94,-10,-70,-278,-82,-68,-103,9,-696
26,-5,-23,-16,-58,-67,-34,-20,-197
-23,21,-33,-98,-45,-51,-63,-10,-302
-29,135,-51,-286,-188,-168,-205,-78,-870
-63,18,-111,-231,-165,-95,-151,-15,-813
72,43,13,-109,19,-56,-73,60,-31
-40,-27,-41,-85,-85,-49,-89,-40,-456
-11,175,-63,-216,-65,-122,-53,41,-314
-43,-14,-48,-188,-171,-121,-112,-37,-734
-19,10,-39,-71,-22,-1,-36,19,-159
-75,-13,-83,-194,-102,-93,-106,-35,-701
-34,5,-40,-112,-73,-59,-48,31,-330
25,79,-11,-212,-171,-102,-160,161,-391
-23,19,-32,-74,-38,-64,-55,-10,-277
135,91,2,-131,-90,-146,-150,-21,-310
167,58,2,-143,-41,-175,-43,38,-137
-146,-84,-170,-282,-230,-98,-194,-13,-1217
-31,14,-45,-70,-33,-48,-45,-4,-262
7,72,3,-123,-14,-87,-24,-18,-184
-21,-10,-48,-71,-69,-54,-72,-7,-352
-40,249,-80,-413,-151,-188,-180,86,-717
-56,200,-66,-350,-68,-99,-156,-79,-674
-142,89,-209,-375,-189,-98,-233,2,-1155
-20,481,-201,-455,-239,-45,-487,326,-640
-14,27,-31,-53,-22,-10,-9,-32,-144
-4,10,-17,-31,-8,-15,-25,-3,-93
-59,255,-106,-312,-55,-40,77,174,-66
12,-5,-7,-35,-39,-33,-28,-19,-154
-17,-4,-18,-20,-7,-7,-22,-10,-105
-20,-11,-20,-48,-33,-28,-12,-19,-191
-32,-2,-86,-176,-135,-137,-181,-69,-818
-82,58,-66,-205,-124,-83,-102,-78,-682
35,15,14,1,18,-3,13,21,114
30,7,10,0,8,-10,8,20,73
29,162,-33,-238,-65,-132,-150,-131,-558
-26,47,-63,-117,-68,-61,-67,-30,-385
-88,21,-61,-133,-72,-109,-90,-41,-573
61,40,-2,-33,-25,-55,-46,-4,-64
46,66,14,2,5,-8,22,58,205
-13,18,-26,-136,-68,-77,-97,12,-387
-18,-4,-22,-49,-32,-31,-24,-16,-196
-5,0,-21,-27,-7,-11,-17,-3,-91
23,83,1,-170,-111,-145,-88,-55,-462
137,58,-26,-179,-116,-227,-178,-28,-559
-142,-5,-179,-410,-237,-148,-257,-6,-1384
-170,-5,-200,-413,-287,-195,-305,-31,-1606
-9,14,-18,-62,0,-49,-25,-11,-160
-39,96,-42,-173,-52,-80,-63,-46,-399
-44,15,-17,-88,-55,-39,-64,19,-273
2,28,3,-45,-26,-48,0,-9,-95
40,21,-4,-97,-89,-87,-79,21,-274
-53,-1,-67,-96,-43,-41,-64,-30,-395
-21,43,-45,-114,-80,-55,-28,-2,-302
-12,12,-4,-45,-29,-9,-28,1,-114
-4,15,-18,-45,-24,-27,-30,-19,-152
-55,134,-243,-520,-231,-396,-339,-14,-1664
264,224,93,-388,-56,-351,-247,273,-188
13,-29,-67,-130,-127,-138,-162,1,-639
-79,-3,-122,-216,-153,-103,-163,-44,-883
-61,37,-140,-312,-245,-198,-197,-34,-1150
-26,59,-59,-162,-48,-32,-78,-18,-364
19,9,-2,-9,12,12,6,3,50
-63,15,-134,-287,-208,-199,-201,-22,-1099
78,67,25,-65,-42,-140,-81,17,-141
19,14,-12,-12,-10,-24,-19,1,-43
-54,98,-135,-248,-72,-131,-171,-49,-762
48,43,-16,-126,-91,-136,-92,12,-358
-40,35,-47,-68,-20,-28,-22,0,-190
43,30,-82,-142,-94,-171,-121,-117,-654
12,13,-13,-25,-10,-14,-16,-22,-75
-20,-2,-40,-68,-37,-42,-58,-9,-276
-8,55,-34,-125,-69,-80,-50,37,-274
11,68,8,-7,12,-20,-48,53,77
55,138,50,1,14,14,-54,-80,138
-46,88,-27,-218,-91,-139,-65,71,-427
-27,152,-124,-338,-85,-152,-170,-28,-772
-6,21,0,-33,-4,-21,-18,3,-58
6,6,-3,-34,-15,-22,-9,-4,-75
-134,70,-83,-206,-88,-38,-84,-9,-572
21,36,12,-33,-8,-7,-31,6,-4
9,20,-4,-110,-81,-53,-69,-17,-305
-15,14,-14,-31,-5,-11,-9,6,-65
-12,-2,-7,-29,-7,-22,-12,6,-85
3,65,-33,-103,-70,-54,-46,5,-233
86,93,-16,-217,-73,-89,-207,106,-317
6,72,-32,-240,-98,-130,-173,130,-465
122,14,-9,-107,-108,-198,-118,-66,-470
183,142,78,-131,88,-173,-145,71,113
-75,12,-62,-142,-111,-56,-105,-5,-544
-19,57,-56,-105,-20,-47,-31,-50,-271
-69,47,-71,-192,-48,-78,-82,-89,-582
0,91,-21,-145,-63,-86,5,72,-147
-26,10,-33,-132,-81,-69,-93,-32,-456
25,24,-41,-51,-63,-63,-63,-67,-299
50,86,18,-71,14,-33,-20,65,109
-24,11,-35,-102,0,-60,-24,26,-208
-23,-2,-36,-69,-35,-38,-51,-31,-285
19,-3,-1,-22,-24,-10,-35,37,-39
-35,-9,-35,-66,-32,-44,-44,-11,-276
-45,10,-21,-125,-101,-37,-79,28,-370
-72,7,-52,-140,-96,-77,-104,-8,-542
-36,7,-24,-116,-181,-88,-134,19,-553
-4,-10,-5,-38,-45,-39,-12,-14,-167
-109,-16,-167,-260,-146,-121,-229,-40,-1088
8,28,-4,-41,-38,-45,-44,27,-109
-44,72,-38,-145,-28,-106,-37,-15,-341
-11,53,-29,-106,-54,-84,-43,-14,-288
118,138,-47,-232,-191,-265,-169,-110,-758
-43,11,-50,-90,-94,-41,-78,6,-379
12,66,-48,-204,-87,-112,-126,-60,-559
-66,-7,-55,-174,-99,-87,-47,-3,-538
-26,0,-56,-106,-137,-118,-147,-1,-591
-29,10,-38,-127,-81,-57,-67,-21,-410
-36,0,-31,-153,-84,-68,-81,-19,-472
-8,6,-36,-123,-99,-98,-47,-51,-456
-14,9,-12,-40,-18,-13,-6,-15,-109
-42,14,-67,-127,-95,-71,-99,-7,-494
-4,3,-7,-51,-43,-47,-47,-20,-216
-51,-11,-35,-97,-83,-10,-45,-7,-339
14,13,-31,-68,-113,-97,-61,-40,-383
-8,30,-27,-92,-18,-71,-72,-45,-303
19,20,-25,-73,-186,-144,-142,-22,-553
-7,22,-54,-61,-95,-77,-49,25,-296
-63,-55,-72,-100,-89,-67,-86,-26,-558
-20,15,-17,-97,-46,-38,-42,-4,-249
-6,13,-45,-82,-29,-40,-48,-49,-286
103,68,-16,-42,-77,-140,-62,-15,-181
-2,1,-3,-24,0,-3,9,3,-19
75,65,14,-61,-60,-111,-73,37,-114
-66,61,-57,-163,-81,-64,-63,-1,-434
-32,24,-61,-89,-25,-43,-63,-1,-290
-137,-18,-169,-332,-171,-153,-218,-88,-1286
-2,48,0,-41,-15,-21,-52,28,-55
13,9,-22,-24,-56,-57,-45,-44,-226
26,27,-39,-67,-64,-47,-59,-25,-248
-18,22,-46,-95,-62,-86,-92,-49,-426
-7,7,-18,-68,-54,-36,-45,8,-213
-9,-8,-3,-26,-27,-12,-21,-14,-120
11,-9,-31,-79,-85,-72,-86,-36,-387
7,15,-5,-40,-13,-27,-22,-9,-94
30,127,-39,-238,-60,-135,-40,104,-251
93,45,8,-125,51,-111,-66,53,-52
26,32,-19,-71,-49,-71,-38,13,-177
-79,24,-63,-146,-67,-54,-93,-5,-483
-39,-3,-77,-97,-70,-66,-98,-19,-469
60,128,-12,-265,-21,-194,-158,39,-423
-48,42,-57,-176,-38,-78,-41,25,-371
83,159,-77,-474,-236,-398,-352,-86,-1381
-59,248,-83,-275,16,-62,35,136,-44
-24,-14,-18,-76,-119,-42,-61,9,-345
-70,9,-44,-191,-122,-76,-115,-48,-657
3,-10,-18,-56,-44,-63,-47,-29,-264
23,39,11,-24,-35,-28,-5,12,-7
25,12,3,-90,15,-26,-37,8,-90
39,70,-18,-104,5,-68,-54,51,-79
38,167,-19,-248,-66,-136,-123,-88,-475
-39,-17,-30,-65,-68,-42,-32,-2,-295
-49,82,-62,-174,-31,-54,-27,59,-256
-5,31,6,-18,-51,-37,-16,51,-39
1,12,-6,-13,-11,-8,-21,-6,-52
-93,174,-114,-364,-72,-134,-107,84,-626
-8,9,-7,-27,-19,-4,-31,13,-74
3,20,-22,-34,-9,-24,-16,-11,-93
47,48,-61,-50,-87,-95,-64,-93,-355
-105,-4,-174,-347,-247,-177,-197,-105,-1356
9,2,11,-44,-59,-29,-20,-5,-135
20,9,20,-23,18,7,-8,17,60
95,31,-12,-120,-100,-166,-156,16,-412
-38,45,-91,-203,-118,-99,-148,31,-621
9,62,-62,-540,-381,-348,-300,287,-1273
108,112,-94,-308,-203,-349,-268,-175,-1177
-40,97,-68,-237,-23,-92,-23,46,-340
-27,15,-31,-86,-84,-16,-27,-8,-264
-86,42,-88,-141,-79,-27,-45,15,-409
-61,57,-83,-144,-111,-51,-61,6,-448
-58,40,-56,-105,-68,4,-28,9,-262
-51,30,-35,-81,-32,-1,0,-21,-191
-45,38,-27,-108,-90,-49,-60,5,-336
-21,19,-25,-61,-19,-34,-25,14,-152
-44,-4,-48,-111,-51,-29,-83,-17,-387
10,129,-15,-206,-126,-139,-61,123,-285
-16,44,-25,-117,-64,-92,-84,-11,-365
-13,-5,2,-21,-6,-6,2,3,-44
-50,48,-117,-221,-178,-159,-153,-40,-870
65,41,1,30,-56,-57,-24,-14,-14
-43,-29,-58,-101,-80,-39,-79,-24,-453
-152,44,-119,-266,-127,-49,-175,-83,-927
-44,-31,-44,-83,-41,-32,-60,-29,-364
-65,96,-36,-229,-100,-112,-153,-124,-723
-35,-13,-47,-68,-53,-34,-56,-14,-320
1,-36,-43,-48,-103,-85,-96,-36,-446
-130,-100,-135,-221,-144,-81,-179,-21,-1011
20,15,10,-17,-25,-43,-20,-10,-70
38,9,-27,-120,-31,-85,-76,-39,-331
-23,14,-69,-165,-183,-160,-184,23,-747
-42,35,-9,-108,-68,-50,-19,29,-232
-39,8,-57,-124,-45,-79,-60,-49,-445
-5,6,-11,-25,-12,-42,-30,-39,-158
-19,96,-21,-54,33,-2,39,27,99
69,129,77,-1,30,58,-1,153,514
4,-4,-25,-33,-24,-42,-28,-34,-186
4,-17,1,-7,-10,-22,-4,20,-35
-22,18,-33,-57,-22,-28,-31,9,-166
-4,102,-59,-194,-140,-143,-126,-50,-614
-76,59,-67,-207,-137,-82,-92,-88,-690
-56,77,-45,-137,-42,-59,-72,7,-327
-819,744,-976,-2182,-950,-822,-1183,352,-5836
-1,33,-70,-174,-149,-171,-171,-103,-806
74,80,28,-128,7,-83,-83,28,-77
959,1536,944,756,815,250,-241,1110,6129
-51,98,-119,-331,-206,-242,-252,64,-1039
2,20,17,-21,-14,-7,-12,4,-11
-12,5,-5,-15,-6,0,-18,-7,-58
2,65,-20,-126,-63,-46,-76,76,-188
-45,-19,-48,-150,-67,-85,-81,-23,-518
211,119,-33,-134,-19,-238,-193,-19,-306
-7,65,-13,-120,-42,-48,-53,-47,-265
-1,-33,-11,-37,-32,-26,-16,9,-147
4,4,-39,-139,-109,-126,-83,-48,-536
-33,3,-16,-54,-19,-11,-19,-13,-162
-54,12,-32,-91,-26,-38,-40,-26,-295
-12,1,-4,-31,-13,-13,-13,-10,-95
-26,11,-35,-75,-40,-33,-47,-31,-276
2,61,-33,-75,-33,-11,-15,31,-73
-45,74,-37,-154,5,-55,-5,35,-182
-45,30,-81,-137,-143,-67,-129,-47,-619
227,124,-28,-198,-49,-290,-163,-88,-465
-117,11,-105,-303,-202,-159,-134,-49,-1058
-61,142,-54,-253,-37,-67,-19,63,-286
-64,19,-32,-123,-49,-36,-39,-15,-339
-26,10,-19,-38,-32,-28,-17,1,-149
-33,7,-24,-103,-105,-48,-137,-21,-464
-2,19,-53,-85,-57,-50,-77,40,-265
14,-3,34,-73,-100,-86,-84,16,-282
-20,4,-22,-35,-18,-28,-34,9,-144
-35,-21,-23,-55,-43,-14,-29,0,-220
-8,32,-27,-44,-19,-23,-20,-16,-125
-2,55,-42,-171,-185,-144,-131,-12,-632
-104,-47,-118,-167,-106,-66,-141,-28,-777
-18,-19,-86,-157,-165,-173,-182,-37,-837
-39,-33,-48,-146,-150,-121,-191,8,-720
-17,-15,-64,-118,-170,-142,-171,15,-682
-118,-44,-120,-188,-132,-80,-149,-13,-844
-8,6,-41,-99,-65,-46,-62,-24,-339
-72,44,-89,-230,-165,-89,-194,-33,-828
-11,-12,-9,-46,-27,-34,-21,-7,-167
-97,29,-157,-345,-214,-233,-284,-96,-1397
-129,46,-190,-539,-387,-204,-319,160,-1562
-51,43,-39,-112,-44,-57,-44,-28,-332
-10,17,-20,-54,-15,-30,-22,-3,-137
31,73,6,-64,11,-25,19,60,111
-4,9,-35,-87,-69,-75,-72,-15,-348
202,251,19,-407,11,-258,-185,166,-201
0,37,2,-74,-38,-39,-36,78,-70
9,1,-1,2,4,7,-2,16,36
-35,25,-75,-153,-57,-104,-129,-73,-601
-62,46,-6,-134,-60,-86,-48,40,-310
38,62,18,11,33,15,51,15,243
-15,69,-24,-107,-44,-48,-18,51,-136
-34,68,-75,-145,-96,-73,-57,27,-385
579,401,237,319,-390,-137,-112,164,1061
-31,132,-91,-229,-120,-127,-129,48,-547
-64,17,-63,-153,-125,-85,-86,27,-532
109,58,-28,-72,-108,-84,0,58,-67
-296,20,-320,-578,-333,-285,-362,-120,-2274
-119,128,17,-385,120,-239,-134,-11,-623
106,93,-2,-118,-33,-154,-171,84,-195
-83,-16,-41,-116,-55,-49,-44,-26,-430
-100,-52,-152,-252,-239,-140,-241,2,-1174
19,333,-123,-650,-146,-221,-248,174,-862
-8,15,-38,-99,-26,-54,-58,-25,-293
-16,16,-21,-53,-41,-19,-27,19,-142
-66,-53,-65,-125,-87,-57,-117,1,-569
-28,81,-41,-85,19,-41,-18,6,-107
-5,16,-33,-76,-97,-72,-43,-10,-320
62,65,-18,-202,19,-38,-34,57,-89
-96,77,-72,-193,-44,-66,-28,-15,-437
-38,29,-44,-67,-44,-47,-66,-24,-301
17,63,-19,-150,-55,-128,-82,45,-309
1,21,20,-22,-19,-11,-18,3,-25
17,8,-24,-69,-9,-60,-46,-28,-211
109,215,32,-348,-24,-265,-143,155,-269
63,45,-11,-142,-13,-72,-40,40,-130
-63,-20,-74,-156,-124,-77,-108,-31,-653
14,5,-9,-24,-35,-42,-14,-10,-115
10,-5,-22,-4,-35,-26,-10,1,-91
-128,-93,-142,-226,-144,-78,-177,-25,-1013
152,203,-45,-147,-146,-204,-286,-180,-653
-19,18,-11,-25,2,-9,-22,-15,-81
-2,10,-7,-35,-27,-32,-45,-6,-144
-58,-23,-41,-78,-61,-26,-62,14,-335
-79,74,-51,-163,-46,-98,-47,-28,-438
-26,-27,-5,-30,-44,-24,-13,0,-169
287,267,122,-331,35,-269,-177,62,-4
-71,122,-118,-344,-222,-79,-179,88,-803
-58,300,-126,-415,-243,-186,-188,-30,-946
-6,24,-38,-162,-103,-132,-100,-62,-579
-35,-12,-33,-93,-49,-30,-59,-27,-338
-5,50,-36,-81,-81,-54,-52,-13,-272
78,45,-1,10,-62,-29,-3,-11,27
5,128,-69,-102,-105,-107,-136,-9,-395
-10,-5,-19,-19,-17,-26,-26,-8,-130
-3,-1,-3,-24,-5,-9,-2,7,-40
-13,-5,-9,-34,-56,-9,-6,4,-128
-60,1,-66,-134,-94,-92,-120,-35,-600
-14,37,-13,-34,4,-17,-1,16,-22
26,22,-12,-125,-110,-125,-87,-22,-433
126,219,-8,-321,-25,-211,-126,-12,-358
36,12,5,-36,-39,-72,-48,-6,-148
159,236,-33,-296,-25,-108,-149,64,-152
-99,87,-37,-285,46,-160,-113,-12,-573
15,24,5,-7,-10,-5,7,18,47
-10,66,-52,-97,-1,-62,-58,34,-180
-75,-20,-68,-145,-99,-65,-118,12,-578
-23,-29,-26,-77,-83,-62,-99,46,-353
-53,5,-80,-266,-155,-152,-176,-59,-936
-26,52,-58,-167,-63,-138,-112,31,-481
-12,-5,-41,-76,-83,-14,-49,25,-255
-8,0,-7,-32,-30,-33,-28,-8,-146
42,85,-52,-168,-112,-67,-50,77,-245
-20,54,-69,-244,-52,-95,-144,-7,-577
-235,-43,-291,-595,-391,-292,-361,-38,-2246
-4,90,-45,-179,-75,-128,-103,-44,-488
-20,17,-12,-40,-23,-19,-34,-2,-133
-6,-7,4,-6,-11,-14,-4,5,-39
-76,-22,-98,-217,-81,-63,-78,52,-583
464,469,184,-227,140,-212,-51,287,1054
-9,25,-23,-51,-44,-32,-37,9,-162
-10,14,-5,-38,3,-15,-20,12,-59
66,74,44,-25,46,-34,-19,71,223
17,12,-8,-30,-17,-27,-25,-32,-110
199,216,51,-120,17,-142,-102,125,244
54,62,-37,-153,-13,-138,-71,-27,-323
27,54,-26,-97,-62,-111,-67,-57,-339
-72,51,-146,-371,-305,-305,-268,-148,-1564
-4,2,-7,-24,-12,-15,-9,-9,-78
-14,14,-20,-52,-79,-81,-55,-2,-289
24,82,-10,-146,-76,-129,-17,48,-224
3,94,-45,-210,-81,-112,-66,-50,-467
-29,39,-63,-120,-74,-61,-61,-27,-396
8,28,-1,-48,-9,-54,-35,-4,-115
87,76,-49,-211,-260,-243,-216,-130,-946
-16,20,-68,-162,-73,-129,-116,-69,-613
-26,39,-44,-160,-51,-87,-102,-56,-487
-21,7,-55,-104,-67,-87,-69,-35,-431
238,185,86,-246,20,-289,-165,109,-62
53,59,-13,-71,-9,-75,-61,-6,-123
-136,13,-146,-372,-216,-238,-273,-12,-1380
19,25,4,-21,0,-8,23,10,52
-25,-1,-21,-83,-43,-33,-36,53,-189
-34,8,-31,-57,-43,-38,-45,-23,-263
-16,2,-9,-28,-18,-12,-28,17,-92
-15,10,-6,-51,-60,-31,-33,19,-167
15,250,-52,-516,-119,-389,-256,50,-1017
-53,-52,-67,-101,-118,-74,-122,-61,-648
-151,48,-73,-221,-77,-39,-90,20,-583
-73,12,-51,-105,-61,-24,-50,-48,-400
-55,-52,-55,-152,-139,-41,-70,29,-535
81,52,70,17,-33,-19,32,25,225
-45,49,-43,-118,-12,-23,-9,15,-186
-40,15,-56,-117,-98,-89,-81,-27,-493
193,-3,9,-33,-129,-199,-110,53,-219
5,18,-20,-62,-72,-79,-66,-40,-316
-208,136,-339,-800,-382,-502,-558,-14,-2667
-16,22,-28,-61,0,-27,-31,-13,-154
-22,20,-20,-54,-16,-34,-33,-9,-168
1,48,-15,-81,-65,-39,-47,17,-181
-10,-24,-21,-35,-33,-26,-17,-21,-187
37,59,14,-119,12,-112,-58,44,-123
0,15,-32,-96,-43,-90,-56,-3,-305
-37,-5,-46,-83,-16,-30,-38,-13,-268
63,148,-33,-169,-214,-129,-57,195,-196
107,116,-86,-268,-161,-284,-202,-156,-934
40,67,-41,-224,-183,-257,-207,-33,-838
5,18,1,-21,-8,-22,-2,-3,-32
-45,-18,-40,-51,-29,-15,-40,9,-229
67,39,-69,-165,-121,-213,-171,-77,-710
63,46,-66,-139,-172,-158,-169,-104,-699
-185,17,-244,-455,-229,-105,-202,-47,-1450
-19,-15,-142,-331,-193,-229,-211,-2,-1142
104,112,5,-75,26,-25,-100,23,70
23,207,-57,-310,-68,-161,-158,-40,-564
-79,-3,-77,-164,-102,-105,-115,3,-642
-17,27,-60,-138,-130,-91,-119,-10,-538
-84,236,-90,-361,-92,-189,-209,-78,-867
-22,86,-9,-74,-28,-74,16,50,-55
-47,-10,-39,-118,-76,-45,-65,2,-398
-101,42,-91,-173,-43,-41,-67,-22,-496
-81,35,-135,-273,-146,-111,-150,-14,-875
-6,20,1,-15,8,-5,7,5,15
-1,27,-7,-15,12,-3,16,6,35
23,66,-2,-15,23,2,33,34,164
42,83,-5,-16,18,-10,39,67,218
-19,16,-15,-100,-24,-48,-55,4,-241
-37,-4,-19,-63,-57,-44,-43,19,-248
-61,-9,-77,-164,-86,-98,-97,-35,-627
-18,4,-52,-85,-49,-35,-39,-4,-278
0,50,-56,-112,-71,-83,-52,37,-287
23,21,-50,-110,-109,-98,-113,-22,-458
-68,-35,-68,-142,-89,-91,-106,-11,-610
15,24,3,-17,-28,-26,-10,-13,-52
-84,-39,-91,-192,-153,-108,-121,-44,-832
18,27,11,-64,5,-58,-4,2,-63
80,56,-11,-161,10,-153,-135,8,-306
-34,38,-35,-89,-43,-31,-50,12,-232
-110,-5,-116,-208,-106,-51,-139,-45,-780
-33,-20,-30,-45,-38,-25,-39,-1,-231
120,332,-68,-199,19,-96,-24,191,275
-27,-9,-35,-50,-54,-55,-60,-15,-305
-38,9,-38,-65,-31,-44,-51,-16,-274
144,238,30,-93,12,-45,51,69,406
-38,37,-66,-151,-31,-78,-32,-26,-385
10,167,-33,-160,-74,-70,-9,146,-23
-58,-47,-86,-88,-101,-65,-86,-37,-568
-20,9,0,-25,-32,-29,-10,0,-107
29,82,-16,-140,-57,-136,-84,37,-285
-47,35,-76,-205,-114,-93,-134,35,-599
-11,12,0,-27,-4,4,-29,16,-39
5,61,-60,-189,-112,-182,-157,-1,-635
-29,-7,-57,-87,-131,-124,-121,-88,-644
-22,15,-78,-109,-94,-90,-108,-40,-526
-5,22,-10,-48,-14,-39,-10,-5,-109
180,293,-11,-227,-174,-159,-31,-66,-195
-20,10,-13,-35,-38,-18,-20,-1,-135
-31,37,-63,-123,-72,-59,-63,-27,-401
63,39,-9,-49,-76,-98,-47,-53,-230
-20,-3,-17,-64,-49,-67,-62,-4,-286
-325,138,-490,-885,-418,-416,-507,-225,-3128
-39,1,-43,-115,-83,-57,-64,-17,-417
36,50,-49,-209,-45,-205,-164,-41,-627
188,134,33,-240,-330,-472,-206,-147,-1040
9,13,-44,-90,-42,-81,-62,-24,-321
-79,65,-69,-204,-131,-88,-102,-87,-695
8,-6,-31,-131,-15,-91,-98,-23,-387
27,5,-12,-112,-33,-98,-40,-4,-267
-40,53,-39,-157,-103,-110,-81,-27,-504
55,51,-4,-33,-77,-95,-53,-53,-209
-22,8,-23,-117,-83,-74,-71,-82,-464
-28,8,-14,-82,-56,-51,-18,-23,-264
10,25,3,-45,-16,-41,-17,4,-77
-25,8,-85,-122,-118,-106,-148,-5,-601
56,26,12,-3,-31,-22,22,32,92
11,15,-11,-33,-50,-47,-60,-31,-206
-159,84,-304,-642,-393,-508,-543,-221,-2686
9,16,-9,-76,-31,-35,-37,19,-144
-29,55,-94,-154,-85,-105,-129,-36,-577
-39,-4,-43,-103,-48,-53,-72,23,-339
42,154,4,-100,-18,-11,17,26,114
-21,18,-17,-43,-10,-19,-26,6,-112
193,376,84,-5,12,-110,-180,263,633
-9,84,-11,-126,-23,-55,1,44,-95
9,30,-13,-45,-7,-36,-28,-35,-125
3,28,-82,-304,-216,-267,-192,-136,-1166
8,4,-15,-15,-5,-18,-20,-24,-85
-28,-16,-29,-49,-45,-38,-45,-15,-265
258,83,84,-57,-62,-173,-94,76,115
-19,-23,-16,-60,-29,-35,-17,-3,-202
-134,52,-97,-234,-85,-89,-51,-8,-646
-21,7,-31,-77,-86,-54,-64,-26,-352
-150,109,-190,-372,-164,-144,-231,55,-1087
181,97,21,-119,-47,-226,-121,-28,-242
53,306,18,-342,-158,-255,-108,157,-329
3,39,-25,-58,-59,-59,-46,-35,-240
58,121,-75,-186,4,-136,-75,25,-264
-19,10,-49,-94,-32,-51,-72,-9,-316
-77,20,-100,-206,-49,-107,-133,-88,-740
-76,12,-72,-203,-69,-105,-126,-48,-687
15,19,8,-31,13,-8,-30,9,-5
-51,21,-59,-132,-99,-77,-69,22,-444
-19,75,-49,-122,-43,-57,-26,51,-190
-115,34,-59,-153,-44,-25,-63,-42,-467
222,212,5,-352,-130,-349,-244,-51,-687
10,9,-19,-39,-68,-51,-29,-12,-199
-3,4,6,-16,-7,-5,6,0,-15
-90,14,-82,-256,-136,-149,-109,5,-803
0,18,-12,-15,-2,-12,-7,-6,-36
-148,-47,-159,-292,-251,-126,-221,63,-1181
27,38,7,-23,-49,-59,-15,-40,-114
53,208,-75,-391,-169,-334,-233,66,-875
-16,-13,-38,-96,-49,-56,-49,-39,-356
367,317,131,-196,67,-313,-174,302,501
19,70,-19,-133,-36,-125,-67,-37,-328
43,20,21,-44,-50,-72,-14,-15,-111
-20,-2,-43,-99,-39,-66,-67,-17,-353
52,18,-1,-30,-16,-49,-53,3,-76
14,57,2,-51,-16,-29,-23,27,-19
-130,124,-227,-829,-640,-362,-444,312,-2196
-43,177,-47,-235,3,-134,-113,-19,-411
65,-19,0,-41,-77,-80,-87,-23,-262
31,233,-215,-1024,-375,-857,-725,-44,-2976
35,-4,-27,-54,-67,-60,-37,-37,-251
51,14,25,15,8,-24,-24,46,111
17,32,10,-64,-54,-74,-44,-6,-183
100,44,23,-15,-36,-27,-45,16,60
-6,52,-21,-120,-16,-97,-94,35,-267
-10,4,-22,-62,-44,-29,-45,4,-204
122,75,-15,-165,-135,-166,-86,-40,-410
-12,13,-18,-42,-15,-41,-32,-8,-155
-12,31,-15,-52,0,0,-22,-46,-116
-1,27,-21,-58,-41,-57,-19,-3,-173
-56,31,-156,-298,-182,-132,-192,-64,-1049
-19,25,-27,-109,-46,-63,-88,-20,-347
-48,12,-24,-97,-51,-46,-58,22,-290
-49,7,-9,-70,-20,-6,-31,-17,-195
-11,128,-56,-250,-32,-123,-60,123,-281
339,123,66,-247,96,-266,-138,47,20
28,38,-19,-114,-60,-94,-62,-8,-291
-51,12,-65,-178,-152,-96,-114,-60,-704
-93,-1,-125,-242,-193,-189,-177,-72,-1092
-55,-7,-158,-309,-218,-239,-252,-62,-1300
-155,59,-166,-409,-154,-110,-191,-111,-1237
43,14,4,-11,-7,-31,-17,20,15
-11,5,-15,-60,-19,-19,-29,5,-143
-268,361,-355,-717,-243,-70,-525,226,-1591
52,3,3,12,-32,-27,-20,12,3
0,13,5,-15,-13,-9,-27,7,-39
108,183,-10,-232,-91,-165,-176,59,-324
35,159,-28,-138,13,-26,-65,75,25
-80,-13,-80,-162,-91,-97,-149,-17,-689
328,491,77,-598,174,-464,-265,282,25
-10,-8,-8,-30,-17,-13,-23,8,-101
-75,28,-102,-213,-120,-71,-99,-23,-675
-52,397,61,-404,-148,-382,98,-65,-495
-33,1,-36,-51,-50,-33,-35,-10,-247
71,-15,-5,-95,-26,-123,-69,-16,-278
16,25,-17,-81,-66,-30,-27,-12,-192
-5,1,-17,-26,-31,-26,-19,-7,-130
-7,52,-11,-81,-34,-42,-80,18,-185
18,26,-6,-57,-75,-59,10,-14,-157
-80,-25,-139,-239,-146,-129,-198,-46,-1002
-1,-13,-5,-13,-35,-9,-26,-4,-106
-19,-7,-22,-90,-132,-110,-100,-49,-529
-53,-10,-77,-107,-89,-76,-86,-33,-531
-24,-13,-28,-96,-121,-120,-85,-39,-526
-59,46,-173,-293,-248,-178,-184,-118,-1207
-46,5,-69,-143,-107,-63,-68,-10,-501
12,67,-32,-86,-84,-35,-11,30,-139
32,26,16,19,-1,-16,-30,5,51
-135,-47,-166,-289,-213,-177,-251,-84,-1362
26,105,20,-58,-25,-43,37,-11,51
16,130,-4,-179,-12,-33,-12,114,20
13,110,-307,-536,-337,-469,-484,-335,-2345
-20,-2,-17,-48,-18,-23,-26,4,-150
9,7,-36,-86,-109,-124,-72,-61,-472
69,29,-12,-78,-114,-121,-87,-13,-327
-35,24,-80,-254,-216,-193,-171,-37,-962
200,130,72,-94,-7,-161,-65,62,137
11,-9,-35,-114,-141,-144,-103,-38,-573
-74,-31,-149,-239,-218,-205,-224,-130,-1270
-21,43,-63,-130,-37,-96,-87,-22,-413
-20,12,-40,-75,-63,-62,-65,-41,-354
22,7,14,-20,-33,-40,-7,6,-51
5,11,-1,7,-19,-19,-22,20,-18
-225,359,-745,-1359,-903,-1058,-1119,-175,-5225
-19,-9,-25,-50,-58,-41,-67,-11,-280
-62,87,-121,-257,-41,-84,-99,-2,-579
49,27,-12,-64,-41,-101,-47,-22,-211
-5,0,-20,-46,-19,-29,-17,1,-135
16,35,8,-4,14,-30,-1,13,51
11,28,16,14,18,-17,3,13,86
-47,107,-107,-310,-131,-124,-130,50,-692
-60,9,-48,-88,-36,-29,-56,15,-293
10,12,4,-28,-6,-30,-4,-6,-48
-110,128,-132,-288,-110,-150,-91,-5,-758
-37,8,-64,-123,-66,-86,-86,-29,-483
-41,15,-53,-134,-80,-86,-81,-101,-561
153,259,81,-392,-67,-308,-215,161,-328
-68,37,-33,-169,-81,-82,-100,-40,-536
8,368,-52,-506,-130,-319,-142,233,-540
-37,33,-74,-228,-55,-129,-81,13,-558
40,151,-107,-377,-162,-282,-193,-26,-956
-143,41,-180,-332,-201,-129,-221,-13,-1178
57,85,8,-99,-29,-120,-59,4,-153
13,1,5,-65,-83,-47,-23,-4,-203
-79,70,-60,-313,-102,-51,-196,-171,-902
0,36,-9,-38,-41,-49,-26,-1,-128
-10,0,-14,-45,-50,-56,-24,-8,-207
105,105,25,-138,-9,-137,-65,34,-80
-11,20,-16,-85,-92,-76,-47,2,-305
329,350,110,-109,81,-151,-160,204,654
5,23,-29,-38,-26,-29,-26,-23,-143
-137,20,-164,-297,-136,-162,-213,-105,-1194
7,35,41,-64,-4,-49,-6,44,4
-7,3,-20,-47,-15,-30,-19,-9,-144
-22,39,-71,-142,-89,-109,-85,-16,-495
-29,-2,-50,-97,-101,-83,-76,-25,-463
14,1,11,-31,-17,-25,-20,-4,-71
-169,-43,-199,-298,-271,-128,-235,5,-1338
-7,23,-19,-38,-39,-38,-38,-8,-164
-28,-16,-21,-66,-29,-41,-27,6,-222
53,42,55,-119,84,1,-79,129,166
5,42,17,40,8,50,-47,53,168
3,59,12,30,14,-17,-5,17,113
3,56,12,18,16,-15,-8,16,98
0,60,6,27,18,-20,-9,15,97
-6,57,9,20,11,-16,-8,16,83
-48,-31,-57,-111,-118,-88,-103,-75,-631
29,148,0,-316,-113,-184,-136,98,-474
46,56,-25,-74,-60,-89,-54,-24,-224
-67,18,-61,-127,-62,-51,-110,-31,-491
-72,176,-94,-244,-77,-67,-73,9,-442
110,173,-38,-205,-40,-198,-110,-40,-348
-18,18,14,-69,-65,-97,-48,-39,-304
-4,47,10,19,12,-20,-5,17,76
6,57,12,26,14,-16,-5,14,108
-24,9,-29,-72,-11,-30,-39,2,-194
-40,11,-44,-150,-103,-121,-69,-25,-541
-14,17,-38,-58,-40,-40,-39,13,-199
-3,46,-13,-112,-16,-43,-46,-14,-201
13,57,-62,-135,-154,-130,-137,22,-526
-23,38,-68,-121,-84,-55,-54,-19,-386
-22,144,-134,-288,-123,-219,-166,-20,-828
5,15,-2,-16,19,7,-3,6,31
-15,9,-18,-30,5,-23,-8,-6,-86
-105,195,-114,-400,-194,-200,-100,54,-864
250,233,65,-142,-98,-269,-61,62,40
22,89,2,-76,-29,-6,-33,64,33
20,97,-6,-57,-37,-44,-40,37,-30
-12,5,-39,-107,-53,-35,-47,4,-284
8,94,29,-279,-39,-93,-90,100,-270
71,45,10,-66,-75,-134,-17,-28,-194
118,20,-15,-20,-26,-114,-86,-19,-142
28,33,-14,-142,-147,-160,-158,-128,-688
27,89,0,-98,-8,-69,-50,57,-52
-11,8,-36,-122,-88,-122,-88,-37,-496
-51,8,-73,-127,-94,-93,-102,-55,-587
-113,-51,-87,-133,-160,-28,-127,9,-690
-123,249,-131,-470,-70,-80,-272,-148,-1045
-59,22,-65,-106,-37,-55,-98,-34,-432
31,1,-17,-28,-73,-61,-51,-57,-255
-61,-14,-31,-154,-163,-79,-121,-50,-673
-35,3,-30,-84,-55,-73,-56,-31,-361
8,38,5,1,7,-32,-9,15,33
15,39,7,2,12,-16,-10,14,63
3,47,3,14,23,-10,-13,18,85
-1,27,2,12,11,-14,-7,8,38
0,27,4,15,10,-21,-9,13,39
-2,26,-2,19,11,-21,-7,12,36
13,-4,-20,-23,-48,-43,-40,-23,-188
57,1,-72,-70,-171,-148,-130,-144,-677
29,6,-7,17,-35,-25,-3,4,-14
-124,196,-107,-405,-83,-233,-150,60,-846
-303,-89,-292,-487,-348,-163,-371,-33,-2086
-27,82,-40,-198,-59,-71,-47,-27,-387
4,92,-22,-91,-107,-74,-25,77,-146
367,236,217,71,201,74,1,44,1211
-42,128,-134,-394,-139,-199,-164,5,-939
-91,48,-115,-279,-43,-114,-80,-1,-675
-81,227,-110,-379,-97,-73,-157,-44,-714
-214,140,-437,-959,-464,-645,-725,-133,-3437
-14,25,-47,-64,-9,-18,-25,-30,-182
10,10,-14,-28,-45,-23,-33,-10,-133
-5,8,-15,-25,-11,-13,-1,-8,-70
0,-18,2,-48,-36,-50,-4,20,-134
16,2,1,-16,4,-11,-16,17,-3
3,16,-27,-62,-90,-39,-46,-19,-264
-27,-10,-40,-103,-93,-71,-70,-30,-444
-19,42,-7,-125,-61,-99,-26,51,-244
50,55,3,-269,0,-217,-216,40,-554
12,51,-35,-63,-22,-42,-6,28,-77
-65,-27,-57,-173,-83,-125,-141,-54,-725
0,50,3,24,17,-20,-9,20,85
9,207,-15,-308,-115,-46,8,113,-147
-202,9,-272,-603,-252,-116,-224,-87,-1747
54,96,-46,-283,-126,-245,-166,-43,-759
264,254,35,-300,-70,-241,-46,99,-5
94,158,-20,-198,-75,-190,-29,144,-116
69,48,-35,-111,-21,-46,-14,115,5
-49,18,-49,-57,-32,-14,-39,-4,-226
4,24,-17,-100,-67,-55,-35,-12,-258
-16,63,-46,-125,-78,-73,-78,19,-334
-59,68,-98,-338,-170,-202,-209,86,-922
-19,-31,-110,-74,-189,-116,-168,-95,-802
20,87,3,-95,-27,-93,-60,0,-165
-39,35,-39,-230,-78,-128,-68,15,-532
18,-12,-28,-75,-74,-72,-30,-16,-289
8,27,-10,-17,-4,-10,-5,-10,-21
-3,-3,-7,-24,2,-23,-6,-9,-73
-38,-17,-29,-88,-76,-33,-52,-56,-389
123,130,34,-108,-71,-129,-143,-70,-234
-31,10,-105,-136,-164,-109,-145,-22,-702
21,57,17,-34,-60,-65,-52,-18,-134
-18,36,-60,-126,-76,-73,-56,7,-366
14,7,0,-53,-25,-51,-6,0,-114
-24,8,-23,-94,-71,-75,-65,15,-329
23,80,-41,-161,-89,-133,-72,-82,-475
30,27,12,-40,-26,-45,-14,-16,-72
-5,33,-11,-43,-22,-47,-23,3,-115
-9,23,-27,-82,-67,-77,-58,-8,-305
15,14,-10,-39,-9,-35,-32,-10,-106
46,22,6,1,-17,-19,9,-3,45
-16,11,-27,-89,-51,-49,-28,-12,-261
-88,6,-121,-204,-95,-103,-153,-32,-790
18,28,-12,-51,-6,-54,-37,-6,-120
-35,-7,-60,-86,-45,-65,-88,-56,-442
4,41,-85,-128,-197,-143,-143,-101,-752
434,214,141,-147,67,-289,-247,87,260
3,6,1,-14,-15,-13,-13,-3,-48
-76,202,-181,-565,-352,-478,-491,-73,-2014
46,31,4,-42,24,-8,-25,69,99
-204,233,-357,-1247,-616,-615,-688,73,-3421
-4,434,-126,-523,-64,-284,-180,93,-654
-161,-12,-184,-447,-255,-242,-245,-133,-1679
-67,149,-97,-212,-67,-182,-86,66,-496
-138,107,-300,-486,-253,-384,-429,-251,-2134
-43,79,-35,-154,-19,-39,-4,7,-208
43,103,-74,-301,-171,-247,-214,-29,-890
-31,43,-48,-184,-92,-76,-61,8,-441
-36,2,-28,-45,-28,-14,-28,-2,-179
-111,47,-96,-201,-92,-118,-110,-28,-709
-82,61,-69,-201,-130,-89,-109,-89,-708
-79,13,-97,-204,-59,-115,-120,-66,-727
-61,14,-75,-127,-107,-85,-117,-36,-594
204,472,-13,-565,-309,-490,-454,-537,-1692
1,29,-29,-58,-50,-46,-37,-37,-227
64,188,-49,-357,10,-313,-175,5,-627
-11,18,4,-39,-18,-34,-3,-1,-84
-36,8,-67,-122,-43,-75,-113,-49,-497
18,29,-6,-106,-37,-98,-44,40,-204
63,65,25,-31,-42,-80,-58,0,-58
115,79,31,-78,-74,-96,-69,38,-54
-88,-25,-96,-231,-162,-98,-112,-23,-835
-15,1,-6,-32,-19,-14,-15,-15,-115
90,8,-24,-49,-60,-131,-97,-15,-278
-86,19,-92,-265,-60,-111,-108,11,-692
-36,129,-60,-197,0,-72,-56,71,-221
-36,24,-26,-74,-30,-35,-69,-2,-248
122,115,-27,-190,-135,-274,-211,-86,-686
-44,6,-73,-136,-94,-105,-119,-42,-607
27,55,4,-42,-53,-37,-53,-27,-126
-36,13,-49,-269,-152,-217,-162,-75,-947
-137,389,-284,-702,-173,-285,-278,101,-1369
-89,-18,-73,-220,-135,-98,-153,-69,-855
-97,51,-58,-150,-43,-59,-74,-24,-454
2,19,4,-23,3,-19,-15,0,-29
18,-50,-16,-56,-95,-97,-103,21,-378
-37,-18,-84,-231,-159,-154,-143,-70,-896
-2,22,-22,-35,-28,-26,-28,-5,-124
1,15,1,-9,3,0,10,8,29
-19,2,-22,-67,-74,-49,-45,-1,-275
351,599,-199,-1554,-2066,-1682,-1334,-239,-6124
-8,80,-23,-96,-22,-33,-8,-14,-124
149,78,41,-159,50,-128,-108,-27,-104
-25,580,-169,-741,-210,-447,-305,127,-1190
-127,159,-141,-480,-178,-221,-265,-48,-1301
1,8,1,-14,-26,-14,-3,0,-47
-18,-8,2,-29,-20,-23,-12,-8,-116
-32,-21,-12,-79,-57,-31,-33,39,-226
287,324,36,-287,161,-226,-160,228,363
-23,22,-44,-109,-88,-87,-53,-26,-408
-17,27,-41,-78,-96,-76,-82,-40,-403
-3,149,-40,-280,-55,-202,-124,28,-527
-76,10,-90,-212,-85,-122,-142,-93,-810
-13,23,-63,-88,-59,-72,-63,-38,-373
-68,35,-89,-197,-57,-109,-135,-81,-701
24,61,-1,-97,-56,-86,-67,33,-189
-1,18,-4,-94,-8,-67,-55,22,-189
3,15,-12,-76,-140,-1,-36,9,-238
-26,40,-53,-149,-47,-89,-74,16,-382
10,13,-2,-42,-8,-29,-11,14,-55
-23,81,-59,-176,-98,-69,-70,67,-347
77,31,31,-141,-85,-177,-106,26,-344
-20,57,-44,-142,-191,-106,-156,105,-497
-47,141,-2,-157,-72,-101,42,18,-178
-14,123,-43,-171,-69,-133,-96,15,-388
-40,59,-113,-220,-144,-147,-169,-52,-826
-51,138,-91,-275,-153,-125,-154,-138,-849
-7,9,-9,-57,-22,-31,-28,6,-139
-62,78,-71,-369,-269,-219,-167,34,-1045
-8,-6,1,-7,-17,-12,-8,5,-52
-89,-28,-111,-175,-131,-123,-197,-76,-930
52,176,-54,-374,21,-323,-168,3,-667
2,475,-219,-790,-168,-483,-437,-207,-1827
-34,-30,-26,-107,-73,-60,-74,43,-361
-208,-12,-198,-599,-429,-177,-392,133,-1882
-2,-4,7,-17,-2,-15,-21,-7,-61
18,29,-19,-88,-132,-113,-61,-40,-406
-81,38,-94,-292,-262,-241,-244,43,-1133
92,361,-53,-584,-35,-367,-165,119,-632
38,97,-24,-210,-73,-201,-147,40,-480
-33,39,-77,-129,-109,-115,-125,-75,-624
19,-3,-4,-3,-28,-42,-20,-15,-96
-42,13,-61,-213,-110,-121,-73,11,-596
-8,92,-46,-157,-104,-147,-104,21,-453
6,123,-23,-171,3,-100,-77,12,-227
16,41,-2,-46,-61,-56,-32,-11,-151
-1,18,-4,-36,0,-22,-9,-5,-59
-81,59,-70,-207,-135,-93,-103,-85,-715
-59,-25,-59,-139,-107,-50,-106,-18,-563
-64,-17,-67,-116,-104,-60,-106,-46,-580
-1,8,9,-37,-10,-46,-10,11,-76
37,14,-4,-129,-67,-127,-45,-21,-342
99,-7,-16,-33,-97,-152,-84,-56,-346
-12,56,-30,-204,-109,-141,-122,-46,-608
-20,12,-29,-129,-104,-79,-78,14,-413
-18,112,-76,-292,-161,-150,-132,97,-620
-34,70,-6,-69,-2,-39,-24,13,-91
-44,156,-129,-172,-156,-60,-214,114,-505
250,214,15,-366,-4,-365,-232,166,-322
-33,-24,-31,-49,-41,-25,-50,2,-251
-38,-12,-33,-70,-43,-38,-42,-5,-281
-13,15,-5,-73,-56,-52,-38,10,-212
-61,79,-99,-217,-93,-77,-60,-1,-529
-78,154,-96,-288,15,-53,-93,-33,-472
66,204,-62,-362,28,-307,-179,12,-600
16,17,-18,-70,-96,-62,-28,-2,-243
-5,1,-12,-37,-10,-26,-34,-8,-131
-31,49,-84,-273,-158,-163,-135,47,-748
-44,-5,-43,-105,-40,-44,-41,10,-312
-19,-13,-26,-76,-58,-51,-42,-11,-296
29,52,-8,-84,-110,-112,-46,-32,-311
-3,92,-54,-160,-95,-157,-127,10,-494
-21,10,-65,-69,-83,-63,-87,-75,-453
-191,68,-356,-627,-386,-450,-579,-281,-2802
-60,5,-110,-177,-129,-95,-143,6,-703
-74,-34,-60,-114,-58,-52,-93,-3,-488
-5,99,-60,-208,47,-36,-24,18,-169
17,13,-5,-185,-46,-94,-67,-20,-387
-40,12,-32,-107,-77,-80,-82,-29,-435
-2,78,-51,-163,-25,-120,-60,3,-340
-89,19,-94,-188,-96,-56,-105,66,-543
-83,20,-88,-220,-70,-108,-139,-54,-742
-55,37,-98,-194,-72,-102,-141,-71,-696
-76,2,-95,-207,-61,-116,-131,-66,-750
-99,37,-120,-246,-48,-118,-146,-88,-828
-47,353,-192,-647,-154,-328,-196,81,-1130
-64,-21,-43,-142,-85,-57,-77,-20,-509
18,73,-15,-129,-23,-72,-33,3,-178
14,20,-19,-165,-97,-113,-58,14,-404
34,113,-99,-351,-109,-300,-202,-62,-976
-26,91,-83,-201,9,-52,-5,13,-254
55,35,4,-3,-9,-17,-58,19,26
39,43,-7,-64,-26,-40,-33,15,-73
-17,9,-25,-59,-38,-29,-48,5,-202
-46,32,-52,-152,-51,-39,-61,-65,-434
8,35,-15,-103,-26,-39,-72,45,-167
6,6,-11,-12,4,-9,-16,-3,-35
-76,8,-99,-205,-66,-116,-126,-67,-747
-53,36,-97,-192,-72,-102,-142,-72,-694
-25,-19,-37,-63,-79,-51,-75,0,-349
-13,-21,-52,-91,-55,-35,-75,6,-336
46,52,-24,-62,-3,-63,-93,26,-121
1,7,-15,-45,-70,-30,-45,12,-185
-28,-15,-46,-61,-66,-26,-79,10,-311
-32,40,-59,-108,-26,-16,-10,15,-196
-128,131,-253,-488,-166,-177,-188,-26,-1295
74,30,13,-28,-24,-60,-29,21,-3
132,199,78,-6,117,59,-215,68,432
-25,0,-37,-69,-49,-34,-65,-26,-305
-39,197,-194,-398,-313,-234,-305,172,-1114
-108,117,-282,-558,-285,-359,-435,-206,-2116
96,196,-27,-292,84,-198,-147,36,-252
54,186,-50,-375,21,-325,-165,1,-653
-11,23,-33,-111,-44,-44,-20,23,-217
-147,96,-164,-420,-197,-155,-78,-5,-1070
80,19,-2,-26,-29,-118,-93,22,-147
-13,73,-26,-127,-44,-88,-38,13,-250
-21,-5,-35,-87,-78,-57,-60,2,-341
-21,-1,-35,-51,-52,-34,-38,-18,-250
-14,-4,-33,-79,-90,-51,-71,4,-338
0,-14,-10,-35,-63,-37,-14,-19,-192
63,74,-18,-64,-28,-108,-42,0,-123
-14,8,-50,-100,-83,-67,-57,-57,-420
256,248,112,-225,23,-251,-135,95,123
1,-9,4,-2,-26,0,-17,17,-32
-44,85,-44,-251,-165,-105,-164,-167,-855
-48,8,-49,-108,-39,-35,-55,-52,-378
-80,165,-191,-576,-160,-319,-264,93,-1332
71,109,6,-71,-33,-134,-67,4,-115
-73,-36,-78,-194,-128,-116,-175,-60,-860
8,-12,2,-64,-72,-56,-53,10,-237
-19,0,-43,-97,-61,-91,-86,-25,-422
-20,179,-87,-383,-161,-257,-168,-43,-940
-25,206,-87,-346,-106,-150,-124,114,-518
-56,-8,-50,-110,-72,-59,-79,5,-429
64,250,1,-214,-127,-227,-109,122,-240
-9,1,-5,-49,-12,-30,-1,18,-87
130,64,37,-156,16,-107,-79,-20,-115
-3,3,-22,-49,-33,-36,-43,-23,-206
-2,4,-1,-40,-16,-25,-12,9,-83
-1,22,-43,-61,-44,-46,-56,-16,-245
-31,-22,-42,-80,-61,-53,-68,-15,-372
-39,54,-125,-216,-142,-123,-133,-72,-796
-53,-20,-53,-90,-72,-47,-92,26,-401
-54,98,-94,-220,-33,-7,-66,22,-354
-21,193,-85,-211,6,-82,-72,46,-226
-85,-24,-73,-164,-102,-94,-108,3,-647
-36,15,-40,-72,-34,-19,-53,-25,-264
-34,163,-100,-230,-33,-144,-131,19,-490
-9,42,-21,-82,-106,-89,-91,-29,-385
-81,4,-117,-247,-136,-188,-188,-68,-1021
-73,-25,-76,-117,-59,-42,-103,27,-468
-10,10,-11,-35,-27,5,-31,17,-82
16,7,-1,-43,2,-33,-26,-18,-96
-11,10,-5,-19,-22,-14,-9,0,-70
-25,-2,-24,-41,-19,-17,-23,0,-151
13,13,-15,-37,-47,-21,-41,-8,-143
-19,12,-60,-103,-134,-91,-119,-76,-590
-2,13,6,-37,-13,-44,-10,5,-82
113,102,14,-113,-46,-181,-162,47,-226
-27,-3,-24,-114,-91,-80,-116,-23,-478
11,27,-10,-63,-58,-36,-56,4,-181
59,114,39,-48,-84,-76,-93,-29,-118
34,39,7,-34,-21,-59,-17,17,-34
-46,26,-66,-116,-106,-73,-79,-3,-463
0,-7,-6,-14,-26,-25,-20,12,-86
87,45,27,-21,-10,-74,-35,-9,10
5,16,-1,-26,8,-7,11,25,31
-8,13,-12,-28,-23,-14,-28,-12,-112
-90,17,-193,-444,-264,-337,-354,-120,-1785
-4,27,-7,-122,-81,-98,-66,-19,-370
7,24,-33,-138,-127,-152,-96,-33,-548
-117,29,-133,-324,-166,-121,-149,-17,-998
-152,-78,-143,-293,-254,-149,-196,-20,-1285
-5,10,-16,-84,-51,-28,-27,12,-189
-1,17,-8,-40,-2,-17,-5,-11,-67
27,70,-27,-87,-108,-79,-95,24,-275
-8,123,-89,-230,-103,-177,-213,-105,-802
-4,-10,-4,-12,-27,-12,-16,-13,-98
-72,81,-37,-243,-89,-147,-49,32,-524
25,162,-42,-199,-33,-154,-133,75,-299
-10,-5,-17,-42,-64,-31,-45,9,-205
-217,-33,-255,-458,-276,-220,-345,-99,-1903
-15,-13,-38,-59,-68,-45,-72,4,-306
-11,24,-43,-188,-47,-112,-119,-39,-535
-475,102,-663,-1619,-1081,-1011,-1129,-514,-6390
6,78,-6,-64,-8,-46,-21,19,-42
-6,67,-38,-186,-150,-90,-111,64,-450
191,138,73,-252,3,-255,-241,69,-274
-100,-10,-126,-223,-180,-113,-178,-76,-1006
79,47,-12,-166,-157,-217,-139,-9,-574
15,16,-28,-83,-56,-98,-59,-24,-317
170,250,5,-126,-64,-88,-4,136,279
14,32,-13,-87,-57,-75,-33,-34,-253
9,14,-76,-175,-118,-131,-110,-65,-652
11,55,-8,-58,-21,-62,-19,24,-78
18,74,6,-104,-74,-67,-84,31,-200
21,7,-5,-7,-27,-36,-14,-19,-80
-16,-6,-20,-106,10,-20,-4,28,-134
-20,19,-34,-148,-109,-149,-105,-42,-588
-50,-5,-98,-168,-132,-128,-132,-56,-769
45,55,-7,-101,-4,-95,-22,6,-123
-55,67,-116,-273,-154,-188,-163,-14,-896
-25,128,-88,-261,-29,-89,-112,66,-410
-22,95,-34,-220,39,-66,-29,117,-120
-148,123,-108,-424,-180,-182,-269,-173,-1361
-41,61,-114,-319,-218,-221,-238,-52,-1142
63,5,-7,-80,-48,-94,-77,-22,-260
4,14,-32,-117,-102,-130,-103,39,-427
-32,5,-60,-157,-92,-121,-121,-43,-621
141,114,-40,-283,-120,-290,-157,-47,-682
-35,-9,-54,-169,-144,-146,-104,-73,-734
56,32,8,-48,8,-64,-39,1,-46
37,57,-36,-146,-239,-163,-117,-51,-658
-40,-16,-28,-89,-102,-67,-42,28,-356
91,107,33,-56,-69,-132,-3,16,-13
67,30,-81,-273,-146,-283,-245,-72,-1003
16,80,-18,-149,-115,-187,-129,-96,-598
-22,25,-36,-139,-129,-119,-95,-38,-553
-17,-10,-19,-74,-79,-60,-46,-10,-315
45,109,3,-137,-21,-71,-57,64,-65
805,1953,88,-1773,166,-749,-1420,1640,710
-68,-25,-105,-170,-135,-94,-118,-45,-760
12,33,-38,-132,-127,-110,-101,-1,-464
9,15,-28,-143,-169,-121,-136,53,-520
-74,42,-73,-252,-195,-155,-176,-94,-977
57,75,-27,-87,-4,-83,-77,-13,-159
-30,54,-58,-134,-128,-94,-95,-30,-515
6,30,-30,-66,-25,-45,-34,22,-142
-50,-14,-124,-209,-153,-130,-176,-64,-920
184,204,-14,-335,-122,-108,-144,250,-85
-66,166,-140,-448,-184,-312,-317,-70,-1371
-52,11,-108,-207,-100,-93,-81,37,-593
-36,-18,-62,-113,-92,-72,-91,-13,-497
-38,-44,-148,-223,-265,-223,-243,-56,-1240
-6,94,-49,-186,-67,-143,-94,47,-404
-91,46,-82,-365,-183,-169,-146,14,-976
186,164,26,-239,-83,-220,-214,117,-263
-62,66,-85,-192,-36,-64,-101,-54,-528
-110,-27,-115,-294,-215,-152,-158,-28,-1099
82,180,55,-92,88,-3,-14,134,430
21,57,24,-15,18,-24,4,32,117
-8,19,-29,-61,-26,-35,-30,2,-168
-107,63,-98,-299,-53,-125,-86,45,-660
-38,-7,-57,-141,-89,-67,-65,-2,-466
-43,68,-52,-143,-35,-39,-79,-71,-394
-4,-3,-12,-84,-88,-76,-45,-5,-317
29,139,-65,-414,-25,-223,-123,-24,-706
163,111,-5,-133,-86,-204,-117,-47,-318
13,35,-80,-232,-120,-179,-164,-56,-783
256,462,48,-472,121,-333,-200,405,287
-132,-66,-131,-239,-179,-139,-176,9,-1053
-55,79,-43,-106,6,-22,-35,-15,-191
-143,184,-397,-854,-478,-704,-574,-301,-3267
49,87,1,-155,-5,-120,-72,-28,-243
-68,60,-76,-198,-71,-86,-90,30,-499
-173,362,-44,-733,-91,-424,-146,218,-1031
-3,463,-246,-676,-231,-264,-197,222,-932
-26,46,-38,-128,-63,-30,-47,37,-249
95,56,5,-139,-31,-163,-149,57,-269
-30,172,-80,-340,-204,-254,-206,-7,-949
-80,54,-49,-139,-43,-16,-66,-66,-405
-40,42,-46,-83,-43,-47,-59,2,-274
-74,47,-131,-311,-179,-219,-210,-101,-1178
-85,82,-20,-108,-43,-73,-82,-6,-335
175,62,19,-136,-22,-158,-142,4,-198
9,4,-20,-111,-85,-123,-98,-30,-454
-12,45,-10,-83,-50,-94,-67,-13,-284
-20,6,-18,-55,-21,-28,-31,-3,-170
4,-2,-7,-28,-53,-40,-32,-3,-161
2,8,3,-17,-11,-18,-2,-2,-37
-83,-18,-57,-193,-129,-123,-114,-1,-718
18,15,-19,-73,-53,-66,-38,-35,-251
-89,-12,-139,-225,-162,-81,-172,23,-857
-1,9,-33,-33,-51,-48,-56,-16,-229
18,184,-52,-252,-37,-177,1,107,-208
9,-17,1,-56,-69,-66,-71,-23,-292
19,16,-3,-29,-24,-43,-19,-15,-98
-20,34,-50,-117,-85,-37,-37,21,-291
-11,191,-195,-495,-134,-309,-325,61,-1217
43,168,-51,-263,-147,-225,-168,-52,-695
89,67,35,-135,-20,-145,-68,-31,-208
0,3,-3,-16,-3,-14,-9,-12,-54
0,-11,-13,-22,-64,-37,-33,0,-180
39,48,1,-100,-63,-110,-54,-43,-282
-35,71,-63,-133,-61,-88,-122,-46,-477
-77,40,-58,-161,-53,-88,-104,-33,-534
-10,-8,-27,-107,-62,-66,-41,-18,-339
-19,-16,-15,-27,-22,2,-17,4,-110
-95,221,-110,-378,-22,-69,-65,99,-419
-12,99,-176,-332,-203,-296,-270,-70,-1260
31,20,1,-84,-3,-36,-42,-4,-117
-101,-17,-123,-271,-186,-148,-212,25,-1033
185,241,23,-133,-14,-84,-66,179,331
-3,58,4,-136,-70,-134,-53,7,-327
-42,202,-65,-391,-189,-260,-164,5,-904
-10,27,-25,-58,-17,-41,-42,-14,-180
-41,54,-2,-86,-34,-38,-18,4,-161
51,111,27,-105,-18,-57,-116,18,-89
-41,5,-33,-163,-89,-47,-84,-7,-459
18,45,-38,-124,-65,-105,-76,-46,-391
18,-13,-4,-81,-90,-92,-57,3,-316
-2,-19,-25,-24,-45,-42,-53,-39,-249
0,-5,-19,-47,-53,-56,-51,-20,-251
-15,3,-21,-46,-8,-20,-16,1,-122
3,24,-24,-128,-69,-105,-77,-20,-396
-19,-9,-21,-78,-47,-18,-27,-15,-234
-23,6,-32,-66,-35,-28,-39,-3,-220
19,137,-118,-348,-157,-256,-259,-31,-1013
100,-1,17,-40,-33,-108,-72,-26,-163
0,20,-7,-78,-29,-49,-41,8,-176
67,46,2,-30,-74,-88,-41,-2,-120
-25,27,-64,-102,-104,-81,-93,-16,-458
-142,41,-155,-348,-103,-64,-135,47,-859
-28,7,-34,-114,-66,-54,-59,-36,-384
19,20,-6,-115,-52,-114,-91,-15,-354
-9,85,-25,-132,-10,-74,-47,-13,-225
-38,4,-17,-98,-43,-32,-41,-12,-277
17,-15,16,-59,-6,16,-32,86,23
45,16,-13,-68,-42,-101,-88,-3,-254
-11,15,-59,-110,-98,-79,-84,-39,-465
21,8,-42,-87,-88,-80,-92,-69,-429
-2,13,0,-56,-15,-39,-31,11,-119
-96,60,-157,-304,-105,-135,-128,-7,-872
-17,41,-103,-248,-154,-199,-157,-23,-860
2,43,-22,-121,-26,-70,-73,9,-258
0,130,-51,-268,-90,-191,-124,48,-546
0,11,3,-48,-15,-34,-20,10,-93
76,178,-51,-439,-198,-401,-270,-215,-1320
-108,-71,-88,-153,-128,-85,-133,13,-753
210,167,78,166,89,12,-18,61,765
-36,-18,-27,-101,-65,-40,-79,-2,-368
-27,18,-29,-63,-28,-41,-51,-10,-231
-118,27,-77,-176,-119,-105,-83,-61,-712
44,10,0,-11,-25,-46,-15,15,-28
3,9,8,-9,-4,6,1,7,21
-20,16,-25,-37,-9,-14,-44,31,-102
-94,20,-106,-270,-157,-102,-162,22,-849
-34,100,-78,-323,-169,-229,-212,74,-871
59,101,-61,-215,-38,-167,-122,-88,-531
18,30,0,-30,6,-8,-9,-4,3
154,199,-56,-389,-188,-427,-290,-165,-1162
-66,-10,-47,-121,-54,-81,-36,-7,-422
15,11,-14,-32,-41,-31,-13,-24,-129
1,67,-43,-85,-43,-57,-55,-17,-232
20,61,4,-26,17,-8,-8,43,103
0,20,-52,-117,-83,-50,-117,-64,-463
-11,25,-22,-61,-13,-26,-50,-18,-176
-45,12,-67,-113,-83,-89,-75,-43,-503
1,-6,-18,-32,-45,-36,-30,-32,-198
-14,24,-16,-84,3,-43,-33,-12,-175
-57,23,-89,-188,-106,-124,-117,-72,-730
0,22,-15,-38,-62,-11,-57,4,-157
101,163,29,-133,2,-130,-95,-20,-83
-34,-22,-47,-174,-124,-72,-55,34,-494
5,18,-24,-49,-50,-44,-42,12,-174
-60,-5,-41,-99,-48,-57,-72,-9,-391
-160,82,-202,-612,-314,-366,-372,43,-1901
-32,11,-31,-113,-41,-70,-113,-17,-406
54,85,-11,-90,-50,-96,-61,17,-152
49,74,-38,-123,10,-102,-71,-39,-240
37,58,2,-99,-27,-98,-80,15,-192
-21,20,-23,-60,-28,-26,-40,-25,-203
-26,37,-45,-127,-65,-99,-97,-13,-435
-39,-10,-79,-177,-198,-185,-126,-19,-833
-68,-1,-109,-164,-214,-66,-116,-2,-740
16,9,-5,-29,-23,-47,-32,-8,-119
-16,-19,-24,-65,-122,-68,-72,-8,-394
-21,-4,-31,-77,-18,-37,-45,-4,-237
-7,6,-45,-92,-77,-57,-69,-30,-371
38,39,-21,-93,-62,-93,-82,-7,-281
-18,58,-21,-47,-39,-45,-52,-6,-170
-53,-2,-63,-167,-147,-126,-91,-25,-674
-1,33,-21,-47,-5,-24,-26,9,-82
25,42,-9,-48,-39,-69,-31,-5,-134
11,-10,6,-62,-48,-67,-66,-13,-249
2,21,9,-71,-68,-64,-52,42,-181
83,33,30,11,12,-15,-63,40,131
-37,-16,-51,-104,-75,-43,-57,-12,-395
-17,-3,-31,-58,-46,-45,-67,-6,-273
-5,12,-32,-64,-62,-41,-52,-16,-260
1,42,-79,-134,-82,-154,-126,-101,-633
-57,51,-140,-344,-212,-105,-161,199,-769
-79,24,-116,-294,-197,-107,-159,147,-781
-23,-9,-18,-39,-2,7,-31,7,-108
-54,85,-34,-180,-73,-119,-64,15,-424
7,4,-31,-92,-24,-59,-59,-25,-279
44,110,-10,-293,-155,-254,-195,56,-697
-44,20,-102,-156,-95,-63,-95,-5,-540
-32,32,-11,-69,-69,-64,-4,23,-194
-89,-24,-89,-149,-94,-72,-143,-21,-681
-89,-17,-72,-146,-96,-57,-126,-9,-612
-75,-36,-59,-127,-99,-62,-128,-16,-602
-77,-29,-77,-125,-82,-83,-144,-26,-643
-79,-22,-71,-148,-100,-79,-135,-16,-650
-91,-19,-82,-135,-102,-79,-140,-16,-664
-95,-28,-84,-144,-99,-79,-135,-33,-697
-35,-25,-70,-106,-115,-98,-127,-85,-661
-90,-14,-74,-146,-106,-57,-118,2,-603
-94,-34,-98,-164,-119,-84,-139,-28,-760
-86,-47,-90,-153,-114,-82,-120,-30,-722
-91,-31,-94,-151,-107,-81,-132,-19,-706
-95,-8,-70,-149,-76,-77,-132,-11,-618
-13,-16,-46,-49,-56,-2,-49,-6,-237
-39,-16,-32,-72,-27,-14,-24,-16,-240
83,195,-38,-193,80,-91,-92,141,85
20,53,-30,-112,-60,-104,-41,-22,-296
-73,25,-113,-223,-155,-114,-155,-28,-836
-9,50,-18,-95,-52,-74,-36,-19,-253
15,89,-27,-209,-69,-166,-100,-59,-526
-7,6,-18,-26,-6,-10,-13,-14,-88
-24,26,-27,-67,-45,-38,-30,-14,-219
1,-9,-29,-79,-20,-55,-42,-23,-256
-10,6,-27,-78,-64,-54,-58,-22,-307
-35,27,-37,-90,-52,-45,-52,-34,-318
14,-2,2,-44,-23,-52,-7,10,-102
21,25,-6,-113,-54,-115,-85,-15,-342
45,62,16,4,24,11,50,6,218
-25,13,-48,-74,-64,-62,-52,-45,-357
32,23,30,-19,-24,-66,-4,12,-16
-2,0,-36,-82,-41,-37,-26,6,-218
-85,46,-73,-209,-12,-47,-17,31,-366
-7,14,-7,-53,-52,-33,-31,-11,-180
64,95,48,-262,-56,-211,-92,51,-363
-125,-5,-163,-389,-229,-216,-224,-82,-1433
15,93,-87,-314,-50,-78,-129,68,-482
37,74,-4,-57,-83,-42,-28,-30,-133
15,185,-44,-323,-94,-179,-131,100,-471
0,26,-10,-16,-31,3,-8,3,-33
-65,7,-79,-172,-144,-119,-93,-38,-703
-32,26,-30,-101,-87,-60,-31,54,-261
1,19,-5,-25,-13,-26,-25,14,-60
28,54,-8,-78,-15,-79,-97,-17,-212
-105,89,-54,-239,-6,-106,-75,-43,-539
-30,-81,-121,-250,-262,-239,-229,-72,-1284
27,-5,16,-66,7,-26,-25,17,-55
-69,-24,-111,-226,-157,-120,-202,-50,-959
-58,-1,-53,-150,-88,-106,-128,-62,-646
89,92,40,-41,41,-41,38,40,258
-36,-45,-41,-66,-160,-65,-108,30,-491
-43,-7,-86,-289,-238,-228,-197,-99,-1187
5,15,-14,-56,-25,-44,-41,-2,-162
0,15,-31,-45,-35,-48,-39,-20,-203
-3,11,-24,-55,-58,-43,-25,-6,-203
-10,62,-45,-140,-47,-44,-63,21,-266
-15,56,-13,-118,-78,-65,-116,-30,-379
-120,317,-178,-653,-227,-396,-233,88,-1402
-21,1,-36,-115,-141,-88,-120,-30,-550
35,48,0,-125,-41,-114,-74,-12,-283
12,90,-12,42,-7,33,-54,7,111
41,139,10,101,6,64,-63,-5,293
18,106,-15,63,-9,31,-56,4,142
8,78,-2,49,-14,23,-38,-6,98
75,218,27,171,26,74,-81,4,514
19,154,-13,74,9,30,-83,18,208
68,209,32,145,35,81,-86,-5,479
8,-1,-57,-120,-135,-115,-121,1,-540
-36,-1,-28,-46,-35,-22,-27,-4,-199
7,18,-40,-250,-120,-186,-103,13,-661
-54,-56,-100,-163,-202,-60,-174,69,-740
80,-23,-2,-22,-38,-28,-33,2,-64
9,40,1,-35,8,-29,-39,-8,-53
19,107,-33,-206,-59,-35,-69,69,-207
-5,37,-32,-135,-34,-78,-75,-14,-336
-16,51,-12,-85,-20,-65,-49,-14,-210
-42,40,-87,-220,-167,-142,-142,-10,-770
-27,4,-36,-149,-108,-97,-95,-8,-516
138,319,-61,-369,50,-236,-146,133,-172
-6,210,-70,-501,-439,-276,-350,154,-1278
-22,156,-85,-218,8,-82,-54,146,-151
3,10,-43,-82,-92,-101,-82,-40,-427
-122,-26,-163,-275,-160,-118,-201,-152,-1217
-63,-21,-121,-183,-156,-153,-193,-86,-976
-9,14,3,-52,-69,-50,-28,3,-188
9,32,-27,-32,-36,-41,-10,-17,-122
62,108,42,-80,15,-88,-40,51,70
-92,-17,-90,-249,-137,-111,-86,48,-734
-58,63,-68,-199,-106,-89,-70,19,-508
8,-43,-44,-156,-211,-213,-139,-16,-814
34,82,-13,-174,-68,-148,-103,-59,-449
-101,24,-157,-327,-138,-181,-187,-159,-1226
-38,-24,-59,-96,-94,-62,-77,-37,-487
26,67,2,-37,37,-26,-32,78,115
-12,7,-33,-53,-49,-14,-28,-49,-231
23,61,15,-93,-23,-56,-21,-44,-138
-39,58,-69,-143,-91,-46,-53,-10,-393
-38,25,-117,-143,-101,-85,-158,-43,-660
-10,-16,-94,-145,-95,-75,-132,-38,-605
33,16,15,-1,16,-3,15,21,112
-10,7,-21,-67,-15,-37,-40,2,-181
-99,-42,-89,-194,-94,-105,-155,-58,-836
37,65,2,-57,-34,-83,-65,60,-75
64,47,9,-37,-47,-94,-25,-36,-119
39,80,5,-53,-21,-47,-7,39,35
-17,-9,-26,-49,-31,-33,-26,-10,-201
11,23,-31,-94,-57,-91,-102,3,-338
30,47,19,15,-14,-15,-9,15,88
-48,84,-149,-315,-143,-217,-231,-130,-1149
89,108,-96,-245,-150,-246,-146,-218,-904
7,9,-73,-102,-117,-121,-115,-75,-587
15,36,11,-32,2,-39,-51,13,-45
54,64,13,-153,-39,-136,-40,17,-220
-17,19,-40,-101,-127,-53,-84,-47,-450
-19,0,-18,-53,-55,-38,-55,10,-228
-66,-3,-82,-149,-151,-103,-97,-39,-690
-10,18,-57,-151,-113,-88,-123,-38,-562
-15,-1,-24,-143,-123,-105,-101,10,-502
4,128,-32,-189,22,-97,-11,27,-148
113,104,41,-93,-11,-48,-72,-23,11
-100,50,-163,-331,-108,-153,-220,-64,-1089
-101,10,-157,-281,-154,-144,-236,-90,-1153
-34,50,-140,-259,-72,-177,-184,-120,-936
-9,-2,-6,-8,-3,7,-1,1,-21
-12,38,-53,-171,-65,-67,-108,44,-394
-75,-14,-63,-169,-109,-75,-114,-42,-661
-148,-39,-151,-323,-199,-174,-223,-36,-1293
-38,-33,-115,-151,-181,-157,-187,-83,-945
219,139,63,-133,-8,-187,-55,60,98
57,51,-58,-109,-159,-204,-170,-30,-622
32,36,-38,-49,-20,-74,-44,-31,-188
16,22,-4,-19,-15,-21,-19,-14,-54
5,11,-4,4,-5,-1,-6,6,10
-14,-1,4,-23,-14,-8,-12,-17,-85
-84,-2,-113,-157,-114,-95,-154,-9,-728
-17,21,-17,-45,-10,-23,-11,6,-96
-46,5,-24,-72,-32,-30,-72,42,-229
-18,30,-46,-92,-89,-42,-75,-48,-380
-10,15,-17,-42,-24,-16,-21,6,-109
-70,54,-82,-209,-80,-78,-95,-27,-587
-11,23,-18,-90,-87,-101,-89,-13,-386
35,110,-31,-213,-71,-146,-91,-35,-442
-27,117,-34,-110,33,-50,-36,-16,-123
-73,138,-59,-203,2,-83,-97,9,-366
12,27,-47,-87,-173,-135,-124,-86,-613
6,-1,-69,-151,-148,-131,-127,-25,-646
-30,-19,-34,-98,-39,-41,-62,-34,-357
-66,-27,-27,-169,-70,-94,-76,-22,-551
-29,26,-42,-123,-28,-37,-38,19,-252
-27,2,-70,-118,-77,-80,-89,-33,-492
47,49,-29,-100,-103,-120,-93,-54,-403
-60,21,-101,-174,-133,-143,-148,-114,-852
12,37,-12,-23,-20,-29,-13,13,-35
26,46,-9,-41,-84,-92,-42,-66,-262
-6,-8,-2,-40,-44,-28,-20,-6,-154
-45,18,-56,-170,-94,-102,-128,-30,-607
-80,21,-98,-187,-118,-99,-138,-29,-728
185,123,9,-94,-145,-246,-137,-80,-385
4,22,8,-86,-37,-53,-33,62,-113
69,114,-10,-152,-5,-125,5,-30,-134
30,19,15,-39,3,-43,-29,-5,-49
-48,-51,-53,-83,-79,-63,-73,-32,-482
44,29,5,-20,-24,-36,-17,-13,-32
-5,67,-11,-113,-89,-59,-37,-26,-273
67,97,-16,-142,-11,-42,-10,77,20
41,-7,1,-11,-17,-33,-26,-3,-55
-9,1,-30,-87,-57,-52,-56,-53,-343
-1,11,-23,-82,-21,-73,-60,-12,-261
0,40,-35,-138,-65,-100,-59,-40,-397
-51,-19,-38,-110,-114,-80,-107,-32,-551
-6,28,-27,-62,-25,-51,-47,-31,-221
-93,138,-71,-292,-47,-52,-4,58,-363
138,285,-26,-471,-111,-421,-245,96,-755
-97,77,-116,-388,-255,-211,-214,41,-1163
-4,-3,-5,-25,-25,-24,-8,-16,-110
-96,-21,-143,-286,-159,-163,-196,-61,-1125
-79,-28,-124,-166,-106,-77,-167,-59,-806
-35,16,-99,-338,-162,-243,-266,-43,-1170
-24,-26,-16,-131,-126,-62,-51,-7,-443
-20,-19,-39,-46,-79,-53,-73,-1,-330
6,11,3,-45,-34,-48,-44,-12,-163
-49,18,-40,-121,-74,-71,-84,-12,-433
76,138,45,-97,-2,-94,-53,82,95
-63,101,-41,-200,-60,-101,-28,7,-385
-22,1,-3,-36,-27,-3,-22,7,-105
-54,4,-69,-183,-169,-122,-129,-23,-745
-19,67,-74,-296,-181,-231,-167,-26,-927
-41,20,-41,-160,-106,-70,-73,17,-454
147,18,-12,-176,-142,-206,-110,-76,-557
-31,4,-31,-55,-57,-14,-30,-23,-237
-70,-24,-59,-146,-104,-111,-107,-62,-683
-19,0,-32,-81,-55,-38,-40,14,-251
1,51,-31,-99,-81,-105,-76,9,-331
-25,5,-37,-114,-104,-96,-75,-77,-523
-30,43,-61,-113,-60,-58,-42,-38,-359
63,60,4,-118,28,-76,-67,10,-96
-126,7,-163,-319,-178,-212,-192,-13,-1196
6,9,-10,-57,-38,-60,-46,-16,-212
-100,18,-41,-122,-76,-43,-57,3,-418
-53,-12,-86,-161,-83,-70,-86,-15,-566
-28,-4,-37,-100,-53,-73,-63,-14,-372
-62,11,-48,-111,-41,-43,-36,-24,-354
-74,63,-110,-279,-64,-146,-84,-54,-748
84,182,-79,-355,-237,-373,-305,-102,-1185
-2,125,-30,-237,-37,-137,-121,-22,-461
-47,-12,-44,-108,-102,-95,-88,-22,-518
-15,-18,-11,-66,-62,-9,-28,9,-200
-16,23,-41,-78,-43,-63,-57,4,-271
0,2,-39,-96,-87,-91,-59,-25,-395
-57,25,-107,-217,-200,-150,-158,-52,-916
-253,-220,-244,-665,-451,-408,-389,-70,-2700
-189,47,-230,-454,-200,-232,-300,-59,-1617
1,28,-26,-88,-27,-56,-25,-11,-204
-61,10,-62,-193,-92,-64,-52,-4,-518
-6,76,-74,-171,-101,-132,-102,-6,-516
88,73,34,-81,-10,-85,-104,78,-7
-133,69,-71,-193,-86,-51,-92,-18,-575
-16,6,-16,-20,-26,-15,-28,-5,-120
-32,135,-74,-200,-49,-120,-70,17,-393
-31,99,-87,-272,2,-71,-134,26,-468
-96,25,-134,-259,-154,-174,-207,-105,-1104
-50,15,-47,-159,-147,-84,-61,17,-516
30,51,20,13,2,-30,-10,38,114
3,43,-9,-111,-11,-80,-24,15,-174
-15,7,-40,-114,-85,-89,-87,-7,-430
-7,18,-69,-142,-93,-96,-108,-84,-581
-44,-13,-90,-125,-123,-94,-138,-14,-641
-42,3,-47,-118,-66,-66,-70,12,-394
-22,-15,-74,-98,-71,-77,-108,-9,-474
-28,8,-24,-88,-19,-40,-51,-14,-256
26,40,-17,-86,-16,-68,5,0,-116
-59,-8,-51,-159,-86,-95,-96,-19,-573
23,25,-2,-13,-33,-21,-18,8,-31
-29,189,-80,-300,-51,-122,-54,66,-381
-5,9,-17,-71,-60,-37,-36,-1,-218
-12,20,-27,-86,-66,-80,-81,-9,-341
-61,50,-131,-263,-135,-150,-190,-47,-927
94,139,-27,-362,-185,-212,-191,71,-673
54,70,-32,-117,-78,-165,-124,-90,-482
7,-1,-5,-75,-39,-45,-51,4,-205
47,33,0,-18,-24,-34,-19,-16,-31
-23,9,-26,-48,-50,-33,-45,-4,-220
-9,17,-15,-67,-42,-48,-54,-22,-240
35,46,-60,-106,-112,-157,-106,-109,-569
10,62,-48,-173,5,-74,-22,33,-207
-13,0,-1,-36,-12,7,1,9,-45
-24,-14,-46,-62,-53,-81,-79,7,-352
-23,-23,-38,-47,-25,-31,-39,-4,-230
30,69,-132,-170,-147,-246,-214,-167,-977
-9,-13,-1,-30,-30,-52,-29,-25,-189
-29,52,-23,-103,-44,-65,-85,42,-255
18,54,-73,-302,-95,-207,-159,-101,-865
-19,16,-12,-74,-55,-59,-39,-20,-262
81,86,9,-27,-4,-14,22,-16,137
6,26,-48,-62,-133,-110,-78,-103,-502
5,16,-13,-69,-118,-66,-24,24,-245
-43,5,-54,-90,-49,-34,-61,-20,-346
22,34,-34,-92,-60,-101,-84,-19,-334
-34,100,-65,-259,-92,-122,-102,30,-544
1,67,-97,-227,-117,-148,-131,-83,-735
-84,95,-43,-157,-50,-87,-90,49,-367
-85,-28,-70,-171,-156,-93,-113,4,-712
-123,0,-57,-174,-96,-65,-89,-3,-607
-1,57,-19,-72,-40,-58,-68,13,-188
31,78,-137,-315,-214,-320,-322,-186,-1385
-53,134,-72,-204,-37,-47,-85,-32,-396
-18,33,-44,-79,-22,-47,-48,-54,-279
-160,20,-220,-364,-88,-157,-204,-105,-1278
-8,-8,-18,-60,-49,-52,-46,-8,-249
-6,21,-31,-50,-21,-17,-15,10,-109
-53,64,-52,-169,-12,-79,-78,-47,-426
3,50,-14,-174,-33,-96,-74,24,-314
13,38,-11,-73,-37,-44,-13,-5,-132
7,2,1,-24,-5,-13,-3,3,-32
67,28,-33,-76,-124,-129,-85,-14,-366
-2,41,-50,-177,-85,-114,-66,19,-434
20,1,-17,-49,-90,-69,-51,1,-254
-16,14,-73,-164,-235,-162,-153,-55,-844
-14,40,-50,-91,-21,-15,-24,21,-154
24,113,-44,-163,-109,-166,-143,39,-449
-45,13,-95,-141,-102,-73,-108,-17,-568
55,116,0,-214,7,-181,-84,-70,-371
51,92,-89,-142,-177,-176,-90,-67,-598
14,26,-12,-64,-75,-52,-58,4,-217
1,2,-5,-44,-25,-32,-19,-9,-131
-83,-3,-84,-152,-56,-68,-41,-72,-559
13,84,-3,-51,-49,-79,-58,89,-54
-25,53,-36,-101,-42,-52,-63,26,-240
-4,29,0,-86,-67,-67,-65,12,-248
-14,57,-15,-71,7,-24,-54,42,-72
14,-10,0,-54,-24,-41,-29,-20,-164
-64,-18,-52,-99,-44,-28,-61,-18,-384
-12,-5,-40,-70,-50,-62,-52,-31,-322
-18,-21,-29,-68,-113,-60,-80,-10,-399
-4,49,-55,-212,-60,-191,-119,-119,-711
-79,54,-53,-133,-33,-47,-60,-11,-362
-22,-13,-50,-72,-99,-75,-74,-77,-482
-21,27,-41,-90,-45,-48,-18,-13,-249
60,21,-39,-117,-217,-156,-139,-70,-657
27,49,12,23,10,46,12,19,198
9,168,-103,-333,-156,-194,-179,60,-728
-106,38,-52,-159,-67,-42,-62,-21,-471
57,48,20,-142,-7,-126,-36,21,-165
-39,-30,-247,-276,-423,-368,-407,-303,-2093
5,40,-27,-28,-27,-23,-14,43,-31
17,79,-2,-114,-11,-63,-35,104,-25
-29,16,-17,-49,-30,-18,0,13,-114
-13,-3,-26,-49,-54,-27,-45,-22,-239
-12,8,-50,-132,-131,-130,-103,-84,-634
-52,-15,-38,-97,-80,-47,-47,-12,-388
-55,-46,-54,-69,-53,-42,-69,-25,-413
-1,23,-82,-122,-103,-121,-94,13,-487
20,28,-35,-79,-97,-91,-58,-13,-325
-72,-9,-74,-228,-116,-109,-108,-32,-748
52,64,4,-43,-18,-63,-90,23,-71
-12,7,-45,-104,-120,-65,-77,-6,-422
3,0,-25,-81,-53,-62,-68,-39,-325
-5,26,-10,-43,-8,-26,-2,14,-54
26,24,14,-19,-10,-16,-11,30,38
5,-2,-16,-39,-66,-38,-36,-7,-199
5,12,16,-56,-61,-26,-70,-15,-195
-9,32,-13,-60,-18,-36,-35,-10,-149
-187,-14,-289,-618,-478,-460,-394,-174,-2614
-7,41,-1,-88,-6,-35,-15,7,-104
1,41,-14,-65,-72,-86,-84,-50,-329
-53,51,-58,-263,-172,-188,-96,67,-712
-19,4,-35,-47,-40,-24,-36,3,-194
-7,81,-115,-247,-61,-175,-156,-70,-750
-71,22,-93,-193,-134,-138,-135,-2,-744
-21,-32,-46,-92,-110,-70,-103,-15,-489
16,26,-8,-87,-3,-59,-27,21,-121
30,4,-37,-31,-99,-73,-85,-50,-341
5,48,-39,-99,-98,-86,-88,16,-341
-40,16,-81,-158,-101,-106,-146,-50,-666
-68,-21,-68,-205,-58,-87,-64,-13,-584
-13,12,-11,-22,-23,-25,-21,20,-83
4,47,7,-71,-56,-79,-62,33,-177
107,31,27,-63,-50,-101,-81,13,-117
38,58,-22,-132,-55,-126,-121,-57,-417
-16,16,-12,-61,-26,-31,-28,18,-140
-59,27,-81,-259,-145,-173,-153,-1,-844
144,117,49,-218,16,-135,-39,44,-22
17,76,-132,-230,-171,-284,-243,-174,-1141
68,57,-35,-161,-151,-206,-133,-102,-663
-8,32,-59,-205,-147,-183,-125,14,-681
-22,134,-75,-247,-45,-86,-80,95,-326
-5,14,-22,-74,22,-39,-8,-1,-113
-15,54,-1,-169,-23,-85,-44,82,-201
28,139,-71,-125,-65,-114,-70,-6,-284
-3,30,10,-75,-39,-47,-11,-11,-146
2,14,-14,-67,-124,-69,-41,-5,-304
-3,12,-10,-10,2,-11,-19,3,-36
-41,68,-41,-110,-28,-62,-68,5,-277
-67,29,-148,-292,-153,-232,-205,-25,-1093
94,79,41,-196,19,-42,-19,109,85
-14,-4,-9,-60,-76,-60,-39,-13,-275
-16,26,-28,-91,-64,-62,-45,-7,-287
-113,72,-95,-358,-283,-254,-177,89,-1119
16,34,-14,-45,-46,-18,-20,40,-53
-2,-4,-37,-82,-58,-78,-54,-29,-344
-48,25,-62,-191,-120,-113,-124,-36,-669
-123,-49,-108,-211,-132,-101,-153,-33,-910
244,367,-48,-399,-276,-500,-192,-113,-917
42,41,10,-63,-17,-57,-23,-1,-68
4,40,-13,-10,-6,8,2,-22,3
-47,-5,-101,-187,-162,-116,-176,-49,-843
-68,44,-58,-192,-118,-85,-131,19,-589
-19,-7,-26,-76,-95,-80,-87,-26,-416
-89,-25,-175,-326,-179,-190,-216,-22,-1222
16,6,10,-21,11,4,-46,14,-6
-160,163,-201,-547,-201,-120,-217,48,-1235
7,22,-39,-101,-76,-110,-96,-61,-454
18,7,2,-28,0,-26,-18,-15,-60
-55,9,-40,-97,-64,-4,-72,22,-301
-37,-26,-51,-66,-64,-44,-50,-21,-359
-27,-1,-16,-131,-99,-69,-54,14,-383
-23,-54,-35,-81,-103,-93,-91,-40,-520
9,38,-64,-132,-169,-96,-141,-55,-610
5,36,-15,-58,-33,-53,-18,-10,-146
-10,11,-22,-60,-99,-104,-80,-15,-379
-96,14,-122,-227,-213,-178,-260,20,-1062
43,24,-2,-37,-73,-71,-29,-17,-162
9,8,-7,-10,-34,-19,-30,-27,-110
-159,93,-184,-411,-192,-192,-247,-28,-1320
-183,184,-243,-586,-306,-401,-359,-83,-1977
-7,43,-36,-95,-103,-117,-80,-43,-438
15,42,0,-83,-64,-50,-28,-15,-183
113,13,33,-5,-43,-95,-49,-13,-46
-1,177,24,-326,-206,-235,-122,207,-482
-6,1,-17,-45,-31,-36,-14,-8,-156
3,6,3,-41,-15,-47,-31,-15,-137
1,6,1,-16,-3,-11,-12,6,-28
-6,3,-29,-46,-53,-39,-45,-14,-229
8,117,-17,-67,-11,-14,-31,-8,-23
10,105,-20,-70,-9,-29,-23,-18,-54
37,86,-28,-141,-32,-130,-63,23,-248
-41,162,-64,-210,-105,-71,-119,-1,-449
3,65,-57,-88,-41,-69,-21,-25,-233
8,68,-31,-115,-10,-67,-29,8,-168
-44,-18,-37,-87,-57,-55,-91,-16,-405
-81,46,-85,-177,-63,-35,-57,23,-429
16,26,-24,-114,-24,-64,-46,27,-203
164,3,16,-65,-73,-139,-78,2,-170
9,18,-18,-112,-53,-84,-50,21,-269
18,59,-90,-208,-174,-170,-178,-147,-890
-19,13,-42,-82,-39,-52,-38,13,-246
-3,-3,-35,-43,-44,-40,-36,-14,-218
-93,-35,-128,-214,-149,-121,-189,-66,-995
75,49,-55,-110,-173,-177,-105,-13,-509
193,259,-26,-315,-93,-390,-164,209,-327
-2,6,-59,-95,-86,-102,-110,-74,-522
-95,-61,-70,-108,-111,-73,-107,6,-619
6,19,-22,-101,-196,-213,-138,-20,-665
-137,53,-115,-266,-124,-56,-112,-50,-807
-126,117,-155,-413,-216,-217,-318,-271,-1599
-63,-38,-74,-144,-142,-73,-123,6,-651
-57,19,-85,-176,-114,-77,-101,-11,-602
-63,-29,-55,-109,-106,-62,-123,-17,-564
-75,27,-41,-104,-35,-49,-51,-12,-340
-141,35,-166,-348,-233,-177,-226,-64,-1320
66,24,21,-29,-25,-59,2,11,11
-20,-16,9,-73,-74,-27,-54,45,-210
-16,7,-40,-215,-258,-156,-169,-35,-882
-134,412,-207,-570,15,-145,-27,123,-533
146,416,-166,-468,-171,-303,-41,-39,-626
-15,-1,-18,-23,-13,-6,-15,-9,-100
-20,27,-61,-102,-65,-99,-101,-66,-487
89,201,-9,-110,-12,-96,-49,114,128
72,85,51,-93,-34,-92,5,61,55
-31,-13,-39,-53,-45,-36,-65,13,-269
-17,-19,-21,-72,-63,-85,-43,-31,-351
160,131,67,-118,102,-120,-62,48,208
156,106,73,-78,38,-122,-86,80,167
-38,82,-73,-232,-14,-43,-115,-71,-504
192,162,-151,-545,-553,-497,-400,-80,-1872
-187,-20,-177,-381,-246,-232,-255,13,-1485
-23,-9,-19,-35,-49,-15,-38,-13,-201
-54,12,-56,-169,-100,-111,-108,-16,-602
27,27,-13,-33,-56,-37,-27,-4,-116
-56,7,-71,-166,-60,-66,-103,-19,-534
-7,27,-20,-44,4,-32,-29,-22,-123
-1,33,-17,-26,-5,-27,-32,12,-63
-20,-5,-17,-32,-33,-26,-34,-9,-176
-24,47,-33,-102,-25,-52,-33,17,-205
-4,14,-17,-60,-16,-37,-51,-40,-211
36,53,6,-112,-151,-165,-153,-2,-488
-46,-34,-61,-118,-109,-54,-75,-28,-525
-16,15,-41,-64,-31,-46,-61,-42,-286
6,12,5,-11,-25,-24,-11,-17,-65
-35,-22,-39,-47,-55,-37,-42,-19,-296
19,48,-35,-154,-63,-145,-108,-27,-465
-2,20,-30,-84,-21,-29,-64,-24,-234
26,-4,-2,-61,-24,-71,-39,-3,-178
-77,74,-91,-277,-75,-141,-169,-111,-867
-14,12,-16,-17,-27,-24,-34,-14,-134
-16,-6,-13,-35,-11,-25,-18,10,-114
-29,-14,-39,-49,-42,-20,-47,-8,-248
-90,-12,-83,-182,-107,-80,-108,-8,-670
-25,4,-31,-66,-33,-53,-48,-24,-276
-8,34,-49,-168,-108,-143,-73,-39,-554
-52,-35,-55,-87,-63,-30,-84,15,-391
37,76,-4,-84,-6,-47,-91,71,-48
49,38,3,-11,-16,-54,-49,41,1
-112,4,-130,-275,-182,-147,-222,-57,-1121
3,16,-24,-37,-38,-36,-46,-14,-176
-20,14,-17,-49,-6,-19,-22,-10,-129
-31,63,-37,-173,-127,-93,-96,79,-415
67,45,-33,-169,-152,-182,-118,-19,-561
0,-9,-26,-17,-40,-26,-44,-6,-168
-9,-17,-60,-97,-90,-86,-110,-31,-500
-67,-33,-73,-151,-135,-53,-115,-36,-663
-20,24,-49,-67,-46,-52,-74,-8,-292
5,31,-12,-47,-38,-42,-58,-1,-162
2,20,-14,-9,10,8,-13,-4,0
-13,-7,-8,-46,-96,-66,-43,-10,-289
-90,-40,-80,-179,-93,-70,-93,6,-639
197,149,53,103,-155,-78,-4,-110,155
-16,-2,-13,-10,-48,-29,-29,-12,-159
-17,7,-23,-39,-17,-22,-26,5,-132
-13,-22,-39,-83,-66,-37,-90,9,-341
-12,7,-3,-24,-14,-14,-13,-14,-87
7,12,-27,-26,-4,-27,-24,0,-89
-7,11,-19,-25,0,-16,-23,6,-73
-15,-1,-56,-159,-54,-79,-152,-5,-521
-39,-29,-39,-114,-26,-41,-73,-23,-384
-12,31,-12,-54,-49,-28,-41,30,-135
1,-17,-34,-85,-73,-67,-64,-9,-348
-9,-3,-33,-27,-25,-41,-41,-6,-185
-1,16,-15,-29,-31,-25,-44,-7,-136
33,18,-2,-74,-84,-49,-91,21,-228
-26,-12,-32,-60,-35,-45,-49,-11,-270
-15,44,-45,-124,-108,-98,-99,-16,-461
-41,-25,-51,-122,-90,-111,-89,7,-522
0,21,3,-62,-62,-82,-69,-12,-263
-41,-5,-37,-103,-76,-38,-77,3,-374
-41,48,-41,-118,-54,-55,-33,16,-278
-86,-21,-120,-233,-148,-140,-175,-77,-1000
-19,48,-17,-84,-36,-13,2,19,-100
-4,32,-9,-70,-27,-31,-91,55,-145
20,23,-36,-96,-87,-125,-84,-55,-440
-13,1,-25,-66,-60,-33,-42,9,-229
1,51,-29,-39,-37,-44,-35,15,-117
22,10,-5,-17,-10,-17,-32,-6,-55
21,38,-1,-53,6,-42,-39,-21,-91
-20,-3,-36,-57,-47,-36,-54,-6,-259
-28,6,-28,-132,-102,-59,-66,8,-401
-1,19,-21,-54,-33,-48,-34,-47,-219
7,23,-11,-69,-40,-48,-33,0,-171
-20,2,-30,-72,-25,-33,-49,-19,-246
-43,-15,-62,-107,-76,-52,-93,-22,-470
37,74,-54,-163,-91,-188,-198,-39,-622
-23,-4,-23,-112,-130,-68,-62,49,-373
54,-35,-23,-66,-116,-115,-101,-56,-458
-10,45,-42,-123,-34,-95,-92,-42,-393
-16,50,-47,-58,-16,-45,-50,21,-161
-5,18,-73,-88,-72,-106,-108,-95,-529
75,47,30,-31,54,-68,-37,17,87
52,74,-4,-63,-47,-99,-50,4,-133
-31,7,-28,-53,-11,-23,-25,-11,-175
-11,16,-7,-45,4,-24,-19,-4,-90
-15,26,-26,-45,-22,-22,-33,-15,-152
10,26,-20,-52,-62,-74,-60,-54,-286
44,82,-41,-83,-45,-84,-82,-37,-246
170,141,-19,-114,-191,-257,-262,-85,-617
-24,7,-24,-45,-13,-47,-28,-24,-198
76,104,-12,-232,-36,-148,-165,42,-371
22,23,-96,-126,-171,-160,-169,-78,-755
-17,-2,-46,-104,-114,-40,-99,13,-409
132,89,27,-99,32,-69,-121,96,87
3,19,-33,-68,-115,-83,-107,-37,-421
-3,123,-59,-145,-125,-48,-156,111,-302
41,55,-12,-88,-4,-60,-68,-7,-143
-8,11,-53,-148,-93,-127,-112,-29,-559
8,8,-20,-53,-55,-66,-59,-47,-284
20,73,-15,2,-9,-15,-37,-3,16
59,50,4,-37,-13,-42,-29,9,1
-39,41,-62,-169,-163,-66,-118,25,-551
3,28,-25,-118,-157,-58,-87,51,-363
27,59,-12,-73,-55,2,-82,-1,-135
90,52,-44,-150,-115,-200,-112,-104,-583
-84,40,-119,-225,-110,-111,-95,-2,-706
-53,-6,-41,-102,-84,-60,-94,5,-435
12,112,-111,-278,-121,-192,-178,-1,-757
-13,35,-29,-52,-6,-14,-39,15,-103
-15,11,-24,-46,-26,-25,-32,-29,-186
-18,33,-30,-52,-21,-48,-58,16,-178
-25,-3,-31,-69,-86,-26,-34,27,-247
1,5,-33,-22,-22,-29,-25,-10,-135
-10,10,-24,-54,-29,-27,-44,18,-160
8,3,-16,-50,-28,-51,-47,-11,-192
5,-2,-12,-40,2,-26,-15,-12,-100
30,24,-7,-47,-2,-46,-16,2,-62
-8,9,-34,-89,-55,-70,-83,-39,-369
17,23,1,-24,3,-22,-22,6,-18
7,5,-15,-18,-19,-37,-19,-3,-99
-4,-2,-12,-37,-21,-28,-18,-8,-130
-43,-8,-50,-87,-90,-46,-51,-1,-376
-3,8,-14,-43,-12,-37,-20,-19,-140
-5,45,-72,-158,-107,-162,-113,-53,-625
21,14,-5,-27,-22,-46,-27,-16,-108
2,12,-28,-44,-79,-69,-83,-28,-317
-14,2,-30,-60,-22,-18,-36,-8,-186
-58,24,-55,-97,-65,-78,-84,4,-409
-19,-11,-44,-85,-43,-47,-66,-36,-351
0,10,-27,-35,-8,-32,-27,-11,-130
-10,28,-32,-47,-51,-16,-29,8,-149
-5,118,-84,-433,-147,-255,-313,39,-1080
-42,21,-13,-43,-21,-8,-23,9,-120
53,61,13,-114,-19,-124,-128,7,-251
-12,-26,-91,-279,-61,-145,-265,94,-785
-34,42,-37,-85,-28,-13,-40,16,-179
-14,31,-26,-47,-41,-17,-33,-3,-150
-28,97,-80,-209,-155,-132,-115,56,-566
-28,111,-86,-198,-50,-95,-120,-82,-548
-63,54,-68,-201,-97,-151,-120,27,-619
8,36,-12,-42,-46,-42,-83,-33,-214
-9,16,-15,-30,-25,-31,-25,-6,-125
140,159,88,-190,101,-140,-133,126,151
4,71,-76,-213,-71,-137,-136,-109,-667
-26,10,-29,-41,-19,-22,-38,-21,-186
20,9,-11,-50,-35,-46,-39,-12,-164
16,294,-257,-1055,-950,-537,-672,748,-2413
-6,33,-63,-178,-148,-186,-143,-99,-790
-94,124,-312,-764,-599,-433,-461,314,-2225
-87,-55,-107,-207,-176,-114,-160,40,-866
-12,-7,-25,-47,-70,-44,-25,-7,-237
-34,72,-36,-91,-38,-31,-34,9,-183
-33,41,-36,-301,-37,-117,-126,-5,-614
44,10,-2,-138,-67,-128,-55,-19,-355
34,24,-14,-107,-32,-87,-57,4,-235
137,188,21,-241,-15,-48,-106,214,150
77,101,22,-37,-18,-102,-108,60,-5
89,48,-48,-73,-102,-129,-93,-87,-395
-7,17,-34,-94,-133,-47,-66,-24,-388
-15,-14,-75,-144,-103,-76,-106,-22,-555
30,168,-15,-212,-71,-163,-80,121,-222
-3,36,-13,-48,-12,-31,-12,1,-82
159,171,-6,-284,-97,-310,-185,56,-496
1,9,-21,-27,-14,-24,-28,-3,-107
-132,-58,-127,-251,-128,-91,-164,-66,-1017
179,531,28,-579,-69,-298,-769,427,-550
-94,-24,-66,-177,-114,-61,-105,38,-603
-32,13,-60,-102,-55,-59,-48,41,-302
12,98,-33,-239,-104,-201,-115,-64,-646
195,303,-21,-234,-7,-210,-78,48,-4
-37,37,-42,-123,-18,-33,-90,-16,-322
-7,0,-21,-29,-26,-21,-16,-10,-130
-154,168,-120,-819,-401,-418,-324,202,-1866
-99,-10,-124,-268,-186,-170,-201,-126,-1184
-1,20,15,-31,5,-12,-6,15,5
-17,16,4,-49,-17,-28,-21,16,-96
-13,21,-14,-123,-77,-105,-77,38,-350
-61,-5,-38,-94,-51,-18,-63,20,-310
-70,-22,-60,-126,-98,-87,-111,-6,-580
-18,4,-27,-51,-16,-40,-42,-27,-217
7,8,-19,-54,-42,-61,-28,-40,-229
78,16,20,-18,-6,-43,-50,63,60
-18,-6,-19,-20,-17,-20,-37,-17,-154
-20,-6,-10,-38,-20,-21,-11,-13,-139
208,270,122,70,107,-87,15,153,858
-106,-69,-99,-206,-145,-76,-125,9,-817
47,23,-43,-112,-139,-145,-121,-89,-579
-24,19,-63,-141,-138,-117,-122,-48,-634
-85,60,-96,-281,-177,-199,-199,-69,-1046
8,25,4,-40,13,-36,-21,19,-28
24,7,-5,-46,-23,-59,-33,-32,-167
-67,24,-44,-174,-100,-93,-61,7,-508
-75,-12,-68,-152,-61,-35,-94,21,-476
25,165,-143,-432,-130,-234,-237,48,-938
-36,-33,-57,-87,-86,-69,-90,-2,-460
-43,-4,-64,-136,-78,-76,-105,-15,-521
65,67,-19,-111,-30,-133,-96,-33,-290
117,251,56,-257,47,-108,-48,62,120
-112,-25,-119,-207,-149,-73,-138,0,-823
-7,-12,-9,-23,-10,-13,-9,12,-71
-84,102,-168,-405,-233,-159,-226,147,-1026
-246,101,-380,-709,-379,-483,-549,-246,-2891
-3,42,-65,-117,-109,-108,-131,-33,-524
-2,3,-29,-77,-108,-39,-64,-11,-327
-49,-17,-53,-139,-85,-46,-92,4,-477
25,-14,-36,-95,-83,-111,-91,-50,-455
-19,-18,-75,-96,-86,-99,-119,-9,-521
12,-12,-28,-84,-98,-130,-65,-44,-449
-9,47,-82,-159,-162,-148,-175,-50,-738
-69,-45,-67,-120,-95,-58,-113,-23,-590
47,104,-107,-164,-35,-162,-161,-159,-637
-72,96,-104,-200,-119,-152,-205,-103,-859
95,82,13,-23,-47,-47,-68,17,22
29,86,-11,-103,-64,-90,-103,-61,-317
-13,16,-40,-94,-31,-63,-46,4,-267
-52,-10,-68,-109,-76,-78,-75,-56,-524
18,4,-21,-82,-86,-111,-94,-19,-391
-22,158,-25,-204,-143,-164,-102,6,-496
11,18,-46,-116,-50,-110,-79,-44,-416
41,141,48,-123,-55,-53,-93,152,58
272,178,-49,-210,-4,-286,-208,42,-265
-36,35,-29,-99,-66,-19,-37,0,-251
-54,-25,-16,-97,-112,-45,-74,36,-387
-61,98,-49,-121,14,-43,-57,-12,-231
17,31,-20,-68,-36,-40,-42,-40,-198
18,59,-23,-104,2,-55,-36,45,-94
-36,69,-68,-204,-104,-96,-72,42,-469
-95,85,-115,-244,-99,-86,-91,25,-620
-9,30,-27,-69,-55,-58,-74,27,-235
-4,16,-64,-132,-117,-123,-94,-76,-594
-112,-7,-133,-247,-150,-112,-135,-20,-916
-45,67,-22,-154,-14,-44,-72,-55,-339
-98,27,-51,-135,-53,-22,-50,-46,-428
-84,55,-63,-245,-121,-102,-130,-37,-727
-47,109,-66,-132,29,-27,-48,22,-160
-142,37,-131,-331,-617,-205,-300,-16,-1705
158,172,37,-206,0,-241,-169,-12,-261
-45,32,-30,-127,-113,-57,-78,14,-404
1,35,-24,-112,-70,-106,-69,-48,-393
36,43,-43,-91,-164,-164,-115,5,-493
-40,51,-106,-294,-172,-252,-212,-240,-1265
96,31,9,-130,39,-144,-81,33,-147
9,61,-25,-107,15,-79,-47,6,-167
128,73,46,9,-22,-64,-117,85,138
-81,77,-61,-165,-7,-72,-63,-56,-428
-89,52,-56,-151,-55,-20,-63,-57,-439
-47,29,-31,-94,-3,-33,-43,-11,-233
-66,26,-141,-300,-298,-233,-242,-54,-1308
24,58,34,-21,18,-8,4,34,143
91,146,64,-4,-4,-33,-30,106,336
-115,46,-74,-193,-46,-47,-90,-11,-530
-75,16,-93,-262,-118,-122,-168,-48,-870
5,113,-31,-273,-101,-212,-143,106,-536
21,10,-27,-115,-7,-71,-55,-61,-305
-48,24,-89,-250,-164,-200,-177,-29,-933
-61,17,-47,-135,-103,-109,-108,-35,-581
-1,36,-54,-212,-125,-222,-174,-55,-807
-51,82,-19,-110,4,-27,-43,14,-150
-34,25,-61,-166,-73,-71,-109,-48,-537
-93,-14,-91,-165,-112,-86,-129,-19,-709
-46,44,-31,-89,-35,-46,-45,-13,-261
-67,31,-45,-184,-80,-93,-86,-71,-595
4,23,-22,-39,-15,-19,-21,-16,-105
-140,79,-90,-237,18,-25,-95,-16,-506
101,139,37,-202,-16,-208,-165,160,-154
-50,-47,-58,-147,-130,-85,-129,26,-620
-1,21,3,-28,5,-19,-3,3,-19
-105,135,-39,-194,-12,-14,-104,-42,-375
-96,-36,-80,-157,-86,-73,-114,0,-642
37,52,33,-70,11,-51,-42,77,47
-89,-60,-103,-170,-183,-114,-170,-17,-906
-19,61,-32,-113,-79,-76,-72,15,-315
40,97,-15,-135,-75,-97,-72,-53,-310
-14,-18,-28,-84,-100,-75,-72,42,-349
-55,31,-28,-98,-40,-38,-20,-16,-264
-113,61,-61,-193,-32,-70,-80,-34,-522
41,28,-17,-91,-13,-86,-52,-10,-200
-33,36,-39,-112,-47,-66,-95,18,-338
34,96,-10,-61,-68,-130,-51,-48,-238
-57,-37,-47,-116,-90,-45,-76,3,-465
57,128,-284,-829,-474,-757,-680,-325,-3164
-4,22,-11,-63,-14,-48,-24,-8,-150
134,254,-97,-240,-168,-255,-142,76,-438
-16,9,-8,-49,-26,-22,-2,-6,-120
-54,10,-83,-146,-15,-41,-63,-60,-452
16,16,-14,-29,-31,-52,-35,-28,-157
13,20,-38,-109,-63,-95,-72,-34,-378
-42,7,-52,-98,-28,-52,-51,-16,-332
-18,203,-96,-215,-76,-106,-60,77,-291
-39,8,-75,-116,-74,-82,-98,-22,-498
12,98,-48,-163,-87,-120,-131,-96,-535
5,14,-9,-23,-14,-31,-22,-6,-86
-24,-22,-62,-64,-68,-31,-85,-4,-360
-94,154,-157,-418,-176,-212,-323,-133,-1359
-8,32,4,-50,-6,-44,-18,13,-77
43,16,11,6,3,-17,-31,-7,24
-25,9,-33,-66,-29,-38,-47,-12,-241
-41,-25,-42,-113,-51,-30,-65,-12,-379
-155,-43,-177,-309,-167,-170,-220,-80,-1321
89,17,8,4,-27,-77,-52,9,-29
-63,45,-141,-214,-128,-91,-184,6,-770
-35,273,-61,-521,-41,-243,-200,103,-725
-245,382,-219,-920,-249,-241,-348,-229,-2069
-7,-7,14,-70,-47,-60,-42,-16,-235
-18,6,-19,-79,-10,-47,-25,-17,-209
81,63,4,-58,12,-83,-24,9,4
3,-4,-5,-7,-7,-7,-4,5,-26
-26,-11,-64,-113,-93,-106,-103,-57,-573
61,70,-40,-81,5,-48,47,-116,-102
49,59,-28,-76,-77,-114,-46,-62,-295
-41,-7,-68,-114,-123,-61,-103,-52,-569
-20,0,-19,-47,-19,-12,-22,6,-133
80,60,30,-25,23,-80,-62,14,40
-437,-104,-439,-1002,-536,-456,-636,-272,-3882
-77,-23,-79,-160,-81,-71,-99,-50,-640
-166,43,-70,-196,-95,-25,-99,-73,-681
80,56,24,-18,5,-43,-11,5,98
-6,33,-40,-73,-5,-54,-39,-29,-213
24,39,-27,-50,-42,-59,-42,-40,-197
-1,25,-33,-81,-37,-83,-53,-65,-328
-24,7,-19,-57,-17,-27,-37,5,-169
-36,30,-82,-163,-115,-166,-138,-127,-797
18,16,-16,-56,22,-17,14,46,27
-136,11,-147,-331,-202,-140,-241,94,-1092
65,215,-212,-607,-509,-485,-561,-43,-2137
246,55,6,-210,15,-266,-202,-14,-370
-37,19,-53,-182,-130,-132,-109,-44,-668
-105,187,-128,-300,-12,-32,-82,-3,-475
30,29,-18,-58,-28,-81,-44,-21,-191
76,35,38,-55,8,-64,-17,1,22
35,19,-8,-46,-34,-81,-59,10,-164
-66,33,16,-72,-60,-85,-119,-11,-364
-29,31,-80,-169,-164,-187,-130,-55,-783
-184,25,-277,-472,-221,-277,-359,-90,-1855
-57,4,-55,-87,-66,-46,-99,-13,-419
-248,127,-303,-613,-134,-207,-225,-165,-1768
484,322,-19,-957,-93,-726,-581,179,-1391
47,182,-21,-209,-69,-175,-149,36,-358
28,3,0,-70,-36,-79,-51,13,-192
-9,-10,2,-23,-40,-19,-23,2,-120
217,107,42,-197,-104,-262,-154,-8,-359
33,59,7,-6,2,-21,-20,-8,46
-12,-26,11,-34,-1,4,-1,12,-47
14,-5,-11,-17,-48,-48,-33,-35,-183
36,9,14,-41,1,-42,-33,6,-50
14,24,12,-9,-52,-50,-21,-8,-90
10,23,-9,-69,7,-66,-57,-6,-167
8,22,-31,-155,-101,-161,-87,-55,-560
105,177,-27,-353,-105,-311,-334,47,-801
-26,52,-52,-91,-20,-35,-38,-9,-219
-346,53,-459,-889,-468,-473,-576,-46,-3204
57,44,31,-37,18,-36,-24,28,81
-1,28,-12,-50,-6,-36,-24,0,-101
12,21,8,-32,0,-24,-14,17,-12
3,17,-12,-26,-20,-14,-26,-5,-83
38,34,-66,-171,-80,-184,-132,-99,-660
-203,162,-471,-1006,-590,-741,-770,-273,-3892
27,19,-12,-42,-86,-77,-66,-48,-285
-33,25,-52,-119,-105,-57,-86,-16,-443
-16,5,-5,-52,-32,-33,-27,10,-150
80,50,32,-35,-20,-82,-37,0,-12
-26,2,-30,-94,-52,-89,-78,-51,-418
9,12,13,-43,0,-37,-15,-11,-72
5,11,-7,-23,-27,-34,-18,-35,-128
-2,97,-43,-150,-40,-117,-94,39,-310
-50,22,-45,-142,-77,-59,-51,-20,-422
1,-2,-12,-99,-43,-100,-48,-14,-317
11,54,-11,-93,-49,-95,-42,-25,-250
-10,15,-39,-152,-176,-150,-140,-69,-721
34,20,9,-9,-7,-36,-5,-19,-13
6,39,-27,-94,-98,-117,-73,11,-353
12,10,9,-35,4,-25,-23,7,-41
-81,-3,-101,-173,-153,-137,-186,-22,-856
43,52,20,-47,29,-42,-14,-2,39
22,22,-11,-55,-37,-70,-28,-3,-160
-26,8,-54,-80,-24,-39,-57,-18,-290
76,60,1,-48,11,-46,-22,62,94
-27,3,-45,-122,-40,-48,-39,-15,-333
-64,25,-104,-233,-138,-141,-166,53,-768
-5,4,2,-6,2,1,-7,-2,-11
13,11,6,-21,-3,-23,-37,-6,-60
-16,-15,-17,-55,-15,-28,-25,-15,-186
18,24,-3,-32,-11,-48,-32,-19,-103
143,84,26,-89,-20,-154,-109,-1,-120
109,243,-36,-374,-50,-244,-195,-29,-576
53,171,-54,-199,-37,-166,-141,28,-345
-99,9,-150,-328,-241,-224,-256,-26,-1315
-100,94,-235,-474,-315,-299,-375,-78,-1782
-22,-5,-79,-116,-148,-121,-142,-37,-670
9,19,-10,-78,-89,-109,-35,-19,-312
51,29,-58,-147,-134,-173,-160,-86,-678
-32,2,-19,-61,-26,-24,-17,-3,-180
10,-1,-21,-62,-95,-67,-68,1,-303
-104,40,-85,-296,-87,-132,-135,52,-747
100,87,-15,-62,-80,-151,-132,-17,-270
-36,31,-19,-46,-13,-19,-23,7,-118
58,27,8,-49,16,-44,-27,-17,-28
21,4,-2,-21,-11,-36,-16,3,-58
17,-5,-1,-57,-22,-62,-40,3,-167
-13,47,-69,-160,-95,-126,-113,-78,-607
8,25,-17,-155,-68,-109,-76,6,-386
-43,-2,-38,-111,-56,-28,-50,-11,-339
-2,36,-97,-250,-106,-96,-73,84,-504
-460,-51,-457,-1080,-488,-298,-472,149,-3157
11,32,9,-28,5,-17,-22,-4,-14
-21,-14,-11,-79,-73,-42,-63,-32,-335
109,58,44,-73,23,-50,-42,54,123
29,4,-9,-54,-85,-96,-53,-63,-327
2,19,-5,-39,-36,-30,-11,-5,-105
-2,32,9,-77,-27,-54,-54,-8,-181
-41,34,-35,-103,-56,3,-48,-5,-251
181,235,36,-224,-15,-167,29,-46,29
1,35,-45,-105,-69,-95,-108,-13,-399
2,115,-1,-157,11,-82,-32,36,-108
-151,73,-178,-625,-176,-268,-301,41,-1585
120,225,-26,-352,29,-201,-135,106,-234
52,59,7,-88,-14,-114,-65,68,-95
-15,117,-79,-407,-63,-258,-220,-47,-972
-83,208,-67,-346,-97,-156,-176,-161,-878
-121,15,-198,-424,-305,-362,-355,-207,-1957
-19,130,-62,-326,-9,-184,-185,42,-613
180,206,29,-309,55,-260,-192,-4,-295
37,27,19,-60,-8,-68,-34,13,-74
-39,8,-66,-189,-83,-99,-87,-58,-613
-7,23,-34,-82,-34,-38,-51,6,-217
-4,6,-30,-46,-31,-52,-41,-30,-228
-30,35,-37,-213,-103,-120,-99,69,-498
-50,27,-84,-146,-91,-81,-100,-44,-569
-9,39,-20,-107,-30,-71,-37,-12,-247
84,11,-19,-152,-150,-218,-108,30,-522
-34,42,-22,-119,-25,-44,-46,-31,-279
8,58,-32,-134,-36,-96,-69,-64,-365
-19,75,4,-49,-4,-31,24,32,32
-33,23,-58,-189,-84,-95,-91,12,-515
1,-17,-13,-24,-23,-29,-26,0,-131
108,123,57,-74,-40,-109,-16,-5,44
-137,29,-163,-386,-232,-201,-267,-95,-1452
16,33,-7,-46,-41,-65,-20,-34,-164
-38,-7,-8,-60,-58,-31,-49,16,-235
-20,91,-82,-359,-185,-247,-193,-105,-1100
-30,-14,-45,-28,-75,-40,-87,-19,-338
-67,50,-90,-320,-332,-313,-288,-40,-1400
-47,43,-88,-169,-69,-103,-125,-26,-584
9,15,-14,-35,-27,-37,-23,-12,-124
-13,-6,-11,-50,-23,-42,-35,6,-174
-33,27,-30,-115,-18,-45,-28,-47,-289
5,5,-75,-72,-137,-111,-93,-59,-537
-13,198,-156,-330,-75,-183,-144,88,-615
15,36,-1,-45,-9,-64,-20,-5,-93
-1,21,-5,-29,-19,-34,-9,2,-74
1,34,-43,-132,-73,-114,-65,-40,-432
174,127,98,-135,45,-150,-97,22,84
26,99,-22,-210,-110,-132,-64,60,-353
-59,179,-171,-461,-166,-278,-240,-88,-1284
-30,9,-36,-71,-29,-12,-54,-16,-239
117,171,41,-129,-35,-141,-70,69,23
-4,3,-11,-42,-41,-42,-26,-18,-181
137,79,-31,-220,-211,-305,-175,-148,-874
-34,-11,-68,-80,-60,-49,-80,-21,-403
-10,42,-33,-106,-74,-94,-65,-29,-369
202,189,-25,-394,-209,-379,-287,171,-732
-19,-9,-24,-46,-36,-41,-30,-13,-218
54,49,-37,-105,-67,-121,-70,5,-292
-6,12,-9,-35,-32,-31,-11,-3,-115
57,23,-2,-57,-69,-101,-101,-14,-264
0,16,-5,-41,-42,-58,-27,-3,-160
-17,-19,-5,-29,-25,-35,-18,-22,-170
61,33,-2,-137,-48,-120,-97,-41,-351
20,137,-25,-159,17,-89,-61,82,-78
-3,23,-16,-32,1,-26,-39,4,-88
-19,12,-10,-81,-68,-81,-66,16,-297
30,-3,-10,-85,-25,-74,-37,-9,-213
-52,-42,-83,-140,-119,-117,-131,-35,-719
26,31,-70,-129,-127,-159,-114,-142,-684
-175,-25,-204,-342,-191,-163,-218,-14,-1332
45,41,-3,-63,-31,-56,-10,-9,-86
117,33,-12,-159,-69,-171,-112,-24,-397
62,129,-20,-218,7,-131,-76,2,-245
-20,39,-91,-369,-66,-174,-119,48,-752
-85,75,-124,-232,-141,-105,-143,7,-748
57,99,-38,-118,-105,-161,-83,-46,-395
42,51,2,-68,-50,-73,-41,19,-118
26,48,17,-38,-39,-70,-27,-9,-92
-38,41,-85,-192,-119,-130,-122,1,-644
-127,31,-197,-366,-202,-232,-251,-64,-1408
-31,0,-43,-85,-65,-38,-58,-30,-350
-13,76,-52,-152,-100,-66,-89,-12,-408
69,234,-81,-238,6,-158,-301,-50,-519
-13,-5,-18,-42,-9,-39,-44,20,-150
-62,4,-41,-128,-131,-47,-72,39,-438
-46,-25,-66,-157,-99,-87,-104,-56,-640
-86,-35,-109,-174,-151,-116,-143,-3,-817
-132,-42,-189,-330,-171,-152,-217,-116,-1349
-7,-8,-13,-9,-13,-7,-20,-5,-82
56,163,19,115,22,69,-75,3,372
17,113,1,68,7,50,-54,4,206
293,224,54,-333,-93,-335,-206,-25,-421
-411,125,-502,-1108,-783,-467,-613,-18,-3777
-22,-1,-38,-198,-177,-96,-125,-13,-670
-79,46,-75,-229,-132,-163,-129,-55,-816
-351,64,-537,-1025,-521,-713,-820,-131,-4034
-46,20,-35,-146,-43,-89,-112,2,-449
149,248,7,-304,-57,-330,-176,162,-301
222,44,9,-313,55,-260,-174,160,-257
-54,149,-64,-246,-45,-144,-123,53,-474
-23,54,-48,-178,-57,-117,-104,26,-447
86,316,-5,-402,-3,-346,-204,203,-355
-65,99,-103,-209,-104,-117,-89,10,-578
-56,-17,-50,-101,-84,-66,-76,-16,-466
133,167,13,-245,-55,-292,-140,30,-389
3,-7,-31,-49,-110,-75,-70,-26,-365
-12,7,-29,-30,-31,-20,-42,-9,-166
-25,-31,-8,-51,-51,-28,-33,17,-210
-52,40,-139,-355,-218,-274,-276,-146,-1420
30,52,-42,-186,-115,-139,-123,49,-474
0,109,-35,-180,-2,-99,-114,41,-280
-48,53,-34,-103,-49,-59,-80,-23,-343
-13,34,-28,-64,-14,-46,-35,-8,-174
-27,29,-16,-124,-63,-83,-73,-28,-385
-159,87,-166,-435,-319,-255,-267,-36,-1550
-51,6,-34,-127,-84,-91,-127,-7,-515
-10,61,-28,-50,-27,-5,-9,-18,-86
194,217,24,-262,57,-231,-88,124,35
-5,-2,-8,-24,-15,-9,-11,46,-28
44,21,1,-12,-32,-63,-11,9,-43
-33,5,-13,-96,-55,-32,-36,1,-259
-21,30,-29,-76,-42,-21,-31,-35,-225
-5,-8,1,-37,-48,-26,-22,-1,-146
-27,72,-26,-115,-44,-54,-31,31,-194
145,188,-67,-419,-90,-345,-301,161,-728
40,9,26,4,6,-38,-21,9,35
66,83,23,-74,-90,-130,-98,54,-166
23,59,-12,-123,-42,-85,-21,105,-96
-18,-5,-13,-31,-23,-14,-28,-14,-146
17,45,-18,-78,-50,-65,-74,20,-203
17,37,9,-53,4,-39,-45,5,-65
-32,-30,-67,-76,-90,-76,-116,-50,-537
-78,-17,-109,-200,-163,-124,-148,-32,-871
158,49,29,-120,73,-102,-148,21,-40
-17,-22,-29,-71,-109,-56,-75,-5,-384
8,23,-8,-29,-47,-29,-17,-18,-117
-18,13,-11,-40,-7,0,-9,4,-68
16,2,-11,-37,5,-21,-30,-2,-78
15,22,-16,-12,-13,9,1,6,12
20,12,-9,-43,-9,-33,-17,-18,-97
47,-49,5,-88,21,-93,-68,57,-168
102,498,50,-38,-56,136,-315,113,490
-23,-6,-16,-28,-22,-21,-24,5,-135
-136,-35,-157,-329,-205,-217,-216,-91,-1386
-193,-32,-223,-381,-201,-190,-275,-50,-1545
-128,-76,-147,-293,-207,-124,-227,11,-1191
160,79,0,-146,-52,-152,-164,16,-259
40,45,25,-38,-67,-82,-6,10,-73
-9,10,-26,-52,-5,-25,-19,-14,-140
123,107,-4,-126,-67,-175,-165,13,-294
-86,43,-106,-252,-93,-168,-169,-35,-866
-59,9,-100,-135,-101,-49,-108,-36,-579
9,238,-30,-177,-76,-76,66,70,24
27,120,-31,-191,-93,-171,-72,-30,-441
-3,187,-104,-352,-117,-256,-174,79,-740
72,85,-37,-192,-23,-144,-157,-7,-403
126,15,13,-203,-145,-248,-125,34,-533
-93,33,-67,-176,-33,-59,-62,-13,-470
183,301,-7,-286,49,-185,-87,153,121
106,152,34,-190,-242,-262,-236,-34,-672
-6,79,-16,-244,-108,-131,-63,33,-456
8,63,-69,-276,-148,-219,-199,-63,-903
131,173,8,-180,-2,-178,-105,28,-125
68,153,-76,-313,-165,-278,-202,135,-678
171,109,-98,-359,-185,-361,-290,-82,-1095
-68,6,-62,-181,-117,-92,-92,-6,-612
-12,34,-100,-269,-293,-172,-137,80,-869
-20,-3,-86,-217,-280,-156,-140,-51,-953
27,99,8,-163,-27,-141,-85,69,-213
-24,-7,-74,-162,-103,-118,-120,-58,-666
-23,117,-31,-255,-200,-110,-49,50,-501
-17,52,-70,-111,-54,-73,-102,-86,-461
-14,1,-53,-128,-190,-119,-155,20,-638
40,15,-14,-44,-27,-79,-67,-18,-194
-6,24,-19,-45,-38,-5,-25,3,-111
68,-11,29,-109,17,-108,-90,15,-189
56,50,-65,-277,-121,-248,-168,-151,-924
-19,74,-81,-214,-69,-60,-43,65,-347
-44,3,-47,-121,-44,-43,-62,-41,-399
10,22,-14,-82,-21,-56,-34,-9,-184
-56,-11,-74,-116,-180,-86,-173,18,-678
-16,12,-46,-96,-84,-31,-92,-56,-409
-77,-20,-60,-125,-44,-49,-33,-25,-433
-70,27,-72,-172,-69,-51,-59,-37,-503
54,39,-69,-126,-125,-178,-148,-91,-644
-150,-25,-180,-316,-131,-118,-162,-77,-1159
-52,-16,-70,-140,-70,-65,-92,-9,-514
17,29,18,-9,-110,-31,-52,-20,-158
-6,47,-69,-100,-63,-53,-52,-42,-338
-63,95,-111,-400,-227,-271,-181,-103,-1261
-49,-2,-59,-94,-78,-71,-99,-27,-479
98,78,62,-96,5,-115,-43,27,16
49,68,-8,-107,-57,-125,-123,-56,-359
-88,50,-58,-131,-10,-52,-63,-6,-358
-35,50,-22,-82,-10,-19,-26,-19,-163
93,30,-23,-61,-177,-121,-90,-15,-364
-14,21,-14,-56,-44,-46,-71,-6,-230
9,39,7,-47,-55,-84,-24,-9,-164
-28,14,-52,-114,-97,-98,-75,-63,-513
52,-4,2,-59,-19,-60,-62,15,-135
33,84,-63,-156,-99,-165,-107,-57,-530
-2,106,8,-113,-72,-115,-4,36,-156
-23,38,-25,-113,-57,-69,-46,-19,-314
14,34,-27,-40,-22,-25,-47,2,-111
30,21,-28,-61,-40,-81,-77,1,-235
-54,-27,-47,-95,-84,-52,-72,9,-422
-152,-39,-150,-389,-248,-212,-278,-82,-1550
-20,135,-41,-244,-74,-116,-86,-7,-453
53,54,-1,-98,-43,-130,-86,-45,-296
-33,-12,-55,-104,-119,-85,-93,-19,-520
84,69,34,-113,8,-114,-74,43,-63
-42,-32,-50,-111,-76,-98,-101,-18,-528
3,26,-32,-69,-44,-79,-70,1,-264
-37,1,-57,-121,-72,-74,-68,-11,-439
-35,-13,-35,-70,-90,-57,-86,-17,-403
-63,-31,-68,-167,-129,-74,-78,-19,-629
-32,-11,-33,-92,-136,-89,-90,-47,-530
-63,-56,-70,-179,-139,-103,-102,26,-686
-44,-7,-25,-117,-86,-83,-84,-21,-467
-86,13,-139,-206,-80,-85,-85,-17,-685
-81,-13,-100,-204,-174,-135,-132,-78,-917
15,13,-16,-40,-37,-32,-12,-23,-132
-84,18,-102,-216,-123,-107,-101,-18,-733
-44,116,-25,-228,-120,-119,-178,-28,-626
-4,90,-30,-135,0,-53,-47,28,-151
-8,23,-1,-83,-54,-77,-33,-24,-257
-18,54,-50,-108,-53,-91,-68,-48,-382
29,46,18,-77,-66,-101,-71,-33,-255
-66,31,-122,-255,-103,-171,-159,-66,-911
-25,6,-31,-75,-60,-58,-54,-11,-308
-36,-14,-43,-71,-77,-57,-64,-16,-378
-60,50,-24,-121,-44,-47,-37,22,-261
-75,45,-115,-210,-87,-106,-118,-46,-712
14,52,-30,-140,-69,-107,-80,-39,-399
-21,-9,-32,-44,-31,-7,-40,0,-184
151,252,-56,-315,-187,-281,-186,38,-584
-58,-34,-117,-194,-177,-113,-189,25,-857
4,26,17,0,-35,-18,-36,-2,-44
13,24,-19,-61,-49,-68,-50,-2,-212
-58,30,-59,-209,-64,-140,-126,7,-619
55,31,-11,-105,-12,-32,-54,20,-108
78,81,24,9,-54,-73,-48,-18,-1
-61,-24,-86,-137,-76,-102,-119,-28,-633
-35,-40,-45,-76,-90,-36,-40,-17,-379
-36,-25,-36,-71,-75,-38,-65,3,-343
-23,0,-62,-127,-111,-106,-105,-56,-590
29,54,-3,-104,9,-95,-35,30,-115
-63,3,-132,-187,-156,-168,-166,-36,-905
-13,21,-42,-125,-65,-101,-78,9,-394
-44,22,-88,-115,-138,-91,-109,-37,-600
79,243,-70,-474,-168,-330,-168,-31,-919
-140,37,-215,-343,-177,-164,-228,-170,-1400
43,84,-107,-265,-271,-322,-254,-214,-1306
-97,-16,-128,-161,-89,-67,-150,-63,-771
30,14,12,-41,-5,-48,-16,-9,-63
68,43,14,-23,-24,-77,-57,-10,-66
-61,-13,-136,-194,-213,-162,-187,-103,-1069
-53,-43,-117,-183,-162,-159,-217,-29,-963
22,63,5,-52,-102,-95,-116,-49,-324
-90,22,-163,-270,-103,-149,-192,-43,-988
4,17,1,-20,-13,-2,12,7,6
1,1,2,-9,-15,4,24,15,23
-1,18,-1,-12,-1,-1,7,11,20
-1,18,1,-18,-26,-8,15,7,-12
-22,2,-70,-159,-153,-149,-166,-28,-745
28,31,1,-20,-33,-49,-30,-16,-88
22,28,16,-56,-46,-88,-39,-20,-183
5,47,-4,-68,-29,-81,-71,-30,-231
70,22,9,-12,-45,-96,-42,-13,-107
91,4,29,-16,23,-41,-33,15,72
29,15,8,-35,-30,-63,-24,3,-97
19,159,-299,-690,-171,-498,-477,-360,-2317
-18,10,-11,-11,-27,0,-6,-5,-68
-21,8,-35,-67,-43,-29,-36,-31,-254
28,22,-9,-63,-67,-76,-38,-24,-227
-1,-1,-29,-70,-60,-53,-34,4,-244
-69,23,-203,-335,-257,-282,-303,-131,-1557
-7,52,-129,-219,-184,-242,-202,-110,-1041
-70,30,-147,-244,-216,-202,-234,-69,-1152
-57,-6,-83,-167,-141,-82,-112,-9,-657
-53,-22,-102,-139,-150,-100,-163,-20,-749
-17,30,-87,-161,-137,-129,-154,-78,-733
-69,2,-115,-152,-135,-79,-162,-50,-760
-9,-11,-22,-49,-47,-24,-36,-6,-204
-30,0,-30,-80,-90,-23,-51,-2,-306
-75,98,-78,-278,-200,-141,-134,54,-754
-102,49,-95,-217,-130,-98,-169,82,-680
6,7,-7,-76,-48,-65,-71,12,-242
-49,62,-54,-162,-82,-81,-105,-7,-478
-17,36,-51,-95,-102,-112,-94,-42,-477
-14,102,-24,-192,-86,-98,-82,115,-279
-50,20,-23,-95,-58,-47,-22,-4,-279
-5,9,-26,-30,-10,-11,-19,-9,-101
-8,12,5,-48,-32,-42,-35,2,-146
-110,-18,-134,-229,-145,-104,-176,-10,-926
-79,-28,-132,-246,-275,-181,-266,-35,-1242
291,214,42,-71,12,-143,-36,49,358
-94,9,-146,-250,-67,-129,-133,-46,-856
9,3,-2,-32,-20,-27,-21,-7,-97
-21,32,-71,-167,-143,-116,-107,-7,-600
20,80,4,-58,7,-54,-20,30,9
10,76,-64,-227,-114,-134,-105,97,-461
-177,-58,-212,-345,-266,-151,-240,-23,-1472
-26,6,-24,-86,-47,-51,-53,-10,-291
-32,14,-25,-64,-54,-43,-57,-25,-286
22,28,6,-8,-3,-3,12,16,70
-1,66,-96,-345,-222,-269,-180,59,-988
-254,74,-351,-675,-330,-325,-477,-133,-2471
61,275,-33,-557,-126,-417,-241,60,-978
-36,49,-71,-272,-196,-145,-143,-53,-867
-18,60,-57,-105,-90,-67,-119,49,-347
20,63,1,-59,3,-53,-41,38,-28
-237,225,-249,-765,-263,-327,-280,73,-1823
-101,82,-54,-176,-50,-81,-82,46,-416
22,97,-11,-124,-61,-89,-71,101,-136
-148,-61,-186,-256,-181,-129,-221,-52,-1234
-157,-61,-136,-327,-259,-183,-224,-28,-1375
-50,34,-36,-134,-69,-89,-71,-44,-459
-8,-3,-15,-11,-9,-3,-16,-15,-80
-5,13,-24,-76,-61,-5,-46,51,-153
50,177,-23,-294,-102,-320,-170,10,-672
30,91,12,-101,-15,-26,-68,24,-53
-27,-29,-115,-261,-180,-170,-191,-35,-1008
-15,36,-13,-62,-65,-47,-13,38,-141
10,15,-41,-147,-124,-116,-116,-37,-556
-66,-12,-59,-155,-61,-67,-107,79,-448
-94,161,-79,-269,-55,-104,-129,-97,-666
-25,57,-108,-226,-99,-151,-163,-45,-760
-133,-5,-206,-325,-203,-129,-235,-14,-1250
25,149,4,-150,-53,-149,-57,58,-173
8,25,-37,-128,-53,-157,-106,-59,-507
21,35,5,-81,-64,-74,-69,15,-212
-68,122,-52,-129,33,-44,-31,41,-128
-104,-17,-138,-291,-214,-200,-236,-105,-1305
17,220,-151,-399,-197,-226,-232,2,-966
22,79,-61,-332,-101,-166,-181,121,-619
27,66,-38,-87,-53,-80,-54,33,-186
-90,-13,-120,-172,-155,-77,-163,0,-790
-64,23,-143,-285,-264,-220,-235,-41,-1229
1,54,-4,-21,-2,17,-37,-2,6
-69,-3,-57,-142,-100,-90,-128,-43,-632
-34,273,-185,-359,-170,-137,-158,125,-645
-158,58,-262,-584,-348,-338,-409,-137,-2178
-202,4,-199,-446,-253,-231,-290,-88,-1705
-109,43,-71,-168,-71,-63,-68,-49,-556
23,63,-3,-45,-75,-95,-85,-76,-293
29,69,7,-51,-59,-71,-84,-59,-219
0,58,-16,-85,-76,-83,-86,-26,-314
18,59,1,-49,-42,-57,-98,-43,-211
-26,5,-8,-86,-54,-64,-51,-16,-300
-103,5,-71,-269,-200,-174,-128,-8,-948
-95,1,-82,-265,-174,-159,-141,22,-893
-131,152,-188,-563,-229,-375,-259,112,-1481
-149,-25,-179,-333,-190,-133,-237,-4,-1250
-97,53,-129,-287,-181,-215,-244,-95,-1195
-42,41,-137,-288,-148,-196,-224,-90,-1084
76,256,-64,-482,-352,-363,-326,-361,-1616
110,489,69,-619,-228,27,-525,726,49
132,505,-8,-657,-274,-211,-529,519,-523
41,69,-45,-231,-252,-202,-236,-47,-903
-9,12,-59,-95,-70,-95,-83,-45,-444
61,181,6,-77,62,-26,-18,102,291
-72,-19,-93,-160,-77,-52,-110,-11,-594
-49,-6,-55,-90,-69,-53,-74,-46,-442
2,21,-3,-39,-9,-9,9,18,-10
9,-50,-32,-41,-62,-43,-106,58,-267
118,67,7,-95,4,-110,-80,63,-26
-86,111,-261,-648,-512,-482,-595,-54,-2527
-257,2,-302,-659,-336,-372,-469,-60,-2453
-3,2,-13,-25,-79,-58,-49,-35,-260
-80,2,-79,-218,-113,-107,-104,-27,-726
42,222,-72,-414,-266,-377,-304,15,-1154
14,54,-27,-84,-57,-75,-61,-27,-263
-101,54,-196,-433,-224,-196,-173,-87,-1356
-94,50,-184,-375,-243,-269,-286,-161,-1562
-13,15,-5,-31,-11,-14,-24,-5,-88
83,76,-4,-137,-59,-173,-143,-10,-367
-4,-15,0,-9,-20,-11,-9,1,-67
-51,6,-61,-140,-59,-62,-57,-22,-446
-12,4,-18,-45,-50,-32,-42,-4,-199
22,16,-12,-55,-3,-38,-32,-8,-110
-77,91,-112,-296,-76,-140,-124,-31,-765
-31,-11,-73,-167,-83,-81,-79,-26,-551
22,30,-5,-51,1,-47,-32,-43,-125
-30,19,-54,-75,-47,-40,-42,-32,-301
-38,-44,-37,-75,-59,-48,-56,-24,-381
-10,48,-17,-206,-118,-137,-145,-59,-644
-1,-3,-9,-33,-26,-26,-18,-2,-118
-84,-50,-195,-302,-334,-246,-337,-251,-1799
-49,6,-79,-129,-31,-42,-46,-39,-409
15,37,-19,-82,-23,-27,-27,-7,-133
-143,95,-184,-476,-285,-188,-257,-29,-1467
6,-1,-62,-125,-157,-146,-125,-59,-669
81,46,14,-56,-139,-182,-97,-36,-369
-25,52,-98,-182,-158,-126,-163,-73,-773
9,11,-17,-16,-44,-32,-34,10,-113
-78,167,-70,-395,-306,-194,-213,62,-1027
11,7,-20,-60,-22,-54,-35,-13,-186
-72,-23,-62,-141,-80,-78,-65,-4,-525
-52,16,-29,-230,-137,-135,-131,-47,-745
-24,25,-19,-60,-3,-27,1,-16,-123
7,101,-42,-212,3,-125,-55,7,-316
99,149,33,-80,-22,-85,8,54,156
2,4,-9,-66,-89,-52,-57,-15,-282
-17,-2,-11,-8,-47,-27,-29,-12,-153
48,49,35,46,23,18,-18,31,232
-14,-13,-19,-37,-35,-25,-35,-6,-184
-72,-26,-61,-239,-189,-118,-122,94,-733
-75,21,-37,-123,-104,-76,-83,-33,-510
-55,143,-97,-289,-62,-145,-99,14,-590
26,30,-5,-104,-8,-69,-65,-27,-222
27,189,6,-403,-164,-109,-146,254,-346
292,203,75,-252,-22,-322,-164,74,-116
-2,36,-3,-64,-53,-18,-40,19,-125
-8,8,-14,-46,-58,-50,-29,-6,-203
-15,13,-16,-40,-29,-41,-18,-15,-161
-29,1,-12,-38,-26,-16,-26,-9,-155
17,42,-6,-54,-39,-58,-48,-15,-161
-22,21,-20,-45,-5,-10,2,-13,-92
-14,1,-17,-47,-27,-18,-18,-12,-152
56,129,12,-175,-41,-141,-131,-15,-306
-93,-30,-104,-164,-85,-52,-126,-12,-666
-75,-1,-68,-132,-76,-79,-114,-7,-552
12,21,1,-89,-87,-101,-66,-21,-330
378,383,53,-256,99,-339,-189,62,191
-188,-59,-264,-452,-380,-269,-319,-81,-2012
-41,195,-96,-277,-124,-131,-144,49,-569
33,38,14,-1,-19,-18,-31,-10,6
-2,115,-15,-146,-131,-106,-39,65,-259
84,54,14,10,-14,-1,-48,28,127
-34,5,-5,-71,-36,-42,-20,13,-190
-19,61,-89,-245,-41,-132,-66,-77,-608
171,62,17,-49,-38,-121,-55,-27,-40
-89,-6,-131,-330,-205,-235,-233,52,-1177
-28,-22,-58,-97,-83,-74,-65,-41,-468
30,93,-93,-494,-449,-422,-292,234,-1393
-51,-3,-54,-113,-88,-25,-71,-22,-427
2048,4477,1875,-27,-1070,708,-1343,2008,8676
76,10,28,-81,-22,-74,-71,78,-56
-65,54,-86,-250,-178,-167,-158,-49,-899
96,5,-4,-103,4,-101,-91,-4,-198
-49,-16,-77,-99,-134,-67,-116,-15,-573
-18,74,-41,-85,-27,-42,-38,-9,-186
58,49,13,-59,47,-56,-16,38,74
-28,1,-33,-101,-42,-62,-47,-44,-356
14,7,-33,-99,-98,-117,-74,-25,-425
-16,19,-26,-85,-53,-34,-32,23,-204
-37,-23,-46,-156,-168,-153,-125,-60,-768
-116,-75,-92,-156,-129,-55,-155,-13,-791
-12,-16,-23,-92,-90,-92,-68,-69,-462
-32,13,-46,-75,-93,-67,-55,-28,-383
-23,42,-36,-187,-96,-140,-76,-11,-527
3,6,-24,-89,-29,-60,-44,-9,-246
-45,3,-98,-220,-162,-162,-159,-91,-934
-26,6,5,-62,-76,-65,-46,40,-224
-31,36,-14,-79,-81,-66,-31,31,-235
-35,26,-44,-93,-48,-50,-50,-4,-298
-25,57,-24,-131,-72,-33,-70,-34,-332
-72,43,-73,-300,-116,-183,-185,17,-869
27,329,12,-363,71,-134,40,231,213
2,33,-55,-84,-80,-92,-87,-48,-411
4,178,-97,-289,-127,-200,-157,14,-674
5,34,-14,-61,-16,-59,-50,4,-157
170,206,-7,-163,-111,-199,-52,53,-103
34,47,8,-28,-2,-24,-17,17,35
121,102,4,-162,-98,-140,-103,22,-254
52,12,10,-64,-53,-103,-55,-16,-217
-26,4,-31,-169,-125,-135,-113,-62,-657
-66,12,-71,-193,-114,-93,-108,-15,-648
-37,41,-57,-154,-44,-64,-62,2,-375
33,47,-18,-131,-52,-111,-61,-18,-311
-35,66,-44,-127,10,-33,-37,28,-172
-52,-7,-57,-162,-85,-107,-82,-40,-592
7,10,-18,-29,-19,-19,-16,-9,-93
14,25,-2,-40,-45,-35,-21,-10,-114
78,42,4,-35,11,-49,-29,37,59
49,85,30,-95,-187,-129,-146,118,-275
13,-7,10,-28,-50,-40,-61,19,-144
-51,38,-61,-205,-118,-160,-146,-36,-739
-30,6,-48,-95,-32,-44,-55,8,-290
-39,36,-47,-112,-59,-61,-51,-13,-346
225,153,15,-124,-32,-181,-99,-7,-50
22,78,-29,-112,-72,-97,-109,-49,-368
4,-1,5,-11,-30,-18,-20,5,-66
-24,27,-52,-79,-33,-43,-48,-18,-270
15,40,-20,4,-1,-3,-7,51,79
-11,12,-41,-140,-74,-107,-59,-41,-461
17,537,-390,-1175,-713,-965,-820,-73,-3582
10,23,-33,-31,-23,-35,-24,-42,-155
92,100,-42,-239,-153,-273,-166,-134,-815
102,66,49,-12,33,-9,-28,110,311
-223,10,-286,-546,-379,-328,-443,-216,-2411
-53,-29,-81,-117,-74,-32,-110,-12,-508
74,151,91,-5,25,-12,-89,44,279
-92,360,-212,-694,-97,-215,-463,-319,-1732
49,11,-18,-72,-154,-137,-71,-71,-463
-34,35,-55,-190,-64,-126,-96,-22,-552
-83,241,-37,-387,-68,-64,-151,-39,-588
-126,-27,-152,-242,-178,-123,-205,-66,-1119
-13,10,-8,-24,-17,-12,-15,-4,-83
-27,7,-30,-36,-14,2,-21,-9,-128
13,15,-50,-62,-50,-64,-72,-1,-271
21,13,0,-77,-45,-48,-46,20,-162
-32,18,-37,-92,-68,-23,-59,26,-267
46,42,-28,-53,-23,-31,-57,7,-97
154,69,57,-30,-1,-56,-63,49,179
-9,6,-7,-49,-42,-52,-27,-5,-185
39,94,-29,-331,19,-31,-77,192,-124
-16,22,-8,-120,-16,-53,-17,24,-184
4,14,8,-17,-16,-1,-10,7,-11
-377,187,-533,-1298,-647,-566,-722,97,-3859
-12,34,-44,-117,-47,-62,-70,-28,-346
-13,2,-19,-65,-47,-31,-41,-16,-230
-28,-8,-28,-120,-41,-58,-62,-31,-376
-13,4,-2,-72,-51,-62,-31,3,-224
-24,-7,-49,-80,-71,-42,-88,-18,-379
7,11,1,-8,-1,-4,3,6,15
-19,5,-8,-25,-16,-4,-12,-18,-97
64,67,23,-74,-56,-124,-69,-18,-187
37,23,10,-38,-32,-42,-34,7,-69
-112,-14,-103,-283,-182,-168,-143,-48,-1053
-122,28,-142,-299,-130,-166,-162,-78,-1071
85,88,44,-60,-56,-104,-33,9,-27
-16,147,-24,-135,26,-80,-58,38,-102
222,381,49,-176,-190,-441,-585,-74,-814
35,-10,-83,-264,-287,-292,-244,-128,-1273
29,-4,-38,-101,-60,-131,-90,-61,-456
-63,47,-70,-254,-140,-120,-107,-14,-721
-9,24,-53,-92,-70,-89,-97,-19,-405
3,27,-10,-43,-40,-8,-37,21,-87
-22,39,-16,-66,-5,-7,2,18,-57
-39,16,-31,-75,-30,-27,-32,-7,-225
-46,-17,-35,-145,-88,-36,-90,3,-454
-7,-5,-30,-77,-68,-80,-54,-60,-381
111,-104,22,13,-12,77,-42,166,231
-29,8,-16,-73,-17,-47,-21,-16,-211
-5,13,-15,-14,-16,-2,-14,-15,-68
-13,73,-34,-183,-133,-121,-137,-48,-596
2,17,2,-33,-58,-36,-54,-16,-176
70,55,15,-20,-40,-93,-29,-9,-51
-21,-2,-23,-50,-16,-26,-32,-14,-184
8,5,-11,-38,-36,-57,-29,-23,-181
-50,33,-58,-173,-103,-93,-109,4,-549
-45,2,-57,-182,-257,-95,-161,107,-688
-22,-43,-30,-78,-94,-84,-78,-22,-451
-37,-1,-94,-130,-67,-88,-96,-51,-564
-42,12,-90,-143,-97,-114,-122,-84,-680
-42,111,-71,-218,-120,-170,-160,41,-629
-28,187,-56,-348,-89,-245,-202,35,-746
-89,9,-136,-162,-94,-57,-142,1,-670
-125,55,-213,-380,-211,-158,-238,86,-1184
8,-23,-42,-101,-104,-148,-160,-61,-631
-59,100,-37,-226,-69,-86,-135,-87,-599
-41,5,-52,-108,-90,-76,-87,-61,-510
-19,-13,-30,-109,-120,-108,-79,-27,-505
-43,2,-31,-132,-94,-103,-58,-3,-462
-33,53,-33,-190,-42,-167,-118,-1,-531
41,26,-46,-130,-112,-167,-104,-120,-612
15,28,0,-9,-27,-27,-16,-21,-57
-5,0,-4,-14,-12,-12,-9,9,-47
-14,6,-19,-37,-35,-12,-23,-18,-152
7,-10,-6,-60,-28,-38,-56,-22,-213
53,86,-17,-109,-75,-127,-86,-11,-286
-9,4,-9,-13,-21,-16,-21,5,-80
24,30,5,-11,-7,-8,-18,-28,-13
-25,85,-85,-179,-96,-82,-90,99,-373
-10,11,-41,-47,-89,-18,-81,34,-241
-109,78,-82,-182,-36,-38,-85,-22,-476
-58,6,-108,-351,-153,-177,-224,-146,-1211
-76,100,-72,-241,-59,-142,-93,2,-581
-18,154,-95,-250,-74,-139,-118,55,-485
-18,110,-20,-176,-16,-94,-90,9,-295
-36,29,-69,-150,-48,-94,-77,1,-444
-36,-30,-24,-46,-35,0,-40,13,-198
-10,27,-24,-75,3,-38,-40,-7,-164
118,405,-68,-355,-162,-299,-143,145,-359
30,28,-32,-216,-17,-143,-121,1,-470
43,140,-38,-338,-67,-219,-63,121,-421
156,164,-39,-103,-77,-108,-22,6,-23
-2,67,-12,-104,1,-30,-50,-41,-171
-20,4,-60,-72,-74,-73,-95,-9,-399
-5,-80,-24,-137,-126,-94,-112,32,-546
23,137,29,-72,-92,-33,-110,86,-32
-106,74,-135,-385,-124,-198,-205,-43,-1122
-15,-21,-94,-190,-140,-118,-93,44,-627
9,26,-19,-79,-148,-131,-84,-36,-462
-31,9,-29,-96,-70,-56,-55,-27,-355
-14,101,-42,-137,-62,-95,-74,-5,-328
5,11,-18,-106,-79,-118,-77,-26,-408
-41,1,-41,-74,-84,-51,-73,-24,-387
-53,14,-17,-138,-138,-42,-46,44,-376
26,-62,-31,-176,-121,-176,-181,-30,-751
12,27,8,-84,-34,-60,-23,-24,-178
-42,4,-74,-138,-100,-107,-101,-67,-625
-5,5,-12,-12,-3,-10,-16,9,-44
14,14,-12,-21,-8,-35,-25,-20,-93
-9,31,-3,-35,-14,-13,-13,-11,-67
0,55,-57,-138,-104,-97,-88,-35,-464
-25,19,-125,-234,-194,-252,-240,-173,-1224
-57,-18,-79,-156,-142,-120,-138,-71,-781
7,20,-34,-99,-102,-72,-73,-56,-409
68,162,-17,-142,-62,-91,-69,98,-53
-27,-68,-90,-57,-162,-90,-138,-56,-688
-11,0,-18,-44,-9,-28,-28,8,-130
14,56,5,-83,-93,-112,-24,19,-218
47,33,-55,-153,-180,-158,-131,-105,-702
-4,9,-67,-132,-57,-82,-92,-57,-482
14,27,-7,-33,-37,-25,-22,6,-77
-15,27,-26,-65,-10,-33,-20,15,-127
8,75,-93,-228,-134,-191,-144,-113,-820
60,64,26,-27,-3,-37,5,48,136
-3,58,-17,-138,-124,-112,-83,-33,-452
15,28,4,-76,1,-41,-59,52,-76
-33,49,-107,-355,-180,-212,-236,19,-1055
30,22,-15,-79,-80,-95,-55,-24,-296
-53,-14,-77,-156,-110,-98,-75,-26,-609
-20,37,-32,-76,-31,-51,-39,1,-211
6,64,-15,-108,-25,-69,-22,28,-141
-87,-32,-91,-159,-140,-80,-130,-32,-751
12,45,14,-140,-71,-133,-105,-30,-408
51,41,-16,-103,-85,-135,-79,-65,-391
-9,16,-27,-66,-53,-57,-51,-29,-276
-60,3,-45,-113,-63,-87,-72,-17,-454
-38,72,-38,-128,-4,-56,-31,1,-222
-59,30,-117,-196,-150,-107,-159,-72,-830
-27,6,-18,-69,-67,-64,-35,-7,-281
-221,8,-117,-272,-173,-134,-133,-94,-1136
60,183,-31,-88,-6,-52,32,57,155
-37,11,-86,-157,-66,-123,-127,-56,-641
-33,92,-43,-189,-75,-99,-80,-11,-438
-46,-18,-71,-82,-100,-44,-104,-27,-492
52,86,-29,-212,9,-80,-116,-33,-323
9,50,-3,-55,0,-43,-18,-11,-71
-121,-11,-148,-245,-178,-77,-193,-24,-997
-311,75,-450,-877,-438,-446,-569,-51,-3067
-53,120,-129,-382,-228,-307,-293,-178,-1450
117,66,6,-155,-97,-186,-120,-22,-391
-73,-5,-76,-161,-125,-68,-114,-18,-640
205,131,24,-230,-87,-165,-125,63,-184
8,10,-45,-109,-13,-89,-77,-61,-376
22,46,-47,-143,-7,-156,-86,-72,-443
-17,-5,-15,-36,-48,-20,-33,6,-168
92,20,-35,-112,-175,-203,-146,20,-539
-110,206,-108,-406,-85,-85,-186,-152,-926
251,393,-164,-711,-12,-448,-362,233,-820
-63,35,-67,-161,-82,-52,-108,106,-392
-94,25,-110,-259,-155,-102,-164,19,-840
-23,-21,-48,-46,-83,-24,-88,-15,-348
-10,22,-12,-88,-40,-40,-28,-5,-201
-641,239,-1085,-1868,-807,-894,-1301,-312,-6669
-30,-1,-18,-52,-47,-32,-34,4,-210
19,20,1,-46,-7,-44,-45,-25,-127
86,33,-9,-44,-85,-100,-83,-54,-256
-16,266,32,-465,-192,-376,-118,150,-719
-3,128,-51,-313,-156,-221,-141,-26,-783
54,84,-36,-158,-59,-102,-87,-43,-347
-9,69,-124,-305,-229,-282,-240,-155,-1275
1,13,0,-65,-37,-38,-33,-12,-171
509,233,340,-61,407,-109,-170,206,1355
121,254,-9,-423,-111,-333,-257,-66,-824
240,38,71,-107,33,-195,-122,2,-40
12,25,-4,-31,-11,-8,-17,-11,-45
-108,59,-130,-271,-145,-109,-115,-17,-836
-32,19,-36,-84,-27,-48,-52,-41,-301
-33,20,-34,-86,-28,-48,-50,-42,-301
-66,-6,-71,-158,-77,-80,-125,-57,-640
-7,10,-14,-39,-15,-20,-25,-16,-126
-26,266,-172,-432,-59,-157,-120,134,-566
-75,48,-102,-323,-243,-224,-256,-60,-1235
64,10,11,-4,-108,-80,-68,-42,-217
72,57,8,-103,-26,-117,-123,46,-186
-67,37,-73,-287,-192,-103,-136,26,-795
6,12,-27,-100,-92,-98,-59,-4,-362
-20,9,-72,-194,-132,-141,-117,-47,-714
55,12,-6,-66,-52,-110,-76,45,-198
-6,19,-8,-15,-32,-33,-20,-15,-110
-33,-11,-59,-155,-123,-110,-120,-43,-654
61,71,11,-60,-69,-98,-89,31,-142
222,194,-62,-158,-190,-275,-194,46,-417
-72,53,-104,-244,-164,-132,-112,21,-754
-32,26,-50,-150,-142,-86,-108,-10,-552
-59,-29,-72,-123,-105,-66,-114,-14,-582
-30,-2,-13,-99,-67,-57,-45,-5,-318
-23,2,-10,-60,-46,-26,-33,6,-190
-48,9,-28,-180,-103,-115,-91,-25,-581
61,60,12,-129,-29,-135,-70,55,-175
21,267,-14,-274,-77,-159,-39,63,-212
42,40,0,-35,-74,-46,-1,-16,-90
-109,61,-38,-162,-75,-28,-67,-31,-449
82,49,74,61,-11,-28,5,9,241
-66,19,-95,-143,-114,-118,-147,-18,-682
-15,24,-36,-93,-106,-87,-63,-43,-419
-12,24,-109,-226,-153,-203,-204,-75,-958
3,0,-8,-59,-39,-35,-18,-15,-171
-7,-25,-54,-159,-115,-153,-113,-7,-633
25,209,-12,-111,-197,-88,-127,47,-254
-104,58,-120,-313,-111,-104,-131,8,-817
-15,-5,-34,-87,-96,-86,-90,-12,-425
-25,11,-115,-218,-115,-182,-191,-111,-946
103,-31,13,-121,-37,-142,-54,1,-268
215,228,75,-11,155,-11,-62,190,779
-77,15,-106,-121,-134,-87,-144,-34,-688
-23,57,-40,-291,-245,-189,-156,60,-827
-31,-18,-30,-108,-51,-65,-72,-11,-386
65,32,-68,-178,-302,-277,-229,-167,-1124
-17,30,-17,-55,0,-16,-13,25,-63
-157,168,-83,-457,-185,-149,-229,-26,-1118
-78,24,-65,-200,-59,-88,-99,26,-539
-80,40,-87,-223,-56,-116,-96,-12,-630
66,76,-112,-229,-186,-278,-213,-180,-1056
-56,-80,-190,-374,-459,-374,-409,-242,-2184
-32,-30,-61,-102,-122,-90,-87,3,-521
16,105,-20,-110,-16,-91,-47,11,-152
-73,-1,-102,-186,-217,-142,-209,-61,-991
204,195,76,-83,35,-142,39,141,465
-40,27,-37,-114,-81,-55,-80,-34,-414
-35,37,-29,-157,-38,-24,-90,-35,-371
34,69,-20,-196,-129,-160,-104,76,-430
-144,57,-220,-415,-269,-299,-348,-131,-1769
-4,133,-40,-181,-5,-69,-27,-23,-216
81,127,27,-107,8,-139,-52,88,33
13,51,-68,-100,-4,26,56,21,-5
21,46,-45,-114,-76,-114,-106,-23,-411
81,84,-28,-223,-144,-250,-156,-19,-655
62,12,-43,-126,-133,-173,-90,-66,-557
-103,-43,-131,-341,-213,-194,-199,-63,-1287
-62,83,-67,-204,-88,-84,-135,-121,-678
7,7,-41,-78,-75,-95,-71,-73,-419
-20,61,-47,-124,-69,-60,-51,31,-279
-236,147,-464,-832,-333,-568,-716,-319,-3321
-39,61,-62,-195,-122,-118,-142,-45,-662
-81,7,-114,-157,-158,-122,-177,-8,-810
18,71,-37,-112,-68,-107,-114,-22,-371
-7,17,-27,-50,-22,-22,-50,-21,-182
-2,34,-38,-191,-134,-183,-140,-32,-686
83,86,-1,-48,-39,-57,-16,4,12
-23,79,-19,-151,-66,-89,-34,37,-266
-70,-46,-78,-155,-133,-129,-130,-45,-786
-12,42,-52,-63,-60,-25,-41,10,-201
37,83,-28,-93,-79,-121,-85,-17,-303
-76,-63,-44,-143,-79,-73,-103,-10,-591
13,31,-10,-60,-1,-28,-27,44,-38
-91,-35,-62,-179,-78,-77,-133,-33,-688
-27,67,-20,-138,-52,-76,-31,-27,-304
-154,84,-210,-375,-120,-205,-249,-167,-1396
-105,66,-200,-329,-123,-205,-230,-156,-1282
-46,61,-100,-218,-108,-77,-101,-69,-658
-154,9,-174,-362,-146,-212,-218,-79,-1336
-48,-12,-92,-143,-136,-111,-128,-22,-692
-55,-23,-58,-98,-48,-56,-79,-4,-421
-4,21,-34,-84,-76,-86,-56,-33,-352
-41,7,-35,-57,-32,-21,-46,-5,-230
-38,27,-37,-145,-86,-91,-31,-19,-420
-28,29,-14,-63,-31,-22,-29,-9,-167
-7,85,-53,-200,-113,-154,-75,13,-504
-26,20,-28,-57,-33,-37,-14,-27,-202
-2,31,-38,-72,-63,-59,-40,-24,-267
15,180,-49,-240,-36,-155,-112,-61,-458
-2,-5,-26,-48,-68,-55,-54,-38,-296
-73,35,-89,-293,-200,-138,-129,-87,-974
-42,21,-126,-205,-164,-168,-185,-86,-955
5,81,-39,-142,-35,-110,-65,28,-277
-37,51,-89,-143,-111,-117,-150,-22,-618
-32,45,-60,-128,-38,-77,-84,-25,-399
-17,-8,-18,-49,-71,-52,-26,-21,-262
-14,-10,-36,-102,-73,-53,-87,6,-369
-21,5,-38,-100,-68,-72,-39,26,-307
-139,51,-218,-582,-375,-331,-332,-11,-1937
-26,13,-37,-77,-21,-38,-38,-1,-225
-13,15,-49,-44,-42,-54,-82,-18,-287
-115,188,-195,-852,-839,-177,-648,620,-2018
-58,274,-313,-663,-251,-496,-402,-365,-2274
0,122,-103,-226,-157,-157,-139,-71,-731
-24,70,-83,-164,-24,-93,-106,-58,-482
0,37,-91,-165,-95,-182,-110,-121,-727
-41,-56,-79,-114,-100,-99,-133,-46,-668
88,65,-26,-184,-109,-172,-108,-66,-512
-38,5,-40,-100,-30,-36,-60,-26,-325
71,107,29,-51,55,19,48,87,365
-6,3,-9,-36,-17,-24,-16,9,-96
-22,23,-23,-41,-33,-3,-16,9,-106
-22,9,-15,-71,-4,-44,-28,-24,-199
122,39,32,-76,-39,-122,-43,23,-64
-28,-2,-30,-65,-37,-39,-29,-13,-243
-35,127,-48,-172,2,-54,4,86,-90
-20,-16,-18,-72,-85,-34,-89,-5,-339
-48,-32,-127,-186,-167,-132,-188,-85,-965
-66,39,-69,-169,-56,-52,-106,-68,-547
27,26,-5,-88,-156,-106,-96,-62,-460
-7,54,-23,-42,-44,-24,-29,30,-85
-3,15,-8,-41,-19,-25,-27,-10,-118
-25,10,-73,-143,-66,-126,-112,-52,-587
2,10,-9,-14,-12,-15,0,-5,-43
1,7,4,-30,-20,-29,-4,-2,-73
-89,-8,-104,-318,-185,-208,-193,-97,-1202
-53,106,-7,-129,21,32,-32,6,-56
19,64,-25,-137,-90,-107,-88,-81,-445
-98,69,-155,-508,-205,-295,-274,28,-1438
-40,-12,-44,-83,-39,-38,-67,-18,-341
-45,34,-38,-109,-10,-34,-39,42,-199
-10,29,-53,-144,-101,-134,-111,17,-507
68,39,19,-78,-68,-143,-119,40,-242
-47,28,-88,-167,-41,-95,-102,-80,-592
-69,25,-67,-162,-48,-43,-43,-43,-450
161,89,52,-56,-42,-165,-58,69,50
-31,1,-51,-184,-134,-90,-118,46,-561
26,60,-2,-27,-64,-67,-17,21,-70
21,27,-1,-61,-140,-67,-127,51,-297
90,64,21,-18,5,-82,-25,-8,47
-33,-1,-28,-41,-27,-10,-32,0,-172
-9,17,-53,-96,-74,-74,-83,-26,-398
-4,4,-42,-93,-84,-98,-62,-61,-440
-22,19,-41,-75,-25,-45,-41,-27,-257
-29,124,-19,-122,20,-37,33,53,23
-18,-6,-39,-57,-49,-48,-39,-13,-269
-176,112,-379,-693,-592,-625,-627,-328,-3308
65,62,13,9,-30,-68,-29,24,46
7,111,-42,-190,-45,-118,-42,29,-290
-10,-4,-41,-120,-98,-89,-101,-62,-525
-46,-5,-65,-138,-99,-112,-89,-37,-591
10,11,1,-49,-76,-56,-58,-7,-224
-16,12,-24,-66,-11,-20,-24,2,-147
58,7,4,-40,21,-63,-66,-14,-93
-13,42,-31,-79,-21,-60,-31,-10,-203
-103,5,-109,-252,-159,-62,-111,-88,-879
-199,-3,-212,-418,-272,-237,-280,-99,-1720
-3,-12,-11,-37,-36,-27,-41,29,-138
36,25,-60,-143,-167,-199,-106,-126,-740
-26,6,-55,-113,-88,-124,-99,-60,-559
48,119,-39,-174,-7,-110,-67,44,-186
0,-47,1,-88,-194,-7,-51,108,-278
-1,51,-29,-82,8,-29,-22,33,-71
-18,11,-39,-86,-43,-8,-56,65,-174
53,68,-6,-196,-141,-202,-122,-37,-583
-74,2,-89,-223,-148,-85,-171,36,-752
-142,90,-70,-216,-14,-85,-85,-51,-573
258,125,2,-228,69,-177,-271,120,-102
186,28,49,-14,-91,-82,-103,-22,-49
12,72,-69,-229,-111,-185,-137,-55,-702
-33,56,-107,-262,-253,-208,-184,-37,-1028
113,109,71,-2,-78,-47,-31,84,219
-27,-8,-36,-45,-48,-13,-36,0,-213
-91,-37,-69,-147,-98,-74,-139,-26,-681
19,84,-74,-232,-163,-222,-148,-121,-857
-7,5,-26,-67,-15,-53,-46,-12,-221
-9,24,-16,-53,-20,-28,-28,8,-122
-19,82,-29,-153,-51,-83,-84,-31,-368
-35,23,-43,-61,-38,-26,-55,16,-219
-41,5,-41,-130,-120,-80,-82,-19,-508
34,16,-25,-79,-30,-72,-66,-32,-254
-35,20,-52,-158,-76,-100,-82,-66,-549
-8,56,-33,-118,-39,-72,-62,-37,-313
-86,20,-62,-129,-30,-44,-46,-29,-406
-4,27,-18,-60,-77,-44,-44,-33,-253
-183,292,-308,-722,-694,-373,-674,284,-2378
59,116,19,-57,-4,-68,-44,76,97
36,10,-21,-131,-34,-99,-74,28,-285
-16,14,-41,-128,-38,-43,-69,23,-298
-144,13,-172,-379,-107,-136,-187,-71,-1183
295,186,147,76,148,45,-13,15,899
-85,8,-67,-156,-45,-51,-59,-25,-480
186,189,32,-205,9,-158,-134,32,-49
0,4,-6,-10,-8,-8,-15,-3,-46
3,7,-4,-6,-5,-8,-11,-3,-27
-13,0,-6,-38,-15,-20,-27,1,-118
-15,1,-7,-38,-20,-26,-32,1,-136
-13,82,-26,-123,-92,-92,-60,2,-322
-56,32,-98,-198,-103,-110,-132,-37,-702
12,13,-46,-85,-56,-67,-81,8,-302
27,-12,-7,-154,-117,-184,-123,-20,-590
0,-13,-8,-3,-70,-39,-33,-4,-170
37,83,24,-36,-86,-69,-125,-30,-202
-39,0,-176,-276,-261,-301,-293,-202,-1548
-19,12,-32,-45,-16,-15,-39,-15,-169
12,21,-8,-56,-54,-76,-44,-32,-237
-13,22,-33,-93,-48,-56,-67,-6,-294
29,58,19,-221,-90,-178,-137,7,-513
5,-19,-14,-142,-89,-136,-67,-51,-513
-114,265,-248,-563,-126,-192,-171,130,-1019
25,22,-19,-58,-122,-88,-59,-49,-348
-19,11,-76,-120,-46,-64,-69,-41,-424
-33,209,-106,-340,-20,-154,-134,17,-561
-15,86,-91,-250,-57,-195,-141,-154,-817
-23,13,-16,-129,-36,-75,-60,12,-314
20,47,-36,-104,-63,-96,-60,-30,-322
25,73,-27,-58,7,-40,-29,58,9
68,50,8,-89,8,-98,-33,4,-82
-130,28,-53,-166,-77,-64,-62,-57,-581
-44,86,-71,-231,-51,-82,-112,-27,-532
-34,4,-66,-117,-85,-63,-96,-18,-475
-43,42,-31,-123,0,-47,-29,48,-183
-9,34,-59,-103,-89,-97,-95,-34,-452
-2,23,-1,-56,-27,-48,-19,45,-85
20,34,4,-73,-33,-59,-81,0,-188
-31,10,-35,-129,-123,-100,-93,-32,-533
14,40,-24,-158,-87,-124,-90,-29,-458
18,48,3,-19,-24,-38,-2,0,-14
3,39,-7,-36,-57,-28,-25,23,-88
2,42,-26,-83,-50,-38,-47,-36,-236
-38,-31,-53,-80,-64,-53,-97,-24,-440
87,181,-81,-253,-3,-219,-78,51,-315
46,120,18,-170,-66,-123,-106,15,-266
-2,27,-36,-60,-14,-36,-36,-18,-175
-38,-18,-63,-119,-137,-40,-81,42,-454
76,28,-26,-87,-152,-158,-119,-121,-559
-31,108,-38,-122,-11,-33,-69,-25,-221
-85,62,-131,-312,-178,-177,-187,-84,-1092
13,123,-22,-163,-78,-104,-97,-55,-383
0,21,-24,-41,-68,-34,-47,-9,-202
-13,50,-76,-250,-162,-138,-161,55,-695
-72,-39,-97,-176,-149,-112,-186,-87,-918
6,72,-52,-165,-242,-126,-104,-68,-679
-69,16,-48,-130,-57,-41,-64,5,-388
54,70,-61,-281,-186,-287,-205,-107,-1003
252,223,32,-124,47,-194,-186,85,135
-34,-10,-34,-88,-69,-35,-50,-17,-337
69,122,-109,-255,-148,-253,-165,-189,-928
-83,6,-90,-182,-111,-70,-99,-8,-637
19,32,-33,-96,-34,-58,-51,2,-219
-13,6,-14,-26,-38,-22,-39,-21,-167
-3,167,-166,-584,-196,-471,-401,-23,-1677
1670,2071,1290,1744,1914,361,-538,1766,10278
99,100,-50,-270,-184,-256,-196,117,-640
-67,-55,-124,-230,-249,-194,-209,-24,-1152
-18,57,-36,-133,-15,-82,-62,-37,-326
50,21,7,10,-39,-31,-39,27,6
70,87,-31,-194,-49,-157,-177,25,-426
-6,12,-1,-21,-12,2,-5,-8,-39
-14,19,-36,-70,-28,-54,-62,-41,-286
38,69,-32,-102,-14,-78,-43,33,-129
-4,10,-22,-76,-17,-46,-6,11,-150
-26,28,-150,-285,-126,-210,-207,-67,-1043
-21,59,-51,-188,-163,-137,-190,-4,-695
135,40,10,-41,-79,-129,-71,-78,-213
-22,22,-32,-87,-89,-69,-60,-6,-343
-105,-52,-107,-165,-100,-66,-117,-16,-728
-14,-25,-33,-72,-81,-87,-115,-57,-484
-27,7,-23,-56,-7,-19,-24,-30,-179
-243,6,-305,-581,-347,-235,-438,-63,-2206
-21,56,-31,-62,7,23,-38,-28,-94
-23,-2,-16,-24,-15,-11,-20,-4,-115
-19,5,-17,-34,-4,-8,-19,-4,-100
57,60,35,54,34,19,-16,31,274
15,76,13,14,22,-14,-46,57,137
-17,55,-3,-38,-12,-3,-41,27,-32
22,12,5,10,19,11,-9,22,92
15,18,19,2,19,11,-18,29,95
-32,42,-80,-172,-135,-135,-146,-37,-695
126,65,-16,-137,1,-175,-146,-32,-314
-56,-15,-34,-141,-103,-53,-91,14,-479
-65,221,-56,-290,-85,-163,-209,-171,-818
5,36,-48,-128,-94,-120,-94,-25,-468
-16,-13,-7,-41,-34,-40,-14,-14,-179
12,10,-10,-44,-8,-27,-18,-7,-92
19,21,-18,-34,-36,-34,-9,-23,-114
-18,37,-62,-110,-76,-60,-71,-36,-396
-20,20,-44,-132,-55,-69,-75,-40,-415
-18,76,-8,-14,-28,13,-66,17,-28
58,428,-49,-655,-289,-449,-393,-141,-1490
21,-8,-2,-48,-44,-65,-52,9,-189
10,13,-16,-57,-77,-59,-14,55,-145
-101,-42,-125,-208,-132,-98,-190,-72,-968
-78,-74,-92,-116,-169,-69,-156,-30,-784
-41,22,-75,-190,-191,-181,-206,-46,-908
12,64,-4,-28,9,-17,-10,59,85
-21,75,-33,-106,-87,-29,-56,24,-233
17,24,7,-70,-94,-106,-72,34,-260
-3,53,-26,-53,-49,-39,-41,12,-146
84,-1,-5,-235,-225,-272,-133,-6,-793
97,88,-61,-224,4,-177,-168,-1,-442
21,43,-28,-50,-6,-30,-38,-21,-109
-24,-23,-56,-98,-46,-71,-61,-47,-426
-24,22,-40,-88,-43,-51,-61,-11,-296
6,15,-25,-46,-69,-51,-45,-42,-257
-46,-14,-127,-254,-173,-210,-256,-141,-1221
6,96,-40,-151,-14,-72,-20,57,-138
-97,24,-129,-245,-168,-163,-212,-103,-1093
-73,-35,-87,-145,-74,-83,-100,-31,-628
33,46,-47,-117,-106,-158,-106,-79,-534
-5,27,-10,-59,-49,-34,-29,44,-115
-34,-4,-34,-69,-52,-18,-61,4,-268
-40,-58,-55,-88,-59,-50,-77,2,-425
6,46,-45,-235,-62,-122,-85,59,-438
-35,59,-53,-80,-38,-1,-41,-31,-220
-36,25,-35,-131,-29,-69,-47,21,-301
-93,36,-115,-259,-88,-117,-135,-35,-806
1,-11,-18,-69,-130,-69,-70,-9,-375
-9,31,-12,-91,-75,-95,-76,21,-306
18,79,2,-35,10,-55,-67,13,-35
26,7,-16,-97,-65,-113,-100,-42,-400
13,-15,-51,-100,-93,-131,-103,-38,-518
-20,11,-56,-136,-55,-124,-127,-42,-549
8,77,-2,-39,-2,-22,-15,12,17
-52,-10,-55,-122,-119,-68,-87,-14,-527
12,12,-27,-58,-27,-51,-44,-8,-191
66,25,47,-51,-90,-117,-89,-23,-232
-205,53,-235,-490,-196,-239,-289,-74,-1675
-67,41,-91,-168,-124,-24,-93,-8,-534
-66,5,-85,-261,-161,-175,-187,-24,-954
-38,22,-52,-100,-83,-55,-61,-55,-422
-31,-19,-37,-91,-79,-77,-66,-34,-434
-18,19,-55,-146,-77,-124,-111,-50,-562
-24,9,-40,-102,-28,-40,-50,-1,-276
23,28,-14,-60,-19,-49,-21,9,-103
71,99,-47,-239,-71,-215,-144,-14,-560
33,20,8,-14,18,-30,5,6,46
-55,27,-80,-191,-111,-105,-136,-9,-660
9,74,-19,-117,11,-54,-53,42,-107
3,60,-21,-159,-14,-65,-45,52,-189
-42,-17,-79,-180,-129,-117,-147,-30,-741
34,34,16,-7,5,-25,3,16,76
-57,-42,-128,-176,-149,-85,-182,-41,-860
44,29,-1,-53,-62,-74,-54,-18,-189
-49,34,-20,-105,-58,-57,-29,-7,-291
5,25,-17,-61,-53,-29,-13,-8,-151
16,60,21,-73,-43,-83,-43,-16,-161
-16,208,-126,-437,-138,-279,-192,61,-919
142,110,25,-195,59,-151,-117,-30,-157
954,1228,289,-628,-107,-255,153,123,1757
-539,-132,-566,-1385,-973,-645,-929,-377,-5546
-21,268,-129,-410,-153,-305,-264,22,-992
-116,85,-151,-303,-165,-113,-186,-175,-1124
-67,27,-148,-337,-185,-203,-212,-111,-1236
-233,22,-275,-446,-263,-176,-272,-82,-1725
-2,4,-7,-13,-2,-8,-3,-3,-34
110,79,7,-130,12,-144,-108,48,-126
-46,11,-33,-128,-85,-91,-91,-42,-505
-24,31,-70,-245,-81,-102,-102,33,-560
-43,77,-68,-121,-29,-60,-96,-25,-365
-30,23,-91,-170,-142,-116,-166,-42,-734
-3,12,-3,-45,-54,-40,-20,-26,-179
-5,11,-11,-21,-3,-10,-23,-5,-67
283,676,8,-419,-94,-461,-318,307,-18
294,635,-30,-513,-54,-502,-292,305,-157
-13,-33,-48,-142,-145,-156,-144,-68,-749
52,39,-46,-167,-149,-231,-149,-125,-776
-28,27,-41,-55,-71,-60,-77,13,-292
-18,13,-10,-57,-30,-34,-29,-15,-180
6,31,9,-52,-34,-33,5,-8,-76
-59,-37,-115,-171,-169,-116,-173,-84,-924
8,13,7,-13,-15,-4,6,4,6
-3,4,-2,-31,-33,-31,-45,6,-135
1,-3,-10,-4,-44,-20,-29,-1,-110
-70,47,-55,-92,-38,-57,-95,-27,-387
-84,-42,-70,-119,-60,-48,-83,-19,-525
3,-2,-17,-93,-100,-100,-66,-34,-409
50,23,-54,-101,-164,-177,-142,-106,-671
73,38,33,-110,-96,-140,-56,27,-231
69,85,-15,-222,-161,-213,-103,-18,-578
31,38,-22,-208,-177,-135,-122,21,-574
-97,37,-106,-268,-169,-144,-206,-35,-988
-25,-18,-23,-50,-30,-12,-55,14,-199
-193,82,-99,-462,-482,-112,-176,44,-1398
24,7,-21,-58,-45,-62,-32,26,-161
-23,-9,-56,-76,-72,-53,-75,-19,-383
4,29,-6,-31,6,-1,-42,7,-34
-64,30,-57,-174,-45,-52,-45,-15,-422
64,61,17,-79,-79,-116,-76,-7,-215
8,20,-47,-114,-213,-126,-183,-44,-699
11,10,-7,-23,-19,-28,-23,-7,-86
-34,-4,-40,-107,-69,-73,-54,6,-375
-54,1,-49,-89,-56,-82,-89,-33,-451
16,103,-3,-81,-10,-24,3,77,81
-26,81,-88,-244,-85,-140,-125,-2,-629
-98,29,-67,-127,-48,-16,-68,-68,-463
22,25,-14,-58,-27,-41,-28,-53,-174
-49,11,-21,-134,-66,-69,-87,-28,-443
5,24,-39,-76,-113,-81,-90,-41,-411
31,32,5,-18,-24,-26,-11,24,13
-90,55,-149,-309,0,-71,-147,-45,-756
48,37,19,-26,-115,-180,-118,-9,-344
-38,17,-79,-126,-77,-51,-63,-60,-477
-33,23,-42,-163,-97,-72,-133,-12,-529
6,79,-40,-231,-113,-196,-133,-22,-650
-111,24,-144,-246,-166,-94,-127,14,-850
-79,-6,-84,-218,-173,-112,-158,-35,-865
-101,-81,-182,-236,-244,-127,-222,-74,-1267
-87,17,-67,-180,-91,-76,-71,4,-551
-24,21,-83,-184,-83,-114,-127,-98,-692
50,175,-54,-374,22,-320,-168,4,-665
-9,191,-96,-374,-113,-234,-175,39,-771
-31,12,-41,-74,-101,-66,-78,13,-366
-18,192,-114,-336,-37,-182,-140,74,-561
-5,153,9,-166,-92,-87,-37,14,-211
28,43,12,-62,-9,-32,-8,9,-19
-47,26,-82,-193,-131,-170,-188,-77,-862
27,92,-54,-95,-60,-86,-94,-16,-286
4,34,-26,-67,-30,-36,-20,-28,-169
6,137,-86,-242,-106,-200,-203,26,-668
-15,4,-61,-168,-144,-156,-120,-17,-677
-81,-14,-79,-204,-92,-115,-97,-44,-726
-1,-3,-14,-10,-8,-9,-11,-2,-58
-69,37,-58,-119,-43,-29,-45,-49,-375
-121,15,-102,-249,-131,-35,-96,28,-691
73,521,-165,-758,-165,-337,-186,293,-724
-165,300,-183,-603,-55,-112,-350,-220,-1388
-37,85,-90,-343,-233,-258,-255,-1,-1132
58,19,14,-1,7,-11,-26,20,80
49,20,20,-8,8,-11,-30,27,75
-2,12,-8,-54,-23,-31,-22,-7,-135
4,34,-11,-35,-24,-34,-17,-5,-88
-16,16,-7,-38,-15,-28,-17,-6,-111
699,679,280,-52,3,-321,-31,247,1504
14,51,-26,-74,-23,-55,-21,-17,-151
3,57,-9,-213,-108,-124,-92,-14,-500
-13,66,-64,-216,-72,-123,-101,17,-506
-110,-17,-105,-201,-64,-59,-110,-49,-715
-20,83,-7,-62,-11,-24,-8,42,-7
-7,-7,-11,-20,-29,-18,-16,6,-102
-31,28,-53,-83,-38,-31,-32,-20,-260
-73,232,-310,-732,-355,-544,-557,-189,-2528
-159,-44,-173,-334,-155,-139,-188,-116,-1308
101,243,-130,-310,-63,-235,-154,65,-483
-64,-33,-79,-122,-126,-94,-138,-42,-698
-69,1,-33,-183,-106,-106,-135,11,-620
-74,4,-78,-198,-100,-78,-93,44,-573
-23,30,-57,-111,-77,-70,-72,-8,-388
2,29,-10,-81,-73,-90,-45,24,-244
-16,45,-41,-213,-198,-39,-105,127,-440
-233,-26,-235,-537,-385,-286,-418,-93,-2213
-226,31,-190,-519,-295,-312,-395,-93,-1999
2,123,-44,-177,-24,-86,-49,112,-143
8,-27,-19,-52,-128,-80,-101,-9,-408
-52,-60,-77,-157,-120,-92,-122,-16,-696
-60,22,-117,-220,-265,-202,-209,-201,-1252
200,29,79,-130,78,-112,-118,132,158
10,162,25,-33,-20,32,-113,64,127
-1,122,-38,-194,-77,-144,-33,33,-332
62,138,-134,-377,-117,-317,-286,-115,-1146
362,406,-1,-386,-236,-415,-336,81,-525
-46,2,-34,-76,-39,-32,-43,-30,-298
-121,16,-93,-187,-126,-89,-131,31,-700
-60,50,-94,-196,-137,-58,-112,21,-586
53,49,-35,-112,-47,-63,-47,-12,-214
75,131,-13,-209,-112,-138,-87,-2,-355
0,170,-49,-328,-165,-230,-174,-16,-792
-46,24,-34,-140,-101,-68,-85,40,-410
-21,-11,-48,-46,-60,-19,-42,2,-245
34,31,-33,-123,-140,-146,-118,-23,-518
274,26,16,-94,-15,-269,-164,16,-210
-33,136,-110,-319,-83,-103,-52,8,-556
31,54,-6,-134,16,-87,-51,39,-138
-77,-23,-61,-244,-194,-133,-136,-59,-927
-7,7,-16,-41,-17,-21,-32,-12,-139
-76,210,-132,-347,-76,-186,-102,9,-700
-31,3,-14,-97,-24,-51,-25,-16,-255
-4,132,19,-93,-49,11,-91,33,-42
1,57,-44,-129,-18,-61,-35,29,-200
38,74,-30,-221,-4,-103,-136,-26,-408
-6,21,-22,-34,-14,2,-12,-9,-74
5,20,-27,-37,-53,-77,-37,-11,-217
-73,-33,-99,-152,-134,-81,-110,-48,-730
-3,11,-24,-57,-44,-42,-34,0,-193
-82,-36,-83,-162,-98,-61,-133,-31,-686
84,97,18,-138,-98,-156,-111,102,-202
28,14,-66,-68,-68,-94,-95,-60,-409
38,2,-6,-45,-22,-65,-48,26,-120
-50,-6,-96,-158,-163,-132,-172,-64,-841
-18,27,-93,-210,-126,-161,-131,26,-686
-19,0,-65,-176,-139,-142,-127,-37,-705
-69,-27,-95,-175,-119,-85,-98,-8,-676
3,43,-37,-69,-33,-81,-79,-33,-286
214,329,50,-248,7,-219,-108,97,122
185,109,29,-108,-35,-164,-131,72,-43
-37,9,-67,-157,-103,-105,-100,-32,-592
-7,-26,-56,-130,-114,-146,-97,-60,-636
10,27,-4,-27,-21,-25,-28,9,-59
-55,-38,-28,-71,-74,-46,-68,-17,-397
18,1,-4,-26,-28,-38,-23,-2,-102
11,16,-9,-27,-17,-8,-13,-1,-48
-30,1,-76,-112,-72,-92,-110,-84,-575
-6,-28,14,-57,-15,-41,-40,36,-137
-13,34,-14,-104,-71,-41,-49,9,-249
73,30,10,-31,10,-61,-43,28,16
48,12,29,-15,14,-23,-11,2,56
47,50,21,-14,-5,-11,6,31,125
-30,-20,-33,-74,-129,-64,-86,-27,-463
-76,-6,-99,-215,-153,-83,-145,-37,-814
-26,19,-17,-48,-44,-38,-40,15,-179
-7,15,-28,-92,-32,-64,-60,-24,-292
-17,66,-126,-248,-47,-168,-147,-102,-789
-92,17,-118,-283,-96,-131,-151,-15,-869
-5,63,-41,-148,43,-36,1,37,-86
-87,9,-52,-172,-62,-71,-97,-76,-608
5,80,14,-73,-42,11,-13,-1,-19
0,56,-34,-146,-88,-107,-77,23,-373
-44,139,-114,-252,-63,-119,-107,93,-467
50,18,3,-111,2,-78,-88,-15,-219
-20,-3,-3,-232,-60,-90,24,-21,-405
-88,-13,-100,-147,-124,-98,-145,-44,-759
57,8,15,-44,-89,-70,-78,-18,-219
1,85,-6,-236,-19,-153,-90,-13,-431
-41,85,-62,-200,-65,-94,-79,10,-446
-35,-14,-32,-114,-93,-80,-58,-11,-437
-13,11,-39,-70,-69,-19,-33,-4,-236
96,104,43,-200,-19,-248,-141,116,-249
163,143,66,81,-2,-93,-92,51,317
-8,93,-42,-357,-321,-300,-269,-35,-1239
-188,35,-97,-398,-186,-111,-189,-72,-1206
-258,-7,-299,-564,-290,-237,-294,-125,-2074
-87,21,-126,-257,-109,-184,-165,-122,-1029
-2,25,-41,-96,-57,-109,-95,-25,-400
-6,-2,-10,-32,-21,0,-26,-26,-123
138,78,17,-182,-74,-234,-145,13,-389
-8,-19,-111,-204,-150,-184,-167,-47,-890
-33,-2,-69,-333,-213,-196,-182,-16,-1044
64,53,25,8,13,0,-3,45,205
-48,15,-45,-94,-56,-62,-63,-32,-385
-88,-26,-50,-161,-142,-91,-142,23,-677
-53,-39,-57,-88,-108,-66,-95,-16,-522
-55,-29,-90,-152,-139,-94,-117,-19,-695
-15,35,-63,-129,-61,-60,-46,-20,-359
-2,46,2,-32,0,-25,25,29,43
98,101,10,-187,-64,-169,-153,-56,-420
91,69,-15,-144,-63,-178,-102,-101,-443
-40,75,-13,-206,-176,-120,-65,12,-533
-124,-1,-61,-269,-95,-126,-138,-75,-889
-47,45,-33,-137,-72,-51,-80,1,-374
-108,74,-148,-255,-111,-91,-123,-17,-779
246,365,42,-360,-24,-352,-152,116,-119
-49,9,-79,-138,-57,-76,-79,-33,-502
-81,196,-91,-335,-34,-120,-132,-83,-680
-29,97,-57,-240,2,-55,-27,34,-275
20,36,-22,-71,-14,-75,-32,15,-143
35,109,-21,-140,7,-62,-41,29,-84
31,21,1,-27,-25,-54,-10,-21,-84
-37,-20,-78,-132,-93,-98,-102,-39,-599
55,151,45,-362,71,-217,58,218,19
53,71,-54,-106,-105,-120,-67,-62,-390
76,66,18,-28,8,-1,-27,17,129
-48,37,-75,-230,-173,-170,-121,-53,-833
-51,13,-92,-223,-158,-124,-125,-43,-803
-104,81,-83,-171,-51,-30,-56,-66,-480
20,58,-8,-125,-57,-37,-31,42,-138
19,-14,-5,-58,-83,-66,-50,-1,-258
-142,206,-201,-570,-254,-272,-167,180,-1220
9,63,-20,-65,2,-27,-27,25,-40
-186,46,-107,-353,-134,-65,-172,-131,-1102
12,154,-42,-226,-83,-127,-130,-77,-519
87,85,41,-106,-42,-163,-26,-4,-128
-90,32,-177,-235,-179,-181,-243,-135,-1208
61,78,-10,-161,-7,-162,-78,-49,-328
-37,108,-41,-209,-57,-105,-42,140,-243
24,38,-17,-35,-3,-39,-21,20,-33
-14,28,-84,-178,-164,-147,-157,-77,-793
-54,41,-11,-136,-54,-42,-8,19,-245
68,5,13,-46,24,-50,-45,15,-16
-12,-3,-34,-127,-121,-65,-71,53,-380
-63,66,-48,-170,-86,-70,-104,-9,-484
70,73,-4,-123,-45,-141,-55,-14,-239
-35,24,-16,-149,-97,-138,-99,-79,-589
-65,-57,-50,-178,-118,-110,-118,-5,-701
20,47,5,-64,-62,-100,-56,-12,-222
-6,48,-35,-163,-139,-148,-102,-40,-585
41,69,18,-28,-24,-43,-4,44,73
-107,-37,-90,-139,-99,-67,-123,-18,-680
-38,80,-54,-296,-96,-162,-164,-40,-770
-40,-7,-16,-122,-77,-65,-59,-6,-392
-94,10,-87,-163,-88,-86,-93,-2,-603
-43,-14,-51,-132,-80,-36,-69,47,-378
-68,41,-48,-140,-62,-32,-63,-48,-420
10,8,14,-18,15,0,20,8,57
43,-2,0,1,10,-35,-39,10,-12
-52,-20,-60,-85,-68,-47,-59,5,-386
-68,16,-66,-140,-89,-118,-109,-45,-619
-54,13,-71,-180,-186,-104,-133,-15,-730
-97,-43,-77,-206,-171,-131,-157,-61,-943
-32,45,-109,-211,-169,-189,-185,-119,-969
9,63,-6,-18,-37,5,-30,37,23
-51,90,-66,-225,-85,-120,-98,11,-544
32,-14,-19,-54,-112,-68,-92,-31,-358
7,56,-85,-203,-112,-161,-159,-113,-770
83,88,-7,-48,-57,-137,-49,-17,-144
21,0,-26,-80,-34,-69,-63,21,-230
33,2,10,-2,-20,-42,-10,-2,-31
57,88,17,-64,-156,-129,-74,15,-246
-121,13,-144,-258,-90,-138,-190,-74,-1002
-60,102,-72,-225,-111,-101,-150,-139,-756
-44,20,-44,-150,-127,-106,-85,-56,-592
48,128,3,-173,-83,-145,-214,57,-379
-43,35,-91,-221,-155,-162,-174,-4,-815
15,54,-25,-104,-9,-87,-87,3,-240
-30,12,-35,-82,-117,-55,-78,-31,-416
-18,21,-39,-83,-57,-38,-68,-27,-309
-94,142,-370,-741,-560,-639,-635,-414,-3311
-17,84,-56,-200,-65,-111,-78,19,-424
-17,110,-25,-152,-9,-61,12,38,-104
-57,59,-35,-106,-34,-30,-39,-11,-253
-44,-27,-59,-107,-87,-55,-82,-44,-505
37,142,4,-155,13,-139,-82,23,-157
19,28,-18,-107,-47,-89,-53,-37,-304
-22,7,-4,-104,16,-33,-51,28,-163
-73,62,-45,-149,-14,-36,-79,-41,-375
42,104,-11,-185,-38,-120,-99,-29,-336
-12,31,-83,-108,-95,-77,-97,-21,-462
-23,37,-74,-155,-101,-92,-74,-51,-533
21,11,-51,-111,-175,-195,-145,-70,-715
-71,-27,-88,-174,-135,-80,-130,-59,-764
-36,8,-22,-82,-36,-52,-45,-2,-267
47,62,-18,-131,10,-130,-97,-48,-305
12,69,-31,-238,0,-131,-32,18,-333
-68,52,-49,-151,-21,-59,-47,1,-342
65,38,-3,-146,-45,-126,-69,26,-260
14,62,-42,-136,-155,-146,-91,-21,-515
31,2,-33,-200,-178,-221,-163,-105,-867
-12,1,-24,-24,-65,-30,-47,18,-183
124,18,-16,-43,45,-59,-58,-15,-4
-6,5,-33,-144,-162,-140,-103,-44,-627
8,15,-7,-116,-88,-58,-63,-21,-330
-58,-42,-55,-83,-52,-31,-68,-18,-407
115,37,-48,-107,-219,-221,-173,-125,-741
-31,-13,-39,-70,-53,-50,-65,-33,-354
-18,114,-85,-271,-163,-114,-111,91,-557
79,56,30,-24,-60,-71,-4,-2,4
-64,22,-68,-176,-99,-76,-105,-30,-596
862,441,478,78,504,144,-156,227,2578
-70,63,-28,-121,-49,-67,-40,-13,-325
99,102,61,-44,26,-92,-70,42,124
203,225,48,-332,63,-208,-186,269,82
23,52,-39,-161,-41,-98,-93,24,-333
-46,21,-136,-186,-161,-126,-162,-16,-812
-180,62,-224,-626,-273,-372,-432,-6,-2051
-47,74,-97,-263,-79,-98,-137,-14,-661
-324,-109,-268,-638,-450,-266,-448,6,-2497
-160,86,-178,-433,-217,-121,-275,170,-1128
-134,-4,-112,-248,-211,-142,-174,-15,-1040
-66,25,-98,-204,-101,-129,-169,-58,-800
-1,108,-165,-325,-179,-313,-288,-142,-1305
-102,576,-171,-1095,-448,-448,-769,449,-2008
-119,-10,-125,-247,-196,-123,-183,16,-987
-69,50,-111,-340,-198,-165,-200,100,-933
-21,10,-38,-72,-59,-70,-59,-58,-367
-25,0,-36,-67,-56,-71,-60,-56,-371
8,90,-65,-231,-147,-178,-206,-56,-785
67,18,-96,-359,-409,-369,-264,64,-1348
-7,16,-23,-133,-36,-91,-99,-28,-401
-7,-6,-19,-58,-57,-41,-52,0,-240
-129,-39,-107,-185,-136,-70,-135,-21,-822
312,220,155,-114,224,-156,-127,224,738
179,194,-122,-333,5,-238,-157,5,-467
-3,-19,-45,-94,-61,-66,-68,-49,-405
0,7,-5,-38,-28,-30,-14,28,-80
-12,77,-46,-134,-50,-65,2,77,-151
-94,-19,-147,-201,-129,-90,-167,-34,-881
0,23,-34,-115,-55,-51,-125,27,-330
-4,1,-12,-18,-25,-13,-20,-4,-95
94,2,30,-53,-5,-70,-81,99,16
21,25,-6,-113,-54,-115,-85,-15,-342
14,-6,-4,-7,-61,-23,-20,-17,-124
-1,11,-4,-41,-43,-53,-26,1,-156
-29,5,-24,-114,-24,-60,-47,6,-287
-82,86,-136,-334,-143,-131,-211,86,-865
-247,120,-380,-1023,-678,-684,-740,-66,-3698
126,180,-9,-220,78,-154,-50,96,47
-23,18,-38,-83,-76,-69,-64,-8,-343
-1,18,2,-42,-17,-24,4,-1,-61
-28,-19,-24,-58,-53,-35,-38,-5,-260
-35,-8,-32,-56,-47,-24,-44,15,-231
-51,16,-148,-259,-234,-147,-190,-22,-1035
-720,-385,-281,-1210,-1095,-786,-821,10,-5288
-49,-35,-50,-136,-73,-53,-48,-25,-469
-6,23,12,-15,-16,-4,5,-2,-3
-14,25,-9,-40,-14,-10,-5,1,-66
26,62,4,-26,-40,-6,37,23,80
-116,-5,-178,-315,-333,-219,-252,-47,-1465
-34,30,11,-65,-13,-25,-34,21,-109
-77,-78,-162,-282,-219,-178,-249,6,-1239
-17,62,-48,-210,-150,-107,-112,78,-504
-24,-18,-37,-62,-66,-39,-61,26,-281
-29,-17,-32,-79,-129,-56,-86,-32,-460
56,118,24,-175,-16,-155,-144,67,-225
-40,126,-128,-367,-153,-187,-191,63,-877
49,126,-224,-658,-434,-611,-509,-324,-2585
-1,15,-16,-41,-14,-24,-20,-3,-104
-48,-25,-60,-94,-100,-93,-106,-4,-530
-1,8,-31,-30,-70,-48,-50,-29,-251
-11,58,-23,-95,-44,-50,-55,-74,-294
-51,-20,-57,-108,-71,-65,-104,-1,-477
-1,-4,-6,-16,-12,1,1,-1,-38
23,24,-26,-69,-23,-51,-71,6,-187
2,64,-30,-84,-73,-43,-54,29,-189
-4,6,-15,-41,-15,-20,-26,-2,-117
-8,68,-55,-177,17,-97,-49,-40,-341
-27,-13,-47,-70,-54,-53,-77,-30,-371
-12,7,-6,-55,-11,-47,-43,2,-165
21,37,-13,-52,-44,-72,-56,-31,-210
-42,10,-74,-151,-119,-53,-69,41,-457
-21,-15,-52,-89,-77,-61,-101,-20,-436
49,50,-88,-269,-302,-326,-268,-207,-1361
-40,-23,-46,-148,-112,-100,-167,20,-616
-34,-28,-31,-106,-26,-25,-38,1,-287
-13,26,-30,-72,-32,-62,-20,3,-200
-36,82,-39,-140,-111,-100,-83,-34,-461
9,8,-27,-85,-76,-44,-31,-16,-262
29,58,-39,-86,-100,-69,-71,-15,-293
51,32,2,-44,-36,-95,-42,-34,-166
-90,-52,-82,-149,-120,-66,-132,-42,-733
-74,-30,-79,-137,-92,-78,-142,10,-622
4,-13,-11,-45,-67,-57,-30,-21,-240
21,31,26,-68,-33,-48,-22,13,-80
-29,97,-27,-267,-63,-139,-83,27,-484
-9,32,-39,-102,-75,-84,-86,-24,-387
4,-4,-19,-74,-91,-106,-75,-7,-372
-23,61,-73,-141,-64,-56,-63,44,-315
20,7,3,-29,-33,-39,-21,-23,-115
23,110,-32,-204,-45,-151,-78,40,-337
-13,2,-19,-26,-11,-2,-14,-12,-95
51,111,-21,-45,-26,-29,15,96,152
10,41,-5,-81,-23,-54,-92,53,-151
48,14,0,10,3,-26,-12,-1,36
-9,30,-39,-63,-20,-60,-59,-30,-250
29,4,-19,-36,-31,-41,-67,25,-136
-71,-32,-78,-181,-90,-96,-128,-22,-698
44,-52,-15,-85,-88,-115,-82,6,-387
-60,6,-96,-337,-317,-285,-255,-19,-1363
-47,0,-39,-96,-37,-64,-19,24,-278
1,40,-43,-75,-67,-75,-72,18,-273
-90,-21,-100,-167,-103,-90,-136,-5,-712
7,40,-18,-30,-27,-12,-1,38,-3
-13,52,-32,-62,-22,-34,-20,-19,-150
-46,52,-126,-229,-168,-191,-210,-91,-1009
11,70,-13,-41,-31,-49,-57,40,-70
-7,39,-91,-193,-106,-144,-134,-86,-722
-25,57,-51,-110,-126,-44,-65,-11,-375
103,137,11,-260,-34,-244,-133,-104,-524
-35,-13,-28,-65,-35,-30,-42,-4,-252
-264,-16,-309,-610,-292,-206,-401,-85,-2183
-23,-11,-30,-74,-64,-45,-41,14,-274
-104,38,-64,-163,-77,-72,-62,-49,-553
-10,47,-24,-80,-121,-28,-47,3,-260
34,36,-19,-121,-51,-123,-112,9,-347
33,-12,-53,-97,-86,-97,-79,-48,-439
2,-6,-76,-158,-122,-133,-95,-26,-614
-91,-11,-62,-136,-102,-81,-123,3,-603
-52,-3,-56,-138,-95,-73,-130,-18,-565
20,66,-25,-89,-39,-84,-72,40,-183
-141,49,-90,-306,-189,-109,-68,112,-742
49,74,-24,-131,-92,-170,-137,-59,-490
18,20,-28,-141,-124,-167,-112,-29,-563
-96,-20,-69,-144,-111,-82,-137,2,-657
27,73,-58,-255,-104,-167,-146,-85,-715
-35,9,-40,-85,-68,-45,-75,-15,-354
-9,12,-11,-42,-6,-14,-2,4,-68
-98,67,-71,-175,-38,-66,-60,-7,-448
-10,86,-50,-199,-38,-74,-77,66,-296
204,77,-28,-137,-92,-186,-140,-94,-396
-41,16,-25,-97,-47,-21,-57,-15,-287
-1,-4,-22,-55,7,-8,-7,11,-79
-29,-38,-34,-64,-76,-70,-58,-22,-391
-35,15,-83,-235,-226,-179,-180,-66,-989
-80,-39,-61,-151,-115,-62,-103,13,-598
39,47,2,-51,-5,-51,-35,-16,-70
-14,-21,-2,-56,0,-43,-31,-4,-171
4,27,-4,-26,-33,-36,-29,2,-95
-41,67,-62,-161,-99,-130,-85,-92,-603
-52,19,-102,-245,-162,-179,-162,-67,-950
2,144,-150,-374,-72,-295,-263,-147,-1155
207,189,45,-171,-39,-177,-125,62,-9
175,158,39,-193,-78,-252,-133,33,-251
-48,45,-46,-188,-140,-86,-97,34,-526
6,84,-75,-201,-63,-131,-67,-114,-561
-61,55,-54,-176,-31,-36,-22,57,-268
-147,56,-216,-663,-229,-324,-359,-43,-1925
3,6,1,-55,-56,-60,-38,-19,-218
-85,2,-75,-214,-80,-73,-56,-10,-591
6,22,-15,-60,0,-46,-33,5,-121
-62,-9,-47,-108,-47,-33,-82,-7,-395
28,47,-17,-70,7,-78,-66,-37,-186
-46,5,-58,-202,-88,-151,-135,35,-640
11,31,-69,-129,-101,-87,-117,-17,-478
-21,30,-22,-48,-44,-41,-44,26,-164
16,126,29,-81,-45,-63,-108,-17,-143
-71,2,-39,-100,-73,-130,-165,-66,-642
218,257,-17,-330,-107,-140,-122,142,-99
-8,12,-22,-59,-30,-37,-27,28,-143
-3,24,-23,-68,-38,-31,-36,10,-165
21,18,-42,-52,-119,-75,-99,-49,-397
-153,-22,-149,-333,-261,-172,-209,-49,-1348
-56,-6,-55,-164,-207,-47,-88,18,-605
7,28,-9,-18,-13,-28,-29,1,-61
-29,266,-127,-510,-232,-291,-279,-11,-1213
-7,44,-34,-125,-58,-89,-102,9,-362
66,58,46,11,-29,-52,-3,9,106
9,37,-20,-67,-19,-52,-37,-16,-165
-136,133,-350,-759,-456,-637,-586,-284,-3075
62,52,-27,-80,-8,-95,-74,-48,-218
38,41,5,-78,-8,-72,-86,17,-143
28,26,-78,-156,-222,-194,-149,-117,-862
-21,12,-2,-25,-34,-26,-10,1,-105
33,147,-17,-139,17,-24,-59,67,25
-11,1,-28,-47,-21,-34,-22,-17,-179
-23,34,-154,-264,-203,-243,-232,-144,-1229
83,142,-90,-217,-183,-240,-186,-207,-898
-16,9,-18,-34,-18,-20,-10,19,-88
-1,38,-25,-67,-30,-70,-47,-15,-217
-10,15,-24,-81,-49,-73,-51,-30,-303
11,26,-7,-56,-6,-49,-31,4,-108
-33,11,-31,-112,-24,-33,-31,-25,-278
-109,308,-268,-906,-424,-622,-566,-81,-2668
0,21,-5,-34,-36,-47,-34,-21,-156
-100,152,-110,-304,-88,-21,-223,91,-603
2,6,-43,-74,-35,-79,-63,-38,-324
-8,56,-59,-107,-87,-68,-86,-45,-404
-4,15,-29,-30,-13,-14,-40,5,-110
7,11,-31,-57,-3,-43,-40,-17,-173
46,69,-67,-164,-106,-176,-130,-103,-631
26,14,-31,-98,-134,-133,-113,-57,-526
-25,-2,-30,-65,-37,-43,-61,-18,-281
21,48,-12,-74,-98,-98,-80,7,-286
-60,50,-46,-153,-28,-66,-55,-4,-362
-26,24,-29,-122,-79,-94,-96,-25,-447
-15,-34,-36,-78,-102,-61,-53,-17,-396
-27,-5,-36,-85,-39,-25,-60,-9,-286
-36,-31,-72,-74,-90,-68,-99,-39,-509
67,122,80,-163,-77,-209,-53,106,-127
-104,185,-105,-358,-194,-154,-187,-90,-1007
-22,-13,-30,-158,-149,-105,-114,28,-563
-26,-2,-19,-90,-30,-71,-42,-47,-327
29,65,-26,-88,-86,-119,-71,-58,-354
196,195,97,-43,19,-161,-184,162,281
15,12,-28,-12,-36,-38,-43,-43,-173
-12,-11,-47,-88,-99,-72,-72,-39,-440
-27,44,-48,-146,-33,-53,-70,17,-316
33,23,16,-1,-5,-12,-7,8,55
299,300,75,-225,39,-302,-220,132,98
0,8,-2,-21,-17,-16,-16,-5,-69
2,4,10,-12,-6,-4,-2,7,-1
0,100,-52,-110,-42,-52,-9,73,-92
148,140,1,-197,-108,-188,-205,127,-282
-56,69,-82,-266,-75,-95,-125,-46,-676
44,42,-2,-86,-75,-117,-25,-23,-242
-88,-28,-71,-181,-133,-69,-100,-28,-698
-19,13,-18,-61,-10,-35,-22,-16,-168
-51,-13,-39,-131,-96,-49,-77,48,-408
-17,9,-35,-83,-110,-43,-59,-31,-369
-70,-41,-63,-102,-75,-52,-71,-38,-512
-20,33,-15,-19,-19,-12,-19,-17,-88
60,39,-25,-106,-54,-114,-52,21,-231
-82,-14,-64,-125,-94,-76,-128,-12,-595
163,46,61,-80,-104,-221,-126,-25,-286
-18,16,-78,-132,-90,-102,-128,-65,-597
51,65,23,-78,24,-40,-63,28,10
-62,39,-134,-202,-110,-91,-179,-58,-797
-25,-11,-57,-123,-87,-64,-70,-58,-495
42,11,12,10,13,-54,-53,5,-14
26,19,-47,-69,-32,-89,-61,-24,-277
18,80,-29,-103,-3,-61,-43,45,-96
-16,60,-51,-173,-104,-82,-73,-41,-480
-49,114,-8,-225,-4,-118,-52,-34,-376
-65,15,-162,-222,-185,-205,-269,-138,-1231
213,114,-35,-251,-153,-361,-272,-42,-787
-74,86,-77,-239,-97,-103,-114,60,-558
-254,-45,-274,-686,-507,-372,-458,-153,-2749
35,108,-22,-132,-92,-89,-69,61,-200
314,274,63,-162,-254,-267,-109,-41,-182
-25,21,-50,-201,-156,-180,-165,-72,-828
2,0,-4,-10,-14,-6,-13,11,-34
142,108,8,-151,56,-141,-84,48,-14
-32,-6,-88,-136,-83,-120,-166,-27,-658
-45,-18,-53,-144,-98,-65,-133,-9,-565
-22,7,-12,-32,-23,-21,-25,-12,-140
-36,15,-35,-98,-66,-39,-45,17,-287
-70,19,-80,-166,-48,-78,-55,-14,-492
75,95,-5,-170,-12,-92,-79,30,-158
-5,33,-22,-83,-91,-59,-58,-10,-295
-31,46,-40,-117,-94,-44,-75,24,-331
-59,11,-18,-55,-12,-20,-37,-17,-207
53,737,-298,-945,-264,-434,-143,388,-906
43,90,-47,-107,-56,-61,-89,-66,-293
-159,36,-228,-418,-282,-257,-280,-95,-1683
-80,26,-75,-190,-61,-110,-113,-53,-656
-59,29,-85,-193,-101,-92,-85,-22,-608
-139,32,-127,-277,-155,-144,-177,-9,-996
-33,17,-63,-203,-120,-151,-104,-71,-728
8,69,-40,-238,-183,-150,-143,33,-644
32,28,-3,-4,-14,-39,-19,-11,-30
-83,45,-104,-282,-214,-185,-272,-25,-1120
180,151,34,-212,29,-214,-105,96,-41
129,163,-28,-185,-43,-132,-79,139,-36
-3,110,-28,-124,-77,-89,-41,11,-241
13,-32,-31,-103,-179,-131,-74,-15,-552
-9,-73,-82,-212,-135,-210,-192,-116,-1029
-13,22,-58,-69,-74,-24,-76,-41,-333
-31,34,-2,-91,-85,-71,-17,9,-254
-37,-16,-27,-96,-68,-36,-54,4,-330
-60,59,-52,-90,-29,-54,-19,60,-185
-8,-18,-15,-28,-74,-49,3,26,-163
32,36,-3,-71,-19,-12,-16,76,23
-17,-11,-16,-67,-88,-70,-75,-1,-345
-2,-10,-29,-93,-103,-114,-89,24,-416
28,49,-15,-110,-63,-101,-96,38,-270
-36,-1,-53,-133,-98,-41,-99,-31,-492
-30,-16,-33,-143,-126,-109,-76,-9,-542
-26,-18,-68,-138,-93,-102,-96,-51,-592
-87,-19,-98,-207,-183,-123,-170,-31,-918
-5,10,-50,-132,-155,-124,-83,-7,-546
31,17,2,-102,-72,-70,-92,5,-281
-40,-12,-82,-168,-176,-111,-120,-42,-751
20,17,-3,-28,-72,-72,-30,-20,-188
70,44,2,-92,-8,-90,-52,-8,-134
-22,65,-60,-192,-115,-137,-101,-11,-573
-40,20,-48,-108,-14,-49,-25,-33,-297
2,50,-71,-171,-99,-129,-133,-72,-623
-11,46,-30,-147,-127,-131,-99,-72,-571
-80,12,-102,-180,-143,-105,-186,-28,-812
-29,6,-58,-72,-29,-34,-50,-26,-292
-83,-22,-75,-166,-134,-23,-100,40,-563
-10,9,-32,-65,-57,-55,-58,-7,-275
6,64,5,-40,-22,-17,10,41,47
-1,15,-21,-99,-52,-97,-66,-28,-349
-73,-28,-63,-151,-108,-93,-104,-32,-652
51,-14,-10,-59,-62,-81,-67,-18,-260
-109,-20,-82,-174,-95,-90,-114,-5,-689
71,25,17,-57,-10,-101,-47,-18,-120
-1,18,-15,-52,-15,-47,-33,-17,-162
-146,398,-171,-735,-105,-282,-333,-247,-1621
-56,8,-27,-101,-55,-22,-61,-6,-320
54,87,-17,-290,-123,-186,-142,96,-521
-31,20,-29,-98,-45,-43,-31,3,-254
-29,2,-29,-63,-47,-14,-14,0,-194
-1,-12,-48,-64,-44,-68,-50,-28,-315
-35,18,-87,-177,-108,-110,-138,-35,-672
-51,10,-73,-134,-72,-66,-103,-4,-493
-75,-40,-71,-122,-110,-66,-88,-9,-581
-19,17,-16,-54,-41,-7,-22,-24,-166
-22,24,-27,-123,-37,-78,-59,25,-297
-15,-2,-10,-21,-9,-5,-16,-5,-83
-31,-24,-40,-108,-83,-64,-79,16,-413
5,18,-5,-23,-44,-27,-36,-24,-136
24,9,-24,-102,-116,-170,-125,-6,-510
-39,-31,-46,-107,-68,-48,-58,-2,-399
3,1,-16,-62,-34,-69,-44,9,-212
0,31,-32,-117,-29,-95,-67,-61,-370
-109,-27,-159,-223,-157,-120,-232,-31,-1058
9,-2,-23,-31,-15,-32,-25,-11,-130
-26,2,-51,-96,-170,-117,-113,-6,-577
-63,36,-66,-209,-113,-105,-104,-13,-637
-48,-39,-124,-183,-177,-135,-182,-86,-974
-4,1,-12,-47,-45,-40,-15,-32,-194
4,92,-52,-167,-27,-96,-67,-43,-356
9,19,-24,-81,-82,-55,-66,7,-273
4,6,1,4,-7,2,4,14,28
-39,104,-45,-119,-35,-43,3,98,-76
0,14,-47,-77,-83,-108,-97,-66,-464
-22,-27,-23,-123,-63,-94,-100,8,-444
-42,-31,-61,-90,-102,-94,-84,3,-501
-10,49,-39,-123,-22,-83,-76,-64,-368
-5,8,-17,-43,-83,-27,-55,-27,-249
-22,26,-89,-171,-67,-96,-128,-33,-580
-7,-2,-23,-37,-29,-27,-34,-6,-165
-47,22,-108,-166,-168,-141,-167,-63,-838
-16,-18,-66,-108,-89,-98,-111,-47,-553
-149,52,-85,-252,-106,-135,-113,-63,-851
0,115,-46,-190,-41,-113,-83,-5,-363
32,64,-18,-102,-102,-93,-51,-86,-356
0,-4,-20,-40,-60,-53,-35,-10,-222
-24,23,-36,-86,-48,-58,-63,-28,-320
3,59,-63,-204,-76,-191,-114,-85,-671
2,35,-13,-18,0,-7,5,4,8
32,31,-13,-42,-85,-122,-78,-34,-311
-48,27,-75,-154,-26,-52,-72,15,-385
33,85,10,-83,-32,-101,-54,5,-137
2,109,-3,-165,-52,-58,-67,5,-229
-21,12,-35,-67,-39,-44,-41,-27,-262
-13,28,-10,-37,-31,-24,-1,0,-88
33,80,-46,-182,-95,-96,-99,46,-359
5,114,-20,-183,-77,-65,-58,60,-224
-31,7,-100,-138,-126,-109,-130,-84,-711
-41,93,-34,-100,-51,-44,-56,10,-223
30,55,-15,-43,-34,-81,-63,-25,-176
79,87,-3,-55,-103,-95,-75,-30,-195
-68,-49,-88,-115,-94,-102,-132,-32,-680
-51,9,-71,-116,-46,-58,-85,-27,-445
-119,33,-90,-303,-181,-111,-127,7,-891
-49,-1,-43,-92,-46,-8,-35,-3,-277
114,21,23,-115,42,-105,-85,133,28
2,5,-34,-108,-136,-116,-76,-19,-482
-39,-29,-38,-99,-81,-81,-74,7,-434
-14,111,-1,-79,-3,-79,16,71,22
-5,-5,-13,-28,-24,-11,-9,-6,-101
-69,49,-101,-221,-108,-89,-122,-46,-707
48,18,-18,-26,-36,-78,-49,-27,-168
51,90,-19,-200,-82,-172,-174,4,-502
19,7,-20,-116,-61,-77,-101,17,-332
-20,16,-23,-95,-23,-26,-63,1,-233
-22,-11,-46,-88,-80,-71,-75,-22,-415
12,35,-16,-36,-19,-29,6,26,-21
23,48,-26,-110,-48,-76,-69,-21,-279
-6,-5,-28,-41,-30,-36,-22,1,-167
-25,-6,-29,-48,-8,-20,-27,-27,-190
13,22,4,-44,-26,-62,-23,9,-107
-22,-2,-15,-94,-69,-76,-78,-40,-396
5,-7,-1,-33,-18,-46,-28,-16,-144
-34,-9,-27,-62,-38,-51,-62,-13,-296
1,9,-5,-47,5,-27,-21,2,-83
-17,7,-15,-66,-30,-32,-18,8,-163
-16,43,-20,-41,-6,10,10,9,-11
114,65,-11,-215,-62,-185,-126,3,-417
0,121,-51,-253,-52,-165,-130,-42,-572
2,13,-35,-105,-55,-80,-92,-15,-367
-14,34,-3,-49,-20,-16,6,32,-30
7,19,-37,-132,-81,-103,-60,-12,-399
-64,-15,-113,-198,-85,-110,-134,-45,-764
43,24,-16,-80,7,-74,-65,-21,-182
1,-4,-28,-58,-81,-42,-66,2,-276
51,122,-38,-162,-26,-129,-92,70,-204
-84,30,-72,-222,-95,-123,-86,-4,-656
-7,0,-23,-20,-29,-23,-25,-22,-149
33,16,-8,-40,-34,-57,-28,3,-115
16,-4,-17,-47,-65,-48,-42,-8,-215
-44,17,-46,-168,-52,-101,-73,10,-457
-31,-11,-61,-96,-71,-78,-77,-35,-460
-26,-23,-54,-117,-83,-74,-75,-1,-453
22,30,-10,-68,-41,-59,-37,16,-147
-111,1,-115,-248,-152,-99,-155,22,-857
-86,-18,-81,-123,-85,-54,-95,-16,-558
48,75,-98,-296,-93,-293,-241,-127,-1025
-65,-7,-45,-133,-38,-42,-49,5,-374
2,2,-14,-35,-21,-37,-18,-31,-152
-61,-5,-64,-119,-90,-80,-138,-29,-586
-66,43,-63,-143,-116,-74,-64,25,-458
1,-15,-30,-146,-173,-152,-141,2,-654
-69,81,-72,-164,-47,-112,-72,47,-408
-16,-8,-68,-71,-76,-86,-92,-69,-486
9,26,-26,-48,-22,-31,-35,-13,-140
5,32,-35,-133,-52,-84,-79,8,-338
-52,-32,-52,-92,-86,-42,-102,17,-441
68,7,7,-110,-53,-163,-71,60,-255
-22,18,-18,-65,-17,-39,-35,5,-173
-20,1,-16,-27,-6,-16,-11,-9,-104
-13,16,-15,-28,-13,-16,-12,3,-78
95,-28,61,-51,8,-48,-62,40,15
-68,-17,-115,-177,-200,-118,-224,9,-910
-12,16,-108,-150,-196,-129,-172,-84,-835
-21,10,-36,-105,-35,-76,-72,27,-308
-75,63,-139,-324,-197,-146,-246,46,-1018
-14,10,-10,-49,-21,-39,-21,-17,-161
14,65,-16,-81,-55,-59,-54,24,-162
-47,17,-47,-103,-42,-42,-52,7,-309
22,29,-49,-66,-85,-80,-60,-69,-358
20,17,-43,-36,-60,-60,-78,-24,-264
-17,4,-12,-48,-9,-34,7,11,-98
28,24,-22,-67,-50,-81,-47,-25,-240
-6,12,-15,-39,0,-4,-13,1,-64
-28,29,-32,-82,-28,-57,-40,-14,-252
-52,14,-59,-125,-96,-62,-74,-10,-464
-69,184,-83,-386,-247,-291,-266,-6,-1164
74,91,1,-33,-63,-86,-66,-3,-85
49,7,-24,-22,-95,-82,-25,-60,-252
-25,-14,-39,-55,-45,-48,-63,-8,-297
-13,-7,-18,-33,-28,-14,-26,11,-128
79,0,1,-17,-17,-62,-34,-2,-52
-63,-23,-46,-161,-92,-80,-77,-49,-591
35,60,-54,-164,-34,-121,-82,-110,-470
-18,9,-32,-59,-26,-36,-55,-23,-240
3,11,-28,-56,-27,-45,-38,-7,-187
-34,11,-29,-84,-40,-35,-61,-23,-295
-32,15,-52,-98,-51,-59,-110,-36,-423
3,7,-12,-78,-90,-41,-35,-6,-252
-78,6,-71,-192,-173,-130,-148,-26,-812
-24,-11,-16,-53,-54,-49,-41,-9,-257
-17,1,-11,-28,-7,10,5,-11,-58
23,19,-3,-39,-35,-81,-58,-13,-187
9,18,-6,-8,-1,-14,16,16,30
-9,-11,-9,-22,-51,-34,-21,-16,-173
13,10,-7,0,-17,-6,-10,-23,-40
21,25,-24,-152,-8,-103,-110,29,-322
-47,13,-30,-127,-30,-33,-67,-35,-356
4,102,-18,-97,-24,-47,-94,8,-166
-51,27,-82,-182,-113,-116,-107,-36,-660
-51,14,-51,-192,-168,-100,-88,-20,-656
-8,-6,-4,-19,-17,-3,-10,3,-64
-17,14,-64,-164,-84,-86,-69,-16,-486
17,19,-5,-58,-36,-47,-58,-4,-172
-47,54,-77,-191,-102,-119,-134,-26,-642
79,80,15,8,4,-27,-20,77,216
1,27,-10,-102,-71,-78,-52,-32,-317
50,31,29,3,-23,-69,-30,24,15
-47,17,-71,-171,-125,-115,-165,9,-668
0,-2,-16,-19,-25,-8,-18,-7,-95
-15,59,-25,-101,-24,-30,-42,-12,-190
54,26,15,-66,-51,-74,-64,9,-151
120,122,1,-96,-67,-201,-138,-107,-366
-48,45,-105,-266,-187,-153,-125,46,-793
-92,-19,-80,-156,-12,-49,-32,-26,-466
-2,75,-5,-207,-25,-121,-69,-9,-363
-57,53,-35,-117,-37,-62,-30,28,-257
24,10,16,-36,-47,-56,-18,-7,-114
19,5,-16,-56,-48,-75,-35,-35,-241
-10,31,1,-83,-42,-42,-88,41,-192
-23,4,-15,-75,-51,-36,-36,1,-231
-40,-14,-66,-84,-77,-71,-95,-36,-483
-76,42,-117,-301,-214,-190,-180,-16,-1052
10,27,1,-16,-12,-20,-15,7,-18
-39,25,-19,-62,-9,-26,-39,-26,-195
-36,7,-19,-74,-80,-33,-60,7,-288
-42,12,-20,-98,-47,-27,-42,21,-243
-9,36,-41,-88,-26,-62,-45,-18,-253
-16,-8,-40,-88,-40,-65,-58,-29,-344
-52,5,-62,-119,-64,-69,-69,-29,-459
-44,54,-47,-117,-61,-72,-100,-61,-448
-62,-23,-44,-98,-83,-43,-82,37,-398
-49,-4,-44,-102,-66,-48,-65,-10,-388
-13,-15,-10,-123,-35,-62,-40,44,-254
-9,23,-20,-51,-4,-16,-30,-32,-139
-5,2,-24,-92,-50,-69,-83,-34,-355
37,4,17,-16,-20,-39,-14,-10,-41
48,60,8,-39,-57,-40,12,83,75
15,22,-15,-58,0,-53,-35,11,-113
148,121,57,-38,-59,-99,-31,18,117
-85,151,-30,-147,-17,-70,-85,1,-282
-25,-18,-10,-53,-31,-45,-12,9,-185
-37,-8,-11,-59,-39,-30,-47,18,-213
-80,97,-69,-118,-59,-65,-63,-14,-371
-17,2,-43,-89,-88,-74,-55,-46,-410
-58,22,-63,-134,-91,-76,-100,-11,-511
-11,15,-53,-65,-47,-57,-64,-54,-336
57,157,57,-135,68,-72,-20,71,183
4,-13,-11,-28,-30,-32,-42,-6,-158
-82,80,-62,-133,-65,-28,-52,-40,-382
21,45,4,-26,29,-9,-2,50,112
54,23,-19,-55,-27,-52,-48,12,-112
-32,-13,-64,-96,-98,-89,-57,-20,-469
-12,16,-40,-47,-16,-33,-29,-21,-182
26,19,9,-78,-78,-92,-47,14,-227
-22,14,-46,-205,-99,-99,-54,-27,-538
196,-6,70,1,77,51,-47,78,420
-9,8,-15,-48,-7,-33,-14,-20,-138
5,104,-9,-142,-24,-64,-29,41,-118
-152,122,-144,-470,-224,-189,-223,-10,-1290
354,314,350,327,254,-6,-124,244,1713
42,28,20,-84,39,-88,-60,-3,-106
38,77,-9,-54,-43,-70,-46,50,-57
-3,44,-15,-46,-10,-18,-51,-4,-103
48,22,11,-37,-40,-54,-21,7,-64
-37,123,77,-152,121,87,-28,-54,137
-62,239,-174,-456,-102,-225,-138,-1,-919
16,13,-8,-68,1,-21,-30,34,-63
-7,47,-38,-60,-39,-50,-30,-5,-182
-90,22,-90,-197,-108,-15,-84,31,-531
-20,15,-83,-135,-108,-128,-128,-61,-648
-6,-1,-12,-25,-20,-23,-32,-7,-126
26,9,17,-16,-38,-76,-71,-6,-155
17,-8,-10,-19,-26,-24,-19,5,-84
-33,6,-67,-107,-85,-88,-93,-22,-489
-34,29,-69,-92,-37,-74,-102,-20,-399
44,59,-45,-100,-125,-152,-83,-97,-499
-119,68,-62,-196,-53,-78,-85,-39,-564
24,17,-22,-92,-66,-64,-17,-3,-223
-60,95,-79,-262,-68,-108,-93,40,-535
-20,30,-29,-114,-19,-43,-41,-2,-238
-34,17,-38,-154,-14,-52,-44,13,-306
-38,22,-55,-165,-110,-170,-95,-52,-663
-103,81,-64,-180,-52,-63,-48,0,-429
0,27,-35,-129,-89,-90,-41,-28,-385
-4,38,-23,-40,15,-9,-1,-12,-36
-5,54,-22,-155,24,-61,-77,-9,-251
-8,30,-156,-183,-317,-229,-194,-237,-1294
72,54,-51,-151,-159,-158,-114,0,-507
8,15,-2,-23,-27,-35,-17,-1,-82
-40,21,-28,-102,-37,-58,-47,-5,-296
-97,-40,-73,-162,-77,-66,-64,-23,-602
67,20,-4,-143,-71,-122,-88,-71,-412
-54,-21,-52,-71,-75,-25,-82,4,-376
-11,-4,-30,-20,-14,-39,-34,-7,-159
65,49,19,5,-13,-46,-23,-8,48
60,128,18,-47,25,-82,-78,-15,9
-112,112,-50,-303,-96,-95,-178,-114,-836
4,42,-53,-54,-22,-46,-75,2,-202
-22,12,-18,-47,-24,-16,-30,-3,-148
92,15,-10,22,-13,-89,-75,27,-31
-29,5,-36,-77,-35,-43,-47,-21,-283
-18,30,-13,-52,-17,-18,-4,7,-85
-22,17,-20,-68,-30,-30,-29,-33,-215
70,28,28,-15,-14,-47,-17,-11,22
-9,-20,-14,-64,-44,-36,-40,2,-225
-111,101,-68,-182,-46,-30,-78,-64,-478
3,23,-15,-30,-19,-14,-19,-4,-75
-8,93,-34,-174,-81,-151,-92,84,-363
-85,64,-21,-121,-38,-53,-38,14,-278
-1,16,-42,-79,-60,-51,-40,-30,-287
12,45,-9,-102,-87,-100,-42,-33,-316
-33,24,-17,-83,-36,-34,-24,2,-201
-28,10,-9,-64,-70,-9,-47,26,-191
-26,-6,-16,-54,-34,-35,-25,-5,-201
-10,17,-21,-50,-23,-39,-27,-10,-163
-37,-7,-55,-99,-89,-92,-98,-55,-532
-4,30,-22,-96,-68,-70,-48,-34,-312
-32,-27,-69,-126,-119,-115,-84,-42,-614
-66,-1,-93,-139,-111,-66,-123,-23,-622
14,19,-47,-74,-106,-97,-68,-46,-405
-11,7,-22,-85,-16,-58,-52,5,-232
-29,15,-28,-55,-49,-30,-27,-17,-220
87,80,38,-113,-4,-95,-31,-36,-74
-17,73,-29,-128,-52,-86,-68,-12,-319
57,3,-59,-60,-26,-68,-75,-33,-261
-57,107,-63,-149,-44,-3,-66,3,-272
-41,35,-88,-170,-101,-50,-122,-42,-579
22,59,-29,-76,-66,-52,-40,2,-180
5,21,-8,-37,-23,-39,-35,-14,-130
29,22,5,-134,-6,-74,-72,60,-170
-66,-30,-44,-133,-90,-79,-82,-28,-552
-43,-24,-63,-94,-74,-55,-87,-53,-493
-21,11,-9,-31,-1,3,9,-4,-43
18,12,21,-57,14,-42,-58,16,-76
80,111,-22,-86,-79,-70,-89,92,-63
-90,54,-27,-137,-40,-52,-91,8,-375
3,19,-15,-64,-27,-54,-42,-12,-192
32,17,13,-37,-24,-57,-16,-1,-73
-17,-1,-19,-65,-48,-58,-26,-29,-263
221,169,25,-92,-16,-187,-96,20,44
-36,-7,-14,-60,-52,-28,-24,6,-215
-17,56,-29,-74,-34,-20,-23,-7,-148
-71,38,-74,-235,-115,-169,-136,12,-750
-82,65,-94,-316,-112,-137,-188,-83,-947
-10,52,-66,-230,-203,-302,-263,-78,-1100
-35,-9,-61,-84,-66,-77,-101,-31,-464
-17,33,-32,-120,-32,-89,-67,-41,-365
-104,130,-5,-156,-51,-69,-38,60,-233
-6,36,-18,-63,-41,-52,-29,-25,-198
-1,-13,-12,-83,-52,-57,-52,8,-262
-20,47,-38,-114,-6,-51,-41,20,-203
-48,57,-29,-109,-19,-55,-69,25,-247
-16,67,-16,-122,-24,-47,-78,-98,-334
-45,-16,-56,-78,-31,-3,-19,-5,-253
-28,-11,-23,-51,-51,-34,-40,-17,-255
0,16,-43,-67,-135,-99,-60,-42,-430
3,62,-21,-273,-182,-223,-143,-43,-820
-54,-5,-49,-115,-75,-79,-91,-35,-503
-46,55,-40,-220,-146,-73,-73,30,-513
-34,100,-19,-63,32,-7,41,37,87
10,-33,-15,-41,-94,-101,-94,-35,-403
-55,-4,-65,-123,-71,-51,-63,-49,-481
-59,11,-56,-121,-36,-59,-53,-32,-405
3,55,18,-102,1,-80,-16,4,-117
16,8,-1,-22,-28,-38,-16,-22,-103
46,36,-106,-220,-216,-260,-189,-170,-1079
111,101,-27,-181,-13,-165,-105,14,-265
-8,42,-37,-69,-17,2,-4,-31,-122
-61,-6,-55,-132,-99,-107,-110,-68,-638
3,29,-5,-109,-15,-44,-76,-25,-242
-89,35,-30,-143,-103,-73,-65,-44,-512
15,15,-10,-55,-10,-76,-58,8,-171
-1,26,5,-26,-14,-24,-18,14,-38
6,14,-41,-111,-101,-79,-72,-19,-403
37,34,0,-74,-110,-110,-84,15,-292
69,36,-45,-119,-135,-161,-116,-88,-559
-27,7,-40,-94,-83,-58,-38,6,-327
22,31,-25,-84,-70,-78,-70,24,-250
-25,56,-46,-102,4,-30,-36,-40,-219
-4,14,0,-35,-18,-8,1,28,-22
31,16,23,-43,-1,-64,-27,12,-53
3,19,-10,-86,-41,-68,-30,-2,-215
-26,46,-24,-50,19,7,31,20,23
19,2,10,-44,1,-46,-33,0,-91
-20,10,-5,-41,-28,-35,-24,2,-141
-55,-17,-78,-184,-104,-118,-124,-3,-683
-48,6,-52,-124,-72,-65,-93,-6,-454
2,6,-15,-38,-29,-32,-14,-6,-126
12,82,-20,-113,-26,-62,14,46,-67
-40,41,-33,-177,-44,-70,-42,62,-303
43,52,45,26,-23,5,-7,9,150
-53,79,-70,-155,-49,-58,-97,-16,-419
-39,37,-55,-109,-102,-68,-92,-18,-446
28,-10,-24,-116,-67,-114,-81,-47,-431
-105,216,-218,-475,-122,-212,-174,-4,-1094
200,282,121,69,-72,-10,24,-68,546
48,43,-48,-126,-106,-138,-89,-75,-491
35,-18,7,-33,-17,-16,-52,56,-38
-9,17,-12,-44,0,-30,-42,14,-106
-33,39,-33,-122,-55,-54,-59,25,-292
18,9,4,-47,-27,-50,-17,13,-97
-19,16,-16,-49,-11,-20,-32,8,-123
25,22,6,-76,-4,-67,-19,-3,-116
-58,12,-47,-146,-52,-56,-57,-22,-426
27,-2,17,-64,-58,-89,-27,10,-186
-2,37,-9,-89,-30,-62,-39,56,-138
-40,125,-45,-161,-25,-35,-53,18,-216
-27,5,-18,-103,-62,-40,-52,14,-283
-21,25,-18,-92,-76,-67,-57,2,-304
-69,6,-102,-170,-158,-112,-171,-22,-798
-103,55,-102,-210,-77,-97,-117,-19,-670
-62,49,-51,-116,-45,-47,-66,-26,-364
-53,37,-52,-163,-65,-49,-85,-87,-517
-117,-17,-98,-243,-163,-94,-121,14,-839
-41,3,-59,-89,-102,-93,-104,-67,-552
-11,37,-10,-105,0,-35,10,43,-71
-82,-29,-101,-166,-85,-85,-82,-20,-650
3,40,-30,-144,-20,-97,-64,-49,-361
-79,36,-52,-152,-61,-36,-83,6,-421
39,-10,26,-109,-6,-116,-67,-41,-284
-74,28,-14,-206,-50,-123,-80,-24,-543
-24,37,-15,-140,-142,-134,-128,23,-523
-25,25,-24,-102,-74,-88,-87,11,-364
20,21,-7,-7,-11,-18,-17,5,-14
71,159,9,-151,38,-116,-8,104,106
21,12,-15,-79,-36,-64,-49,-3,-213
7,35,4,-75,10,-56,-37,24,-88
-5,25,-29,-44,-7,-20,-5,-6,-91
21,24,-16,-120,-186,-165,-138,-74,-654
14,41,-21,-115,-57,-93,-47,-42,-320
6,39,3,-56,-20,-34,-16,1,-77
-68,-4,-101,-163,-109,-46,-118,32,-577
14,53,-88,-199,-140,-222,-149,-89,-820
6,16,-18,-26,-24,-32,-33,-14,-125
88,48,10,-98,-23,-155,-73,-66,-269
64,44,-21,-150,-120,-193,-124,-87,-587
18,28,-10,-66,-6,-65,-39,-13,-153
-11,74,-26,-91,-18,-48,-18,38,-100
-26,34,-78,-154,-146,-130,-116,-26,-642
-19,23,-12,-63,-36,-34,-43,11,-173
-54,82,-41,-268,-78,-151,-110,131,-489
6,33,-39,-81,-104,-86,-89,26,-334
8,21,-9,-43,-28,-66,-4,-13,-134
22,13,-8,-29,-21,-35,-17,-4,-79
-52,-56,-79,-170,-102,-107,-126,-56,-748
-49,110,-112,-293,-101,-128,-120,13,-680
-18,9,-22,-59,-63,-45,-44,7,-235
-66,36,-13,-137,-55,-85,-17,42,-295
35,75,-3,-102,-26,-107,-40,-8,-176
39,36,0,-79,-40,-108,-73,41,-184
-57,-38,-49,-92,-132,-40,-86,-21,-515
-52,84,-148,-328,-151,-203,-225,-51,-1074
0,-8,-19,-33,-62,-56,-22,-4,-204
-60,38,-50,-186,-92,-73,-67,-32,-522
-60,117,-118,-321,-76,-92,-219,-202,-971
2,3,-30,-48,-86,-74,-48,-7,-288
-65,6,-59,-120,-60,-70,-65,-11,-444
49,64,-165,-215,-357,-332,-249,-257,-1462
-199,-58,-182,-341,-295,-155,-256,-29,-1515
-121,151,-88,-187,-64,-41,-60,7,-403
-5,67,-23,-126,-31,-69,-59,78,-168
-97,242,-178,-481,-350,-303,-348,90,-1425
-33,-2,-60,-133,-205,-112,-115,-22,-682
4,87,-77,-234,-206,-157,-135,-43,-761
-153,64,-159,-309,-118,-87,-141,19,-884
-21,12,-39,-94,-41,-53,-26,-18,-280
24,2,-3,-42,-9,-53,-13,10,-84
14,33,-20,-94,-17,-68,-56,-15,-223
41,29,9,-39,-5,-45,-23,1,-32
-39,-27,-50,-62,-52,-41,-55,-13,-339
-71,-35,-88,-96,-147,-45,-136,-8,-626
91,75,21,-145,-6,-146,-113,-30,-253
-4,66,-88,-172,-117,-79,-103,-2,-499
23,48,8,-46,-19,-67,-34,7,-80
5,51,-30,-155,-85,-91,-137,2,-440
-24,27,-23,-91,-55,-50,-80,6,-290
-48,-5,-69,-90,-66,-66,-106,-28,-478
15,46,-33,-76,-26,-76,-50,-28,-228
-60,-19,-94,-172,-119,-95,-159,-67,-785
-3,-24,-42,-78,-103,-89,-106,-50,-495
24,55,1,-86,-36,-34,-1,-19,-96
-11,-35,-50,-147,-114,-148,-143,-35,-683
42,-5,3,-7,-29,-38,-16,-19,-69
-119,-68,-143,-234,-215,-105,-214,27,-1071
56,10,10,-6,-48,-43,-55,13,-63
-40,-23,-26,-92,-64,-49,-67,1,-360
-30,15,-56,-124,-85,-98,-99,-44,-521
-28,9,-53,-129,-64,-73,-88,-17,-443
4,-17,-34,-94,-113,-92,-128,5,-469
-80,1,-122,-201,-120,-81,-149,-26,-778
1,19,-35,-65,-103,-68,-70,-54,-375
-16,6,-104,-215,-170,-165,-188,-93,-945
-44,64,-98,-164,-121,-134,-170,-56,-723
23,80,-33,-149,-199,-199,-125,-31,-633
-43,2,-48,-84,-77,-39,-94,-37,-420
-63,-6,-73,-114,-66,-78,-130,-58,-588
57,11,-9,-98,-49,-141,-73,-1,-303
97,101,-46,-92,-65,-100,-46,-11,-162
4,19,-26,-108,13,-71,-61,-17,-247
-105,-18,-172,-319,-233,-209,-244,-108,-1408
21,39,-62,-58,-89,-66,-53,-74,-342
-14,17,-13,-59,-77,-54,-55,31,-224
-9,23,-17,-51,-34,-18,-48,-28,-182
-30,-13,-89,-157,-122,-97,-136,-27,-671
-25,-14,-23,-74,-99,-70,-61,-30,-396
-12,26,-27,-91,-62,-77,-84,-12,-339
0,28,-24,-106,-93,-114,-47,-57,-413
-96,-47,-122,-215,-134,-97,-183,10,-884
-10,16,-31,-98,-108,-39,-54,19,-305
43,29,17,-66,35,-48,-42,31,-1
-32,1,-33,-87,-64,-41,-66,11,-311
86,24,13,-30,-2,-57,-27,12,19
-22,25,-43,-89,-46,-58,-58,-18,-309
-3,1,10,-48,-5,-39,-31,26,-89
23,72,23,-45,-7,-41,-33,31,23
-36,29,-22,-65,-39,-36,-32,-6,-207
-5,19,3,-27,-13,-34,9,1,-47
13,22,-37,-93,-90,-61,-66,5,-307
62,87,-32,-120,-43,-129,-123,-52,-350
74,81,74,20,34,24,44,41,392
10,36,-15,-61,-18,-41,-39,35,-93
9,26,-56,-121,-151,-168,-121,-82,-664
-24,48,-72,-231,-95,-139,-106,-12,-631
-47,38,-36,-111,-79,-39,-74,40,-308
-25,-7,-13,-64,-33,-36,-57,5,-230
145,134,29,-162,15,-168,-63,-32,-102
25,28,10,-66,-22,-35,-15,46,-29
126,144,72,37,93,31,-46,7,464
33,58,19,-34,-22,-68,-41,0,-55
63,12,-4,-35,-129,-88,-83,-19,-283
-20,-1,-43,-115,-52,-56,-79,-8,-374
-63,23,-107,-147,-149,-95,-158,4,-692
51,120,21,-182,-25,-156,-64,60,-175
-33,9,-22,-126,-71,-72,-46,15,-346
22,75,-37,-140,-113,-134,-87,22,-392
3,19,-30,-63,-100,-79,-97,-37,-384
-2,95,3,-135,-11,-75,-27,25,-127
-52,-27,-34,-121,-78,-91,-118,-22,-543
-60,11,-96,-182,-193,-183,-214,-32,-949
-8,-35,-39,-116,-86,-111,-70,-48,-513
-33,8,-57,-176,-69,-61,-96,4,-480
-16,16,10,-62,-87,-22,-45,56,-150
-36,45,-32,-91,-43,-51,-50,-25,-283
57,66,-77,-133,-141,-153,-177,-112,-670
-53,-10,-42,-167,-70,-82,-121,-6,-551
-47,-6,-41,-106,-65,-57,-80,-14,-416
-1,18,-39,-155,-82,-141,-138,-38,-576
-116,27,-124,-309,-211,-129,-179,6,-1035
-385,120,-629,-1357,-789,-729,-883,-424,-5076
17,69,-13,-103,-45,-79,-54,72,-136
40,160,-60,-218,-76,-180,-48,-37,-419
-42,15,-57,-164,-170,-139,-152,-25,-734
-4,97,-32,-147,-22,-86,-47,84,-157
21,24,4,-50,-25,-56,-7,13,-76
-26,-2,-23,-41,-20,-22,-40,-15,-189
-47,14,-62,-140,-104,-107,-128,-39,-613
-19,79,2,-85,-17,-43,1,36,-46
-43,-15,-74,-129,-123,-101,-95,-10,-590
-27,-6,-23,-54,-64,-30,-22,7,-219
-21,-9,4,-52,-41,-76,-51,2,-244
-39,17,-39,-96,-53,-33,-85,16,-312
-22,3,-53,-58,-24,-29,-68,-41,-292
-159,-86,-177,-268,-220,-111,-252,-57,-1330
10,21,-34,-113,-79,-46,-63,25,-279
-66,30,-49,-157,-54,-74,-71,7,-434
-4,19,-11,-45,-28,-33,-25,-19,-146
-107,84,-62,-279,-89,-99,-129,-92,-773
50,60,-12,-136,-75,-152,-41,-55,-361
-4,3,-4,-13,-8,-16,-12,-8,-62
45,24,-47,-141,-110,-196,-153,-88,-666
72,55,-8,-17,-40,-88,-109,-1,-136
6,17,-26,-73,-41,-27,-45,15,-174
-36,-12,-61,-143,-107,-81,-101,5,-536
-113,76,-85,-336,-152,-120,-241,-183,-1154
-22,63,-17,-109,-30,-14,-32,-37,-198
31,52,-54,-197,-56,-170,-147,-14,-555
-68,37,-16,-146,-66,-48,-82,-49,-438
126,201,-56,-367,-92,-311,-226,-38,-763
34,102,-22,-191,-17,-103,-119,-30,-346
44,38,29,-3,14,-44,-52,18,44
-3,93,-68,-233,-65,-154,-143,-117,-690
105,79,72,-18,33,5,21,71,368
-49,67,-69,-271,-106,-135,-176,7,-732
-36,87,-72,-174,-94,-60,-73,0,-422
-50,-12,-59,-110,-72,-88,-49,-15,-455
-73,80,-70,-188,-35,-98,-73,80,-377
101,93,21,-110,16,-109,-80,79,11
3,-1,-43,-92,-65,-67,-60,-33,-358
16,-9,-26,-42,-78,-79,-35,-43,-296
222,327,-207,-1029,-1107,-899,-634,15,-3312
-128,32,-296,-593,-458,-514,-546,-385,-2888
-42,44,-99,-213,-83,-67,-64,32,-492
4,34,2,-62,21,-43,-31,-12,-87
113,-12,43,60,55,-40,-29,60,250
31,33,17,-11,4,8,5,7,94
-16,49,-11,-70,-38,-37,-10,-3,-136
48,83,-16,-64,-70,-92,-67,43,-135
-138,8,-168,-397,-303,-222,-258,-26,-1504
-231,322,-106,-752,-104,-254,-139,102,-1162
16,24,-65,-104,-162,-126,-101,-75,-593
9,59,-27,-93,-36,-56,-78,5,-217
14,155,-77,-261,-76,-123,-57,23,-402
75,86,27,-205,-2,-189,-133,103,-238
-248,97,-218,-561,-286,-166,-307,-42,-1731
-5,24,-31,-69,-130,-40,-133,-2,-386
-50,30,-26,-105,-42,-42,-16,8,-243
-144,40,-60,-193,-72,-55,-46,-40,-570
135,130,71,-130,-93,-230,-97,-39,-253
-44,-24,-32,-48,-63,-16,-56,18,-265
-73,-22,-71,-148,-120,-121,-123,-72,-750
-179,66,-135,-422,-219,-110,-230,-106,-1335
551,631,296,-15,424,-11,-54,460,2282
-61,55,-61,-121,-33,-8,-42,0,-271
-126,-11,-239,-379,-307,-260,-360,-250,-1932
112,134,-17,-192,8,-222,-110,-10,-297
-29,13,-46,-113,-160,-76,-95,53,-453
81,146,-54,-315,-46,-232,-165,134,-451
-16,27,-17,-40,-26,-27,-19,13,-105
-29,10,-24,-61,-28,-29,-45,-3,-209
-15,20,-42,-51,-74,-68,-62,-71,-363
-9,25,-17,-56,-12,-51,-17,-14,-151
66,11,-6,-5,-74,-89,-36,-43,-176
25,22,-14,-62,1,-70,-52,-18,-168
66,92,5,-107,-34,-123,-95,120,-76
33,67,-43,-272,-41,-174,-158,58,-530
-20,23,-63,-123,-84,-117,-83,-68,-535
-100,-27,-123,-200,-118,-104,-181,-65,-918
-76,-56,-66,-155,-166,-81,-161,-12,-773
45,73,-118,-191,-185,-218,-153,-104,-851
-179,-5,-147,-392,-163,-130,-186,8,-1194
-86,30,-82,-230,-113,-108,-98,0,-687
-16,4,-52,-85,-55,-32,-40,15,-261
-70,62,-116,-240,-116,-161,-192,-74,-907
15,70,-19,-141,-3,-93,-37,17,-191
174,15,39,-53,-2,-86,-78,92,101
19,16,-32,-72,-147,-121,-99,-50,-486
-16,-2,-45,-148,-103,-131,-96,-39,-580
-17,-10,-29,-44,-19,-22,-16,3,-154
-22,98,-48,-200,-63,-32,-22,-17,-306
-79,-24,-65,-133,-75,-78,-88,-22,-564
-32,-13,-18,-95,-89,-82,-83,-41,-453
-35,-2,-24,-67,-25,-42,-54,-10,-259
-23,22,-25,-71,-24,-27,-38,2,-184
112,95,9,-162,-3,-181,-122,74,-178
-36,39,-45,-145,-82,-75,-70,19,-395
-6,-19,-40,-58,-57,-51,-69,-33,-333
-5,79,-43,-160,-27,-99,-68,17,-306
-68,17,-85,-227,-113,-124,-164,-29,-793
-51,25,-46,-117,-71,-153,-225,24,-614
-80,19,-88,-200,-95,-76,-113,-30,-663
-5,8,0,-22,11,-8,-4,4,-16
-151,11,-133,-281,-145,-158,-174,-47,-1078
32,114,-55,-214,-145,-176,-103,-23,-570
-77,35,-41,-133,-26,4,-49,-43,-330
-13,77,-10,-104,-38,-39,14,23,-90
-29,-22,-15,-69,-55,-42,-54,-6,-292
34,24,6,-47,0,-56,-13,26,-26
29,36,-5,-111,-123,-112,-44,-5,-335
-104,102,-82,-237,-39,-75,-60,-40,-535
-38,-4,-86,-184,-105,-142,-121,-70,-750
-30,38,-20,-142,-5,5,-76,-94,-324
-24,-11,-27,-50,-36,-41,-38,10,-217
-16,54,-9,-87,-44,-51,-40,-17,-210
-104,26,-61,-152,-40,-60,-70,10,-451
-60,-15,-48,-138,-66,-41,-67,-6,-441
-63,10,-45,-103,-47,-28,-63,-12,-351
-1,117,-26,-181,-95,-117,-131,43,-391
-50,148,-63,-229,-68,-116,-81,39,-420
-99,40,-78,-135,-56,-15,-46,-61,-450
-39,61,-78,-155,-151,-60,-110,19,-513
55,118,-28,-202,-24,-142,-116,70,-269
-88,45,-59,-255,-96,-113,-107,48,-625
-62,65,-152,-306,-127,-180,-171,-68,-1001
-22,116,-132,-346,-161,-185,-168,-38,-936
36,82,-47,-158,-47,-130,-39,-62,-365
29,79,17,-150,8,-96,-60,64,-109
21,25,-8,-51,-106,-99,-61,-31,-310
-113,48,-40,-168,-64,-78,-83,15,-483
-5,13,-27,-55,-22,-50,-48,-18,-212
18,17,-10,-36,-32,-46,-20,-7,-116
-62,22,-136,-218,-156,-136,-189,-34,-909
-52,-2,-78,-138,-134,-100,-94,-34,-632
0,-13,-47,-92,-103,-105,-88,-39,-487
-11,-1,-18,-24,-4,-18,-22,-18,-116
-15,1,-11,-29,-16,-6,-9,-3,-88
250,351,92,-143,-78,-370,-312,156,-54
0,37,-19,-78,-4,-32,-53,9,-140
-5,-39,-43,-120,-128,-141,-84,-72,-632
-104,-32,-157,-252,-181,-138,-213,-94,-1171
-19,39,-65,-153,-122,-107,-118,-13,-558
-40,-51,-29,-80,-88,-81,-69,-9,-447
-183,33,-194,-507,-272,-231,-201,-31,-1586
116,431,9,-422,123,-220,-6,302,333
-21,52,-66,-122,-12,-67,-62,-65,-363
-50,-5,-71,-85,-101,-78,-127,-28,-545
-21,-10,-24,-36,-24,-24,-29,-19,-187
-21,1,-19,-24,-7,-1,-31,-6,-108
-30,12,-17,-20,-15,-1,-17,-6,-94
-28,-2,-31,-78,-91,-47,-52,-6,-335
153,391,-39,-389,-85,-380,-258,88,-519
-23,8,-47,-97,-46,-48,-21,-14,-288
-46,11,-56,-124,-62,-80,-76,-21,-454
27,50,17,-78,-4,-85,-20,64,-29
0,26,-37,-113,-6,-65,-98,20,-273
-111,-57,-157,-246,-352,-183,-278,-83,-1467
488,604,119,-932,112,-518,-514,615,-26
-28,15,-38,-120,-97,-46,-69,3,-380
-8,-17,-62,-142,-154,-88,-102,-48,-621
-143,7,-271,-626,-400,-399,-375,-75,-2282
227,102,83,-81,61,-68,-159,94,259
-26,31,-26,-70,3,4,-35,-22,-141
12,31,11,-68,-44,-45,-56,6,-153
-682,861,-1155,-2805,-1441,-1588,-2201,-1028,-10039
-62,40,-49,-168,-25,-78,-43,1,-384
-58,117,-139,-388,-197,-223,-217,12,-1093
29,43,-9,-112,-67,-120,-55,-27,-318
-96,-50,-83,-160,-105,-67,-115,-48,-724
111,784,24,-471,-273,-193,3,329,314
-11,6,-113,-181,-195,-204,-160,-111,-969
17,19,3,-47,-54,-64,-22,4,-144
710,391,258,188,331,-218,-306,335,1689
-90,-45,-74,-209,-151,-70,-149,33,-755
4,13,-43,-173,-93,-138,-103,-73,-606
-31,54,-34,-150,-93,-110,-102,7,-459
-2,20,3,-71,-63,-45,-61,44,-175
-28,-2,-24,-52,-79,-39,-57,9,-272
43,45,30,-75,4,-33,-57,53,10
103,43,-4,-98,-11,-134,-83,12,-172
-25,17,-48,-190,-162,-153,-110,-8,-679
40,2,10,1,-36,-25,-46,-19,-73
-55,-5,-81,-121,-87,-81,-90,-33,-553
-83,-67,-66,-131,-121,-65,-109,16,-626
130,101,27,41,-6,-70,-81,-6,136
-30,24,-82,-183,-132,-136,-129,-73,-741
2,39,-47,-101,-54,-68,-35,-28,-292
-24,-24,-32,-120,-55,-83,-84,-33,-455
-87,36,-220,-365,-241,-265,-339,-158,-1639
-24,55,-74,-145,-84,-112,-111,39,-456
13,124,-59,-229,-59,-184,-158,42,-510
-36,-20,-18,-36,-31,-22,-31,-13,-207
-1,11,-26,-212,-150,-128,-88,61,-533
-3,18,-4,-37,-26,-24,-2,7,-71
-187,83,-265,-738,-626,-476,-576,43,-2742
-22,26,-53,-128,-65,-57,-91,-29,-419
-33,48,-110,-179,-77,-76,-112,26,-513
49,64,-30,-67,-43,-76,-32,4,-131
-35,-23,-23,-35,-37,-23,-40,5,-211
-87,9,-63,-198,-63,-54,-99,-93,-648
-36,41,-95,-245,-109,-212,-151,-84,-891
-108,-60,-113,-211,-153,-105,-137,-17,-904
29,48,-22,-161,-20,-143,-99,5,-363
23,96,-60,-91,-62,-59,-134,39,-248
-7,-27,-57,-147,-99,-116,-83,-13,-549
8,-25,-74,-140,-105,-113,-137,-26,-612
16,13,-15,-24,-28,-27,-19,-19,-103
11,-11,4,-34,-3,-3,-8,9,-35
-35,22,-49,-103,-47,-63,-70,20,-325
20,326,-103,-503,-85,-242,-134,144,-577
12,6,-19,-79,-62,-87,-73,-27,-329
-64,-19,-30,-113,-55,-67,-38,6,-380
755,397,448,164,446,193,-31,187,2559
45,35,2,-25,-65,-111,-73,-31,-223
-25,35,-37,-96,-96,-73,-46,-7,-345
28,117,-54,-164,-115,-185,-62,16,-419
-2,10,-1,-36,-43,-26,-38,-9,-145
-11,43,-52,-222,-115,-136,-152,105,-540
-67,-42,-59,-119,-156,-75,-121,2,-637
-103,35,-99,-292,-199,-175,-186,-27,-1046
-44,-13,-50,-145,-116,-89,-161,21,-597
91,7,15,-128,-115,-169,-125,-10,-434
20,50,-18,-90,-92,-119,-71,-94,-414
-92,-24,-102,-185,-104,-98,-119,-22,-746
3,23,-38,-98,-117,-78,-49,2,-352
-20,46,-98,-234,-122,-169,-144,-70,-811
-16,41,-34,-136,-81,-95,-93,-72,-486
-64,57,-105,-293,-166,-95,-137,54,-749
-52,-21,-76,-73,-90,-48,-90,-14,-464
84,107,17,-52,-60,-125,-4,94,61
-158,282,-161,-602,-237,-177,-205,95,-1163
-7,5,-11,-28,-3,-5,-4,-6,-59
24,12,-7,-22,-22,-47,-30,-19,-111
-115,26,-159,-248,-162,-157,-198,-56,-1069
-16,14,-23,-75,-39,-49,-38,-1,-227
109,36,33,-42,-35,-119,-37,-27,-82
-57,38,-66,-179,-102,-89,-98,-24,-577
-43,-4,-64,-121,-62,-78,-67,-12,-451
-96,-39,-75,-152,-123,-60,-135,-3,-683
-62,-18,-53,-101,-104,-90,-144,-50,-622
-56,-23,-53,-94,-111,-94,-141,-57,-629
-102,-37,-103,-147,-119,-82,-163,0,-753
-89,-38,-64,-127,-117,-69,-135,-1,-640
-70,-14,-68,-123,-95,-61,-137,5,-563
-80,-13,-70,-130,-107,-78,-135,-15,-628
-87,-18,-81,-159,-116,-101,-140,-22,-724
-84,-24,-61,-127,-114,-73,-130,2,-611
-80,-11,-83,-139,-106,-83,-119,-24,-645
-66,-13,-75,-144,-68,-64,-118,-22,-570
-77,1,-82,-151,-94,-68,-138,-23,-632
-47,10,-44,-111,-98,-95,-141,-19,-545
-57,20,-59,-115,-79,-72,-130,-15,-507
-82,3,-90,-161,-106,-88,-141,-38,-703
-84,-7,-65,-132,-97,-60,-136,-7,-588
-96,-23,-80,-148,-119,-82,-125,-20,-693
-75,4,-68,-135,-84,-71,-142,-17,-588
-43,2,-62,-108,-86,-95,-100,-38,-530
-95,-39,-90,-142,-90,-77,-133,-30,-696
-80,-7,-90,-132,-91,-58,-143,-42,-643
-81,-26,-60,-133,-104,-55,-115,-18,-592
-92,-43,-100,-142,-111,-64,-132,-20,-704
-70,-34,-75,-137,-103,-60,-114,-27,-620
-85,-53,-75,-153,-119,-79,-117,-19,-700
-86,-44,-68,-138,-95,-53,-148,-9,-641
-104,-57,-86,-154,-113,-52,-136,9,-693
-81,5,-78,-172,-99,-84,-153,-14,-676
-85,-22,-77,-168,-104,-81,-121,-12,-670
-95,-39,-53,-149,-116,-61,-136,-2,-651
-67,-46,-74,-127,-127,-80,-141,-54,-716
-68,-57,-78,-138,-127,-70,-132,-41,-711
-104,-18,-85,-183,-118,-71,-127,-5,-711
-91,-27,-75,-155,-84,-33,-112,-3,-580
-90,-26,-74,-156,-96,-43,-123,-11,-619
-102,-33,-84,-147,-106,-56,-117,2,-643
-84,-52,-84,-163,-107,-57,-130,-21,-698
-87,-44,-68,-153,-120,-83,-114,-26,-695
-80,-54,-77,-149,-106,-54,-117,-21,-658
-84,-22,-60,-144,-91,-47,-116,4,-560
-94,-30,-78,-175,-103,-77,-149,5,-701
-91,-35,-63,-134,-99,-62,-122,13,-593
-84,-37,-63,-142,-97,-55,-145,-11,-634
-79,-49,-70,-130,-108,-70,-124,5,-625
-88,-14,-77,-159,-93,-66,-131,-12,-640
-77,-14,-85,-138,-85,-56,-120,-22,-597
-77,-18,-64,-179,-123,-103,-120,-21,-705
-70,-27,-61,-133,-73,-61,-118,0,-543
-89,-19,-70,-156,-95,-77,-153,-12,-671
-103,-15,-45,-155,-102,-55,-126,1,-600
-82,-45,-80,-141,-134,-77,-142,-23,-724
-89,-28,-101,-145,-140,-90,-158,-45,-796
-64,-39,-73,-138,-125,-89,-104,-31,-663
-94,-37,-96,-152,-109,-98,-140,-64,-790
-72,-26,-56,-122,-104,-65,-125,-19,-589
-74,-29,-90,-140,-120,-101,-140,-42,-736
-90,-27,-94,-131,-114,-75,-137,-16,-684
-79,-39,-83,-157,-116,-60,-125,0,-659
-86,-43,-75,-145,-106,-63,-142,-25,-685
-95,-23,-82,-152,-103,-69,-147,6,-665
-85,-22,-88,-147,-106,-85,-132,-9,-674
-101,-38,-86,-139,-116,-86,-137,2,-701
-90,-22,-90,-149,-109,-76,-146,-5,-687
-87,-26,-73,-142,-95,-70,-122,3,-612
-120,-41,-116,-177,-108,-73,-144,-15,-794
-70,5,-88,-157,-82,-58,-125,10,-565
-70,3,-79,-144,-91,-83,-144,-13,-621
-95,-13,-84,-126,-86,-59,-130,10,-583
-79,0,-78,-151,-98,-62,-132,-1,-601
-75,-38,-100,-170,-94,-79,-125,-53,-734
-81,-29,-91,-150,-119,-93,-147,-41,-751
-89,-18,-99,-154,-111,-91,-161,-34,-757
-81,-45,-94,-172,-100,-80,-115,-49,-736
-100,-61,-75,-160,-114,-55,-117,-11,-693
-74,-44,-69,-121,-107,-65,-119,-24,-623
-72,-34,-105,-139,-107,-91,-120,-47,-715
-80,-30,-65,-130,-102,-71,-127,-27,-632
-80,-40,-96,-143,-102,-98,-136,-57,-752
-81,-3,-54,-151,-86,-70,-123,-22,-590
-95,-31,-70,-167,-106,-78,-129,-36,-712
-91,-24,-70,-145,-106,-60,-128,2,-622
-84,-15,-60,-121,-100,-67,-136,-3,-586
-64,-26,-55,-113,-115,-60,-140,13,-560
-80,-18,-73,-138,-109,-66,-138,-18,-640
-80,-26,-61,-133,-98,-67,-114,-12,-591
-91,-76,-86,-132,-133,-63,-131,-9,-721
-93,-62,-97,-154,-117,-71,-140,-14,-748
-101,-53,-94,-151,-113,-71,-122,-36,-741
-104,-50,-93,-165,-126,-102,-148,-45,-833
-101,-53,-93,-152,-111,-75,-131,-15,-731
-102,-50,-92,-147,-109,-78,-140,-19,-737
-61,-28,-91,-153,-106,-107,-132,-79,-757
-105,-48,-100,-171,-108,-93,-147,-38,-810
-87,-38,-75,-146,-116,-100,-135,-30,-727
-115,-24,-110,-188,-116,-102,-142,-49,-846
-106,-55,-102,-164,-132,-59,-117,-23,-758
-81,-64,-95,-118,-147,-100,-152,-71,-828
-82,-69,-83,-122,-144,-88,-148,-48,-784
-87,-40,-82,-151,-126,-101,-129,-37,-753
-61,-32,-60,-99,-111,-102,-145,-22,-632
-99,-50,-103,-178,-117,-67,-144,-2,-760
-99,-16,-79,-154,-96,-74,-132,-25,-675
-93,-28,-95,-172,-94,-66,-137,5,-680
-88,-22,-71,-146,-102,-78,-130,-23,-660
-81,-32,-79,-153,-76,-68,-130,-13,-632
-82,-19,-87,-160,-104,-57,-139,15,-633
-84,-18,-83,-140,-92,-65,-129,-33,-644
-90,-49,-87,-138,-99,-49,-132,-8,-652
-99,-24,-75,-140,-92,-64,-133,-18,-645
-91,-39,-65,-148,-92,-62,-128,-2,-627
-98,-45,-88,-169,-138,-78,-141,-19,-776
-93,-9,-67,-158,-105,-78,-137,10,-637
-82,-28,-63,-150,-105,-66,-127,-32,-653
-96,-19,-76,-181,-102,-101,-165,-58,-798
-77,-34,-87,-139,-133,-106,-148,-39,-763
-76,-38,-61,-124,-121,-90,-129,-2,-641
-83,-32,-66,-139,-107,-97,-131,-13,-668
-74,-27,-54,-138,-115,-89,-139,-13,-649
-68,-18,-53,-132,-103,-87,-124,-10,-595
-71,-20,-73,-125,-92,-61,-127,-28,-597
-90,-9,-70,-142,-101,-46,-112,3,-567
-92,-47,-83,-135,-102,-58,-133,-8,-658
-94,-5,-75,-158,-97,-77,-133,7,-632
-86,-39,-51,-133,-99,-53,-106,19,-548
-87,-56,-73,-139,-107,-59,-118,-4,-643
-83,-33,-69,-129,-93,-64,-127,-18,-616
-77,-26,-83,-141,-93,-70,-144,-19,-653
-79,-28,-70,-117,-117,-56,-140,19,-588
-67,-27,-64,-129,-124,-89,-134,-33,-667
-80,-42,-80,-126,-117,-91,-142,-44,-722
-95,-25,-87,-153,-94,-54,-141,-3,-652
-96,-28,-97,-158,-120,-93,-152,-41,-785
-69,-26,-82,-138,-109,-72,-143,-42,-681
-82,-27,-91,-130,-112,-68,-129,-31,-670
-64,-13,-83,-126,-92,-94,-137,-18,-627
-99,-23,-76,-171,-94,-90,-132,1,-684
-53,-19,-63,-111,-138,-125,-146,-56,-711
-39,-12,-69,-128,-123,-109,-119,-52,-651
-92,-15,-75,-154,-96,-71,-118,9,-612
-55,-30,-73,-132,-106,-105,-126,-42,-669
-92,-10,-83,-159,-71,-78,-101,-10,-604
-68,-7,-87,-133,-83,-78,-127,-36,-619
-78,-17,-63,-131,-120,-75,-137,-13,-634
-82,-4,-88,-157,-95,-75,-135,-34,-670
-82,-14,-67,-151,-92,-70,-126,-1,-603
-68,-6,-87,-136,-106,-91,-130,-43,-667
-82,-27,-71,-148,-99,-85,-148,-24,-684
-75,-21,-94,-133,-103,-62,-118,-2,-608
-83,-36,-99,-141,-119,-68,-131,-11,-688
-78,-28,-88,-122,-121,-77,-125,4,-635
-86,-14,-96,-154,-101,-75,-123,-24,-673
-86,-22,-88,-142,-107,-71,-130,-17,-663
-85,-11,-88,-140,-98,-70,-117,-13,-622
-76,-4,-90,-156,-90,-87,-135,-35,-673
-82,-5,-92,-154,-101,-100,-133,-64,-731
-95,-27,-84,-148,-90,-53,-123,-5,-625
-92,-43,-99,-152,-104,-78,-149,-46,-763
-72,-20,-81,-156,-99,-84,-126,-40,-678
-70,-37,-79,-128,-101,-63,-122,-11,-611
-95,-44,-83,-144,-98,-60,-121,-3,-648
-7,6,-54,-118,-117,-125,-113,-74,-602
47,5,-58,-148,-136,-179,-127,-70,-666
-64,-16,-74,-141,-130,-80,-128,-48,-681
-112,-26,-106,-167,-95,-88,-160,-11,-765
-91,-23,-85,-145,-95,-55,-131,-15,-640
-89,-39,-74,-134,-105,-60,-128,-6,-635
-101,-34,-102,-168,-105,-86,-143,-22,-761
-89,-37,-94,-148,-120,-77,-155,-27,-747
-98,-18,-75,-176,-93,-80,-149,-23,-712
-62,9,-60,-124,-94,-93,-143,-39,-606
-76,-22,-67,-141,-98,-77,-133,-13,-627
-90,-39,-97,-161,-119,-66,-135,-38,-745
-87,-26,-84,-156,-99,-82,-133,0,-667
-103,-49,-100,-166,-114,-68,-146,-25,-771
-81,-55,-77,-130,-112,-80,-142,-29,-706
-72,-45,-81,-142,-105,-91,-129,-44,-709
-85,-20,-89,-157,-116,-70,-136,-34,-707
-64,-21,-85,-136,-104,-102,-139,-26,-677
-113,-47,-83,-173,-127,-78,-134,-2,-757
-92,-33,-79,-161,-92,-57,-134,-3,-651
-90,-29,-88,-148,-103,-81,-139,-50,-728
-93,-51,-95,-142,-124,-78,-142,-48,-773
-91,-39,-72,-127,-108,-44,-125,7,-599
-88,-34,-74,-128,-118,-69,-124,-3,-638
-59,-10,-63,-142,-92,-60,-119,2,-543
-83,-11,-98,-131,-96,-88,-153,-31,-691
-97,-51,-68,-136,-123,-68,-135,-5,-683
-71,-7,-80,-153,-100,-73,-134,-25,-643
-75,-20,-79,-141,-109,-88,-140,-36,-688
-82,-22,-80,-141,-126,-94,-144,-41,-730
-76,-31,-72,-133,-85,-72,-121,-5,-595
-80,-28,-73,-123,-101,-69,-134,-19,-627
-69,-17,-89,-128,-102,-73,-130,-24,-632
-76,-31,-77,-124,-83,-83,-143,-27,-644
-54,8,-65,-119,-92,-89,-138,-32,-581
-64,-32,-71,-120,-112,-96,-117,-35,-647
-94,-30,-94,-155,-88,-64,-126,-50,-701
-55,-12,-79,-144,-101,-91,-125,-22,-629
-68,-22,-77,-147,-72,-62,-121,-25,-594
-41,-3,-99,-150,-118,-141,-140,-88,-780
-58,28,-97,-156,-86,-110,-141,-52,-672
-82,-41,-73,-125,-87,-62,-135,-18,-623
-89,-29,-67,-134,-115,-74,-124,-3,-635
-86,-28,-80,-146,-118,-73,-137,-12,-680
-98,-44,-94,-167,-97,-28,-136,-26,-690
-83,-23,-62,-136,-102,-55,-120,-13,-594
-78,-30,-77,-147,-115,-75,-122,-43,-687
-59,-17,-95,-152,-113,-84,-128,-39,-687
-92,-30,-73,-177,-106,-74,-136,3,-685
-82,-20,-73,-151,-102,-73,-140,-17,-658
-94,-22,-76,-160,-91,-53,-145,-9,-650
-89,-23,-69,-115,-107,-72,-130,18,-587
-85,-47,-66,-128,-114,-44,-123,-4,-611
-96,-40,-86,-137,-91,-61,-136,-4,-651
-100,-38,-108,-164,-104,-81,-151,-17,-763
-75,-36,-76,-134,-112,-55,-125,-25,-638
-80,-31,-92,-155,-104,-90,-133,-70,-755
-98,-70,-91,-140,-137,-52,-122,-17,-727
-92,-43,-93,-162,-113,-75,-133,-34,-745
-73,-33,-78,-132,-135,-92,-128,-45,-716
-103,-30,-102,-158,-108,-101,-141,-47,-790
-99,-64,-90,-140,-141,-73,-119,-17,-743
-103,-18,-89,-177,-108,-93,-146,-22,-756
-77,-34,-75,-162,-85,-88,-126,-28,-675
-104,-39,-104,-150,-107,-88,-144,-55,-791
-80,-43,-67,-115,-128,-111,-157,-25,-726
-83,-6,-89,-137,-69,-61,-121,-19,-585
-103,-26,-99,-169,-101,-64,-125,-33,-720
-87,-26,-79,-136,-100,-64,-133,-26,-651
-80,-27,-53,-120,-102,-35,-114,6,-525
-62,-6,-83,-131,-85,-62,-132,-28,-589
-70,-49,-107,-137,-124,-89,-140,-60,-776
-87,-30,-91,-178,-106,-78,-135,-39,-744
-91,-27,-71,-151,-103,-84,-127,-48,-702
-82,-27,-82,-148,-100,-80,-144,-61,-724
-87,-14,-67,-144,-105,-37,-116,2,-568
-90,-38,-68,-135,-124,-68,-151,-6,-680
-59,-5,-86,-139,-90,-53,-127,21,-538
-75,-22,-63,-112,-88,-51,-112,18,-505
-71,-10,-73,-119,-98,-54,-116,13,-528
-93,-20,-89,-167,-89,-49,-138,-8,-653
-84,-33,-88,-160,-102,-83,-118,-4,-672
-108,-39,-94,-174,-113,-77,-120,2,-723
-35,-8,-37,-60,-50,-38,-58,-7,-293
-91,-22,-71,-150,-94,-78,-141,-9,-656
-69,-17,-73,-121,-109,-75,-139,-41,-644
-64,-5,-73,-124,-101,-86,-123,-48,-624
-62,-15,-63,-107,-119,-94,-146,-22,-628
-94,-62,-81,-122,-99,-57,-122,-13,-650
-92,-59,-87,-143,-103,-62,-121,-11,-678
-98,-41,-69,-156,-115,-53,-128,13,-647
-94,-24,-96,-154,-98,-75,-140,-24,-705
-94,-43,-78,-153,-105,-58,-117,5,-643
-77,-25,-68,-162,-109,-59,-130,34,-596
-75,-45,-64,-117,-109,-80,-125,-19,-634
-25,-24,-28,-25,-32,-9,-34,-13,-190
-1,7,-3,-21,-4,-4,-6,-15,-47
67,39,7,34,-41,-57,-18,22,53
17,26,-22,-181,-93,-109,-137,-20,-519
-44,8,-62,-143,-141,-83,-110,-30,-605
26,43,1,-93,-52,-110,-67,1,-251
9,42,-9,-86,-25,-57,-93,50,-169
54,64,-19,-84,-80,-123,-94,24,-258
-12,3,-22,-17,-52,-3,-49,19,-133
-110,92,-57,-393,-93,-194,-107,-1,-863
-3,-3,-41,-60,-110,-90,-62,-48,-417
-72,6,-66,-121,-69,-49,-64,12,-423
-39,44,-74,-182,-64,-80,-98,-42,-535
45,-6,-60,-115,-62,-121,-123,-12,-454
-106,16,-75,-207,-37,-47,-100,-38,-594
-39,50,-14,-165,-59,-39,-48,-17,-331
-64,19,-57,-158,-134,-59,-75,-50,-578
-29,-26,-23,-57,-41,-28,-32,0,-236
-9,14,-21,-36,-28,-34,-25,-11,-150
36,28,43,15,10,-1,-32,26,125
-14,13,-38,-52,-41,-41,-63,-21,-257
-49,9,-73,-132,-78,-29,-66,6,-412
-83,-21,-105,-171,-149,-121,-156,-26,-832
-70,-9,-89,-170,-156,-104,-140,-63,-801
-7,27,-12,-70,-11,-17,-37,42,-85
0,22,20,-24,-16,-10,-17,3,-22
-170,-77,-187,-379,-311,-241,-236,-11,-1612
-73,-40,-62,-146,-75,-52,-86,5,-529
-98,11,-106,-285,-166,-145,-167,-9,-965
-46,28,-30,-92,-69,-13,-58,-15,-295
-2,110,-41,-142,-41,-67,-71,103,-151
-42,-28,-44,-68,-57,-28,-67,-13,-347
14,-1,20,-4,-9,-25,-12,17,0
96,97,46,19,15,-36,-61,-7,169
-13,-7,-13,-27,-19,-30,-29,6,-132
0,-3,-32,-63,-90,-37,-59,-8,-292
20,-2,-10,-3,-5,-15,-20,-11,-46
18,43,11,-48,-11,-63,-37,22,-65
-121,-49,-183,-282,-190,-206,-268,-63,-1362
-29,17,-61,-170,-82,-60,-89,-6,-480
8,67,-61,-126,-128,-146,-110,71,-425
76,84,17,-239,-40,-162,-88,37,-315
-34,13,-29,-102,-75,-87,-63,-21,-398
-55,68,-26,-207,-80,-107,-77,-20,-504
11,17,5,-63,-31,-64,-29,-12,-166
2,25,1,-22,5,-1,7,10,27
-27,135,-78,-192,-67,-18,-52,72,-227
-64,44,-83,-203,-61,-65,-87,35,-484
7,1,-26,-19,-20,-18,-23,-3,-101
-201,137,-276,-470,-162,-178,-159,-117,-1426
17,7,-21,-59,-72,-76,-52,-20,-276
-11,11,-23,-89,-79,-68,-44,-22,-325
-22,-20,-19,-45,-26,-33,-33,10,-188
62,258,-95,-411,-295,-172,-158,95,-716
-53,47,-104,-271,-185,-150,-157,-28,-901
18,34,-6,-54,-58,-46,-48,7,-153
33,-8,-31,-63,-95,-100,-60,-77,-401
-56,78,-33,-145,-87,-56,-58,-26,-383
47,3,-56,-106,-134,-125,-108,-68,-547
-92,84,-81,-259,-115,-107,-113,-29,-712
83,25,25,-26,-84,-104,-97,-42,-220
-25,31,-25,-52,-8,-17,15,9,-72
-82,39,7,-105,-28,-62,-50,17,-264
-23,38,-25,-64,2,-18,-40,9,-121
-19,-10,-3,-60,-86,-28,-50,2,-254
-19,7,-16,-73,-66,-52,-50,-23,-292
-72,-13,-68,-179,-175,-131,-114,-40,-792
-24,91,-100,-291,-209,-163,-121,120,-697
31,24,-1,-50,3,-45,-26,7,-57
-13,14,-6,-35,-12,-16,-15,-17,-100
-18,0,-11,-27,-40,7,-22,18,-93
2,3,-13,-61,-45,-75,-49,-40,-278
-15,-28,-17,-33,-69,-16,-54,23,-209
17,5,-14,-48,-49,-67,-39,-13,-208
-123,28,-150,-236,-208,-156,-289,-62,-1196
14,16,3,11,-17,-12,-4,-2,9
3,56,46,-80,-31,-84,50,54,14
22,38,12,-3,-28,-37,-22,17,-1
-74,-10,-66,-167,-167,-117,-125,0,-726
12,5,-8,-45,-29,-43,-31,-32,-171
-51,8,-62,-146,-142,-103,-73,-20,-589
-9,25,-5,-46,-20,-32,9,13,-65
-111,19,-67,-148,-34,-45,-68,-45,-499
-43,-20,-29,-51,-77,-34,-84,-17,-355
7,9,-17,-31,-44,-38,-37,14,-137
0,18,-5,-51,-38,-58,-34,7,-161
-122,-26,-121,-248,-143,-132,-163,-59,-1014
-5,3,3,-46,-36,-51,-10,-5,-147
-23,4,-15,-47,-57,-12,-52,14,-188
15,43,-16,-84,-112,-48,-54,-14,-270
58,44,-20,-37,-27,-85,-96,-35,-198
-21,64,-26,-113,-12,-58,-27,0,-193
-16,40,-23,-56,-15,-31,-50,-13,-164
-99,63,-110,-238,-122,-140,-165,-13,-824
1,-18,-54,-103,-112,-101,-129,-22,-538
-10,38,-26,-51,-14,-15,2,18,-58
-10,6,-27,-29,-30,-25,-25,-32,-172
-57,1,-64,-211,-135,-132,-144,-26,-768
25,22,-1,-84,-5,-64,-33,-10,-150
78,42,35,34,54,-12,3,75,309
152,73,-2,-159,-48,-158,-83,-2,-227
-104,78,-38,-176,-69,-80,-74,-54,-517
-43,1,-48,-93,-48,-55,-67,-2,-355
0,11,-66,-99,-102,-105,-91,-23,-475
37,9,-2,-35,-18,-82,-39,-39,-169
-56,63,-70,-177,-56,-56,-46,33,-365
-23,29,-43,-133,-87,-67,-82,9,-397
-7,4,15,-33,-20,-33,-14,9,-79
63,48,16,3,-47,-73,-60,-12,-62
-41,94,-27,-117,-36,-56,-54,18,-219
-16,39,-15,-65,-10,-16,-30,-3,-116
15,31,-54,-187,-110,-131,-118,-101,-655
-37,1,-37,-80,-92,-47,-68,-24,-384
0,26,2,-40,-33,-42,-32,21,-98
-38,61,-40,-122,-78,-81,-74,-3,-375
-2,4,-11,-63,-13,-44,-36,-33,-198
60,23,2,-112,27,-86,-118,68,-136
-41,32,-42,-136,-54,-64,-64,-26,-395
54,19,22,-30,-29,-69,-25,9,-49
-22,-14,-59,-64,-40,-39,-39,-21,-298
-15,28,-19,-86,-52,-45,-50,-31,-270
53,0,15,7,4,-46,-56,21,-2
33,57,-16,-131,-117,-154,-146,-38,-512
55,47,-59,-277,-84,-211,-224,-7,-760
6,28,4,-18,-14,-9,-2,4,-1
-42,5,-44,-125,-69,-73,-72,-44,-464
12,32,-3,-77,-68,-45,-52,-11,-212
-16,-13,-13,-80,-82,-57,-65,25,-301
-15,31,-12,-99,-60,-70,-60,3,-282
1,76,-45,-162,-118,-154,-102,-6,-510
-22,3,-69,-137,-96,-126,-139,-22,-608
19,3,-34,-107,-17,-104,-83,-28,-351
-78,16,-46,-118,-31,-34,-32,-24,-347
189,133,20,-83,-111,-225,-167,52,-192
-41,22,-48,-157,-64,-32,-41,34,-327
-5,14,-18,-60,-91,-52,-64,-2,-278
-28,-10,-92,-122,-101,-62,-84,-8,-507
10,132,-64,-175,-72,-113,-111,3,-390
-43,15,-29,-66,-35,-36,-21,-8,-223
-46,31,-73,-215,-130,-140,-109,-9,-691
55,64,48,-5,-25,-11,-11,44,159
-83,-4,-143,-209,-240,-125,-228,2,-1030
39,80,-17,-180,-102,-160,-114,20,-434
-34,-22,-41,-135,-75,-66,-71,-4,-448
102,72,-12,-65,-12,-104,-45,-72,-136
111,80,14,-141,36,-192,-121,-1,-214
-55,-48,-54,-68,-53,-38,-71,-26,-413
-10,-2,-33,-64,-59,-71,-49,-16,-304
-76,-18,-73,-134,-105,-62,-121,15,-574
-25,3,-26,-62,-73,-37,-49,-22,-291
5,22,-39,-49,-57,-47,-46,-36,-247
-13,24,-29,-58,-29,-16,4,25,-92
-28,-17,-50,-73,-86,-51,-61,-31,-397
-36,46,-26,-125,-67,-71,-76,-52,-407
-31,-1,-26,-66,-117,-51,-87,-25,-404
-12,11,-31,-27,-49,-26,-60,31,-163
1,-5,-20,-120,-100,-114,-76,7,-427
-49,-12,-64,-116,-96,-43,-108,7,-481
29,50,-16,-58,-19,-37,-72,-57,-180
0,22,-47,-130,-94,-102,-100,-63,-514
26,65,-4,-45,-2,-55,-41,57,1
-16,-17,-23,-34,-33,-20,-41,-8,-192
23,27,-9,-17,-4,-17,-21,3,-15
-15,22,-23,-103,-68,-77,-78,-39,-381
-12,64,-69,-210,-77,-146,-121,7,-564
32,19,4,-16,-19,-40,-32,-2,-54
-38,-30,-43,-115,-85,-49,-82,-11,-453
-26,-8,-31,-38,-32,-19,-38,-11,-203
-13,10,-12,-39,-19,-30,-38,-12,-153
1,12,8,-38,-18,-34,-18,-11,-98
-52,-15,-63,-111,-81,-74,-97,-25,-518
-36,-20,-27,-91,-77,-49,-78,18,-360
-16,-6,-31,-123,-80,-66,-66,28,-360
-69,201,-91,-305,-42,-70,-205,-166,-747
-82,83,-146,-323,-203,-168,-162,25,-976
-121,143,-114,-283,-30,-58,-102,-15,-580
-75,33,-58,-288,-130,-163,-106,-67,-854
-2,52,-23,-122,-70,-34,-62,56,-205
-80,54,-45,-143,-26,-46,-53,-33,-372
-39,29,-48,-78,-37,-32,-14,2,-217
-68,47,-28,-129,-47,-33,-46,21,-283
-54,-15,-39,-98,-40,-35,-80,-15,-376
30,80,6,-148,-30,-92,11,20,-123
-79,13,-108,-196,-78,-114,-136,-17,-715
-37,0,-37,-87,-74,-63,-87,-44,-429
-4,5,-11,-24,-18,-13,-11,13,-63
-84,90,-62,-215,-45,-56,-108,-23,-503
-100,51,-58,-176,-84,-94,-75,-24,-560
-31,-7,-51,-95,-90,-83,-114,-5,-476
-43,93,-106,-175,-105,-49,-109,82,-412
-33,-6,-25,-62,-18,2,-22,-14,-178
-17,-7,-31,-87,-60,-55,-57,3,-311
19,54,-8,-138,-25,-85,-88,-3,-274
-35,23,-25,-108,-74,-66,-63,2,-346
40,91,9,-87,-136,-122,-100,20,-285
-22,45,-62,-177,-63,-138,-124,-15,-556
-82,-4,-93,-304,-179,-133,-177,-12,-984
-16,33,-55,-156,-99,-146,-72,14,-497
7,22,-14,-66,-43,-83,-39,21,-195
-37,10,-30,-81,-79,-46,-47,-11,-321
47,58,18,-61,59,36,-10,81,228
-28,32,-30,-148,-102,-93,-108,-49,-526
-1,10,-16,-126,-78,-75,-78,-29,-393
-1,31,-38,-87,-22,-38,-39,6,-188
-3,-2,-21,-55,-26,-27,-28,-23,-185
-65,11,-67,-146,-112,-70,-86,-9,-544
-88,-44,-84,-148,-122,-91,-113,-46,-736
-41,4,-41,-84,-36,-32,-19,-21,-270
-33,5,-16,-60,-17,-24,-16,-11,-172
-52,6,-94,-196,-114,-107,-161,-31,-749
-14,-11,-14,-20,-6,-2,-4,-6,-77
-18,-3,-19,-66,-62,-56,-39,-31,-294
-35,-10,-34,-55,-48,-2,-35,36,-183
-44,-22,-57,-97,-92,-64,-83,-39,-498
-28,-18,-11,-55,-30,-9,-29,22,-158
-39,11,-31,-63,-56,-36,-38,-32,-284
-128,69,-178,-364,-143,-179,-236,-143,-1302
-12,2,-36,-105,-90,-46,-30,17,-300
-17,13,-64,-220,-191,-241,-211,-54,-985
-7,21,-19,-57,-8,-37,-26,-20,-153
4,-28,-3,-16,6,-3,-16,12,-44
-60,6,-89,-124,-70,-72,-68,-36,-513
-91,-94,-121,-164,-228,-159,-206,-23,-1086
-41,146,-86,-193,-137,-169,-103,45,-538
-102,8,-127,-231,-101,-108,-138,-53,-852
-47,11,-20,-104,-58,-41,-54,14,-299
-42,21,-48,-213,-231,-122,-127,23,-739
-54,12,-46,-143,-119,-82,-95,19,-508
10,-1,-13,-66,-77,-72,-51,-13,-283
-40,26,-57,-124,-74,-73,-117,10,-449
-12,-18,-73,-164,-159,-156,-168,-16,-766
-96,-50,-100,-189,-163,-88,-169,-23,-878
-42,4,-95,-111,-86,-57,-90,-43,-520
-105,-17,-139,-237,-142,-114,-159,-39,-952
120,797,-104,-974,-270,-482,-287,483,-717
-69,37,-141,-370,-179,-232,-220,-29,-1203
-52,103,-191,-417,-308,-355,-327,-121,-1668
-5,21,-19,-50,-9,-48,-39,-32,-181
-19,40,-55,-129,-72,-70,-85,39,-351
-89,-52,-70,-149,-125,-73,-125,4,-679
-30,6,-41,-99,-66,-42,-40,-27,-339
29,18,-32,-181,-139,-176,-134,-108,-723
-18,3,-18,-35,-26,-25,-25,-11,-155
-8,19,-27,-52,-3,-57,-41,-7,-176
-27,44,-85,-281,-166,-214,-162,-113,-1004
49,34,22,11,-8,-16,-21,37,108
-6,-1,-10,-19,-12,-15,-4,7,-60
-14,2,-14,-50,-23,-27,-39,-5,-170
-41,23,-47,-102,-46,-58,-63,-41,-375
13,23,-38,-148,-114,-159,-88,-52,-563
-50,48,-32,-109,-55,-47,-69,-49,-363
-22,87,-39,-215,-101,-149,-170,-136,-745
10,72,-32,-159,1,-111,-116,9,-326
-5,131,-46,-187,-118,-90,-150,0,-465
-92,51,-126,-246,-157,-146,-193,-6,-915
-8,-10,-48,-112,-84,-89,-79,-17,-447
-71,39,-55,-135,-31,-6,-23,-68,-350
19,301,-154,-586,-298,-352,-231,24,-1277
-10,-23,-26,-115,-115,-60,-98,-18,-465
32,148,-21,-263,-121,-197,-187,-127,-736
5,15,-16,-21,-11,-19,-23,-22,-92
22,17,2,-50,-33,-56,-33,-27,-158
-30,50,-112,-327,-289,-266,-312,-112,-1398
-59,-14,-54,-93,-79,-30,-66,-11,-406
-52,-18,-17,-80,-101,-4,-28,2,-298
59,66,10,-112,8,-78,-44,16,-75
-426,-130,-490,-1167,-785,-592,-863,-296,-4749
-13,69,-75,-455,-403,-280,-304,204,-1257
8,13,-14,-1,-23,-10,-19,-21,-67
-46,1,-71,-144,-116,-100,-87,-42,-605
-19,34,-50,-199,-113,-141,-137,-61,-686
69,31,12,-1,-44,-98,-47,20,-58
41,28,6,-4,-46,-26,-22,24,1
-55,54,-86,-180,-105,-61,-81,41,-473
-61,4,-97,-176,-165,-87,-148,-32,-762
52,23,9,-6,-1,-34,-22,2,23
56,94,20,-208,-31,-147,-92,7,-301
13,79,-2,-221,-186,-159,-69,-14,-559
131,110,63,-2,70,-17,-74,33,314
-128,-51,-117,-176,-141,-62,-165,-10,-850
-14,8,-18,-38,-12,-26,-33,-16,-149
-41,30,-36,-131,-82,-50,-64,65,-309
-15,64,-33,-202,-58,-161,-140,-52,-597
-22,12,-54,-119,-91,-66,-83,-31,-454
-109,114,-178,-354,-179,-184,-206,-57,-1153
-18,23,-14,-49,-32,-36,-36,-29,-191
-50,136,-172,-359,-196,-213,-129,11,-972
-30,40,-75,-237,-110,-158,-149,44,-675
-59,-42,-93,-150,-109,-58,-157,-18,-686
-177,174,-302,-754,-567,-536,-572,59,-2675
-44,17,-123,-187,-96,-97,-132,-74,-736
13,16,1,-48,-57,-55,-51,-22,-203
-5,38,-3,-33,-8,-1,-32,1,-43
53,224,-65,-513,-249,-339,-343,-49,-1281
-80,6,-98,-208,-123,-142,-154,-31,-830
-33,22,-50,-159,-127,-120,-127,-1,-595
88,97,-13,-110,-91,-123,-99,1,-250
-48,-32,-9,-90,-54,-28,-10,2,-269
-68,-35,-66,-115,-70,-64,-93,9,-502
8,2,-6,-34,-41,-27,-12,-12,-122
-8,-6,-45,-80,-56,-48,-42,-7,-292
-33,37,-29,-81,-62,-51,-68,-16,-303
-16,-34,-26,-38,-59,-34,-45,-11,-263
-27,131,-29,-179,-88,-78,-7,-30,-307
60,40,-19,-86,-142,-134,-65,-41,-387
13,25,-11,-46,-27,-50,-29,-21,-146
-94,-37,-85,-171,-105,-94,-109,-23,-718
-24,28,-68,-153,-71,-135,-152,-21,-596
-72,27,-68,-163,-84,-116,-116,-29,-621
41,17,-95,-129,-63,-168,-162,-84,-643
-73,-20,-71,-112,-62,-47,-78,-18,-481
13,19,-70,-119,-92,-147,-121,-90,-607
-31,-31,-87,-141,-150,-144,-115,-45,-744
-45,2,-76,-107,-100,-90,-99,-15,-530
-53,-8,-96,-170,-119,-123,-164,-67,-800
-53,-17,-81,-136,-90,-87,-131,-41,-636
-151,-9,-176,-305,-111,-129,-156,-56,-1093
-14,4,-86,-173,-130,-140,-142,-72,-753
-8,135,-26,-181,-33,-52,-57,80,-142
-193,159,-370,-998,-937,-455,-519,669,-2644
-10,7,-13,-67,-43,-23,-51,-47,-247
-33,14,-52,-136,-95,-44,-77,-13,-436
-13,-34,-24,-68,-56,-47,-60,-23,-325
-57,180,-233,-764,-447,-598,-629,98,-2450
-201,154,-198,-550,-165,-214,-324,-102,-1600
-15,25,-64,-107,-83,-64,-82,-43,-433
50,120,-53,-214,-96,-182,-161,-52,-588
101,67,-45,-268,-233,-328,-187,2,-891
51,97,-53,-252,-143,-239,-177,-126,-842
3,48,-33,-85,-28,-82,-61,-35,-273
78,82,11,-58,-47,-61,-79,-14,-88
6,46,-18,-75,-40,-63,-52,-8,-204
-149,-49,-153,-304,-206,-153,-258,21,-1251
114,78,-28,-132,-180,-247,-112,-77,-584
-96,-14,-113,-198,-193,-115,-194,-2,-925
-24,98,-59,-202,-193,-157,-172,-22,-731
11,124,-50,-178,-111,-160,-188,26,-526
41,70,-54,-165,-110,-136,-109,-15,-478
-31,101,-43,-236,-180,-184,-145,9,-709
7,127,-66,-191,-68,-80,-139,62,-348
22,67,-30,-206,-12,-128,-102,-18,-407
62,23,1,-164,-110,-179,-82,-20,-469
-9,5,-19,-50,-49,-41,-22,-24,-209
-460,-75,-581,-1346,-950,-664,-942,-323,-5341
-27,78,-64,-229,-92,-96,-76,27,-479
38,55,-8,-153,-65,-159,-99,-5,-396
19,47,-178,-315,-331,-362,-348,-209,-1677
-20,51,-28,-144,-27,-101,-53,36,-286
-16,33,-92,-233,-141,-208,-159,-81,-897
-77,-8,-59,-152,-61,-90,-93,-44,-584
-7,21,-54,-140,-68,-48,-54,-55,-405
-99,-21,-154,-316,-167,-178,-179,-91,-1205
-9,22,-17,-47,-26,-28,-13,5,-113
18,19,0,-92,-135,-112,-28,27,-303
-18,13,-32,-64,-111,-52,-43,39,-268
-5,5,-18,-56,-39,-56,-65,-10,-244
37,107,-1,-227,-27,-91,-78,81,-199
-52,-1,-57,-147,-144,-78,-73,-4,-556
-34,-13,-26,-69,-37,-20,-26,-9,-234
-56,-8,-126,-136,-156,-69,-155,-19,-725
-10,101,-42,-180,-79,-153,-80,-19,-462
47,32,-1,-23,16,-49,-43,0,-21
-6,6,-18,-52,-15,-42,-48,-21,-196
58,2,-35,-288,-67,-188,-182,-24,-724
114,111,20,-143,-128,-203,-140,5,-364
206,250,-32,-309,-137,-365,-215,-60,-662
-91,42,-138,-282,-160,-174,-183,-94,-1080
-36,16,-155,-521,-469,-349,-344,113,-1745
-22,377,-185,-622,-267,-369,-239,190,-1137
-8,83,-34,-193,-101,-122,-111,17,-469
-105,105,-204,-365,-248,-249,-246,-85,-1397
-23,17,-218,-364,-227,-303,-379,-166,-1663
94,156,41,-86,-147,-81,-175,59,-139
123,196,-79,-409,-181,-379,-274,-191,-1194
145,200,34,-250,-68,-236,-200,-144,-519
-66,-3,-70,-196,-175,-98,-126,42,-692
-73,178,-114,-415,-226,-249,-260,105,-1054
8,17,-21,-86,-84,-78,-78,-7,-329
9,27,-11,-51,-16,-55,-31,1,-127
-42,79,-83,-257,-135,-195,-187,40,-780
68,195,36,-198,-135,-197,-78,119,-190
-26,14,-35,-89,-67,-74,-31,-11,-319
96,145,7,-234,-77,-124,-94,-9,-290
-36,56,-221,-355,-244,-304,-321,-235,-1660
-7,48,-34,-124,-26,-93,-56,-18,-310
-85,32,-70,-214,-92,-91,-108,23,-605
-49,-45,-80,-94,-108,-111,-128,-43,-658
106,190,35,-118,20,-100,46,154,333
-83,-5,-114,-259,-207,-217,-169,-36,-1090
-8,-4,-10,-14,-16,-22,-18,-6,-98
-18,-8,-9,-28,-28,-13,-23,-8,-135
-42,108,-212,-393,-242,-366,-365,-187,-1699
-115,65,-70,-170,-118,-21,-65,-96,-590
166,177,-9,-165,-316,-253,-212,-256,-868
-21,108,-55,-148,-74,-117,-91,-7,-405
0,36,-60,-234,-153,-179,-135,-70,-795
-90,53,-53,-140,-54,-23,-56,-37,-400
-75,128,-61,-198,-19,-105,-75,-11,-416
-42,170,-86,-307,-141,-181,-162,76,-673
-32,50,-39,-183,-113,-94,-105,16,-500
100,78,6,-48,-49,-107,-46,-9,-75
-67,162,-54,-174,17,-67,-50,18,-215
-128,-7,-127,-303,-278,-215,-163,-16,-1237
-35,68,-46,-140,-33,-85,-52,18,-305
56,59,-9,-151,-65,-163,-114,-17,-404
80,96,-44,-178,-169,-245,-186,-73,-719
-183,-41,-195,-371,-323,-171,-269,-14,-1567
23,47,-5,-82,-2,-80,-33,16,-116
23,6,-25,-71,-96,-70,-53,-16,-302
-13,16,-26,-61,-105,-19,-44,-22,-274
-53,26,-74,-207,-19,-103,-113,-37,-580
33,47,10,-83,-7,-87,-88,82,-93
-55,21,-88,-142,-132,-75,-157,9,-619
303,366,63,-390,35,-410,-216,84,-165
160,-9,34,-104,48,-132,-54,47,-10
10,100,-4,-245,-60,-129,-121,26,-423
12,14,8,-73,-64,-82,-43,11,-217
23,25,13,-6,18,-2,13,21,105
-15,9,-13,-29,-12,-20,-12,-10,-102
-14,28,11,-42,-11,-13,-4,-13,-58
-2,9,-64,-110,-85,-51,-40,-61,-404
-16,27,-18,-51,-35,-28,-24,1,-144
-60,-29,-88,-201,-163,-178,-167,-48,-934
-97,88,-74,-193,-66,-106,-100,11,-537
18,42,-1,-87,-105,-131,-88,-41,-393
-8,22,-18,-81,-75,-53,-43,-12,-268
40,32,10,-2,-37,15,-26,52,84
-18,1,-20,-43,-8,-17,-30,36,-99
-128,26,-133,-311,-112,-78,-142,-74,-952
-1,38,-19,-104,-61,-53,-64,-14,-278
94,101,2,-53,-113,-107,-69,-76,-221
-4,14,-64,-153,-84,-94,-115,-14,-514
11,27,-4,-64,-2,-41,-9,6,-76
-40,90,-149,-322,-176,-243,-266,-119,-1225
-64,-14,-76,-130,-88,-61,-73,-19,-525
-27,0,-38,-117,-80,-67,-77,9,-397
-46,-52,-51,-154,-122,-160,-89,-78,-752
-47,-1,-46,-70,-46,-36,-40,-25,-311
-34,-15,-21,-74,-39,-52,-38,-12,-285
-32,-6,-43,-54,-31,-19,-36,-4,-225
-29,-3,-35,-90,-42,-25,-22,6,-240
-18,24,-31,-98,-126,-40,-79,-4,-372
-160,-77,-163,-232,-234,-177,-233,-28,-1304
28,38,0,-100,-17,-88,-25,45,-119
12,28,-8,-28,-31,-54,-33,-28,-142
-3,25,-2,-25,-15,-15,-27,4,-58
11,27,1,-50,-22,-35,-19,25,-62
94,11,21,-72,-24,-124,-95,-23,-212
-33,-19,-65,-168,-184,-126,-125,38,-682
-37,24,-47,-96,-85,-74,-85,22,-378
-16,-2,-14,-47,-29,-29,-22,13,-146
-41,19,-112,-208,-162,-154,-175,-99,-932
62,31,23,2,1,-47,-27,34,79
-22,56,-40,-77,-51,27,18,3,-86
-62,40,-19,-109,-70,-5,-15,41,-199
35,54,-58,-196,-57,-181,-109,-21,-533
-18,-9,-41,-137,-103,-119,-88,-1,-516
21,54,-24,-142,-33,-116,-57,-61,-358
-4,50,-7,-40,-17,-42,-33,26,-67
9,63,-25,-87,-18,-57,-22,26,-111
-11,16,-29,-44,-71,-40,-34,-9,-222
-8,29,-1,-39,-32,-21,-10,-38,-120
-42,-14,-80,-129,-130,-80,-151,-22,-648
-18,20,-14,-63,-65,23,-36,67,-86
236,42,50,-101,-13,-181,-145,28,-84
-44,-9,-46,-100,-105,-60,-55,-2,-421
-22,22,-104,-171,-152,-173,-169,-111,-880
-21,10,-18,-36,-20,-20,-25,10,-120
-56,-39,-116,-253,-224,-181,-203,-97,-1169
6,27,6,10,-30,17,-15,19,40
89,95,2,-262,-58,-241,-159,-26,-560
-20,-21,-15,-50,-43,-21,-31,7,-194
26,26,-12,-37,-44,-38,-42,-17,-138
-56,-17,-54,-186,-271,-57,-174,74,-741
-24,-7,-24,-69,-64,-53,-44,-33,-318
-44,92,-152,-334,-231,-229,-245,-8,-1151
82,-23,-76,-113,-139,-141,-162,-46,-618
-66,40,-103,-177,-199,-108,-174,-11,-798
9,10,-16,-47,-29,-48,-8,-18,-147
32,-21,-14,-80,-42,-92,-72,-45,-334
23,72,-34,-192,-100,-139,-58,55,-373
6,24,-9,-35,-21,-26,-11,-23,-95
-26,4,-53,-128,-101,-60,-87,-14,-465
77,105,-37,-193,-72,-229,-174,-66,-589
-21,14,-37,-103,-90,-74,-89,-34,-434
89,59,26,-21,-14,-97,-44,1,-1
16,26,19,-18,-28,-2,-39,27,1
8,20,-6,-37,-15,-2,-31,45,-18
-6,-5,-5,-18,-22,-15,-12,-12,-95
-68,-5,-110,-164,-133,-108,-169,-15,-772
-6,-8,-28,-34,-33,-2,-29,10,-130
-2,66,-27,-124,-76,-97,-62,-25,-347
-20,7,-43,-91,-62,-79,-71,-67,-426
308,594,-56,-483,-17,-366,-149,407,238
17,34,-7,-47,-78,-68,-58,-49,-256
-64,-18,-57,-205,-73,-79,-95,-34,-625
26,28,21,-33,-13,-32,5,15,17
-4,19,-18,-10,-29,-13,-27,-9,-91
-3,-15,-42,-73,-60,-59,-108,9,-351
-22,31,-39,-124,-71,-121,-87,2,-431
-26,-1,-44,-65,-52,-35,-68,-32,-323
-41,11,-36,-82,-45,-50,-68,-29,-340
61,72,-10,-104,12,-69,-39,8,-69
63,39,5,-68,26,-60,-32,75,48
13,49,-39,-64,-49,-87,-56,-42,-275
-59,11,-52,-116,-43,-37,-43,-15,-354
26,22,-9,-71,-56,-87,-78,21,-232
1,65,19,-118,-112,-89,-66,16,-284
33,46,3,-49,-31,-73,-51,-36,-158
-58,5,-60,-140,-90,-56,-92,-40,-531
19,24,-27,-69,-44,-55,-55,-40,-247
-82,-17,-94,-202,-126,-97,-137,14,-741
-37,10,-32,-82,-56,-45,-38,-22,-302
-15,0,-56,-122,-132,-81,-81,-27,-514
13,20,-10,-42,-39,-61,-30,3,-146
11,11,-69,-149,-87,-143,-121,-68,-615
48,37,-62,-277,-230,-300,-144,-82,-1010
101,180,1,3,-18,-55,89,140,441
-34,-8,-44,-82,-72,-64,-71,-43,-418
-15,9,-7,-59,-21,-33,-22,29,-119
-5,9,-18,-55,-57,-37,-32,8,-187
-10,-18,-42,-37,-62,-48,-46,-7,-270
2,14,-29,-75,-48,-48,-69,22,-231
-12,10,-26,-51,-32,-34,-55,-13,-213
-31,7,-42,-109,-36,-27,-66,-29,-333
-16,11,-3,-36,-22,-25,-19,5,-105
-36,37,-44,-90,-48,-24,-43,-31,-279
16,35,-5,-19,-10,-8,-10,-20,-21
-15,-11,2,-24,-24,-4,-12,18,-70
6,3,1,-13,-9,2,23,-1,12
6,29,-7,-29,-17,-14,-9,4,-37
-4,26,3,-32,-15,-38,-10,22,-48
-15,35,7,-68,-28,-45,19,35,-60
-11,4,-1,-26,-7,-3,-11,-5,-60
-11,13,-36,-50,-44,-45,-24,-22,-219
-47,-5,-19,-117,-73,-29,-52,-2,-344
-100,40,-101,-331,-230,-205,-257,-11,-1195
-31,-12,-74,-167,-140,-107,-139,-35,-705
9,7,-29,-52,-52,-47,-45,1,-208
-29,38,-65,-111,-16,-53,-56,15,-277
-1,8,-14,-57,-59,-62,-66,-32,-283
-100,7,-135,-213,-117,-113,-180,-47,-898
12,20,-27,-68,-88,-41,-59,11,-240
8,66,6,-153,-52,-149,-102,4,-372
-51,137,-72,-273,-180,-182,-47,-20,-688
151,44,-8,-98,-83,-138,-111,0,-243
-65,109,-67,-187,-35,-90,-79,13,-401
-70,-11,-70,-152,-133,-75,-99,-3,-613
3,28,-25,-87,-65,-58,-65,51,-218
-1,3,-9,-18,-7,-11,-9,2,-50
-73,-68,-65,-158,-129,-91,-114,7,-691
-47,1,-44,-97,-41,-33,-56,-21,-338
-24,-15,-58,-104,-47,-50,-85,-12,-395
-67,-4,-55,-125,-95,-26,-65,22,-415
2,-32,-49,-142,-122,-152,-119,33,-581
-6,22,-3,-28,-17,-23,-24,-6,-85
32,40,11,5,-13,-2,14,16,103
-5,17,-10,-68,7,-34,-32,-8,-133
8,38,-18,-31,-31,-47,6,-19,-94
-10,26,-3,-65,-56,3,-23,-11,-139
-33,13,-39,-104,-121,-137,-107,-99,-627
-21,13,-27,-94,-37,-54,-50,23,-247
-22,-10,2,-36,-32,-34,-14,-3,-149
-8,10,-18,-30,-26,-34,-6,10,-102
-21,12,-46,-71,-22,-47,-75,-43,-313
-11,-3,-17,-27,-29,-14,-23,6,-118
-3,48,4,7,-24,-17,-16,-10,-11
17,138,-39,-225,6,-104,-66,70,-203
-53,-11,-81,-86,-105,-43,-120,-17,-516
-16,-10,-67,-149,-149,-145,-119,-57,-712
2,20,-8,-37,-61,-45,-33,-10,-172
-8,6,-17,-35,-28,-34,-37,24,-129
23,21,1,11,-24,12,-37,51,58
39,50,-7,-18,-9,-46,-49,34,-6
7,33,-9,-38,-6,-13,-31,-27,-84
-60,12,-40,-120,-28,-33,-63,-17,-349
39,32,-23,-107,-18,-98,-92,-21,-288
-8,3,-34,-94,-85,-66,-63,-22,-369
-23,-10,-26,-31,-36,-18,-31,16,-159
-5,31,-5,-39,-15,-41,-17,57,-34
-19,-4,-42,-142,-91,-134,-108,-7,-547
11,0,-8,-14,-9,-16,-11,-24,-71
-17,3,-15,-37,-61,-32,-25,-13,-197
-11,3,-24,-37,-24,-19,-19,6,-125
-4,51,-20,-43,-3,-45,-36,12,-88
-39,64,-84,-156,-80,-70,-82,-76,-523
7,47,-20,-83,-84,-59,-44,-24,-260
19,226,-34,-424,-121,-262,-147,146,-597
-127,-54,-162,-231,-195,-157,-240,-67,-1233
-52,94,-35,-183,-48,-56,-43,21,-302
14,82,-30,-205,-130,-168,-87,-60,-584
-115,223,-132,-395,-43,-69,-188,-20,-739
19,23,7,-11,9,-10,8,13,58
309,87,96,-56,86,-133,-122,134,401
-1,-22,-16,-28,-44,-28,-21,-11,-171
104,160,-57,-453,-140,-349,-225,-30,-990
18,62,-32,-110,-18,-68,-40,39,-149
-1,25,-13,-85,-109,-91,-58,-41,-373
-104,157,-88,-489,-278,-252,-106,124,-1036
-39,16,-84,-184,-94,-129,-115,-46,-675
-52,355,-117,-352,-231,-2,-411,-13,-823
65,30,28,-81,-77,-111,-60,-14,-220
1,18,-6,-24,-4,-28,-13,16,-40
-56,-22,-112,-216,-142,-114,-178,-87,-927
-24,51,-82,-163,-22,-107,-131,-65,-543
16,14,4,8,-35,9,-47,47,16
-13,-1,-18,-67,-120,-62,-63,-2,-346
69,53,18,-104,-99,-121,-100,21,-263
-16,37,-13,-167,-50,-84,-60,-19,-372
-5,71,9,-172,-26,-148,-69,52,-288
-26,4,-70,-94,-96,-88,-91,-53,-514
-98,-14,-134,-225,-194,-150,-237,-40,-1092
16,75,-12,-94,-94,-71,-83,2,-261
3,29,-19,-48,-17,-39,-35,-7,-133
-1,17,-15,-27,-4,-13,-6,-2,-51
-47,-1,-40,-107,-90,-60,-105,18,-432
7,-3,-12,-27,-36,-19,-20,-2,-112
-15,23,-19,-58,-12,-35,-12,-9,-137
-264,1,-289,-578,-307,-203,-402,-55,-2097
-285,-2,-353,-568,-411,-215,-429,1,-2262
-64,78,-31,-114,-77,-10,-68,28,-258
-22,-1,-28,-41,-38,-20,-32,13,-169
12,14,-17,-56,-42,-41,-41,-28,-199
-42,36,-103,-210,-85,-111,-126,-119,-760
141,108,-21,-261,-88,-257,-123,95,-406
-108,19,-156,-307,-150,-178,-225,-209,-1314
-18,4,-15,-43,-29,-22,-26,-10,-159
-72,75,-87,-200,-81,-79,-135,-91,-670
-58,5,-72,-150,-45,-68,-124,-24,-536
-46,121,-23,-160,-49,-77,52,28,-154
-15,-16,-32,-61,-65,-47,-48,-24,-308
-84,59,-85,-167,-80,-105,-92,11,-543
1,14,2,-21,-13,-16,-13,-22,-68
8,-2,-7,13,-13,-2,-4,2,-5
-188,-50,-174,-315,-122,-72,-203,-38,-1162
-26,54,-69,-109,-37,-49,-43,-47,-326
-15,5,-15,-39,-41,-24,-29,0,-158
325,100,46,-195,-64,-289,-199,3,-273
277,123,18,-244,-33,-263,-188,-27,-337
29,132,-61,-226,-77,-201,-143,-54,-601
30,71,-29,-211,-59,-169,-134,92,-409
5,58,15,-90,-19,-78,-2,81,-30
70,34,50,-40,-12,-26,-50,-16,10
16,29,-10,-31,-38,-39,-29,2,-100
16,8,5,-10,-2,15,-3,21,50
-34,15,-77,-143,-109,-69,-91,-19,-527
35,81,-20,-89,-68,-121,-57,-22,-261
-47,21,-57,-126,-60,-54,-55,-32,-410
28,190,-74,-433,-213,-306,-238,94,-952
-15,5,-3,-24,-15,-2,-16,-2,-72
-350,176,-728,-1660,-1639,-697,-1038,675,-5261
-700,606,-994,-2270,-792,-969,-1400,-724,-7243
110,171,33,-73,-74,-87,-75,46,51
-15,-15,-66,-85,-124,-82,-96,-79,-562
-52,37,-40,-124,-47,-78,-47,31,-320
-33,21,-39,-100,-70,-77,-60,-23,-381
-40,72,-87,-273,-75,-167,-128,30,-668
10,21,-51,-134,-150,-174,-114,-123,-715
-46,1,-29,-129,-150,-142,-114,-11,-620
1401,4945,415,-4898,-789,-2964,-3313,3316,-1887
-24,0,-38,-57,-27,-18,-23,-15,-202
43,83,-1,-153,-9,-104,-94,-8,-243
-74,-22,-76,-142,-61,-63,-75,-15,-528
-38,-1,-87,-150,-125,-117,-115,-88,-721
-2,0,-45,-62,-89,-82,-60,-41,-381
-15,11,-58,-87,-80,-96,-82,-54,-461
22,39,-2,-40,-18,-23,-22,8,-36
-22,-3,-45,-92,-102,-52,-86,15,-387
-53,23,-119,-345,-307,-262,-190,-31,-1284
33,31,8,-5,-17,-36,-15,13,12
-40,-4,-44,-82,-75,-54,-73,-31,-403
51,43,23,-15,-79,-105,-106,-4,-192
63,128,12,-193,-118,-135,-188,51,-380
41,12,-7,-135,-70,-130,-44,-19,-352
-37,0,-52,-100,-77,-34,-58,-81,-439
-109,68,-73,-263,-93,-92,-159,-98,-819
-423,-147,-506,-1113,-812,-623,-848,-258,-4730
2,9,-9,-36,-54,-41,-36,-24,-189
203,121,70,-263,59,-297,-166,13,-260
-77,9,-131,-217,-212,-173,-225,-66,-1092
-22,87,-73,-248,-229,-232,-181,71,-827
-14,18,-49,-92,-51,-66,-69,-17,-340
5,183,-76,-188,0,-37,-2,21,-94
69,5,-16,6,-37,-75,-65,-47,-160
-9,31,-6,-93,17,-54,-65,-9,-188
45,57,-10,-141,-104,-124,-81,39,-319
-42,37,-51,-132,-91,-99,-116,-20,-514
40,77,11,-111,-27,-129,-88,34,-193
-11,22,-37,-64,-32,-45,-52,-42,-261
-100,42,-86,-252,-73,-58,-122,-75,-724
-17,90,-35,-153,-66,-92,-79,50,-302
-61,40,-78,-185,-93,-72,-83,-56,-588
137,425,-61,-438,59,-196,-144,298,80
-12,19,0,-48,-25,-22,-20,-6,-114
-29,34,-33,-103,-53,-30,-36,-24,-274
-40,-27,-53,-135,-161,-107,-113,1,-635
-44,92,-61,-245,-188,-103,-225,122,-652
-23,24,-12,-58,4,-22,-14,-28,-129
34,123,-76,-270,-68,-229,-154,9,-631
-39,9,-52,-97,-38,-53,-80,-17,-367
-21,105,-47,-136,-59,-74,-42,82,-192
-5,78,-79,-258,-86,-158,-150,19,-639
-84,275,-189,-728,-281,-392,-284,108,-1575
51,7,5,-4,-22,-50,-46,6,-53
-8,24,-21,-55,-28,-35,-34,-16,-173
19,76,21,-163,-55,-54,-39,33,-162
114,179,21,-108,74,-143,-171,151,117
-16,134,-94,-322,-150,-231,-181,-30,-890
48,60,4,-11,-10,21,17,36,165
-21,9,-57,-119,-110,-112,-85,-62,-557
-4,31,-40,-98,-83,-79,-57,-53,-383
-12,-9,-29,-37,-17,-27,-30,-18,-179
-11,-7,-20,-34,-11,-19,-47,-3,-152
-2040,496,-1234,-8185,-6124,-2011,-3148,2622,-19624
32,31,-4,-29,-18,-26,-38,19,-33
3,53,-18,-39,-2,-24,-22,-16,-65
-76,-34,-69,-171,-168,-92,-134,-42,-786
-127,131,-179,-451,-257,-201,-233,23,-1294
-33,-2,-32,-71,-45,-49,-54,-19,-305
59,6,-44,-49,-110,-111,-67,-62,-378
7,30,-23,-87,-42,-75,-62,2,-250
111,226,-97,-386,-122,-291,-199,-52,-810
167,144,-5,-255,-74,-296,-189,-8,-516
-11,-5,-54,-94,-40,-56,-51,9,-302
42,23,-10,-64,-28,-53,-20,-20,-130
-79,-20,-85,-140,-78,-82,-145,-17,-646
-93,-17,-82,-148,-113,-75,-140,10,-658
-90,-15,-80,-145,-112,-62,-126,3,-627
-1,29,-14,-41,-19,-21,-39,-34,-140
-38,-21,-65,-156,-151,-115,-110,1,-655
-99,-30,-118,-258,-254,-138,-157,-30,-1084
-85,-13,-78,-144,-62,-75,-138,-41,-636
-5,-1,-10,-15,3,-6,-9,-2,-45
182,75,-45,-71,-169,-192,-98,-157,-475
3,28,6,-61,-43,-53,6,3,-111
-83,-15,-58,-194,-133,-131,-117,-1,-732
-82,-11,-66,-193,-143,-132,-125,5,-747
-2,7,-29,-100,-65,-65,-63,4,-313
-48,5,-42,-108,-94,-86,-78,-9,-460
-64,-3,-43,-121,-82,-77,-62,-14,-466
-21,0,3,-108,-75,-59,-53,-5,-318
-24,-8,-18,-23,-31,-15,-35,4,-150
58,67,-17,-113,-19,-99,-72,-16,-211
-8,-3,-33,-61,-92,-42,-84,-19,-342
-18,-15,-47,-88,-49,-39,-88,21,-323
11,-25,-25,-40,-73,-62,-82,6,-290
-6,55,-47,-50,-19,20,-91,144,6
-13,28,-29,-98,-130,-35,-90,-10,-377
69,73,-22,-185,-115,-249,-177,-11,-617
-45,29,-67,-230,-129,-116,-94,27,-625
-7,91,-29,-41,-55,-87,-141,-83,-352
19,18,4,-41,-94,-57,-52,-3,-206
-265,-47,-413,-955,-689,-672,-720,-310,-4071
-36,25,-58,-102,-67,-86,-57,8,-373
-4,1,-16,-30,-55,-5,-36,-12,-157
-128,-30,-107,-233,-79,-124,-182,-46,-929
39,41,11,-10,-37,-26,10,-16,12
-38,-26,-67,-179,-168,-160,-180,-18,-836
-41,10,-52,-114,-184,-94,-119,-69,-663
-24,-7,-49,-76,-57,-36,-39,-37,-325
65,45,-3,-117,-62,-153,-99,0,-324
17,-10,0,-57,-5,-52,-46,1,-152
-51,-32,-73,-109,-91,-69,-115,-10,-550
-81,-29,-113,-188,-150,-107,-152,21,-799
8,63,-21,-56,-38,-58,-66,9,-159
-61,96,-226,-530,-291,-413,-417,-158,-2000
-2,79,-71,-183,-106,-119,-89,84,-407
115,118,-21,-248,36,-143,-153,72,-224
27,166,-31,-105,-63,-46,13,60,21
-18,29,-69,-178,-146,-180,-150,22,-690
-17,114,-122,-326,-110,-237,-207,-55,-960
-123,-64,-117,-224,-162,-86,-163,31,-908
80,257,-109,-482,-139,-240,-245,199,-679
-5,40,-21,-141,-53,-70,-64,23,-291
-62,110,-156,-424,-208,-226,-146,28,-1084
-13,73,-28,-95,-41,-80,-67,26,-225
-20,19,-60,-116,-62,-77,-86,-40,-442
-90,-23,-105,-221,-137,-117,-146,-58,-897
54,-33,-29,-192,-4,-125,-99,2,-426
14,52,-49,-168,-111,-121,-68,13,-438
-19,5,-23,-75,-44,-53,-60,4,-265
-70,5,-56,-239,-182,-127,-112,71,-710
16,70,-28,-23,-42,-47,-52,10,-96
-27,12,-38,-54,-31,-36,-37,-22,-233
-76,-1,-81,-187,-84,-94,-91,-12,-626
46,-27,11,4,-27,-42,-65,49,-51
-33,-22,-68,-105,-76,-75,-70,-8,-457
63,56,-56,-155,-30,-164,-131,-8,-425
-22,-10,-37,-55,-51,-22,-26,2,-221
14,155,-57,-300,-83,-237,-245,-36,-789
19,73,-14,-130,-78,-54,-48,14,-218
-42,314,-62,-444,-68,-134,-46,165,-317
-42,-7,-117,-206,-202,-144,-198,-27,-943
-11,5,-18,-27,-25,-20,-11,-11,-118
269,167,76,-80,113,-154,-132,121,380
10,44,15,-55,-70,-61,-77,29,-165
-17,38,-70,-153,-128,-58,-56,5,-439
-41,39,-40,-149,-90,-50,-75,-21,-427
-54,-18,-52,-130,-92,-86,-87,-60,-579
-47,-39,-69,-114,-99,-65,-105,-16,-554
-223,-14,-227,-527,-377,-230,-366,-70,-2034
18,66,-60,-189,-36,-118,-129,38,-410
82,184,-44,-253,7,-217,-162,80,-323
4,2,-31,-120,-54,-84,-121,-4,-408
-56,75,-63,-189,-74,-127,-87,40,-481
0,301,-125,-540,-277,-370,-309,-179,-1499
92,68,17,-161,-36,-158,-48,47,-179
-165,123,-455,-853,-655,-689,-800,-504,-3998
39,-6,61,-408,23,-290,-164,-60,-805
200,172,27,-114,-103,-214,-104,-30,-166
93,146,-51,-215,-200,-234,-189,-84,-734
-74,67,-50,-272,-252,-229,-128,26,-912
-197,55,-328,-709,-421,-484,-554,-242,-2880
27,135,-58,-240,-101,-228,-158,33,-590
23,9,-6,-30,-38,-42,-27,-31,-142
-50,-24,-114,-145,-183,-143,-167,-63,-889
78,196,-14,-199,-122,-228,-164,-42,-495
-96,-28,-77,-370,-272,-245,-209,-25,-1322
73,304,-84,-248,-11,-151,-60,157,-20
-22,14,-36,-83,-61,-36,-55,-17,-296
8,40,-13,-140,-97,-106,-93,-29,-430
-72,-57,-62,-140,-124,-103,-125,16,-667
-69,16,-116,-238,-157,-128,-157,43,-806
-40,21,-37,-87,-21,-26,-34,4,-220
-43,-10,-44,-110,-67,-59,-77,29,-381
-57,-1,-34,-102,-43,-53,-62,-26,-378
-23,27,-28,-120,-45,-67,-18,-3,-277
59,131,-60,-211,-140,-170,-102,30,-463
-66,34,-55,-124,-27,-52,-69,-26,-385
-93,105,-200,-425,-400,-277,-298,170,-1418
-99,6,-156,-263,-81,-139,-147,-8,-887
40,135,-40,-133,-16,-106,-68,29,-159
-64,-8,-127,-181,-137,-133,-156,-69,-875
25,14,10,10,-19,-6,3,-6,31
8,80,-23,-21,-3,10,21,27,99
52,64,-7,-120,-61,-82,-81,45,-190
-48,30,-97,-216,-76,-150,-126,-150,-833
-73,34,-88,-264,-129,-157,-123,-40,-840
-47,-40,-45,-283,-337,-283,-260,14,-1281
-36,25,-36,-79,-29,-46,-44,-1,-246
-42,64,-49,-126,-84,-112,-111,-8,-468
135,66,29,-56,41,-52,-57,11,117
119,50,20,17,37,-36,-39,80,248
-420,108,-663,-1250,-961,-797,-973,-273,-5229
-1,-7,-12,-50,-72,-65,-46,-13,-266
46,25,-15,-169,-49,-118,-78,51,-307
2,30,-41,-123,-125,-59,-73,6,-383
-25,-3,-19,-36,-88,-50,-35,18,-238
5,12,4,-21,-27,-25,-31,-7,-90
-4,116,-92,-287,-154,-62,-154,50,-587
-5,144,-42,-254,-255,-125,-160,175,-522
-36,0,-61,-127,-88,-57,-89,-14,-472
60,39,-36,-94,-53,-124,-78,-46,-332
-39,-10,-60,-165,-108,-119,-121,-52,-674
-9,59,-33,-93,-78,-108,-108,-36,-406
-25,21,-45,-108,-58,-84,-31,-19,-349
140,189,-58,-270,-185,-318,-198,-53,-753
-7,2,-1,-42,-88,-25,-42,24,-179
-54,53,-109,-263,-198,-180,-163,-70,-984
-51,26,-61,-147,-80,-37,-32,-14,-396
97,23,3,-81,-44,-79,-116,79,-118
-17,-13,-31,-100,-95,-83,-83,-47,-469
-21,33,-12,-69,-54,-67,-51,-41,-282
54,48,-22,-60,-33,-83,-84,14,-166
-6,39,-5,-53,-30,-57,-14,-12,-138
0,41,-16,-48,-22,-68,-16,5,-124
25,49,-15,-140,-40,-136,-77,38,-296
41,-15,-48,-29,-88,-94,-80,-60,-373
361,236,157,-303,135,-280,-235,285,356
87,363,-24,-393,48,-216,-76,276,65
42,0,50,-114,-133,-99,-94,42,-306
-63,20,-148,-405,-267,-261,-272,-160,-1556
-51,8,-65,-155,-99,-64,-55,47,-434
-16,10,-26,-90,0,-2,-18,67,-75
311,277,228,274,249,153,5,150,1647
-20,106,-45,-233,-47,-107,-119,-80,-545
-17,25,-64,-110,-116,-94,-83,-28,-487
-37,155,-59,-562,-358,-451,-368,-333,-2013
-112,-36,-85,-174,-148,-80,-169,8,-796
-34,2,-62,-85,-57,-20,-56,-5,-317
-16,15,-77,-254,-189,-128,-111,134,-626
-84,286,-89,-112,-198,-123,-310,93,-537
57,-13,25,3,-12,-30,-38,17,9
-51,8,-49,-148,-82,-79,-94,8,-487
-37,-45,-64,-216,-93,-121,-129,-23,-728
-28,7,-78,-211,-139,-121,-112,-11,-693
-97,76,-55,-122,-99,-11,-145,-4,-457
13,190,0,-265,-120,-156,-90,53,-375
27,219,-26,-163,-62,33,-7,95,116
-33,88,-59,-376,-26,-141,-141,48,-640
75,32,-6,-65,-38,-98,-43,-19,-162
66,59,14,-37,-4,-54,-38,11,17
-20,-53,-91,-115,-254,-222,-213,-96,-1064
63,34,32,-70,-113,-128,-82,12,-252
19,-10,-20,-3,-71,-45,-49,-27,-206
-7,45,-26,-115,-32,-53,-33,-13,-234
-93,1,-134,-243,-163,-87,-171,-79,-969
-78,-24,-91,-166,-104,-80,-119,-6,-668
-51,40,-64,-157,-78,-83,-85,-10,-488
-45,-2,-68,-226,-143,-121,-132,14,-723
78,47,4,-50,-26,-91,-49,-2,-89
12,79,-52,-328,-187,-195,-224,249,-646
37,61,-38,-137,-64,-112,-87,45,-295
-9,6,-6,-70,-54,-22,-24,8,-171
20,-19,-12,-48,-101,-82,-67,4,-305
-13,14,-19,-40,-43,-27,-54,-17,-199
-217,114,-136,-472,-160,-111,-235,-131,-1348
48,34,-26,-38,-73,-119,-86,-24,-284
4,4,-16,-26,-45,-27,-14,-10,-130
43,15,-12,-50,-62,-92,-47,-16,-221
-223,26,-281,-559,-372,-250,-421,-6,-2086
11,100,-58,-276,-74,-177,-147,-100,-721
-99,34,-128,-314,-216,-179,-179,-85,-1166
1,5,-17,-47,-29,-28,-21,11,-125
-123,36,-107,-322,-218,-210,-222,-93,-1259
83,88,-52,-177,-177,-105,-152,39,-453
-45,-11,5,-100,-102,-29,-44,-12,-338
-34,52,-99,-243,-96,-157,-164,-50,-791
-92,-50,-90,-157,-112,-61,-130,10,-682
26,-23,11,-36,-12,17,-29,77,31
0,9,-35,-36,-51,-46,-60,-17,-236
182,135,38,44,14,-132,-124,32,189
-11,43,-108,-177,-183,-177,-227,-66,-906
-3,43,-12,-55,-16,-31,-20,35,-59
-3,12,-13,-65,-28,-46,-30,3,-170
6,33,-7,-59,-32,-47,-18,14,-110
33,43,0,-85,-58,-82,-27,-7,-183
-23,32,-65,-254,-127,-184,-148,-35,-804
121,47,0,-120,-78,-146,-42,18,-200
45,2,16,-88,-57,-81,-83,-32,-278
-2,16,-20,-19,-48,-22,-35,-13,-143
-34,7,-26,-51,-56,-20,-32,-6,-218
100,107,-63,-204,-127,-251,-160,-44,-642
46,37,27,-6,12,-39,-9,37,105
41,18,-44,-186,-91,-176,-128,-34,-600
215,30,146,109,1,27,-77,75,526
12,47,-26,-74,-106,-98,-98,-40,-383
75,14,-8,-57,-56,-75,-64,-21,-192
-29,-20,-57,-164,-136,-124,-152,-14,-696
-24,79,-100,-272,-116,-141,-116,35,-655
366,172,13,-309,248,-44,-267,164,343
-15,34,-18,-60,-50,-38,-39,17,-169
-63,9,-119,-216,-156,-141,-218,-43,-947
-19,-6,-10,-51,-71,-38,-33,-6,-234
-23,8,-40,-93,-75,-61,-83,-33,-400
37,13,12,-46,-62,-59,-90,44,-151
-127,-47,-179,-271,-205,-172,-218,-114,-1333
-28,130,-80,-347,-172,-242,-140,-75,-954
-11,1,-23,-74,-53,-36,-24,-14,-234
-3,-1,-28,-25,-35,-36,-37,-15,-180
69,32,-6,-94,-68,-125,-97,-48,-337
36,26,6,-50,15,-48,-41,8,-48
-43,23,-16,-115,-88,-29,-59,-1,-328
-93,58,-145,-239,-36,-53,-114,-66,-688
-41,31,-50,-170,-68,-100,-55,22,-431
10,94,-42,-151,-145,-157,-115,-54,-560
0,31,-40,-153,-140,-116,-45,10,-453
89,101,59,-96,-29,-140,-108,105,-19
-117,-58,-301,-630,-432,-459,-513,-120,-2630
-89,-12,-86,-222,-136,-61,-136,21,-721
23,11,-25,-115,-18,-76,-58,-46,-304
-69,94,-92,-266,-190,-143,-157,29,-794
-96,-10,-130,-229,-145,-95,-159,-107,-971
20,34,-36,-85,-64,-81,-90,-72,-374
-6,21,-13,-43,-4,11,-18,-19,-71
-94,-42,-124,-291,-148,-81,-181,-11,-972
125,26,43,-53,53,-12,-135,77,124
22,7,-10,-54,1,-37,-12,-16,-99
-81,-69,-71,-178,-156,-132,-123,3,-807
-34,-11,-57,-96,-65,-58,-77,-13,-411
60,179,-10,-208,-59,-131,-89,126,-132
27,198,-97,-560,-104,-398,-462,51,-1345
33,82,-3,-136,-57,-159,-90,79,-251
15,10,-15,-36,-40,-34,-12,-26,-138
-17,11,-2,-23,-32,-28,-9,-1,-101
-11,30,-10,-8,-14,-12,-19,-12,-56
-47,-28,-88,-272,-313,-200,-238,-73,-1259
-10,26,-33,-99,-87,-41,-41,16,-269
4,6,-1,-60,-96,-60,-73,-41,-321
-24,-23,-34,-45,-19,-33,-32,-21,-231
-25,-11,-22,-52,-48,-25,-24,-5,-212
-33,5,-13,-75,-129,-104,-84,-32,-465
6,43,9,-50,-93,-86,-50,-38,-259
8,-2,-31,-65,-41,-27,-47,28,-177
-106,-4,-169,-346,-168,-156,-199,-53,-1201
-38,-13,-47,-84,-86,-62,-67,-7,-404
-9,19,-20,-90,-50,-34,-31,0,-215
-24,4,-20,-46,-30,-22,-35,-1,-174
-17,8,-8,-34,-17,-26,-12,-4,-110
6,-19,-10,-37,-44,-26,-35,17,-148
2,17,-11,-29,-15,-26,-22,-18,-102
40,58,18,1,25,5,52,14,213
24,10,8,0,-59,-33,-20,-7,-77
18,16,-2,-18,-35,-36,-34,-20,-111
-12,42,-13,-38,-21,-2,-7,18,-33
55,44,19,-55,11,-108,-22,24,-32
12,-39,-74,-90,-140,-160,-132,-69,-692
-143,18,-198,-350,-188,-189,-250,-96,-1396
27,42,17,-46,-55,-65,-40,20,-100
20,37,21,-49,-14,-48,-24,27,-30
47,38,10,-40,-34,-75,-38,-18,-110
-19,3,-6,-22,-24,12,-20,16,-60
-8,69,-22,-100,-47,-104,-40,-2,-254
-30,118,-22,-181,-105,-55,-34,71,-238
12,65,-52,-216,-65,-183,-129,-22,-590
-37,-6,-20,-65,-53,-44,-36,-7,-268
18,2,5,11,-28,-14,-24,5,-25
-8,13,-12,-35,-2,-22,-24,-5,-95
-26,8,-37,-76,-35,-41,-39,25,-221
-92,-10,-134,-192,-129,-87,-160,20,-784
-10,121,-30,-149,-45,-96,-42,-28,-279
0,14,-3,-56,-23,-38,-29,-9,-144
-19,2,-15,-49,-38,-33,-40,33,-159
5,50,-17,-83,-48,-62,-74,37,-192
-43,-11,-52,-113,-167,-135,-123,-52,-696
-36,12,-53,-93,-69,-78,-91,-31,-439
-10,-24,-43,-53,-59,-45,-82,-14,-330
-13,-7,-10,-29,-38,-14,-5,2,-114
9,-7,-28,-73,-80,-76,-51,-36,-342
-54,31,-61,-145,-30,-100,-110,30,-439
7,12,-32,-39,-20,-15,-89,12,-164
-13,13,-16,-47,-25,-19,-11,-25,-143
-48,-5,-100,-210,-102,-164,-141,-28,-798
-84,-24,-87,-127,-124,-61,-138,18,-627
46,53,-19,-104,-189,-162,-128,-50,-553
-61,22,-50,-122,-49,-61,-76,-40,-437
-34,-30,-31,-153,-126,-97,-103,-59,-633
-15,5,11,-19,-8,-6,7,6,-19
-36,46,-43,-93,-20,-17,-53,-5,-221
5,37,-25,-48,-39,-52,-39,-37,-198
-15,-7,-15,-25,-72,-39,-42,-2,-217
-54,0,-91,-130,-72,-60,-87,-34,-528
14,132,-45,-172,-99,-185,-123,22,-456
-12,27,-20,-141,-127,-107,-61,44,-397
-40,32,-64,-109,-86,-53,-85,-23,-428
-85,-46,-86,-136,-123,-49,-113,-8,-646
31,33,5,-51,-13,-43,-17,4,-51
10,7,13,-45,-106,-63,-44,19,-209
-37,-10,-39,-79,-42,-32,-67,-28,-334
78,27,-76,-157,-128,-206,-164,-113,-739
-73,14,-109,-237,-221,-177,-151,-93,-1047
46,33,-38,-84,-53,-103,-66,-59,-324
0,11,8,-45,-26,-26,-20,24,-74
-43,-15,-39,-77,-65,-30,-49,8,-310
68,-11,23,33,-3,-8,-49,39,92
-29,-27,-54,-136,-171,-148,-112,-27,-704
-26,23,-51,-97,-42,-50,-36,11,-268
-69,-58,-75,-141,-113,-73,-114,-10,-653
-22,-14,-57,-121,-170,-156,-162,-63,-765
-44,8,-41,-122,-123,-76,-90,-60,-548
-48,23,-54,-128,-73,-65,-86,-15,-446
130,162,-31,-265,29,-194,-174,38,-305
-15,-15,-14,-22,-20,-15,-37,4,-134
-75,-21,-55,-127,-74,-85,-130,-14,-581
64,51,17,-3,17,-48,-12,31,117
-55,30,-26,-117,-21,-45,-26,2,-258
10,16,15,-81,-5,-47,-58,28,-122
-7,30,2,-59,-6,-27,-6,-9,-82
-29,-54,-48,-74,-92,-53,-120,40,-430
-34,9,-16,-104,-60,-60,-50,38,-277
-36,-23,-19,-74,-77,-32,-52,8,-305
-49,-28,-73,-172,-169,-113,-105,10,-699
-59,-14,-54,-176,-78,-48,-79,57,-451
49,72,-58,-132,-143,-150,-107,-85,-554
-28,36,-114,-203,-118,-168,-190,-129,-914
-23,8,-24,-100,-82,-73,-55,-20,-369
15,66,12,-84,-26,-82,-81,-9,-189
7,34,0,-48,-7,-41,-20,-14,-89
6,8,-17,-38,-10,-39,-10,-12,-112
-17,8,-14,-58,-49,-24,-56,-16,-226
-25,19,-4,-32,-33,-28,-20,5,-118
-11,-2,-43,-130,-108,-130,-80,-57,-561
-26,-42,-42,-116,-116,-137,-107,-65,-651
61,110,-8,-146,-73,-114,-72,-107,-349
4,27,-3,-27,-9,-27,-6,7,-34
-40,-12,-42,-107,-119,-50,-66,28,-408
-46,4,-56,-111,-55,-35,-79,0,-378
-13,8,-11,-43,-21,-21,-32,-3,-136
6,33,-14,-82,-23,-37,-59,32,-144
-44,-10,-78,-122,-89,-100,-130,-40,-613
1,-12,-2,-8,-42,0,-5,-15,-83
-24,29,-20,-65,-43,-12,-59,57,-137
-18,-14,9,-64,-53,-7,-20,12,-155
-3,5,-9,-44,1,-31,-36,14,-103
14,9,-14,-56,-81,-83,-51,-27,-289
26,-14,-4,-5,-129,-90,-75,-32,-323
-14,42,-21,-86,-59,-82,-46,-13,-279
14,32,-18,-37,-36,-8,-21,4,-70
-43,-37,-62,-122,-111,-62,-104,-5,-546
-16,11,-29,-62,-26,-26,-14,39,-123
-11,-3,-34,-43,-43,-33,-29,6,-190
-19,21,-15,-64,-72,-43,-40,-2,-234
28,37,12,-46,-45,-84,-53,-12,-163
-19,16,-21,-62,-24,-22,-10,38,-104
-110,47,-136,-326,-185,-202,-232,-109,-1253
-31,4,-38,-84,-124,-63,-94,-9,-439
-25,-5,-31,-43,-26,-17,-23,1,-169
59,15,17,-36,-9,-48,-32,11,-23
129,86,60,-9,14,-60,-68,8,160
116,70,96,9,31,-40,-76,37,243
-2,-1,-19,-42,-18,-53,-26,-27,-188
18,46,-35,-114,-106,-132,-100,-18,-441
-84,-7,-146,-229,-157,-156,-219,-96,-1094
-68,64,-55,-243,-141,-109,-135,-157,-844
-13,23,-34,-78,-38,-58,-59,-33,-290
-21,17,-29,-91,-59,-67,-51,-23,-324
-60,1,-68,-146,-131,-71,-120,-32,-627
117,123,-42,-236,-113,-269,-146,-86,-652
-16,0,-74,-170,-105,-119,-111,-72,-667
162,30,88,67,-24,12,-58,48,325
-62,-25,-143,-278,-252,-222,-220,-80,-1282
-21,5,-42,-120,-62,-57,-101,-9,-407
-9,54,-36,-95,-19,-45,-34,-88,-272
15,36,2,-32,-9,5,-10,27,34
-24,-4,-27,-57,-56,-39,-39,-15,-261
-22,39,-15,-103,-67,-40,-43,-1,-252
-32,13,-22,-88,-52,-48,-41,-4,-274
-49,-60,-59,-101,-60,-53,-75,10,-447
-65,-22,-85,-143,-113,-104,-121,-42,-695
-7,3,-78,-158,-111,-161,-100,-75,-687
44,66,-37,-136,-17,-142,-91,3,-310
-48,65,-64,-150,-38,-81,-96,-6,-418
28,54,-6,-115,-15,-63,-86,20,-183
35,57,12,-84,-9,-60,-15,-3,-67
10,58,-32,-70,-50,-75,-86,-38,-283
105,175,-4,-124,-25,-117,-13,-68,-71
-33,13,-22,-63,-43,-60,-83,-19,-310
10,44,-36,-116,-75,-86,-75,-54,-388
48,29,2,-43,-13,-65,-54,19,-77
5,13,9,-14,-14,0,6,18,23
10,-1,9,-27,-36,-27,-28,-9,-109
52,90,-26,-202,-32,-132,-89,46,-293
15,-15,-13,-13,-4,-33,-39,13,-89
-41,31,-86,-172,-114,-111,-116,-67,-676
-5,9,-21,-48,-78,-53,-38,-16,-250
45,37,-21,-170,-304,-190,-150,-98,-851
-16,45,-18,-143,-91,-114,-73,0,-410
9,33,4,-125,-87,-56,-73,38,-257
243,274,-200,-390,-336,-620,-554,-149,-1732
6,-1,-33,-53,-61,-45,-41,-12,-240
-12,8,-15,-51,-56,-58,-44,-20,-248
-3,71,-18,-77,-17,-46,6,54,-30
-18,8,-14,-36,10,-10,-17,20,-57
233,105,84,-25,-49,-200,-68,48,128
-61,-32,-67,-100,-74,-67,-92,-18,-511
58,106,18,-32,-56,-77,-13,78,82
-8,21,-29,-74,-57,-38,-39,-8,-232
1,38,-39,-84,-32,-69,-74,-18,-277
70,11,11,-45,-18,-66,-30,1,-66
-28,-9,-30,-53,-44,-41,-47,1,-251
-5,20,-9,-22,-21,-14,-29,-12,-92
3,-7,-16,-10,-22,-26,-15,-7,-100
31,43,-2,-18,1,-25,-1,20,49
-21,11,-29,-120,-69,-65,-52,16,-329
85,40,-28,-90,-125,-137,-85,-79,-419
-24,-9,-22,-70,-51,-49,-50,-16,-291
14,6,-22,-66,-111,-92,-83,-37,-391
-25,23,-41,-65,-26,-29,-49,-7,-219
11,132,-9,-180,-13,-46,-22,65,-62
31,46,-7,-131,-16,-122,-77,-32,-308
4,51,-104,-173,-184,-174,-220,-41,-841
-10,44,-4,-202,-23,-68,-102,34,-331
-9,-7,-23,-69,-55,-55,-59,-13,-290
-43,4,-33,-97,-28,-23,-31,-2,-253
30,16,1,-42,-10,-48,-29,15,-67
53,20,-14,-102,-104,-139,-90,0,-376
14,31,-14,-108,-17,-73,-57,-10,-234
-18,2,-35,-39,-10,2,-45,49,-94
-21,29,-84,-166,-126,-124,-137,-64,-693
-41,-26,-61,-100,-133,-83,-115,-29,-588
-25,13,-28,-89,-40,-22,-42,-17,-250
-42,17,-103,-264,-127,-188,-168,-121,-996
11,56,26,-20,-14,-11,10,-18,40
15,17,-14,0,-57,-32,-27,-14,-112
38,2,-32,-75,-104,-128,-71,-90,-460
-24,4,-23,-53,-38,-6,-35,-1,-176
24,-18,-31,-65,-24,-72,-48,-12,-246
30,92,-3,-158,-38,-135,-72,78,-206
-14,-9,-34,-77,-90,-68,-66,-41,-399
0,4,-15,-32,-16,-26,-9,-25,-119
-56,-9,-10,-133,-140,-13,-70,59,-372
-18,-6,-21,-43,-34,-21,-40,-10,-193
-72,-2,-79,-163,-70,-83,-88,-32,-589
-25,5,-29,-86,-55,-50,-52,-39,-331
-46,-23,-58,-133,-88,-67,-72,0,-487
23,3,-11,22,-30,-26,-25,-17,-61
-42,82,-41,-126,-73,-70,-59,8,-321
-14,58,-12,-82,-38,-54,-23,63,-102
-5,1,-12,-47,-41,-22,-15,-5,-146
-13,54,7,-76,-6,-34,-21,13,-76
75,86,-4,-132,-85,-144,-87,-19,-310
-25,49,-32,-166,-102,-99,-64,47,-392
19,106,-19,-85,12,-69,-25,51,-10
30,68,-5,-97,-14,-142,-59,-27,-246
3,29,-8,-81,-43,-53,-46,-6,-205
-33,5,-34,-113,-102,-50,-84,-38,-449
-34,7,-94,-129,-62,-68,-95,4,-471
-11,-25,-18,-41,-28,-19,-34,14,-162
5,20,-55,-102,-67,-69,-61,-59,-388
-153,17,-222,-561,-363,-310,-353,-1,-1946
-121,152,-178,-572,-237,-355,-336,75,-1572
66,67,26,-13,-8,-28,-79,50,81
29,9,-26,-110,-77,-111,-85,12,-359
11,31,-13,-62,-32,-54,-10,-60,-189
-26,-24,-43,-118,-106,-94,-95,-56,-562
35,68,1,-82,-13,-47,-67,-10,-115
-20,16,-2,-18,-23,-23,-37,-14,-121
23,45,-60,-139,-114,-146,-130,-94,-615
-31,4,-38,-197,-168,-151,-133,-93,-807
15,12,-39,-84,-116,-75,-100,-61,-448
109,99,-161,-255,-220,-359,-281,-217,-1285
24,20,-6,-24,-41,-20,-35,-33,-115
12,10,-23,-66,-39,-16,-27,-7,-156
-36,107,-19,-167,-66,-70,-38,22,-267
-29,19,-6,-97,-63,-82,-29,-13,-300
15,45,-55,-163,-108,-114,-135,-67,-582
-2,27,-41,-85,-89,-88,-65,-29,-372
-166,98,-266,-511,-209,-273,-315,-131,-1773
14,33,-4,-64,9,-57,-3,3,-69
15,37,7,-36,-45,-41,-11,10,-64
-21,-3,-27,-67,-27,-48,-39,-43,-275
-16,-5,-39,-104,-75,-72,-52,-39,-402
18,24,7,1,-22,-10,-24,0,-6
45,61,9,-68,-26,-58,-58,27,-68
23,5,1,-52,-50,-71,-28,-34,-206
-15,18,-17,-59,-12,-34,-19,-6,-144
69,128,8,-57,17,-51,-54,50,110
-16,4,-41,-93,-72,-82,-82,-22,-404
-82,5,-80,-272,-190,-173,-156,-24,-972
-8,-8,-68,-120,-151,-162,-117,-114,-748
-7,-5,-25,-43,-58,-40,-41,-31,-250
-46,13,-76,-87,-60,-43,-76,4,-371
22,33,6,-49,-22,-32,-23,11,-54
-16,23,-23,-51,6,7,-9,41,-22
15,41,0,-44,-6,-12,-27,9,-24
-33,11,-75,-120,-95,-111,-112,-46,-581
26,51,-6,-58,-12,-30,-21,58,8
34,58,-23,-58,-106,-91,-40,12,-214
-12,12,-26,-104,-68,-66,-72,-18,-354
8,7,-20,-41,-53,-47,-27,-30,-203
-23,21,-27,-133,-138,-78,-110,-27,-515
-31,87,-92,-238,-130,-164,-162,-90,-820
22,105,-33,-180,-101,-155,-150,-180,-672
-17,6,-25,-86,-83,-67,-61,-24,-357
3,164,-29,-205,-77,-125,-164,-131,-564
22,20,-1,-10,-26,-34,7,2,-20
6,65,-66,-243,-84,-161,-146,13,-616
-57,-29,-53,-96,-87,-73,-113,-19,-527
-44,-5,-25,-93,-111,-74,-87,-4,-443
-22,16,-18,-84,-45,-39,-61,-40,-293
-52,-23,-33,-150,-61,-65,-75,-15,-474
-49,36,-17,-138,-42,-148,-60,-15,-433
27,1,-5,3,-53,-35,-43,6,-99
72,34,-4,-136,-153,-121,-213,42,-479
0,16,-14,-42,-39,-29,-5,-55,-168
15,27,-10,-101,-82,-73,-63,-2,-289
-36,103,-52,-155,-50,-55,-99,-81,-425
-36,-3,-34,-123,-122,-52,-29,21,-378
-88,9,-102,-271,-214,-243,-235,-97,-1241
24,54,-13,-45,-49,-75,-12,47,-69
-26,23,-43,-77,-42,-61,-94,4,-316
28,39,-3,-55,-38,-43,-52,24,-100
-37,29,-20,-75,-10,-27,-32,-14,-186
-4,60,-70,-138,-18,-105,-83,-62,-420
-29,39,-27,-90,-21,-37,-35,11,-189
12,-3,-8,-26,6,-25,-24,-7,-75
42,71,-22,-132,-145,-117,-38,74,-267
42,1,-8,-9,-75,-77,-44,-30,-200
-29,4,-14,-60,-45,-38,-46,7,-221
1,-6,-35,-83,-54,-92,-89,4,-354
-47,57,-27,-119,-36,-14,-104,59,-231
-77,-22,-48,-146,-112,-86,-91,6,-576
33,20,-23,-94,-145,-126,-107,-107,-549
-13,0,-24,-76,-19,-46,-53,-29,-260
6,20,-20,-80,-36,-71,-36,-29,-246
136,67,31,-90,1,-119,-89,131,68
-46,-26,-48,-101,-70,-46,-75,-9,-421
24,5,3,-16,-40,-32,-28,-17,-101
0,18,-19,-31,-26,-26,-29,13,-100
-28,-15,-16,-69,-66,-28,-29,-4,-255
11,5,-3,-7,-21,-14,-19,-5,-53
-28,-2,-24,-100,-106,-66,-64,-14,-404
-7,5,-29,-64,-45,-54,-74,-43,-311
5,21,-9,-64,-18,-39,-44,8,-140
-16,49,-105,-197,-96,-151,-146,-104,-766
7,19,-32,-67,-87,-78,-61,-11,-310
-38,-22,-57,-78,-73,-46,-60,-15,-389
-68,35,-48,-148,-32,-49,-47,-51,-408
6,-25,-30,-41,-21,-31,-63,3,-202
30,33,-15,-49,-47,-68,-35,-41,-192
23,28,3,-17,-10,-12,-9,5,11
-8,7,-19,-46,-50,-44,-22,-27,-209
60,36,9,-92,-36,-74,-73,2,-168
-30,-20,-23,-48,-64,-23,-28,7,-229
73,17,39,41,-26,-15,-18,45,156
-2,26,-2,-55,-77,-41,-26,15,-162
-110,-55,-103,-186,-136,-80,-101,-42,-813
-43,44,-46,-167,-74,-71,-71,0,-428
-96,-19,-99,-214,-127,-90,-121,-10,-776
-26,-4,-45,-70,-65,-30,-42,-5,-287
75,218,-14,-160,25,-72,-193,30,-91
-118,-12,-131,-367,-234,-186,-193,-117,-1358
325,160,91,-295,199,-244,-212,28,52
-36,-4,-22,-120,-75,-58,-57,-4,-376
-28,-6,-25,-35,-43,-19,-39,-4,-199
-36,27,-57,-100,-46,-38,-83,-35,-368
7,95,-36,-261,-62,-152,-79,49,-439
6,-4,-12,-11,-33,-28,-25,-12,-119
-12,5,-26,-53,-20,-37,-53,-18,-214
-3,-12,-43,-117,-56,-59,-66,-11,-367
-518,-318,-644,-1341,-1119,-760,-1065,-611,-6376
-29,17,-51,-123,-89,-37,-56,25,-343
111,190,26,-60,-16,-75,-48,70,198
-53,56,-42,-114,-53,-59,-71,40,-296
110,104,24,-68,3,-83,-55,4,39
-10,-14,-22,-67,-103,-33,-20,6,-263
-7,-34,-14,-102,-77,-95,-53,-33,-415
-31,21,-39,-99,-73,-61,-62,-14,-358
-31,6,-64,-134,-99,-89,-108,-13,-532
9,10,-29,-65,-64,-72,-58,-63,-332
47,78,-5,-11,-41,-32,-17,21,40
-16,24,-28,-60,-33,-52,-35,-3,-203
-38,39,-41,-140,-67,-52,-93,-78,-470
-94,107,-126,-317,-96,-115,-140,-23,-804
-67,18,-46,-145,-53,-5,-44,23,-319
26,22,-4,-82,-72,-55,-81,-7,-253
-19,11,-51,-83,-44,-78,-85,-46,-395
-2,-32,-47,-58,-72,-49,-86,-21,-367
30,57,28,-60,17,-53,-12,58,65
-23,-2,-11,-63,-63,-47,-36,-17,-262
13,13,-4,-26,-39,-29,-9,-13,-94
-12,-12,-8,-17,-24,-23,-12,19,-89
-3,-3,-13,-27,-60,-20,-25,29,-122
-22,2,-45,-101,-78,-90,-66,-35,-435
-29,12,-72,-141,-46,-59,-61,-17,-413
-10,-3,-21,-48,-52,-30,0,-3,-167
148,112,87,31,70,-67,-57,89,413
-24,11,-27,-71,-36,-60,-42,-25,-274
-72,-24,-88,-181,-84,-76,-112,-48,-685
-21,11,-18,-71,-20,-42,-23,-10,-194
-5,29,-49,-41,-10,-43,-43,5,-157
-62,105,-48,-208,-22,-72,-103,-82,-492
-29,39,-48,-123,-82,-83,-83,-18,-427
58,58,-39,-115,-114,-121,-35,44,-264
-34,-19,-50,-96,-86,-52,-59,-7,-403
-12,86,-57,-245,-100,-166,-139,-164,-797
-4,36,-11,-42,-92,-51,-37,37,-164
-18,16,-24,-49,-21,-18,-38,3,-149
-62,36,-85,-194,-129,-107,-93,-24,-658
-13,-4,-12,-83,-75,-76,-39,-4,-306
-3,34,-47,-87,-26,-43,-53,-33,-258
46,12,-10,-34,-103,-67,-85,-6,-247
14,80,24,-102,-27,-99,-51,-21,-182
-16,3,-18,-50,-75,-50,-51,-13,-270
-10,-2,4,-23,-10,-9,7,7,-36
-7,-12,-25,-65,-92,-73,-42,-42,-358
30,46,9,-7,3,6,37,-7,117
11,39,-42,-168,-37,-98,-98,-36,-429
28,55,1,-80,-31,-51,-43,2,-119
-58,-27,-103,-157,-148,-113,-147,-94,-847
-28,7,-31,-64,-18,-16,-36,-9,-195
-64,55,-74,-245,-85,-107,-119,51,-588
22,23,-19,-79,-73,-94,-66,-27,-313
32,39,7,-76,-17,-89,-43,10,-137
-28,-15,-19,-55,-48,-58,-39,-22,-284
0,17,2,-26,-35,-33,-12,-5,-92
7,17,-24,-61,-122,-65,-76,-32,-356
0,35,-34,-177,-177,-148,-133,11,-623
18,0,-4,-46,-78,-60,-30,-35,-235
28,87,-92,-245,-139,-247,-190,-155,-953
29,77,-13,-122,-55,-109,-72,31,-234
117,33,65,24,48,8,-26,64,333
-10,30,-66,-122,-89,-113,-150,-60,-580
8,22,-23,-38,-50,-53,-62,-5,-201
-35,-5,-35,-84,-53,-68,-50,-15,-345
-59,14,-78,-151,-90,-84,-94,-33,-575
-16,31,-26,-128,-99,-121,-120,-72,-551
32,65,-118,-145,-97,-159,-181,-154,-757
-14,-13,-15,-67,-88,-67,-60,-15,-339
-23,13,-35,-89,-61,-58,-53,3,-303
8,30,-6,-75,-33,-40,-11,-30,-157
-29,-2,-50,-72,-65,-34,-57,-8,-317
224,107,99,-253,148,-61,-47,199,416
4,70,-20,-82,-29,-55,-53,-7,-172
-11,-15,-11,-87,-56,-55,-76,16,-295
-15,-15,-16,-27,-24,-7,-18,-5,-127
-37,32,-81,-121,-63,-89,-127,-28,-514
46,42,-31,-85,-111,-116,-68,-8,-331
9,41,24,-72,-73,-18,-54,60,-83
-21,19,-17,-58,-34,-19,-10,-13,-153
27,38,-13,-65,-48,-54,-38,12,-141
-66,-16,-104,-182,-173,-163,-157,-54,-915
5,32,-20,-62,-54,-46,-43,-20,-208
35,-15,-5,-65,-102,-112,-88,-59,-411
-10,36,-20,-102,-83,-100,-83,-52,-414
-8,46,-27,-133,-82,-103,-71,-11,-389
109,72,19,-65,-47,-84,-133,62,-67
-181,-83,-151,-396,-266,-235,-300,-54,-1666
-9,-6,-12,-27,-55,-18,-47,-17,-191
-17,19,-48,-103,-89,-43,-60,-29,-370
15,28,-27,-62,-44,-45,-43,-41,-219
-46,-15,-38,-103,-67,-58,-58,0,-385
-1,16,-40,-148,-76,-113,-78,-75,-515
231,149,90,98,30,-112,-128,4,362
-27,31,-103,-254,-94,-186,-160,-26,-819
19,28,-12,-76,-58,-53,-26,4,-174
-127,-2,-187,-377,-254,-278,-360,-7,-1592
4,65,-7,-89,0,-36,-59,16,-106
-15,17,-5,-45,-23,15,3,24,-29
1,44,-34,-114,-60,-52,-33,17,-231
-2,19,-2,-61,-62,-35,-39,36,-146
-6,19,-17,-68,-41,-55,-45,-21,-234
-10,40,-78,-179,-94,-138,-111,-86,-656
-37,23,-38,-73,-47,-31,-46,35,-214
-44,53,-79,-288,-157,-152,-140,-63,-870
-70,3,-109,-219,-95,-142,-97,-44,-773
7,24,-13,-35,-53,-25,-51,-5,-151
27,42,14,-57,-47,-66,-22,-23,-132
3,29,-7,-73,-17,-48,-11,10,-114
-16,35,-43,-120,-81,-93,-64,-46,-428
-2,4,-11,-22,-19,-26,-24,2,-98
29,46,-17,-109,-40,-79,-27,-15,-212
-55,9,-54,-133,-61,-78,-83,-52,-507
-4,-11,-8,-2,-27,-3,-13,10,-58
-20,32,-6,-70,-92,-30,-34,30,-190
-83,-11,-129,-197,-160,-124,-212,-86,-1002
-87,-32,-57,-183,-120,-89,-74,-11,-653
-50,-4,-60,-91,-96,-97,-99,-31,-528
-33,-20,-41,-91,-102,-57,-82,17,-409
32,80,-31,-207,-59,-195,-149,-64,-593
-3,16,-19,-43,-38,-23,-21,-15,-146
-11,8,-12,-21,-22,-19,-21,-1,-99
16,21,9,-2,-14,-18,-13,7,6
99,99,-47,-243,-132,-320,-190,-42,-776
52,68,-21,-136,-109,-155,-113,-54,-468
9,27,5,-37,-28,-36,-21,1,-80
17,54,-20,-103,-10,-62,-40,-29,-193
31,15,-23,-91,-100,-91,-82,-29,-370
-37,-11,-74,-63,-58,-15,-74,-32,-364
-33,38,-104,-178,-47,-77,-64,-24,-489
0,17,-36,-63,-41,-31,-35,9,-180
0,-1,-6,-14,-7,8,-7,24,-3
0,12,9,-69,-91,-51,-56,4,-242
-26,-14,-57,-52,-70,-51,-88,-25,-383
-27,8,-24,-86,-35,-62,-18,13,-231
-29,-1,-53,-69,-82,-68,-93,-26,-421
-2,22,-1,-53,-16,-19,-21,0,-90
-50,94,-59,-270,-91,-133,-181,-73,-763
2,8,-75,-105,-110,-85,-103,-24,-492
-21,-9,-45,-102,-96,-94,-75,-57,-499
-30,8,-15,-88,-85,-77,-46,-17,-350
-70,-62,-102,-151,-126,-95,-102,-41,-749
36,38,-7,-47,1,-37,-26,-8,-50
22,39,-11,-53,2,-51,-58,21,-89
-27,41,-17,-89,-22,-16,-30,-11,-171
-10,-1,-24,-50,-19,-28,-25,20,-137
66,58,15,-108,-58,-148,-100,-24,-299
11,17,-17,-137,-135,-130,-87,-101,-579
-2,18,-3,-36,-28,-24,-3,8,-70
106,27,25,13,-61,-57,-70,35,18
-46,12,-66,-127,-93,-108,-119,-67,-614
-3,26,-89,-129,-63,-127,-125,-82,-592
-8,-12,-56,-86,-130,-141,-107,-76,-616
-25,37,-59,-121,-70,-81,-80,32,-367
-7,37,-24,-87,-43,-37,-17,31,-147
3,19,-26,-68,-102,-73,-72,-58,-377
-34,17,-33,-73,-37,-34,-46,-21,-261
-29,46,-14,-154,-68,-96,-20,4,-331
-82,-38,-63,-136,-114,-81,-113,-17,-644
46,19,-25,-66,-100,-98,-80,-44,-348
8,42,-12,-187,-32,-103,-106,19,-371
-18,0,-42,-113,-58,-75,-40,-36,-382
-92,75,-85,-254,-81,-132,-124,-7,-700
-82,91,-33,-127,-46,-65,-84,-24,-370
-7,17,-4,-41,-5,-19,-21,-17,-97
7,-5,-3,-13,-24,-35,-29,4,-98
24,20,12,-2,23,-10,-26,19,60
-16,-14,-37,-51,-41,-20,-38,-5,-222
40,41,-3,-28,-25,-71,-20,-20,-86
-53,10,-52,-162,-85,-67,-87,-24,-520
-13,-19,-5,-60,-57,-1,-25,14,-166
3,23,-2,-29,-16,-36,-41,7,-91
1,-42,-25,-108,-99,-93,-97,-1,-464
15,-6,-3,-76,-68,-67,-68,-6,-279
17,10,-33,-61,-87,-71,-73,-9,-307
-38,42,-13,-112,-83,-58,-8,52,-218
125,143,14,-81,-40,-113,-90,-13,-55
17,25,-45,-96,-105,-124,-116,-77,-521
-28,57,-42,-183,-162,-105,-61,-47,-571
-17,-6,-35,-132,-188,-115,-154,-34,-681
-41,12,-76,-129,-41,-87,-76,-53,-491
88,77,21,-50,-21,-82,-55,-6,-28
2,9,-15,-60,-67,-65,-61,4,-253
6,26,3,-19,6,-2,6,3,29
21,30,9,-10,-22,-4,12,11,47
-3,24,-8,-59,-21,-50,-13,-2,-132
88,79,-18,-162,-131,-141,-97,35,-347
-31,-22,-64,-164,-133,-162,-134,-37,-747
-10,19,-96,-197,-139,-97,-114,19,-615
10,12,-9,-14,-10,-4,-6,2,-19
2,100,-76,-182,-80,-142,-84,45,-417
6,16,-4,-10,-1,-17,-8,2,-16
-19,5,-9,-30,-54,-10,-27,-5,-149
41,43,-7,-54,-10,-48,-21,14,-42
9,9,11,-65,-7,-62,-17,10,-112
-56,17,-94,-205,-126,-132,-185,-70,-851
-43,6,-20,-89,-26,-25,-35,3,-229
-22,71,-9,-123,-53,-70,-84,32,-258
6,28,-23,-46,-61,-41,-56,-40,-233
-43,-5,-36,-98,-59,-38,-56,-2,-337
4,11,-24,-45,-25,-34,-28,-16,-157
-78,44,-51,-119,-47,-20,-59,-45,-375
-74,-38,-93,-309,-245,-243,-198,-95,-1295
8,53,-84,-97,-82,-111,-127,-87,-527
-41,-19,-34,-80,-106,-39,-91,15,-395
-8,36,-33,-67,-53,-69,-59,-44,-297
24,20,27,-44,-30,-86,-58,-12,-159
-5,23,-53,-92,-110,-107,-105,-67,-516
353,230,78,-193,23,-269,-257,171,136
57,42,21,-72,-22,-77,-76,16,-111
160,119,-80,-328,-270,-441,-346,-252,-1438
-6,-20,-19,-40,-32,-22,-24,33,-130
-8,22,-40,-78,-70,-108,-84,-54,-420
102,66,31,-185,-22,-210,-134,-17,-369
65,46,-25,-76,-75,-62,-73,58,-142
19,77,-1,-29,-1,-13,-58,-15,-21
19,3,-29,-67,-78,-62,-59,-12,-285
-21,5,-79,-140,-55,-64,-68,-34,-456
16,19,-28,-63,-60,-82,-54,-47,-299
-30,23,-18,-155,4,-73,-57,14,-292
-33,17,-40,-85,-34,-36,-45,-32,-288
-14,-1,-19,-20,-28,-29,-31,-9,-151
-20,26,-14,-69,-50,-44,-50,17,-204
-47,-1,-76,-113,-84,-53,-110,-15,-499
-6,33,-44,-99,-44,-62,-58,13,-267
-29,61,-46,-160,-21,-56,-74,35,-290
31,71,11,-67,14,12,-6,6,72
-3,9,-39,-43,-48,-42,-63,11,-218
-5,1,-17,-30,-40,-40,-24,-20,-175
17,18,-19,-67,-85,-69,-31,7,-229
9,-33,2,-133,-22,-78,-65,-7,-327
24,10,-28,-92,-141,-85,-75,-26,-413
-51,10,-206,-608,-439,-517,-421,-200,-2432
-44,3,-38,-107,-80,-45,-76,-41,-428
-17,-2,-52,-63,-83,-89,-96,-51,-453
-71,59,-55,-132,-48,-64,-82,-18,-411
7,9,-6,-12,-11,-27,-30,-15,-85
0,-12,-3,-33,-18,-40,-30,-11,-147
96,45,-3,-79,45,-48,-28,89,117
-9,-5,-47,-72,-81,-61,-55,-34,-364
-1,-14,-21,-65,-69,-84,-41,-38,-333
-6,8,-2,-29,-27,-14,-18,-5,-93
-63,24,-100,-236,-175,-195,-179,-110,-1034
-27,22,-18,-76,-48,-27,-31,9,-196
-50,15,-78,-145,-73,-70,-87,-59,-547
-72,12,-125,-287,-236,-239,-245,-113,-1305
27,46,-11,-65,-71,-43,-32,-24,-173
-8,38,-75,-233,-135,-122,-141,-24,-700
47,25,1,-28,-47,-71,-49,-18,-140
12,-9,-6,-25,-23,-26,-12,-8,-97
11,30,-24,-74,-98,-102,-94,-33,-384
24,13,-5,-65,-86,-87,-72,0,-278
4,8,-8,-27,-29,-28,-12,-6,-98
91,29,27,-39,-83,7,-37,56,51
17,57,-9,-77,-66,-44,-8,-4,-134
-37,66,-16,-48,-26,-27,-38,-14,-140
37,19,-12,-97,-99,-147,-109,-93,-501
-5,-1,1,-5,-16,-14,-13,2,-51
5,2,-7,-11,-30,-12,-11,-1,-65
21,70,33,-50,-109,-25,-62,37,-85
-26,-7,-55,-165,-86,-75,-75,3,-486
20,65,-17,-121,-88,-104,-22,15,-252
13,13,-19,-62,-49,-57,-50,-28,-239
12,-13,-26,-42,-109,-31,-52,-46,-307
-48,58,-92,-267,-107,-133,-118,-97,-804
-20,-11,-31,-152,-79,-98,-49,21,-419
127,112,29,-36,-28,-94,-77,-21,12
-58,39,-88,-180,-109,-111,-93,-74,-674
10,51,-50,-212,-86,-179,-120,-61,-647
-19,0,-48,-122,-85,-39,-71,-24,-408
-31,-16,-52,-76,-99,-82,-82,-25,-463
34,12,14,3,-25,-35,-13,-14,-24
-30,67,-45,-130,-94,-67,-92,24,-367
-3,5,-27,-53,-24,-27,-18,-14,-161
-3,10,-12,-42,-7,-19,-12,-4,-89
-12,22,-37,-98,-68,-39,-65,-4,-301
20,75,-17,-90,-25,-52,-55,15,-129
76,26,3,-53,32,-78,-42,20,-16
-163,80,-103,-280,-62,-118,-128,-53,-827
1,3,0,-3,-5,2,2,5,5
63,31,-24,-74,-91,-71,-57,-51,-274
38,0,8,-31,-24,-44,-29,-19,-101
5,68,-40,-163,-20,-112,-26,-4,-292
-5,-6,1,-18,-21,-15,-14,-8,-86
72,22,15,-15,-38,-80,-47,-44,-115
19,4,-19,-41,-47,-36,-30,-12,-162
-41,51,-81,-181,-130,-137,-85,-8,-612
-71,-35,-68,-133,-75,-61,-106,-37,-586
48,7,1,-45,6,-80,-28,2,-89
-43,-28,-69,-92,-78,-59,-97,-6,-472
-9,0,-8,-5,-18,-11,-15,1,-65
-29,12,-14,-43,-11,-14,-23,-24,-146
-32,-4,-22,-71,-62,-40,-49,-28,-308
-69,-44,-61,-111,-115,-82,-84,26,-540
53,67,15,-31,6,-54,-13,15,58
-61,-35,-75,-109,-71,-62,-85,-47,-545
-24,63,-36,-117,-22,-47,-45,-19,-247
-13,0,-28,-82,-53,-36,-45,15,-242
-13,92,14,-117,-59,-100,26,53,-104
-17,18,-25,-47,-94,-28,-29,19,-203
12,47,-18,-204,-59,-48,-79,56,-293
-9,22,-31,-89,-80,-66,-63,-11,-327
-189,20,-193,-440,-396,-271,-386,-61,-1916
-198,8,-207,-486,-332,-251,-421,-50,-1937
-11,36,-10,-47,-18,-35,-22,-15,-122
34,12,-3,-132,-188,-139,-107,65,-458
-16,-17,-13,-23,-46,-30,-50,14,-181
114,39,9,-5,-88,-82,-71,-36,-120
3,32,-21,-96,-27,-74,-21,-24,-228
179,171,50,-341,-72,-330,-171,133,-381
-66,-21,-100,-271,-184,-135,-138,-1,-916
12,120,-70,-261,-169,-237,-175,-53,-833
-32,54,-76,-111,-93,-68,-80,-38,-444
21,117,-53,-185,-11,-60,-61,57,-175
-549,-122,-571,-1333,-969,-639,-1000,-270,-5453
-82,20,-143,-284,-146,-156,-203,-92,-1086
89,89,21,-41,-12,-90,-82,23,-3
-44,25,-53,-140,-124,-113,-127,-32,-608
17,58,-16,-91,-123,-80,-80,-8,-323
-53,-4,-45,-155,-103,-89,-97,-4,-550
-120,-18,-153,-309,-167,-150,-166,-122,-1205
-81,70,-35,-144,-63,-39,-59,-16,-367
61,50,7,-42,41,-22,-18,66,143
-44,-15,-42,-100,-65,-55,-45,-15,-381
140,100,7,-108,16,-153,-113,63,-48
130,5,29,-40,-13,8,-40,38,117
-20,-8,-38,-129,-93,-117,-89,25,-469
-157,126,-74,-234,-75,-93,-45,-50,-602
-104,20,-120,-292,-181,-161,-179,-40,-1057
87,1,-16,-100,-195,-163,-99,-7,-492
1164,626,293,-465,370,-772,-405,128,939
9,145,-73,-298,-171,-176,-172,-46,-782
55,75,-101,-326,-196,-323,-300,-93,-1209
-276,70,-486,-803,-417,-480,-571,-279,-3242
-87,-33,-109,-215,-136,-128,-167,-71,-946
195,169,41,-7,-20,-114,-46,11,229
-52,0,-43,-105,-98,-24,-69,29,-362
65,145,9,-158,-23,-162,-73,140,-57
60,38,0,-101,-119,-126,-82,24,-306
308,189,122,-83,170,-120,-105,179,660
-39,71,-42,-168,-84,-128,-85,-11,-486
-115,76,-190,-517,-201,-378,-285,211,-1399
99,62,-22,-141,92,-88,-72,68,-2
-230,229,-259,-568,-117,-155,-156,-59,-1315
-5,27,-1,-105,-37,-48,-47,69,-147
68,120,23,-65,35,-52,-40,70,159
-30,314,-122,-372,4,-76,-178,-78,-538
124,197,47,-208,-276,-222,-218,23,-533
-47,-11,-94,-176,-155,-139,-150,-107,-879
160,145,-27,-394,-122,-334,-259,-54,-885
-24,105,-40,-143,-86,-112,2,15,-283
13,-6,-44,-153,-164,-86,-115,72,-483
485,197,-141,-587,-727,-858,-559,-34,-2224
5,128,-83,-235,-95,-145,-86,103,-408
-15,25,-15,-63,-39,-33,-76,10,-206
-44,21,-52,-199,-106,-87,-85,-4,-556
-26,30,-98,-184,-141,-151,-199,-89,-858
-65,3,-113,-176,-157,-96,-179,-26,-809
-79,-10,-76,-204,-164,-123,-155,-31,-842
-13,8,-48,-112,-58,-73,-58,18,-336
55,77,11,-84,-60,-100,-59,26,-134
11,26,5,-82,-15,-59,-42,16,-140
-88,-83,-80,-170,-148,-88,-130,-11,-798
11,7,-3,-19,-28,-14,-17,0,-63
-48,-30,-39,-92,-80,-51,-75,-7,-422
72,64,5,-45,-57,-86,-21,-34,-102
50,60,18,-57,20,-55,-39,27,24
-8,26,-61,-98,-49,-49,-46,-28,-313
-15,-26,-65,-137,-88,-122,-131,-16,-600
-118,-7,-102,-188,-161,-109,-153,5,-833
28,60,-24,-120,-86,-158,-50,-62,-412
86,-25,-4,-71,-55,-131,-109,-4,-313
-45,69,-31,-94,-27,-69,-70,0,-267
-68,130,-116,-277,-202,-169,-161,67,-796
-121,22,-139,-246,-169,-129,-184,42,-924
57,28,24,-32,-46,-66,-60,23,-72
-110,192,-139,-314,-49,-111,-157,14,-674
-78,-46,-91,-169,-125,-80,-139,21,-707
-18,16,-26,-62,-60,-32,-21,2,-201
-36,-3,-27,-50,-52,-25,-48,-14,-255
-37,23,-54,-147,-70,-94,-37,-55,-471
0,58,-20,-77,-101,-36,-56,53,-179
-37,28,-36,-136,-31,-76,-44,-9,-341
35,-10,-40,-61,-114,-91,-85,1,-365
3,21,-1,-6,-4,-17,-7,-5,-16
-8,2,-11,-22,-13,-18,-14,1,-83
1,258,67,41,21,133,-194,102,429
29,30,-36,-128,-99,-146,-129,-24,-503
-20,6,-26,-78,-31,-52,-55,-21,-277
42,77,-88,-188,-167,-236,-188,-129,-877
-10,-3,7,-31,-9,-21,-27,-13,-107
-16,20,-65,-162,-161,-142,-142,-18,-686
-69,-8,-81,-139,-102,-91,-136,-55,-681
13,8,-15,-32,-40,-32,-13,-26,-137
6,101,7,-163,-3,-53,-19,38,-86
31,2,-9,-46,-57,-62,-42,21,-162
-12,15,-34,-125,-128,-53,-88,6,-419
44,13,-28,-66,-15,-54,-59,1,-164
12,5,-26,-62,-34,-61,-43,-23,-232
-49,95,-85,-322,-135,-171,-164,-55,-886
5,11,-18,-82,-45,-63,-34,9,-217
8,42,-30,-113,-33,-113,-67,-23,-329
-88,54,-104,-293,-169,-140,-205,-49,-994
-20,19,-27,-81,-102,-24,-53,2,-286
-38,40,-33,-106,-29,-26,-45,-57,-294
162,99,-7,-251,51,-143,-130,62,-157
86,169,-39,-262,-198,-192,-91,40,-487
88,34,-4,-84,-211,-215,-172,3,-561
-42,24,-68,-146,-89,-103,-122,-36,-582
-18,15,-36,-71,-53,-46,-55,-14,-278
31,104,-24,-166,-31,-112,-42,-22,-262
47,13,-1,-52,-80,-90,-57,-17,-237
-2,19,-24,-68,-41,-55,-50,-40,-261
0,9,-7,-27,-11,-26,-15,-3,-80
-5,22,-8,-38,-8,-31,-22,-2,-92
-10,36,-88,-145,-90,-122,-125,-65,-609
-42,29,-76,-178,-92,-92,-81,39,-493
52,137,-88,-413,-465,-419,-329,-61,-1586
176,137,61,-250,35,-188,-174,154,-49
14,44,-17,-42,-3,-34,-5,22,-21
-2,8,-15,-25,-15,-25,-32,-12,-118
-12,21,-16,-50,-17,-22,-13,-23,-132
-66,-24,-73,-115,-53,-56,-85,-47,-519
-57,-18,-42,-115,-62,-66,-54,-9,-423
14,41,-12,-53,-33,-51,-29,19,-104
-5,8,-8,-29,-11,-13,-24,13,-69
-13,22,-31,-60,-49,-15,-24,-11,-181
-2,6,-2,-69,-42,-55,-41,16,-189
23,34,-13,-59,-74,-63,-50,-32,-234
-10,1,2,-54,-46,-35,-10,-6,-158
-6,-14,-31,-70,-52,-41,-39,-18,-271
44,90,2,-208,-70,-176,-114,7,-425
-111,95,-174,-392,-177,-192,-212,22,-1141
20,9,-10,-20,-45,-28,-51,-13,-138
-81,42,-88,-172,-58,-73,-81,-49,-560
29,-9,-36,-65,-116,-137,-85,-70,-489
144,439,-66,-509,-122,-301,-96,69,-442
335,88,9,-715,-316,-523,-496,91,-1527
-15,-19,-15,-91,-126,-49,-70,31,-354
-112,118,-111,-405,-196,-142,-201,-130,-1179
-20,3,-11,-74,-9,-42,-18,-6,-177
368,405,93,-264,-65,-279,-134,77,201
7,43,-35,-97,-53,-37,-63,48,-187
6,29,-25,-102,-63,-84,-76,42,-273
11,30,-2,-64,-84,-72,-57,-6,-244
-86,5,-91,-195,-75,-100,-135,-24,-701
-94,-3,-82,-188,-96,-109,-127,-43,-742
-77,11,-103,-181,-89,-106,-115,-40,-700
-75,9,-104,-189,-106,-107,-135,-49,-756
-47,88,-24,-179,-27,-26,-102,-16,-333
-4,17,6,-17,-4,-4,-12,6,-12
-11,17,-17,-44,-86,-51,-54,23,-223
-33,-17,-27,-47,-93,-31,-58,22,-284
34,94,-24,-185,-2,-134,-110,44,-283
5,23,0,-43,-6,-39,-30,-9,-99
-9,29,-23,-90,-65,-61,-57,-10,-286
57,50,-47,-140,-81,-173,-130,-70,-534
-12,-2,-27,-43,-36,-37,-45,-11,-213
-26,3,-83,-138,-68,-84,-93,-50,-539
-19,10,-33,-116,-51,-62,-63,40,-294
-47,-21,-19,-95,-64,-48,-50,14,-330
-3,16,-28,-77,-95,-76,-65,-18,-346
-1,33,-5,-73,-36,-58,-32,13,-159
-9,21,-24,-44,-25,-17,-1,1,-98
21,65,-24,-72,11,-60,-53,-6,-118
2,-11,-16,-38,-43,-31,-19,-7,-163
-28,52,-33,-96,-34,-63,-37,-24,-263
12,-11,1,-43,-67,-85,-58,-1,-252
-2,14,-4,-31,-22,-23,-14,-3,-85
-15,4,-9,-39,-22,-33,-12,15,-111
9,-22,1,-25,-14,-27,-22,-24,-124
1,7,-20,-39,1,-28,-30,-3,-111
-49,82,-38,-133,-33,-39,-67,-25,-302
6,17,-7,-110,-43,-89,-48,-2,-276
-52,0,-22,-115,-83,-63,-83,-58,-476
27,68,-1,-60,-31,-70,-50,-15,-132
-25,14,-14,-38,-31,-27,-30,-1,-152
-4,4,17,-42,-15,-16,-19,20,-55
32,5,1,-23,-18,-39,-17,0,-59
-11,36,-44,-94,-109,-97,-84,-32,-435
9,28,3,-32,-6,-33,-18,2,-47
-95,-33,-73,-160,-95,-70,-130,5,-651
-21,12,-56,-126,-62,-85,-73,-45,-456
-79,-9,-64,-165,-108,-79,-117,-10,-631
-24,27,-40,-137,-43,-62,-50,-6,-335
-12,5,-15,-37,-42,-2,-25,17,-111
-1,23,-33,-204,-118,-105,-131,76,-493
-95,83,-65,-194,-59,-88,-67,4,-481
-28,9,-56,-125,-75,-82,-75,-54,-486
-21,22,-63,-115,-67,-64,-44,29,-323
-9,-4,-18,-84,-37,-73,-58,-31,-314
-47,44,-28,-123,-40,-65,-35,-35,-329
78,42,-8,-186,-113,-201,-119,-96,-603
-49,32,-53,-99,-14,-51,-49,-2,-285
38,56,9,-81,-14,-58,-14,1,-63
16,27,-26,-73,-45,-58,-30,-8,-197
-12,13,-19,-36,-23,-4,-16,-1,-98
-62,-10,-76,-116,-63,-64,-94,-44,-529
-27,72,-9,-193,-60,-135,-71,37,-386
4,13,-3,-69,-43,-59,5,7,-145
-7,4,-10,-45,-28,-45,-45,-14,-190
6,13,-10,-59,7,-28,-49,20,-100
-76,-32,-71,-200,-111,-82,-95,-18,-685
73,17,25,-102,-59,-81,-85,21,-191
-57,-1,-50,-165,-97,-97,-100,-65,-632
-64,-5,-105,-184,-145,-78,-91,-30,-702
64,53,28,-39,-67,-102,1,56,-6
10,27,-14,-33,-32,-49,-33,-13,-137
3,78,-51,-161,-27,-122,-59,3,-336
-20,52,-36,-134,10,-33,-34,-6,-201
-65,-13,-80,-179,-89,-64,-83,-8,-581
1,13,-20,-62,-81,-64,-46,-22,-281
-21,99,-16,-161,-80,-121,-170,-49,-519
45,33,15,-29,10,-45,-7,5,27
-55,34,-95,-248,-100,-141,-122,-27,-754
-15,7,-25,-57,-9,-39,-26,-26,-190
-136,235,-103,-380,-91,-128,-91,-19,-713
-2,6,-13,-40,-16,-47,-22,-3,-137
-219,267,-756,-1722,-662,-1263,-1275,-727,-6357
-101,62,-80,-239,-80,-98,-137,-28,-701
-73,31,-44,-152,-88,-20,-90,-93,-529
-25,23,-67,-161,-75,-92,-115,2,-510
-46,-23,-55,-138,-129,-61,-123,3,-572
-41,11,-17,-99,-55,-25,-65,-29,-320
-22,76,-49,-168,-102,-84,-123,-62,-534
-17,-9,-49,-83,-56,-34,-50,-25,-323
111,9,34,-50,28,-60,-48,11,35
-56,-39,-72,-171,-118,-99,-94,-47,-696
-6,14,-33,-89,-83,-88,-80,-8,-373
-90,47,-103,-260,-81,-116,-155,-82,-840
31,105,3,-144,-69,-137,-67,-68,-346
-18,11,-22,-65,-25,-20,-45,-38,-222
-71,-18,-91,-171,-137,-110,-166,-27,-791
-11,7,4,-77,-57,-75,-30,2,-237
-24,-15,-58,-113,-67,-74,-112,-26,-489
-18,16,-14,-49,-33,-34,-29,-19,-180
-55,103,-143,-312,-145,-228,-201,-76,-1057
-30,84,-36,-132,-52,-101,-45,36,-276
-2,12,-14,-37,-11,-19,-11,-2,-84
3,30,-12,-61,-19,3,18,15,-23
11,28,12,-31,-8,-38,11,4,-11
-1,1,-3,-62,-51,-59,-46,14,-207
-16,44,-14,-51,-33,-24,-19,9,-104
73,47,-2,-55,-31,-85,22,-33,-64
-3,3,-10,-62,-48,-51,-22,-25,-218
-34,3,-33,-78,-66,-32,-37,7,-270
30,47,24,-32,2,-59,-4,1,9
-55,-57,-69,-103,-102,-60,-81,-39,-566
-83,62,-52,-211,-75,-95,-68,47,-475
-5,23,-21,-74,-72,-60,-44,-27,-280
-68,34,-142,-291,-218,-235,-207,1,-1126
7,125,-61,-261,-171,-178,-179,-45,-763
-30,3,-65,-175,-94,-124,-115,-51,-651
-6,44,-13,-81,-22,-25,-3,6,-100
0,-1,-26,-170,-225,-176,-125,-32,-755
-16,67,-55,-184,-53,-122,-83,11,-435
-182,41,-211,-368,-172,-205,-226,-156,-1479
-45,9,-11,-79,-49,-45,-19,-18,-257
29,40,-5,-92,-9,-98,-52,-52,-239
-62,34,-78,-183,-74,-128,-120,-24,-635
-13,-19,-24,-72,-76,-69,-64,-19,-356
-145,79,-77,-367,-188,-90,-157,-62,-1007
13,18,17,-49,-30,-69,-10,3,-107
-123,73,-98,-174,-115,-96,-122,-65,-720
214,176,9,-249,-88,-285,-187,101,-309
0,-19,-26,-59,-117,-67,-57,-32,-377
18,29,-7,-26,-50,-38,-41,-19,-134
-116,-50,-186,-262,-141,-141,-254,-76,-1226
10,119,-76,-132,-54,-147,-66,56,-290
10,10,-2,-22,-12,-21,-22,0,-59
-185,136,-211,-546,-295,-76,-221,18,-1380
-55,143,-55,-240,-43,-77,-143,-79,-549
-15,42,-32,-99,-8,-43,-32,-12,-199
-80,110,-63,-137,-112,-88,-118,-32,-520
49,132,35,-135,-44,-96,65,128,134
15,-4,3,-38,-37,-33,-91,56,-129
-61,-35,-80,-115,-75,-36,-105,0,-507
-74,-31,-65,-108,-53,-49,-96,8,-468
10,31,-20,-33,-29,-25,-13,-12,-91
-1,-26,-94,-202,-166,-161,-146,-88,-884
-33,14,-61,-145,-121,-105,-112,-15,-578
2,-21,-48,-29,-71,-45,-61,-31,-304
69,108,55,-131,21,-84,-42,2,-2
4,29,-10,-73,-80,-4,-32,-20,-186
77,78,23,-20,-10,-62,-90,57,53
19,55,-34,-182,-58,-125,-69,-31,-425
-30,8,-52,-113,-96,-80,-89,-49,-501
8,25,11,-46,-14,-37,-27,17,-63
18,7,-5,-25,-35,-46,-25,-1,-112
-2,12,0,-25,-20,-23,3,4,-51
-50,-11,-86,-175,-83,-108,-127,-52,-692
-36,97,-29,-182,-113,-100,-131,-153,-647
-32,-11,-95,-168,-111,-147,-156,-58,-778
-49,22,-19,-79,9,-21,-22,-2,-161
103,86,-6,-133,-44,-160,-96,6,-244
-107,43,-60,-165,-63,-13,-41,-47,-453
-418,51,-564,-1050,-618,-558,-698,-221,-4076
-23,0,-25,-66,-28,-51,-42,0,-235
-45,2,-39,-72,-30,-44,-56,-1,-285
-85,56,-36,-129,-56,-20,-45,-52,-367
-37,94,-53,-192,-71,-117,-63,18,-421
23,11,3,-32,-31,-58,-6,2,-88
-69,75,-48,-147,-3,-45,-68,-24,-329
85,101,14,-158,15,-84,-58,96,11
-37,-36,-91,-149,-134,-158,-165,-99,-869
-157,41,-227,-625,-343,-385,-384,-30,-2110
-5,20,-11,-38,-26,-27,-51,-6,-144
20,-21,1,-105,-193,-107,-148,-25,-578
3,100,-18,-96,-24,-80,-36,3,-148
-73,-43,-127,-195,-189,-157,-178,-74,-1036
-17,55,-32,-94,-24,-47,-40,-12,-211
-25,1,-40,-145,-113,-120,-73,-17,-532
62,53,-17,-73,-59,-99,-71,-90,-294
23,47,-5,-106,-72,-122,-94,-7,-336
-12,-5,-31,-49,-19,-34,-36,-25,-211
-30,-35,-15,-79,-93,-50,-52,-5,-359
-3,62,-13,-89,-60,-48,-16,11,-156
-28,34,-14,-40,-13,16,1,-9,-53
-29,5,-18,-72,-42,-44,-36,-4,-240
-71,23,-41,-110,-66,-65,-45,14,-361
-74,32,-78,-196,-93,-133,-107,0,-649
-20,-8,-30,-90,-42,-76,-49,-26,-341
24,80,-81,-145,-116,-84,-84,-102,-508
-57,65,-41,-126,-14,-65,-70,2,-306
-93,7,-55,-136,-51,-65,-57,-10,-460
-202,14,-255,-469,-217,-237,-317,-56,-1739
-41,43,-61,-240,-117,-116,-134,11,-655
-74,3,-60,-129,-70,-59,-54,-17,-460
38,31,18,-1,-16,-62,-29,-5,-26
-63,56,-36,-122,7,-49,-58,-2,-267
-49,-6,-84,-156,-183,-152,-154,-33,-817
-74,85,-43,-143,-39,-47,-23,-15,-299
8,40,-21,-82,8,-35,-45,31,-96
-16,60,-54,-148,-51,-117,-87,-1,-414
10,60,-43,-76,-39,-60,-42,2,-188
-68,39,-57,-150,-75,-82,-98,-30,-521
-64,57,-51,-235,-84,-68,-144,-75,-664
-20,36,0,-35,-20,-17,-27,7,-76
104,82,-3,-88,15,-105,-77,54,-18
9,51,5,-127,-148,-58,-93,-6,-367
31,28,8,-21,-11,-37,-18,-7,-27
-172,-78,-175,-320,-256,-160,-270,21,-1410
54,25,22,-67,23,-61,-36,16,-24
-38,-4,-33,-105,-97,-76,-80,-35,-468
-17,2,-13,-34,-27,-22,-31,-8,-150
31,16,-40,-95,-146,-175,-109,-114,-632
-18,3,-4,-9,-2,-28,-25,-2,-85
16,27,-16,-30,-17,-40,-29,-26,-115
39,30,-6,17,-32,-4,6,3,53
-21,-13,-16,-42,-63,-38,-55,-1,-249
-34,7,-121,-159,-132,-129,-186,-82,-836
40,117,-18,-203,-210,-192,-242,67,-641
93,74,32,-133,-23,-173,-109,-60,-299
-1,21,-37,-89,-125,-94,-100,-65,-490
-39,80,-140,-282,-199,-221,-195,-87,-1083
53,188,-63,-356,38,-165,-118,80,-343
-38,52,-50,-127,-66,-78,-87,-14,-408
33,64,1,-129,-30,-111,-123,-9,-304
213,110,12,28,-135,-96,44,-16,160
10,81,-33,-144,-65,-117,-112,29,-351
2,44,-49,-158,-79,-174,-100,-58,-572
76,43,8,-68,11,-106,-118,-6,-160
33,24,-10,-62,-84,-93,-109,-37,-338
-13,-8,-4,-37,-3,-25,-20,-12,-122
-34,-6,-20,-61,-60,-30,-42,-24,-277
40,26,-66,-110,-92,-142,-93,-45,-482
-33,17,-42,-119,-64,-38,-58,7,-330
-30,32,-43,-93,-58,-67,-47,-33,-339
-163,89,-157,-373,-147,-208,-206,-122,-1287
15,44,-42,-149,-81,-138,-109,27,-433
-34,92,-41,-194,-99,-144,-112,44,-488
245,188,164,-36,126,96,-49,126,860
30,56,-18,-171,-161,-228,-158,2,-648
12,29,-72,-398,-233,-335,-246,-115,-1358
10,52,-47,-173,-213,-208,-169,-61,-809
-31,25,-12,-72,-103,-45,-57,36,-259
-107,21,-115,-235,-131,-130,-178,-6,-881
-45,4,-62,-106,-76,-45,-53,10,-373
-6,104,-48,-156,-95,-145,-107,22,-431
-82,-36,-77,-163,-127,-63,-107,-13,-668
-63,7,-62,-178,-123,-105,-112,20,-616
-89,-14,-102,-160,-96,-56,-127,0,-644
-100,-38,-98,-164,-120,-79,-120,-11,-730
-31,6,-68,-115,-119,-128,-144,-64,-663
-75,-19,-163,-266,-309,-231,-304,-105,-1472
28,7,-16,-83,-66,-93,-105,-29,-357
-47,2,-62,-117,-77,-91,-102,-51,-545
-184,-76,-201,-309,-232,-142,-223,-3,-1370
-49,10,-45,-100,-92,-43,-116,23,-412
-34,-7,-44,-65,-60,-51,-55,-23,-339
0,25,-38,-86,-43,-80,-74,-14,-310
-36,0,-23,-61,-35,-9,-36,-2,-202
92,186,-90,-320,-28,-108,-135,85,-318
24,59,-42,-166,-108,-93,-122,58,-390
-22,-4,-17,-38,-12,-12,-36,20,-121
46,23,-20,-134,-121,-162,-134,-67,-569
-56,-34,-28,-103,-52,-19,-75,2,-365
-36,1,-24,-109,-77,-53,-75,11,-362
88,119,-98,-334,-252,-380,-331,-104,-1292
259,274,76,-392,-134,-452,-311,109,-571
-74,45,-100,-255,-209,-201,-220,-52,-1066
-14,8,-15,-45,-23,-35,-21,-2,-147
-40,75,-43,-92,-24,-17,-8,-16,-165
0,-1,-17,-33,-58,-30,-32,-17,-188
-22,25,-51,-187,-121,-93,-117,30,-536
-48,14,-28,-95,-90,-69,-60,-33,-409
-22,2,-15,-43,-24,-18,-36,10,-146
-38,-17,-50,-109,-59,-61,-79,-35,-448
88,45,32,-13,-3,-43,-31,-1,74
-50,-7,-74,-192,-185,-145,-188,-92,-933
-12,20,-13,-39,-11,-28,-11,2,-92
9,8,10,-7,21,6,11,19,77
-14,64,-42,-135,-61,-78,-48,33,-281
258,76,71,126,-174,-194,-116,52,99
-16,1,-21,-39,-9,-16,-35,-24,-159
-39,-6,-51,-75,-75,-13,-67,26,-300
-43,25,-59,-163,-100,-71,-116,-18,-545
-53,15,-44,-64,-61,-45,-31,-39,-322
48,34,0,-81,2,-69,-48,-31,-145
-296,-85,-313,-502,-308,-196,-404,-88,-2192
163,79,64,-207,108,-158,-167,112,-6
-16,15,-23,-58,-57,-43,-59,-27,-268
-22,19,-8,-64,-15,-27,-14,12,-119
-30,16,-61,-153,-85,-63,-98,-55,-529
-44,30,-69,-177,-87,-61,-113,-49,-570
10,95,-44,-280,-215,-204,-140,110,-668
7,71,-4,-124,-71,-79,-90,63,-227
19,50,-6,-20,-23,-38,-14,18,-14
-48,79,-30,-127,-63,-112,-70,-18,-389
-27,42,-57,-145,-170,-161,-179,-37,-734
-12,4,-52,-170,-119,-141,-137,-1,-628
-22,3,-19,-73,-7,-12,-33,6,-157
-17,-7,-18,-31,-17,-20,-26,0,-136
-7,17,-50,-70,-94,-52,-96,-40,-392
4,-1,-3,-52,-49,-60,-8,-5,-174
0,-2,-7,-51,-43,-62,-7,-6,-178
-17,47,-21,-160,-99,-62,-63,40,-335
-17,1,-46,-218,-50,-142,-103,27,-548
-7,-9,-45,-83,-69,-54,-51,-48,-366
25,7,7,-39,-7,-21,-41,24,-45
91,166,-3,-278,-17,-205,-253,27,-472
7,42,-18,-113,-69,-80,-53,-25,-309
151,73,49,20,-15,-121,-92,51,116
201,208,71,-134,147,-146,-89,93,351
64,128,-36,-141,-49,-136,-81,91,-160
54,105,15,-67,-17,-104,-62,-22,-98
-36,41,-101,-206,-40,-100,-106,-36,-584
62,204,-41,-307,-197,-320,-225,-84,-908
49,61,35,-36,22,-68,-17,46,92
-87,-4,-115,-301,-153,-156,-166,-37,-1019
-52,156,-82,-297,-116,-160,-101,-2,-654
-61,32,-42,-163,-117,-66,-65,39,-443
-77,35,-36,-146,-105,-33,-45,40,-367
149,453,-50,-574,-261,-121,-565,527,-442
396,122,43,-238,31,-297,-185,8,-120
-76,72,-116,-344,-178,-170,-184,20,-976
222,394,167,3,-510,-66,-302,-5,-97
-20,26,-82,-168,-161,-143,-111,13,-646
-43,-17,-56,-131,-88,-63,-62,-51,-511
-332,157,-470,-1106,-754,-837,-920,-262,-4524
-5,-28,-85,-151,-159,-162,-118,-86,-794
-62,27,-46,-130,-27,-33,-57,-21,-349
-13,26,-47,-123,-50,-81,-73,-22,-383
-16,177,-160,-425,-245,-281,-328,-12,-1290
-12,41,-43,-116,-74,-80,-56,3,-337
-8,-23,-16,-36,-37,-30,-31,-2,-183
-26,-21,-50,-91,-41,-37,-75,-36,-377
-23,-21,-8,-74,-60,-60,-12,19,-239
-221,198,-216,-587,-138,-112,-216,-54,-1346
-48,77,-144,-349,-149,-246,-258,-143,-1260
-13,57,-57,-128,-35,-39,-80,-46,-341
-16,2,-10,-27,-31,-19,-30,-6,-137
21,227,-97,-382,-59,-293,-170,81,-672
210,174,100,3,139,0,-95,25,556
-45,8,-73,-142,-65,-71,-81,-30,-499
-90,1,-134,-192,-135,-99,-192,-19,-860
-3,39,-1,-90,-32,-40,10,29,-88
3,31,-83,-141,-174,-139,-146,-13,-662
-136,346,-175,-470,-85,-163,-52,59,-676
-20,77,-100,-281,-10,-151,-148,-28,-661
-55,3,-61,-134,-71,-85,-71,-15,-489
6,47,-23,-118,-57,-58,-68,-13,-284
54,113,-8,-39,-54,-88,-9,188,157
-57,-26,-82,-184,-108,-85,-108,-19,-669
105,56,11,-168,113,-86,-25,25,31
-12,-5,-19,-20,-44,-42,-45,-26,-213
37,-4,-7,-90,-77,-99,-51,-41,-332
-103,-33,-153,-252,-182,-161,-175,-61,-1120
-4,11,-17,-38,-14,-29,-22,-1,-114
3,174,-85,-222,-135,-197,-155,29,-588
13,18,-30,-18,-23,-29,-34,-37,-140
66,63,32,20,-24,-19,-8,1,131
-13,22,-44,-88,-102,-103,-108,-44,-480
138,65,0,-63,-103,-171,-92,-55,-281
-9,10,-20,-93,-101,-94,-75,-19,-401
-223,-22,-247,-548,-368,-245,-346,-26,-2025
27,133,-10,-217,-63,-173,-142,41,-404
-51,-35,-160,-594,-378,-295,-280,185,-1608
6,54,-6,-63,-16,-59,-10,27,-67
-28,-1,-49,-141,-103,-119,-111,-45,-597
-199,-43,-214,-450,-249,-265,-328,-129,-1877
-37,96,-59,-192,-60,-40,-90,-14,-396
13,23,-25,-39,-35,-34,-17,-19,-133
-73,15,-108,-172,-84,-119,-120,-60,-721
78,187,38,-312,-109,-162,-62,133,-209
-8,5,-14,-27,-17,-5,-9,-9,-84
-47,210,-105,-418,-87,-222,-244,-123,-1036
-80,-34,-69,-107,-100,-49,-130,3,-566
-76,-9,-55,-89,-100,-55,-127,4,-507
-91,-22,-76,-131,-92,-79,-146,-23,-660
-96,-21,-97,-136,-118,-62,-149,1,-678
-76,-23,-70,-118,-106,-86,-147,-34,-660
-88,-32,-86,-156,-100,-80,-140,-60,-742
-85,-39,-91,-145,-105,-81,-131,-38,-715
-80,-26,-86,-154,-90,-81,-134,-45,-696
-78,-16,-80,-136,-81,-48,-122,13,-548
-104,-42,-72,-155,-106,-67,-132,-17,-695
-83,-27,-59,-133,-102,-55,-117,-17,-593
-85,-26,-70,-153,-90,-65,-131,10,-610
-75,-14,-69,-126,-90,-89,-122,-16,-601
-72,11,-72,-144,-84,-61,-136,-10,-568
-74,-16,-64,-122,-82,-77,-122,-12,-569
-72,-12,-57,-125,-79,-62,-118,20,-505
-95,-12,-79,-129,-89,-57,-123,10,-574
-92,-27,-88,-164,-104,-70,-131,-1,-677
-97,-70,-95,-155,-147,-100,-117,-30,-811
-93,-48,-100,-160,-124,-70,-142,-22,-759
6,-50,-90,-148,-149,-144,-124,-80,-779
-46,17,-98,-153,-84,-71,-101,-19,-555
12,81,-89,-235,-143,-184,-149,65,-642
62,54,11,-42,-58,-89,-58,39,-81
-62,58,-50,-138,-56,-43,-52,-6,-349
78,37,-13,-43,-72,-77,-89,17,-162
29,186,-81,-317,-200,-261,-203,-43,-890
35,44,-80,-114,-111,-153,-138,-94,-611
-24,27,-28,-126,-47,-53,-67,-21,-339
-73,-28,-76,-116,-114,-47,-112,41,-525
-56,-32,-73,-113,-109,-49,-98,24,-506
-113,-41,-80,-139,-100,-51,-128,13,-639
28,21,-20,-55,-29,-64,-50,-15,-184
-13,17,-7,-43,-39,-38,-4,-2,-129
513,191,103,-133,19,-273,-225,200,395
81,13,-4,-1,2,-60,-38,-13,-20
6,-11,-76,-98,-84,-84,-122,-74,-543
20,179,10,-127,-22,-76,3,95,82
63,104,-26,-156,-38,-140,-124,33,-284
-341,0,-417,-908,-660,-326,-571,26,-3197
-11,-14,-11,-17,10,-10,0,13,-40
-112,31,-150,-341,-206,-172,-213,82,-1081
107,53,59,-214,63,-176,-135,100,-143
6,-5,-19,-43,-9,-35,-35,-2,-142
32,14,-34,-125,-74,-128,-84,-34,-433
-18,-22,-57,-146,-120,-93,-109,-6,-571
6,22,-53,-148,-175,-98,-52,4,-494
-49,-21,-32,-99,-99,-50,-83,6,-427
-12,-5,-18,-112,-212,-95,-106,10,-550
2,15,-47,-134,-150,-156,-115,-71,-656
-15,43,-56,-222,-116,-131,-99,-16,-612
1,74,-11,-152,-44,-98,-69,25,-274
28,128,-29,-94,-41,-55,-51,95,-19
-75,0,-62,-165,-126,-79,-106,-20,-633
4,178,-81,-346,-16,-148,-120,108,-421
36,57,-30,-214,-16,-69,-117,-27,-380
-11,88,-97,-382,-256,-291,-410,-31,-1390
-110,-20,-137,-292,-209,-188,-233,-39,-1228
-37,40,-111,-251,-170,-197,-153,6,-873
-27,14,-43,-125,-86,-54,-76,14,-383
-3,4,-39,-100,-116,-122,-86,-71,-533
-6,10,-33,-106,-88,-97,-77,1,-396
-33,261,-203,-626,-377,-528,-433,113,-1826
-266,210,-262,-1187,-1148,-382,-681,486,-3230
179,211,31,-262,38,-226,-158,57,-130
-50,13,-138,-298,-395,-320,-285,-144,-1617
-52,-42,-83,-191,-129,-170,-162,-67,-896
102,55,27,-54,-28,-87,-63,-7,-55
-22,19,-33,-134,-173,-162,-142,-29,-676
21,-12,3,-45,-36,-60,-61,-13,-203
-2,7,-26,-41,-55,-52,-27,-49,-245
-21,9,-30,-71,-55,-58,-34,0,-260
-6,24,-104,-189,-165,-164,-192,-139,-935
31,128,-105,-273,-163,-209,-129,27,-693
-12,10,-34,-103,-37,-74,-74,-34,-358
-1,23,-11,-73,-85,-62,-49,-7,-265
-12,-9,-56,-135,-152,-157,-151,-39,-711
0,27,-22,-154,-50,-114,-44,21,-336
70,53,-32,-99,-136,-163,-89,-9,-405
84,51,17,-44,7,-135,-102,34,-88
100,130,1,-84,0,-110,-86,58,9
-20,19,-81,-113,-119,-101,-90,-53,-558
-41,-20,-33,-86,-76,-57,-42,3,-352
69,61,-15,-57,-12,-84,-92,22,-108
10,-1,-8,-64,-53,-59,-53,-23,-251
8,38,-2,-52,-16,-48,-18,-8,-98
-4,60,-16,-144,-88,-137,-63,36,-356
15,7,-6,-16,-7,-13,-2,5,-17
0,1,-25,-48,-18,-28,-29,-3,-150
-53,-24,-87,-127,-129,-116,-131,-38,-705
-22,-1,-28,-70,-76,-75,-43,-7,-322
-75,-23,-127,-150,-147,-99,-162,-33,-816
103,94,22,-116,-119,-129,-95,4,-236
-30,79,-59,-156,-63,-46,-31,-1,-307
-105,45,-107,-262,-189,-120,-147,-74,-959
189,69,18,36,-115,-161,-103,-85,-152
-56,76,-40,-217,-79,-117,-55,52,-436
-26,-21,-80,-135,-124,-120,-121,-68,-695
-83,51,-75,-177,-18,-52,-100,-46,-500
34,21,-64,-134,-153,-159,-134,-105,-694
85,67,46,-46,6,-111,-74,97,70
-21,20,-7,-96,-59,-62,-41,-9,-275
5,81,-46,-122,-103,-107,-99,-44,-435
-42,-2,-80,-82,-74,-30,-92,-40,-442
11,-5,-13,-122,-35,-94,-135,37,-356
-112,51,-69,-160,-93,-97,-83,-44,-607
-40,-8,-101,-187,-158,-149,-181,-75,-899
3,-8,-12,-26,-41,-23,-25,-2,-134
65,79,-13,-58,-86,-140,-68,-93,-314
24,22,-16,-117,-105,-114,-112,1,-417
-38,-12,-52,-101,-66,-63,-80,-17,-429
-84,312,-207,-583,-171,-255,-343,-179,-1510
-43,103,-28,-122,-23,-50,-58,16,-205
60,-9,2,-68,-40,-78,-57,9,-181
23,63,-59,-181,-69,-120,-121,-97,-561
-84,17,-51,-159,-46,-36,-44,-8,-411
86,211,-20,-97,19,-73,96,154,376
-15,31,-62,-272,-160,-181,-168,22,-805
-19,100,-41,-239,-30,-113,-117,-90,-549
-41,31,-62,-143,-110,-76,-90,36,-455
-40,3,-35,-112,-83,-58,-53,-10,-388
-24,14,-62,-133,-90,-79,-93,-12,-479
22,136,-40,-199,-47,-218,-96,-13,-455
20,-13,-10,-50,-18,-66,-44,-16,-197
-65,43,-52,-193,-139,-167,-111,-13,-697
59,156,29,-149,13,-49,6,-63,2
10,107,-48,-169,-43,-83,-81,58,-249
-87,300,-112,-338,-83,-83,39,154,-210
173,11,19,-22,-7,-153,-135,-21,-135
115,138,90,-184,-134,-261,-79,-7,-322
5,45,-28,-116,-113,-126,-116,-47,-496
-8,146,-71,-191,-104,-110,-150,-115,-603
-14,-12,-7,-45,-33,-20,-35,11,-155
-51,-37,-98,-162,-121,-136,-170,-44,-819
2,43,-51,-102,-61,-75,-86,-35,-365
-11,26,-49,-115,-73,-68,-87,-31,-408
256,299,71,-695,-315,-562,-214,232,-928
3,2,-17,-66,-51,-59,-29,-19,-236
22,14,-18,-144,-102,-100,-48,-48,-424
-28,6,-19,-61,-60,-46,-58,-34,-300
-53,72,-75,-161,-83,-41,-14,44,-311
-8,4,-6,-30,3,-7,-23,1,-66
-66,36,-189,-377,-221,-303,-306,-177,-1603
-51,-12,-112,-198,-198,-122,-201,-16,-910
-3,56,5,-109,-105,-76,-72,40,-264
-11,11,-10,-32,-35,-29,-25,2,-129
111,46,-10,-99,-90,-151,-77,-31,-301
-54,36,-97,-214,-152,-124,-141,22,-724
-11,-6,-49,-151,-103,-153,-133,-26,-632
-32,62,-47,-192,-148,-120,-118,-22,-617
41,85,-44,-107,-94,-118,-75,-42,-354
-9,73,-114,-273,-66,-192,-179,-73,-833
-26,23,-24,-83,-22,-50,-44,-40,-266
168,224,67,-90,82,-134,-118,123,322
250,552,31,-432,-149,-315,-425,369,-119
37,-20,22,-52,45,7,-39,25,25
40,-16,13,-52,33,-19,-44,23,-22
-267,-39,-356,-643,-385,-193,-448,70,-2261
-25,19,-59,-117,-128,-59,-113,-28,-510
0,1,-10,-18,-13,-10,-15,-25,-90
-24,-9,-39,-100,-60,-66,-32,-33,-363
-23,-9,-68,-183,-200,-178,-184,-73,-918
10,18,-9,-40,-59,-23,-24,29,-98
-83,98,-69,-156,-104,-28,-123,-24,-489
-6,10,1,-53,-81,-27,-37,-2,-195
-27,-5,-33,-29,-103,-23,-73,-5,-298
35,40,5,-8,-7,-24,-18,5,28
-6,5,-11,-20,-24,-15,-19,2,-88
-37,50,-29,-71,-24,28,8,-4,-79
-26,-8,-21,-45,-34,-18,-43,5,-190
-6,-13,-15,-54,-106,-46,-44,2,-282
102,61,30,47,-48,-49,-62,-15,66
61,109,32,-9,-43,-80,-87,-35,-52
29,44,-17,-88,-17,-28,-31,82,-26
-42,77,-44,-206,-78,-103,-96,-71,-563
-68,6,-141,-183,-211,-118,-197,-52,-964
-91,-7,-71,-151,-72,-66,-89,-13,-560
240,391,41,-94,76,-236,-388,-138,-108
-79,72,-141,-282,-36,-103,-123,-91,-783
19,49,-28,-69,-9,-42,-22,30,-72
14,45,3,-25,-10,1,-38,16,6
-2,15,-8,-33,-19,-6,-33,-16,-102
-7,14,-29,-93,-74,-52,-66,-25,-332
-30,-16,-35,-84,-102,-51,-60,-4,-382
189,187,14,-252,-133,-361,-238,-18,-612
-15,32,-25,-62,-42,-67,-38,-20,-237
11,17,-10,-18,-54,-19,-26,-11,-110
-78,-28,-93,-177,-127,-104,-145,-38,-790
120,86,55,-143,-33,-161,-123,11,-188
108,111,41,-51,-2,-85,-111,115,126
70,100,5,-68,-66,-67,-99,79,-46
-43,0,-44,-156,-90,-55,-76,42,-422
8,42,-15,-85,-92,-46,-57,37,-208
-16,89,-61,-137,-172,-91,-118,66,-440
-14,-1,0,-30,-44,-26,-17,-15,-147
-73,-32,-85,-153,-123,-114,-122,-31,-733
42,11,-18,-54,-111,-79,-66,-29,-304
-65,-35,-34,-61,-102,-58,-85,18,-422
-2,45,-26,-97,-93,-74,-107,13,-341
37,-10,-6,-85,-56,-67,-75,7,-255
-43,37,-37,-116,-68,-25,-37,-43,-332
-7,20,-6,-41,-7,6,-6,-2,-43
-27,123,-81,-140,-109,-60,-16,-56,-366
-21,207,-81,-326,-30,-193,-88,113,-419
-61,12,-70,-163,-64,-70,-62,-8,-486
65,101,-49,-239,-60,-188,-106,-30,-506
-109,30,-131,-266,-115,-138,-179,-74,-982
73,132,-8,-220,-130,-262,-150,123,-442
-106,-14,-137,-367,-296,-283,-270,-47,-1520
-31,-9,-37,-69,-126,-37,-76,20,-365
-104,-16,-62,-192,-124,-71,-107,34,-642
-11,7,-47,-65,-79,-24,-69,4,-284
-47,88,-69,-272,-103,-166,-101,-46,-716
-9,1,-11,-37,-16,-17,-27,-5,-121
-2,4,-7,-31,-36,-22,-30,-5,-129
74,4,-11,7,-49,-66,-38,-34,-113
93,-32,3,-172,-27,-125,-106,-49,-415
-13,8,-7,-27,-3,0,-13,-9,-64
29,293,26,-232,77,-153,36,262,338
-12,71,-36,-129,-89,-125,-82,14,-388
58,24,12,-68,-1,-64,-64,57,-46
7,11,-17,-108,-59,-78,-75,46,-273
22,14,5,-8,-44,-25,-28,9,-55
-14,12,-4,-57,-40,-23,-24,16,-134
-17,21,-11,-49,-38,-24,-33,7,-144
80,123,-33,-164,-58,-122,-104,45,-233
25,-18,-26,-71,-52,-83,-80,-27,-332
-15,64,-22,-85,-4,-41,-39,30,-112
-77,35,-80,-193,-167,-131,-118,-28,-759
12,62,-50,-43,-5,-20,-9,-4,-57
16,-3,-29,-14,-128,-50,-75,-72,-355
-15,8,-14,-30,-10,-13,-20,-7,-101
38,52,-10,-80,31,-52,-14,17,-18
25,31,-16,-60,-53,-85,-49,-28,-235
18,8,-6,-6,-37,-19,-29,-11,-82
5,20,-30,-98,-82,-55,-58,-15,-313
-94,-17,-127,-185,-118,-89,-176,-14,-820
68,3,7,-19,-14,-100,-57,3,-109
5,-34,-19,-39,-54,-46,-45,-14,-246
-27,7,-31,-87,-68,-46,-58,-43,-353
18,45,-44,-110,-55,-71,-71,18,-270
66,67,-45,-176,-27,-156,-106,-54,-431
-28,-2,-42,-71,-37,-49,-51,-26,-306
-35,-6,-49,-120,-37,-48,-29,-22,-346
-94,33,-125,-258,-120,-105,-147,92,-724
-16,6,-10,-61,-33,-21,-14,-3,-152
-26,62,-55,-169,-122,-122,-83,5,-510
-90,9,-75,-260,-117,-174,-118,22,-803
-9,204,-158,-409,-215,-240,-239,-19,-1085
80,68,-10,-24,-15,-44,10,-39,26
-56,-2,-66,-128,-70,-38,-50,17,-393
-85,88,-61,-146,-11,-52,-55,-12,-334
-78,-6,-75,-162,-109,-68,-112,35,-575
-57,-13,-87,-130,-154,-136,-121,-48,-746
-92,-25,-91,-164,-104,-94,-130,6,-694
-121,-27,-95,-211,-141,-80,-130,18,-787
-81,92,-155,-372,-284,-197,-249,-11,-1257
63,70,-6,-54,-40,-100,-58,-20,-145
-13,14,-59,-92,-84,-76,-68,-43,-421
45,19,4,-51,-21,-52,-25,9,-72
-32,77,-65,-122,-19,-29,-24,24,-190
52,28,21,-28,20,-51,-12,51,81
-351,257,-608,-1157,-618,-705,-756,-103,-4041
347,81,75,-71,70,-210,-117,264,439
86,38,-3,-67,-31,-108,-79,-17,-181
-38,5,-33,-117,-109,-92,-108,1,-491
9,0,-11,-87,-49,-63,-70,53,-218
-57,-19,-125,-271,-366,-162,-237,-78,-1315
-17,166,-67,-239,-5,-99,-18,25,-254
-75,-10,-77,-133,-106,-46,-84,-25,-556
27,9,-12,-32,-75,-42,-45,-26,-196
127,181,50,-533,-418,-89,-289,503,-468
16,37,-23,-97,0,-67,-44,46,-132
-48,-10,-9,-99,-60,-28,-38,-4,-296
-2,-1,-34,-48,-67,-39,-68,-20,-279
-14,20,-58,-123,-101,-130,-137,-50,-593
-31,-2,-29,-68,-43,-39,-53,-29,-294
-48,106,-77,-223,-62,-114,-81,20,-479
86,71,51,23,-1,47,19,44,340
-17,3,-9,-44,-22,-25,-27,0,-141
21,-10,-6,-16,-15,-16,-46,15,-73
1,12,-22,-67,-43,0,-7,42,-84
-14,-13,-35,-40,-37,-30,-50,-11,-230
-54,28,-44,-178,-79,-97,-101,-50,-575
76,66,-35,-138,-50,-127,-110,8,-310
67,92,-19,-246,-28,-177,-172,103,-380
36,13,-12,-27,-80,-47,-37,-46,-200
-3,3,-29,-75,-81,-100,-63,-25,-373
35,69,-22,-42,-18,-59,-49,-7,-93
7,28,-22,-133,-65,-98,-78,53,-308
-8,-1,-9,-36,-31,-1,-25,14,-97
-118,-24,-212,-516,-443,-344,-477,-138,-2272
6,50,-10,-150,-70,-115,-69,50,-308
-20,1,-25,-53,-39,-38,-42,-29,-245
25,68,-33,-101,-91,-83,-65,56,-224
-22,12,-8,-79,-77,-55,-106,32,-303
-70,-16,-71,-146,-98,-81,-146,16,-612
-37,23,-38,-83,-60,-53,-45,36,-257
-35,13,-73,-187,-156,-161,-162,-93,-854
-30,9,-30,-126,-178,-72,-93,-21,-541
18,22,-6,-53,-9,-50,-25,1,-102
-123,-61,-128,-228,-187,-94,-166,-3,-990
-13,-1,-24,-61,-85,-63,-57,-21,-325
-53,-13,-120,-172,-145,-90,-156,-37,-786
58,9,14,-24,-33,-76,-37,12,-77
63,101,-41,-196,-7,-111,-147,23,-315
15,6,-4,-78,-34,-45,-82,20,-202
-13,7,-19,-58,-55,-49,-35,-36,-258
-8,11,-27,-65,-34,-41,-41,-5,-210
-3,-1,-22,-94,-101,-72,-83,21,-355
3,-33,-46,-115,-210,-100,-123,-60,-684
-3,16,-76,-214,-172,-179,-156,-40,-824
-31,6,-31,-95,-90,-61,-67,-18,-387
20,42,16,-28,-26,-28,-10,3,-11
49,4,-4,-52,-37,-72,-72,6,-178
122,99,29,-23,0,-72,-57,26,124
-18,5,-10,-48,-52,-15,-31,19,-150
-10,52,-24,-73,-42,-65,-84,-63,-309
-46,-27,-34,-79,-93,-37,-58,14,-360
-17,15,0,-25,-28,-28,-9,3,-89
12,10,-15,-33,-39,-33,-14,-26,-138
-18,11,-3,-24,-26,-22,-8,3,-87
-18,15,-3,-23,-31,-27,-8,1,-94
-62,-8,-122,-213,-160,-139,-212,-40,-956
-25,2,-17,-41,-64,-26,-59,1,-229
3,3,-1,-26,0,6,3,10,-2
-99,-20,-78,-173,-114,-85,-104,31,-642
45,19,-4,-26,-47,-83,-27,-13,-136
113,79,46,-22,27,-81,-53,39,148
17,77,1,-97,-45,-58,-45,-6,-156
12,0,-11,-129,-6,-33,-61,29,-199
57,84,-24,-216,4,-133,-68,77,-219
17,11,14,-23,14,7,-16,1,25
-38,1,-38,-90,-67,-59,-73,-27,-391
-11,48,-23,-75,-43,-45,-63,-29,-241
68,-13,3,-27,-4,-65,-106,14,-130
28,29,-6,-70,-102,-86,-63,-25,-295
54,-16,9,-18,15,-29,-5,25,35
25,50,-43,-109,-44,-98,-77,-25,-321
98,9,-7,-15,-41,-122,-64,-11,-153
-4,67,-32,-174,-159,-185,-132,31,-588
-6,34,-38,-104,-19,-43,-55,-13,-244
-7,46,-13,-77,-27,-26,-39,-18,-161
-14,35,-43,-103,-45,-17,-47,-16,-250
-51,39,-99,-137,-86,-42,-112,49,-439
54,25,7,3,-6,-37,-27,18,37
89,36,44,64,49,-19,-26,38,275
-11,-1,-14,-50,-29,-23,-7,-16,-151
4,58,-25,-129,-70,-75,-88,7,-318
-56,181,-306,-772,-515,-704,-570,-329,-3071
-50,-19,-56,-117,-8,-29,-52,15,-316
-75,-9,-20,-155,-143,-61,-91,74,-480
-32,10,-35,-63,-59,-50,-35,-4,-268
-12,34,-26,-114,-64,-104,-70,-54,-410
27,30,-1,-66,12,-47,-21,28,-38
-321,621,-298,-1322,-316,-376,-697,-286,-2995
-22,-27,-50,-126,-92,-101,-109,-64,-591
-4,12,-6,-94,-183,-48,-85,-7,-415
11,17,6,-29,-39,-43,-33,-14,-124
-91,-40,-78,-154,-103,-46,-102,-12,-626
-44,-9,-43,-113,-128,-78,-91,-40,-546
-26,-12,-26,-68,-63,-69,-44,6,-302
-25,-20,-20,-73,-47,-70,-50,-19,-324
-22,14,-36,-78,-78,-28,-60,-46,-334
5,5,-21,-54,-102,-55,-52,-22,-296
-124,34,-159,-346,-267,-169,-231,-112,-1374
10,-2,-7,-21,-41,-33,-8,-2,-104
-29,6,-40,-105,-96,-44,-73,-22,-403
-22,31,-30,-121,-125,-62,-94,-12,-435
-35,47,-50,-99,-64,-51,-77,-32,-361
3,0,-3,-11,-8,-14,5,1,-27
-16,3,-10,-45,-53,-17,-31,18,-151
-9,10,-18,-27,-20,-7,4,27,-40
-40,36,-37,-128,-66,-79,-32,61,-285
31,-1,17,4,-88,-87,-66,3,-187
-7,26,-19,-29,-8,-23,-38,-4,-102
-20,-5,-28,-88,-40,-25,-46,11,-241
42,30,5,-23,-1,-11,-22,28,48
-13,22,-25,-25,-44,-32,-61,28,-150
-9,9,3,-61,-38,-35,-32,-6,-169
-82,13,-105,-162,-112,-84,-112,29,-615
-17,122,4,-142,-112,-89,-34,61,-207
7,17,-1,-30,-20,-36,-11,-8,-82
-11,6,-27,-31,-13,-8,-28,-11,-123
17,19,-37,-74,-85,-81,-54,-48,-343
-47,-9,-39,-96,-45,-45,-49,-12,-342
-44,36,-91,-222,-170,-175,-133,-79,-878
56,49,32,19,1,-1,6,4,166
-8,16,-16,-75,-43,-39,-56,15,-206
-99,59,-51,-58,-41,29,-102,-11,-274
7,19,-13,-78,-84,-84,-63,9,-287
0,32,-14,-78,-88,-88,-60,-54,-350
-7,64,-32,-192,-94,-145,-83,-3,-492
-44,25,-15,-96,-20,-23,-35,-16,-224
18,0,-27,-60,-45,-56,-52,-12,-234
26,45,-51,-45,-117,-77,-41,38,-222
43,0,6,-75,-50,-115,-59,-11,-261
-18,-25,9,-53,-68,-34,-67,17,-239
0,-6,-22,-98,-74,-79,-55,-14,-348
-1,28,-38,-77,-90,-98,-83,13,-346
-69,59,-71,-147,-28,-75,-57,13,-375
-15,20,-36,-51,-58,-56,-53,-6,-255
3,8,-12,-46,-18,-24,-20,-6,-115
-32,8,-43,-73,-58,-59,-70,-17,-344
58,39,-33,-128,-98,-165,-109,-92,-528
-11,-20,-9,-26,-35,-27,-13,-16,-157
0,9,-7,-16,-4,-13,2,-8,-37
6,33,-11,-44,-31,-47,-34,15,-113
19,18,-18,-61,-67,-77,-43,-30,-259
-16,-23,-27,-69,-108,-58,-73,-6,-380
-1,7,-30,-75,-91,-58,-76,-45,-369
40,41,-4,-22,2,-52,-2,23,26
23,46,1,-41,2,-22,-4,45,50
-105,200,-128,-356,-51,-149,-75,70,-594
-26,121,-136,-371,-171,-274,-291,-136,-1284
39,70,15,-100,-70,-110,-84,-38,-278
-37,8,-73,-125,-87,-61,-63,-38,-476
-4,29,-9,-37,-13,-3,-16,-8,-61
-25,66,-76,-182,-92,-105,-80,-14,-508
7,17,-3,-67,-43,-62,-58,-16,-225
98,34,20,-172,4,-98,-49,88,-75
-119,79,-190,-314,-149,-147,-145,-107,-1092
36,114,-20,-151,-100,-177,-113,-81,-492
9,38,-22,-102,-23,-75,-47,-33,-255
-30,-11,-55,-72,-74,-67,-68,-26,-403
58,101,-20,-220,-47,-155,-97,12,-368
-48,17,-98,-169,-108,-105,-118,-25,-654
10,7,-7,-39,-44,-45,-3,-27,-148
98,126,14,-195,-31,-163,-119,-43,-313
-21,26,-29,-77,-13,-32,-37,14,-169
-22,-4,-48,-81,-56,-45,-67,-21,-344
81,68,14,-67,-42,-78,-66,45,-45
-41,-25,-22,-83,-37,-30,-32,16,-254
9,28,-28,-52,-53,-37,-30,4,-159
-29,27,-48,-135,-61,-85,-93,-26,-450
14,23,2,-39,-28,-49,-16,-3,-96
7,-32,-67,-122,-202,-150,-198,33,-731
73,205,-82,-341,-212,-226,-300,-204,-1087
-24,-11,-41,-65,-70,-32,-43,-10,-296
-26,32,-59,-215,-178,-178,-177,-3,-804
62,12,-12,-78,-87,-88,-93,47,-237
62,40,17,-36,2,-16,-36,24,57
-13,9,-18,-36,0,-2,-14,-7,-81
38,36,-11,-79,8,-68,-53,3,-126
-20,-4,-27,-75,-50,-38,-36,1,-249
-4,-10,-34,-103,-60,-82,-43,-19,-355
29,16,15,-33,-27,-48,-16,-4,-68
-36,-19,-83,-142,-70,-109,-124,-70,-653
-4,-3,-96,-198,-169,-208,-185,-134,-997
180,100,47,-23,-38,-102,-81,29,112
-5,25,-8,-36,9,-23,-16,8,-46
10,15,-27,-42,-51,-41,-23,-28,-187
-24,11,-28,-121,-130,-77,-58,9,-418
-67,39,-45,-175,-59,-49,-65,-65,-486
-82,58,-46,-136,-57,-74,-68,-7,-412
3,26,-3,-24,-31,-35,-30,-7,-101
-1,14,-12,-16,-9,-5,-10,-1,-40
-64,10,-150,-293,-151,-244,-259,-149,-1300
-46,62,-67,-206,-86,-93,-141,-11,-588
104,71,58,-108,-2,-118,-5,62,62
-29,-15,-36,-54,-80,-38,-52,8,-296
-12,2,-31,-61,-15,-23,-14,-5,-159
46,71,-43,-179,-93,-183,-110,-95,-586
-13,104,-30,-143,-35,-55,-44,-6,-222
-39,-3,-47,-74,-89,-77,-109,-20,-458
-30,-21,-16,-83,-53,-43,-37,3,-280
2,15,-12,-42,-16,-34,-12,-33,-132
2,6,-5,-58,-33,-49,-48,-31,-216
44,34,2,-57,-14,-97,-59,-12,-159
-21,8,-28,-70,-62,-58,-48,-13,-292
18,10,-35,-87,-118,-142,-101,-52,-507
132,119,37,-82,2,-133,-167,-26,-118
-6,12,-27,-68,-80,-56,-50,-31,-306
29,91,52,-62,-7,-104,-21,120,98
-56,-23,-68,-90,-90,-75,-111,-24,-537
-15,26,-39,-58,-35,-19,-54,11,-183
9,41,7,-30,6,-35,-37,28,-11
12,23,-33,-65,-47,-59,-63,-18,-250
-7,45,-20,-95,-120,-77,-61,-1,-336
-48,32,-102,-188,-116,-106,-135,-27,-690
12,36,-2,-54,4,-18,-2,-3,-27
27,18,0,-7,-28,-32,-11,1,-32
179,42,77,58,109,-2,-33,70,500
20,16,-24,-80,-61,-85,-57,-60,-331
-35,-13,-43,-83,-58,-40,-59,-10,-341
15,2,-35,-55,-60,-76,-89,-20,-318
11,32,8,-55,-28,-60,-41,-6,-139
-5,8,-13,-84,-99,-53,-72,-1,-319
-11,136,-34,-146,-41,-97,-46,-40,-279
-56,-10,-79,-161,-79,-121,-117,-20,-643
-4,5,-65,-120,-131,-104,-110,-35,-564
79,134,-23,-96,-52,-114,-36,36,-72
24,112,-53,-261,-40,-200,-127,-19,-564
-29,28,-12,-79,-109,-61,-53,7,-308
17,75,-1,-118,-44,-100,-40,23,-188
-3,0,-6,-28,-10,-18,-18,-22,-105
4,12,-15,-40,-29,-16,1,4,-79
-12,15,17,-20,-4,1,7,-4,0
-23,39,-59,-117,-76,-63,-68,-26,-393
-33,-3,-23,-69,-33,-35,-43,-17,-256
-9,13,-2,-26,-2,-10,9,-8,-35
-28,24,-23,-80,-17,-18,-2,-1,-145
-36,-7,-46,-93,-50,-68,-86,-33,-419
-13,14,-12,-33,-39,-34,-56,-23,-196
-14,12,-20,-87,-99,-74,-70,-9,-361
11,12,-12,-46,-20,-31,-19,-12,-117
8,14,-27,-35,-21,7,-43,-24,-121
-3,46,-14,-63,-75,-61,-27,-8,-205
-29,16,-57,-113,-74,-67,-107,-53,-484
59,75,-19,-158,-131,-132,-136,-108,-550
-60,19,-48,-108,-26,-32,-49,-39,-343
3,8,-2,-11,-9,-14,1,-12,-36
-38,-33,-56,-90,-83,-65,-66,9,-422
-50,44,-36,-108,-38,-55,-53,-36,-332
-38,81,-30,-88,-20,-39,-41,23,-152
-16,-17,-11,-50,-34,-12,-21,21,-140
-59,-17,-59,-126,-82,-62,-92,6,-491
-90,-19,-100,-163,-108,-85,-120,-7,-692
-8,-17,-28,-42,-55,-41,-54,-4,-249
3,-15,-91,-98,-123,-158,-173,-43,-698
-73,-43,-108,-203,-169,-150,-183,-79,-1008
-35,-6,-2,-69,-53,-32,-42,-1,-240
-100,62,-72,-246,-84,-69,-96,-16,-621
-13,39,-8,-84,-1,-32,-4,36,-67
-22,15,-4,-75,-48,-13,-20,9,-158
-5,23,-38,-127,-52,-92,-85,-37,-413
61,11,-17,-38,8,-64,-54,46,-47
21,4,-4,-87,-68,-82,-47,-14,-277
1,-1,-8,-22,-9,-9,-1,6,-43
6,-6,-27,-51,-104,-80,-62,-37,-361
-12,25,-21,-114,-74,-88,-30,66,-248
-20,-13,-35,-61,-70,-37,-35,8,-263
-55,32,-14,-108,-43,-72,-32,17,-275
16,45,-22,-55,-42,-76,-48,-18,-200
-30,-13,-25,-69,-43,-44,-51,2,-273
-3,10,-39,-61,-57,-67,-53,-13,-283
11,-14,-27,-57,-74,-84,-68,-53,-366
5,32,-33,-138,-55,-120,-90,-48,-447
-72,17,-59,-122,-80,-57,-91,-56,-520
-94,-18,-147,-296,-245,-202,-274,-124,-1400
-21,111,-17,-177,-34,-72,-47,5,-252
17,59,-4,-65,-42,-83,-33,13,-138
-23,113,-120,-331,-131,-230,-185,-80,-987
-6,-10,-42,-48,-57,-72,-68,-52,-355
-47,53,-26,-126,-62,-66,-56,34,-296
-31,1,-30,-85,-92,-54,-83,-3,-377
23,41,-78,-163,-156,-184,-141,-89,-747
21,-18,-28,-64,-91,-54,-61,-72,-367
-52,9,-35,-97,-36,-54,-39,-19,-323
-13,-16,-38,-52,-79,-80,-76,-35,-389
-17,49,-41,-121,-102,-109,-92,-3,-436
-41,-13,-76,-106,-64,-38,-78,-7,-423
16,36,-23,-157,-91,-159,-126,-62,-566
-16,-7,-40,-97,-41,-47,-53,19,-282
-2,23,-16,-23,-32,-49,-13,12,-100
29,30,-14,-80,-71,-97,-55,-38,-296
9,62,-6,-101,-14,-31,-55,-46,-182
-43,41,-57,-160,-51,-95,-66,27,-404
2,-9,-4,-10,-31,-28,-12,-16,-108
1,14,-24,-45,-27,-25,-37,23,-120
-41,55,-88,-215,-61,-141,-143,-73,-707
1,50,-30,-64,-37,-42,-42,-32,-196
-34,9,-30,-119,-73,-60,-60,-30,-397
-53,8,-76,-152,-96,-116,-118,-75,-678
10,3,-4,-15,-12,-16,-17,-17,-68
37,92,-17,-72,-20,-74,-53,-35,-142
3,34,-24,-81,-56,-67,-31,-24,-246
-48,11,-37,-135,-51,-81,-80,13,-408
6,33,-6,-67,10,0,10,32,18
22,25,-1,-67,-49,-91,-67,5,-223
-7,11,-16,-41,-14,-27,-11,-18,-123
4,-28,-30,-45,-47,-26,-40,13,-199
-18,5,-11,-41,-29,-12,-29,-1,-136
60,19,-3,-59,-33,-86,-85,-61,-248
-28,-23,-49,-83,-121,-95,-106,-68,-573
75,34,5,-47,34,-85,-65,8,-41
-64,-1,-22,-136,-83,-60,-46,24,-388
-40,76,-17,-164,-37,-52,-101,-107,-442
20,29,1,-27,-19,-31,-43,-20,-90
92,118,-10,-119,32,-119,-95,94,-7
384,228,59,-255,-143,-340,-81,111,-37
-50,-6,-59,-153,-127,-120,-105,5,-615
-12,6,-6,-42,-28,-35,-19,0,-136
-20,-28,-55,-124,-100,-90,-111,-44,-572
71,10,-21,-71,-68,-61,-62,-42,-244
-2,30,-11,-49,-21,-25,-36,-13,-127
-17,5,-12,-63,-28,21,-23,23,-94
-40,18,-94,-184,-75,-103,-108,-28,-614
-11,52,-27,-109,-84,-64,-48,-15,-306
-13,5,-28,-33,-39,-33,-27,-6,-174
-62,26,-83,-146,-114,-68,-76,-56,-579
1,7,2,-16,-13,-18,-1,3,-35
33,63,0,-49,-15,-50,7,28,17
19,-1,21,0,19,-2,16,16,88
18,9,2,-53,-25,-58,-49,-5,-161
12,13,-12,-34,-36,-31,-11,-19,-118
-10,6,-22,-30,-18,-11,-19,-6,-110
71,15,-54,-185,-139,-199,-127,-79,-697
9,29,29,-27,-5,-14,-26,-35,-40
-12,12,-30,-62,-24,-16,-34,-10,-176
7,95,-39,-42,11,9,26,31,98
-11,7,-16,-43,-22,-3,-8,-16,-112
-48,60,-128,-214,-53,-113,-100,-100,-696
31,-17,-26,-104,-69,-87,-34,-12,-318
-33,-9,-51,-117,-89,-93,-89,-19,-500
4,0,-18,-82,-82,-65,-85,2,-326
-6,35,-50,-118,-69,-106,-85,-68,-467
44,30,-17,-136,-50,-125,-82,-1,-337
-57,19,-152,-350,-336,-343,-315,-194,-1728
-81,-56,-101,-270,-125,-146,-199,24,-954
-12,4,-18,-35,-42,-40,-49,-6,-198
-45,22,-54,-133,-71,-79,-87,-36,-483
-21,-6,-59,-107,-62,-35,-84,-22,-396
52,9,-54,-89,-120,-133,-75,-112,-522
-18,-1,-20,-76,-99,-59,-66,-9,-348
15,16,-15,-42,-58,-52,-38,-41,-215
22,71,-27,-134,-25,-137,-84,22,-292
-4,1,-30,-68,-80,-55,-45,-21,-302
-12,-9,-104,-280,-164,-215,-215,-120,-1119
-41,53,-26,-103,-5,17,-47,12,-140
-4,1,3,-55,-58,-46,-36,-1,-196
-26,20,-44,-104,-51,-70,-67,-26,-368
-2,4,2,-14,-7,-1,3,8,-7
9,33,-30,-96,-71,-76,-59,9,-281
5,53,-8,-31,-25,-56,27,-10,-45
-30,-13,-37,-64,-31,-27,-40,-7,-249
39,-2,-34,-39,-121,-97,-73,-87,-414
52,45,6,-82,-5,-73,-12,29,-40
1,3,-15,-51,-45,-24,-22,-14,-167
-10,12,-25,-99,-97,-73,-63,4,-351
11,46,-30,-87,-70,-84,-59,-21,-294
-10,-2,-35,-58,-77,-49,-61,5,-287
44,10,-12,-61,-47,-78,-47,13,-178
-21,4,-23,-55,-44,-30,-45,-16,-230
-9,27,-10,-33,-27,-2,-23,11,-66
15,16,14,-50,-67,-56,-43,26,-145
1,28,-27,-49,-5,-36,-25,-19,-132
-26,62,-22,-134,-14,-68,-26,14,-214
29,21,-6,-41,-26,-50,-29,-29,-131
85,70,10,-93,-36,-131,-121,-8,-224
-52,5,-36,-159,-118,-108,-117,-8,-593
-12,25,-35,-100,-47,-97,-82,-49,-397
150,44,52,-4,23,-65,-21,146,325
-6,-12,-8,-24,-23,-28,-6,-2,-109
38,63,-44,-160,-76,-147,-155,-61,-542
37,47,3,-92,17,-47,-37,48,-24
-29,-29,-20,-60,-42,-25,-53,-13,-271
46,17,13,-15,-28,-51,-35,8,-45
-32,-29,-74,-111,-107,-97,-138,-59,-647
44,76,0,-101,-44,-101,-60,32,-154
11,36,-11,-31,-5,-9,-12,-12,-33
-23,-26,-20,-76,-49,-42,-78,-13,-327
25,14,-28,-34,-40,-27,-40,-46,-176
0,38,-17,-51,-49,-33,-23,-12,-147
-79,84,-38,-221,-209,-117,-10,-63,-653
66,67,-28,-74,-46,-97,-72,12,-172
-18,4,-36,-47,-14,-35,-24,11,-159
0,-3,-21,-34,-81,-21,-40,-9,-209
26,1,25,-24,3,-5,-15,29,40
6,11,-29,-72,-90,-87,-88,-31,-380
-11,77,28,-88,-65,-129,-8,103,-93
-16,1,-30,-33,-50,-34,-42,-16,-220
22,16,-15,-5,-3,-12,-6,-7,-10
34,0,-10,-6,-44,-31,-34,8,-83
-50,105,-47,-126,-60,-56,-82,-3,-319
-23,-17,-8,-45,-52,-32,-18,-1,-196
-36,23,-45,-122,-21,-70,-60,-23,-354
-55,-35,-110,-188,-140,-155,-164,-79,-926
9,-2,-22,-29,-43,-53,-35,-32,-207
6,5,-34,-67,-170,-103,-95,-70,-528
-44,-17,-47,-94,-69,-64,-86,2,-419
18,3,-7,-18,-25,-29,-14,-4,-76
-10,15,-48,-139,-126,-119,-128,-57,-612
37,111,-27,-114,-65,-129,-41,-12,-240
-7,45,-44,-133,-79,-104,-90,-35,-447
-11,-1,-13,-25,-27,-9,-21,-3,-110
-46,1,-47,-129,-131,-57,-45,8,-446
-12,-1,-22,-70,-65,-72,-49,-28,-319
-8,-26,-11,-28,-34,-19,-23,-14,-163
29,38,-4,-67,-10,-56,-10,15,-65
94,457,-81,-763,-249,-433,-512,-522,-2009
16,12,-19,-79,-95,-76,-63,-27,-331
-18,-4,-26,-40,-48,-39,-49,-12,-236
-24,3,-13,-58,-65,-47,-44,9,-239
-26,20,-68,-144,-76,-140,-143,-55,-632
-21,-4,-4,-33,-38,-24,-29,-1,-154
-11,-6,-63,-122,-97,-96,-127,-35,-557
20,23,6,-46,-25,-64,-18,-8,-112
24,44,-51,-86,-24,-87,-63,-55,-298
-15,10,-38,-171,-115,-133,-92,4,-550
15,33,10,-47,-53,-46,-36,39,-85
-52,-38,-52,-146,-121,-111,-108,-54,-682
-17,31,-68,-94,-60,-60,-47,-28,-343
-7,-3,-14,-38,-90,-61,-32,14,-231
3,43,-3,-69,8,-28,10,-3,-39
-6,21,-55,-87,-77,-97,-86,-55,-442
-36,-13,-51,-134,-124,-103,-106,-39,-606
22,31,-22,-20,-36,-11,16,-13,-33
2,122,-57,-248,-145,-190,-134,-59,-709
-55,-28,-69,-146,-91,-81,-117,-29,-616
-10,13,-14,-87,-20,-59,-54,16,-215
-59,136,-80,-226,-42,-100,-44,13,-402
-32,-19,-87,-177,-123,-151,-149,-103,-841
-31,98,-52,-209,-54,-79,-38,-49,-414
4,-9,-9,-45,-44,-46,-37,-10,-196
-114,-40,-175,-245,-126,-121,-182,-81,-1084
-34,-11,-29,-83,-46,-30,-44,-13,-290
-41,-45,-56,-61,-92,-51,-89,-21,-456
150,210,75,23,9,-66,-117,21,305
-20,6,-6,-47,-23,-28,-19,-23,-160
8,3,-16,-41,-47,-52,-25,-9,-179
140,155,-7,-192,-14,-193,-82,20,-173
-26,64,-43,-124,-54,-36,-43,6,-256
15,64,-70,-231,-192,-217,-107,-90,-828
-80,68,-134,-363,-206,-254,-253,-122,-1344
-13,54,-31,-107,-89,-83,-32,30,-271
-2,62,-38,-111,-64,-65,-31,-10,-259
30,15,-25,-94,-4,-66,-74,-25,-243
-35,-8,-33,-104,-76,-88,-90,-74,-508
18,194,-28,-398,-82,-162,-113,146,-425
-35,8,-20,-79,-64,-18,-24,30,-202
17,12,-10,-33,-6,-39,-34,-6,-99
10,24,-29,-70,-9,-36,-13,-10,-133
-2,4,-8,-18,-29,-23,-6,11,-71
-41,8,-36,-75,-68,-39,-57,28,-280
126,127,27,-119,14,-113,-43,42,61
10,45,-8,-59,-28,-60,-33,-14,-147
46,136,6,-199,-34,-119,-89,-23,-276
-92,10,-128,-230,-128,-159,-178,-70,-975
13,21,-4,-4,-49,-14,-10,-5,-52
-65,-38,-37,-83,-73,-52,-103,18,-433
-4,-13,0,-21,-17,-19,12,13,-49
3,10,-17,-93,-112,-95,-40,-25,-369
-32,23,-43,-83,-28,-40,-58,-50,-311
55,159,15,-113,-19,-90,21,42,70
-8,-13,-14,-28,-21,-13,-12,3,-106
-3,4,-27,-33,-43,-18,-43,-16,-179
4,23,-38,-91,-14,-37,-24,-7,-184
9,17,-16,-36,-51,-26,-35,2,-136
5,32,-76,-214,-182,-185,-144,-96,-860
-5,29,-10,-65,-49,-62,-37,-15,-214
15,28,-5,-60,-153,-74,-63,-22,-334
1,-1,-10,-30,-24,-22,-15,-1,-102
17,14,-16,-125,-95,-172,-73,-47,-497
-36,47,-30,-144,-70,-53,-85,-23,-394
30,2,8,-17,-104,-88,-66,-14,-249
158,54,70,71,51,-60,-58,51,337
8,12,-3,-54,-18,-56,-14,-17,-142
4,20,2,-25,-43,-12,-27,3,-78
21,89,-207,-476,-240,-444,-364,-234,-1855
11,9,-6,-22,-1,-12,-5,7,-19
-14,-5,-8,-11,-16,-17,-20,-4,-95
14,19,2,-20,-13,-33,-18,18,-31
-15,21,-15,-75,-53,-55,-38,0,-230
-65,85,-57,-153,-52,-53,-81,-6,-382
-20,-23,-40,-81,-96,-50,-47,-4,-361
54,48,27,-209,4,-151,-85,59,-253
37,42,16,8,1,10,-37,11,88
-8,-10,-46,-93,-73,-81,-91,-21,-423
-8,-18,-60,-84,-57,-76,-97,-15,-415
-15,5,-42,-99,-100,-90,-86,-26,-453
-17,65,14,-116,-28,-73,-3,56,-102
-60,28,-67,-219,-79,-85,-75,36,-521
-7,19,-3,-43,-49,-15,-19,-19,-136
32,153,-68,-327,-168,-299,-185,-107,-969
56,170,-36,-155,-16,-39,-54,13,-61
34,27,11,-70,-42,-62,-62,-1,-165
39,36,-36,-201,-105,-150,-149,126,-440
-28,7,-45,-86,-47,-39,-37,-9,-284
-28,38,-26,-100,-76,-33,-45,-14,-284
-27,47,-62,-174,-102,-108,-92,5,-513
162,43,78,63,89,-39,-44,83,435
89,60,10,39,-73,-100,-64,-29,-68
-6,25,-42,-60,-94,-82,-83,-59,-401
31,52,-41,-83,-69,-86,-83,-44,-323
-40,49,-45,-93,-4,-59,-8,6,-194
107,67,24,-6,-23,-90,-70,22,31
-32,54,-52,-159,-133,-76,-95,-27,-520
-201,185,-151,-441,-124,-116,-100,101,-847
74,71,25,-69,-27,-49,20,57,102
46,-34,6,38,-118,-51,-45,-17,-175
15,17,-8,-38,-53,-46,-43,37,-119
9,50,-30,-114,-136,-126,-117,-28,-492
-74,110,-156,-331,-154,-144,-136,9,-876
119,144,9,-341,-77,-254,-109,113,-396
-26,5,-30,-78,-63,-37,-33,12,-250
20,3,-16,-23,-57,-39,-16,-11,-139
40,144,-51,-233,-48,-93,-103,29,-315
52,7,-6,-40,-148,-80,-77,-14,-306
6,18,-42,-49,-45,-55,-51,-36,-254
-16,17,-25,-32,-45,-6,-27,11,-123
-32,29,-147,-251,-163,-228,-235,-129,-1156
-95,33,-45,-132,-86,-49,-66,-4,-444
-250,83,-253,-612,-322,-305,-379,25,-2013
-4,16,-15,-17,-21,-30,-32,5,-98
-34,-20,-61,-153,-135,-93,-114,-19,-629
-34,15,-45,-124,-81,-100,-105,-82,-556
-90,-55,-98,-153,-93,-63,-120,-14,-686
5,18,-21,-66,-88,-65,-41,-20,-278
-31,13,-24,-95,-53,-59,-50,-20,-319
291,132,-9,-157,-48,-259,-186,3,-233
-60,66,-186,-289,-126,-197,-235,-88,-1115
-27,50,-56,-136,-114,-96,-106,23,-462
6,94,-52,-137,-116,-130,-117,7,-445
-29,-13,-35,-144,-120,-96,-100,-39,-576
-70,-33,-76,-133,-109,-97,-111,0,-629
-93,-51,-103,-143,-98,-83,-131,-21,-723
-46,7,-83,-183,-205,-123,-136,-30,-799
2,2,-31,-70,-87,-25,-56,-25,-290
-84,16,-73,-141,-60,-63,-112,-16,-533
267,149,118,-144,139,-156,-150,132,355
65,148,-16,-137,-68,-147,-79,-1,-235
-30,-6,-29,-129,-100,-119,-105,-43,-561
-33,65,-43,-129,-18,-29,-64,-21,-272
48,4,-6,-30,-34,-59,-26,-34,-137
-4,11,-34,-38,-73,-45,-83,-26,-292
15,-25,-26,-47,-106,-73,-57,-8,-327
15,32,-43,-109,-79,-107,-69,-31,-391
8,-12,-1,-28,-42,-39,-57,26,-145
62,34,27,-9,7,8,-46,31,114
6,30,2,-43,-25,-20,-33,13,-70
28,42,3,-23,5,31,-29,30,87
66,11,2,-18,-74,-81,-70,17,-147
34,40,19,11,18,18,-37,25,128
70,39,26,24,26,40,-35,31,221
53,34,-28,-73,-114,-143,-92,-57,-420
-52,-15,-73,-124,-55,-47,-96,-52,-514
-94,-25,-166,-235,-169,-140,-175,-185,-1189
72,22,-12,-7,-59,-106,-52,-9,-151
-2,89,-66,-143,-50,-99,-90,7,-354
-9,23,-37,-85,-6,-19,34,41,-58
-63,108,-89,-302,-200,-240,-230,-72,-1088
-104,109,-98,-368,-165,-202,-178,-41,-1047
11,29,-10,-34,-6,-53,-55,-14,-132
244,187,30,-367,-117,-183,115,-108,-199
40,54,-36,-110,-131,-164,-113,-68,-528
-26,53,-46,-108,-38,-43,-58,28,-238
-44,19,-50,-105,-3,-34,-45,-15,-277
-27,24,-42,-91,-23,-53,-31,39,-204
-2,12,1,-17,-1,-11,3,18,3
18,42,-109,-245,-208,-280,-316,-138,-1236
14,48,-32,-160,-52,-75,-13,-16,-286
-65,139,-90,-365,-152,-190,-263,68,-918
108,111,-35,-53,-94,-185,-191,-62,-401
-6,8,-5,-85,-88,-90,-82,-35,-383
-111,-47,-91,-260,-205,-116,-145,-51,-1026
-153,-30,-175,-330,-112,-148,-163,-73,-1184
-21,48,-42,-108,-2,30,-45,77,-63
324,203,218,78,231,132,-23,74,1237
-45,-24,-28,-75,-63,-55,-42,-24,-356
-14,35,-45,-86,-73,-81,-79,-25,-368
-61,14,-56,-125,-77,-45,-57,48,-359
-3,80,-10,-107,-8,-25,-16,19,-70
-70,6,-128,-235,-222,-165,-190,-66,-1070
-3,33,-46,-89,-57,-74,-75,-48,-359
-102,36,-156,-281,-135,-91,-112,29,-812
-181,400,-357,-704,-188,-279,-265,244,-1330
-78,83,-123,-357,-230,-130,-157,49,-943
-170,41,-237,-481,-283,-206,-233,-61,-1630
-7,4,-20,-38,-20,-26,-25,-4,-136
-75,94,-124,-295,-156,-134,-175,-49,-914
21,49,-29,-56,-68,-70,-67,-49,-269
54,30,-2,-54,-66,-67,-69,-10,-184
-79,88,-112,-254,-37,-84,-98,-29,-605
-17,-7,-39,-56,-31,-39,-39,-40,-268
-16,1,-26,-53,-49,-37,-46,9,-217
17,15,1,8,-7,-8,4,2,32
-6,1,-16,-18,-16,-8,-17,-9,-89
-16,-12,-14,-39,-24,-27,-20,-4,-156
-65,51,-107,-246,-148,-143,-109,-85,-852
27,17,-16,-75,-69,-89,-91,-38,-334
-195,115,-276,-483,-253,-247,-347,-77,-1763
92,125,-37,-184,-43,-124,-161,8,-324
-59,147,-138,-335,-114,-105,-98,-83,-785
-93,125,-152,-323,-122,-93,-125,-98,-881
-21,25,-28,-61,-59,-36,-28,27,-181
-28,52,-18,-50,14,-7,-2,11,-28
-46,34,-46,-146,-71,-63,-60,3,-395
-16,16,-12,-39,-3,-17,-3,-3,-77
-96,16,-114,-305,-176,-136,-244,-24,-1079
-20,-1,-64,-68,-42,-52,-72,-40,-359
-37,2,-80,-138,-139,-126,-165,-11,-694
39,43,11,-39,-45,-38,-70,-41,-140
-67,96,-79,-306,-228,-178,-173,-65,-1000
-21,39,-40,-88,-43,-25,-70,-15,-263
-81,46,-115,-178,-104,-79,-163,4,-670
-5,-7,-36,-49,-22,-22,-72,30,-183
-117,-33,-89,-168,-111,-75,-114,30,-677
4,7,-18,-65,-40,-63,-52,-50,-277
-165,76,-90,-238,-21,-38,-109,37,-548
-2,7,-20,-47,-23,-4,-27,-24,-140
-20,-23,-16,-38,-84,-37,-76,13,-281
-17,45,-19,-58,-57,-36,-35,-35,-212
8,38,7,-42,-17,-23,-24,-4,-57
21,6,-52,-99,-56,-28,-40,26,-222
4,32,-13,-52,-72,-27,-59,4,-183
-9,-7,-23,-50,-61,-12,-28,5,-185
-19,-10,-16,-26,-21,-16,-3,8,-103
-67,-50,-66,-149,-138,-49,-112,-18,-649
-3,21,-14,-32,-4,-15,-16,-16,-79
-96,70,-173,-446,-282,-313,-264,-139,-1643
-6,12,-44,-107,-111,-53,-81,21,-369
-17,-15,-51,-76,-87,-74,-69,-64,-453
27,40,-16,-82,-61,-73,-69,-36,-270
3,19,6,-90,-78,-77,-32,-5,-254
-76,29,-115,-213,-125,-169,-178,-132,-979
58,72,-37,-127,19,-115,-108,-5,-243
-3,115,-61,-176,-61,-129,-93,40,-368
246,248,80,-311,-55,-333,-93,78,-140
322,149,25,-314,-168,-407,-226,-17,-636
0,19,-33,-90,-101,-89,-52,-40,-386
11,24,15,-96,-158,-72,-82,-23,-381
-67,-13,-49,-156,-139,-83,-125,-27,-659
-2,1,-9,-52,-21,-29,-19,8,-123
-24,-22,-19,-50,-61,-44,-37,-14,-271
-14,-19,-15,-53,-45,-32,-23,-4,-205
-18,21,-25,-92,-58,-47,-29,-44,-292
5,-3,10,-69,-51,-66,-73,-33,-280
-13,11,-16,-28,-32,-30,-36,-17,-161
-28,11,-42,-93,-63,-42,-43,-24,-324
-20,-20,-41,-81,-98,-52,-72,-14,-398
34,-19,-20,-70,-22,-80,-43,-37,-257
24,50,-24,-87,-116,-133,-97,14,-369
20,30,14,12,24,-13,6,14,107
-1,-20,-10,-22,15,-15,-5,9,-49
-28,21,-64,-137,-36,-56,-66,-3,-369
12,41,-85,-246,-315,-189,-245,138,-889
-45,-29,-98,-152,-128,-82,-146,-22,-702
-53,-48,-54,-83,-86,-63,-91,2,-476
-36,28,-2,-91,-22,-19,1,41,-100
18,24,-2,-89,-87,-73,-51,12,-248
-13,28,-30,-84,-60,-44,-23,47,-179
-28,-7,-25,-74,-46,-28,-53,2,-259
-49,52,-72,-163,-63,-55,-97,-16,-463
15,98,-105,-259,-121,-137,-193,66,-636
80,74,-13,-55,-25,-85,-91,26,-89
-12,91,-52,-150,-49,-76,-82,31,-299
16,17,-2,-30,-3,-26,-43,-19,-90
-29,-2,-87,-210,-124,-155,-159,-23,-789
-90,7,-60,-164,-64,-68,-93,-28,-560
115,69,74,39,71,14,-58,114,438
-15,-11,-160,-724,-683,-688,-500,-259,-3040
-1,21,-8,-68,-31,-48,-44,-13,-192
-33,19,-22,-83,-64,-55,-74,-35,-347
11,14,6,-13,-36,-38,-31,-8,-95
41,54,-19,-160,-5,-110,-118,15,-302
-5,-7,8,-54,-65,-51,-43,-50,-267
35,244,-58,-410,-173,-192,-208,194,-568
36,64,0,44,-21,25,-26,-18,104
-56,42,-32,-44,-35,12,-80,6,-187
-55,39,-34,-39,-29,14,-80,6,-178
-55,30,-37,-39,-34,13,-73,7,-188
-61,36,-42,-44,-35,11,-81,3,-213
-58,44,-37,-43,-43,16,-89,7,-203
-97,57,-49,-66,-47,21,-106,-5,-292
-92,47,-47,-57,-38,21,-94,-6,-266
-42,56,-31,-45,-31,-1,-72,-10,-176
-91,60,-50,-59,-46,20,-100,1,-265
-78,43,-49,-48,-38,19,-86,-1,-238
-100,51,-54,-68,-46,15,-107,-4,-313
-87,50,-49,-67,-41,13,-93,-6,-280
-75,46,-43,-53,-28,27,-79,-12,-217
-85,68,-52,-74,-55,-13,-105,-8,-324
-60,51,-31,-37,-22,15,-62,-3,-149
-17,17,-16,-47,-9,-14,-33,-7,-126
-18,13,-14,-49,-9,-16,-34,-7,-134
-13,8,-21,-39,-1,0,-27,-2,-95
-39,28,-18,-47,-20,19,-49,3,-123
-14,79,-6,-27,-23,12,-55,24,-10
-68,25,-70,-146,-49,-65,-59,-41,-473
-25,39,-83,-137,-129,-129,-136,-41,-641
-21,68,-53,-123,-69,-41,-51,3,-287
-35,29,-13,-45,-20,20,-43,5,-102
-47,17,-46,-162,-132,-132,-135,-79,-716
-137,-64,-183,-263,-234,-162,-226,-10,-1279
14,16,1,-64,-54,-80,-51,-1,-219
-39,27,-17,-45,-20,20,-45,6,-113
-29,17,2,-121,-103,-46,-110,-14,-404
-27,40,-35,-103,-29,-60,-62,-5,-281
21,61,-26,-99,-50,-43,-70,18,-188
-29,-22,-40,-110,-100,-1,-61,32,-331
25,25,-19,-81,-48,-61,-34,8,-185
67,108,-6,-142,-30,-129,-86,86,-132
-51,34,-101,-180,-165,-138,-161,-84,-846
78,466,-38,-502,-60,-317,-89,313,-149
-18,11,-9,-23,-25,-13,-28,-4,-109
-6,17,-87,-256,-153,-203,-203,-105,-996
-76,37,-96,-255,-188,-136,-126,-64,-904
-29,-6,-17,-69,-99,-46,-81,22,-325
-58,13,-44,-127,-91,-42,-71,-3,-423
-53,-36,-66,-184,-168,-180,-150,-9,-846
-8,8,-26,-16,-10,-35,-30,7,-110
76,83,-13,-125,-61,-181,-168,-88,-477
13,24,-13,-71,-126,-100,-73,-55,-401
7,56,-46,-158,-110,-114,-92,-24,-481
-174,-5,-240,-548,-363,-291,-380,-60,-2061
8,35,-50,-116,-101,-106,-80,-4,-414
-8,21,-53,-92,-87,-78,-71,-42,-410
22,59,-42,-223,-199,-186,-150,46,-673
36,68,-28,-292,-248,-244,-210,65,-853
36,108,-18,-201,-214,-211,-241,63,-678
-42,-7,-33,-72,-63,-40,-55,6,-306
-51,166,-53,-255,-126,-84,-71,83,-391
0,16,-10,-18,-1,-20,-14,-15,-62
-28,-17,-6,-22,-20,-26,-22,-2,-143
2,6,-4,-9,10,-9,5,-7,-6
10,32,-14,-26,-6,-25,4,-12,-37
-43,45,-121,-324,-255,-124,-142,145,-819
-64,37,-128,-341,-270,-131,-154,169,-882
18,41,2,-131,-23,-106,-90,37,-252
118,19,29,25,-51,-85,-62,-27,-34
-50,90,-235,-656,-476,-496,-591,-78,-2492
-51,9,-91,-191,-127,-139,-163,-22,-775
6,72,-18,-87,-27,-49,-25,5,-123
-76,3,-50,-148,-62,-32,-80,-26,-471
-20,6,-28,-86,-32,-46,-43,-16,-265
-11,15,-29,-70,-52,-42,-21,14,-196
56,65,11,-107,35,-97,-93,-13,-143
-32,-17,-60,-130,-79,-67,-72,-34,-491
-23,-5,-18,-94,-96,-56,-50,-7,-349
61,33,-1,-79,-27,-102,-53,-20,-188
-83,2,-41,-176,-150,-107,-119,-40,-714
-15,12,-4,-63,-52,-26,-27,-17,-192
45,37,-16,-127,-59,-118,-76,-52,-366
-35,109,-115,-223,-75,-108,-86,22,-511
-10,83,-38,-212,-111,-191,-90,-11,-580
-40,51,-83,-239,-128,-147,-94,55,-625
-119,162,-126,-422,-140,-126,-237,-231,-1239
-22,-11,-38,-66,-87,-40,-34,-36,-334
40,6,-62,-117,-105,-132,-108,-117,-595
18,-15,-19,-101,-111,-112,-91,-49,-480
-93,18,-188,-356,-256,-249,-252,-69,-1445
133,57,32,31,-41,-113,-90,-13,-4
-44,86,-15,-131,-31,-9,18,-46,-172
-76,-54,-79,-210,-234,-133,-114,-70,-970
-5,-4,-11,-56,-22,-36,-53,-6,-193
-11,8,-25,-120,-103,-106,-106,-34,-497
-86,-80,-114,-191,-131,-86,-169,-26,-883
38,4,-86,-124,-117,-164,-147,-94,-690
-35,4,-78,-148,-86,-103,-149,7,-588
15,30,5,-16,-44,-24,-13,22,-25
31,48,-34,-53,-131,-91,-37,11,-256
-9,-2,-16,-20,-5,-15,-22,1,-88
-13,-5,-13,-14,-26,-7,-11,-9,-98
-23,-16,-18,-28,-30,-22,-36,-10,-183
153,104,15,-117,-134,-234,-94,-98,-405
28,75,-52,-218,-128,-183,-144,10,-612
-9,11,-14,-37,-19,-40,-48,-22,-178
-24,8,-20,-14,-28,-4,-38,-11,-131
42,35,10,-10,-36,-58,-51,33,-35
-18,-5,-24,-59,-50,-52,-51,-25,-284
-16,6,-36,-71,-42,-36,-67,-23,-285
-19,-11,-33,-63,-26,-36,-58,-49,-295
-7,2,-11,-23,-20,-16,-17,-1,-93
44,5,-13,12,-28,-17,-74,35,-36
-28,41,-62,-149,-185,-87,-78,12,-536
-50,-5,-25,-92,-85,-38,-67,14,-348
-12,52,-108,-203,-203,-145,-159,-40,-818
25,88,-43,-236,-95,-130,-120,2,-509
42,35,-22,-97,-59,-120,-104,-73,-398
-3,42,-43,-67,-55,-45,-35,5,-201
22,51,-25,-100,-33,-74,-112,-13,-284
29,12,-29,-115,-37,-106,-80,-40,-366
-11,-2,-14,-15,-9,-2,-17,1,-69
2,25,-46,-106,-66,-48,-55,-37,-331
-74,-51,-114,-140,-142,-106,-167,24,-770
-31,132,-134,-331,-140,-196,-182,104,-778
-90,-10,-117,-209,-151,-89,-172,-46,-884
-44,-63,-89,-121,-126,-106,-141,-46,-736
-58,-62,-77,-114,-135,-73,-139,-23,-681
-72,62,-52,-193,-121,-120,-147,-120,-763
-20,44,-45,-116,-22,-44,-35,33,-205
-18,5,-16,-68,-52,-24,-41,4,-210
-28,-18,-34,-65,-54,-49,-57,-32,-337
-26,42,-56,-106,-45,-37,-88,-20,-336
65,107,-169,-403,-376,-477,-348,-103,-1704
-11,62,-52,-170,-54,-65,-93,-37,-420
-103,107,-180,-502,-206,-347,-301,-185,-1717
-16,-10,-9,-27,-11,-8,-17,1,-97
-16,27,-24,-72,-46,-73,-59,-2,-265
4,0,-9,-19,-9,-5,-5,-6,-49
129,28,13,-27,-54,-124,-69,-39,-143
13,21,3,-2,-14,-8,1,-3,11
-34,20,-28,-142,-95,-85,-97,-36,-497
2,48,-33,-125,-83,-129,-115,32,-403
12,59,-32,-119,-104,-98,-79,-72,-433
-51,17,-50,-142,-75,-66,-102,-8,-477
-55,8,-55,-136,-77,-44,-81,-10,-450
-54,-7,-29,-127,-77,-62,-82,-12,-450
-17,54,-56,-144,-123,-23,-65,59,-315
63,27,-1,-8,-40,-37,-22,-41,-59
52,80,-13,-104,2,-120,-46,-9,-158
-21,44,-7,-87,-19,-36,-71,-18,-215
38,72,-1,-72,-14,-64,-42,-22,-105
-60,193,-192,-600,-206,-340,-372,79,-1498
-165,33,-232,-523,-252,-199,-262,-162,-1762
-32,59,-18,-181,-94,-95,-47,-75,-483
-133,83,-146,-333,-146,-105,-191,-149,-1120
2,132,-65,-212,-139,-151,-211,117,-527
420,319,6,-480,129,-503,-408,-54,-571
128,284,48,-307,9,-269,-136,224,-19
81,98,-6,-106,-40,-114,-156,35,-208
-22,-2,-35,-95,-92,-90,-90,-40,-466
-103,119,-141,-475,-235,-167,-265,-9,-1276
71,112,7,-188,14,-115,-107,123,-83
-49,46,-91,-242,-135,-184,-178,-62,-895
-45,83,-163,-368,-229,-257,-300,-171,-1450
183,163,41,-175,-16,-153,-151,82,-26
523,466,165,-74,104,-275,-63,162,1008
6,38,-85,-187,-134,-140,-157,-43,-702
52,92,-8,-101,4,-95,-39,14,-81
102,189,7,-318,-144,-367,-199,134,-596
52,114,-53,-207,-183,-138,-126,123,-418
-27,63,-18,-170,-50,-83,-79,21,-343
-65,421,-142,-809,-196,-434,-318,71,-1472
-74,15,-135,-242,-143,-172,-186,-109,-1046
-42,119,-76,-268,-97,-98,-62,69,-455
103,271,-132,-443,-279,-435,-301,-37,-1253
94,156,-51,-306,-20,-227,-131,41,-444
28,103,-13,-165,-18,-143,-88,68,-228
-138,5,-190,-368,-235,-257,-301,-97,-1581
38,165,-16,-285,-174,-241,-142,17,-638
0,15,-23,-120,-45,-67,-41,23,-258
171,435,-47,-516,-43,-383,-159,209,-333
-35,32,-46,-116,-58,-46,-43,-2,-314
-35,73,-33,-107,-15,-73,-35,2,-223
-20,356,-122,-422,-297,-264,-206,53,-922
-414,-137,-501,-1191,-899,-612,-846,-215,-4815
-11,23,-94,-149,-137,-165,-149,-54,-736
85,50,-28,-210,-94,-213,-111,36,-485
-9,12,-16,-124,-126,-100,-129,-34,-526
187,157,61,-199,-77,-277,-176,-11,-335
-98,41,-89,-224,-84,-91,-119,-56,-720
12,213,-33,-257,-29,-175,-98,82,-285
-133,247,-67,-340,-105,-160,-173,73,-658
-11,51,-45,-184,-72,-112,-69,-59,-501
-3,-7,-41,-106,-69,-113,-100,-36,-475
428,152,284,67,226,44,-17,87,1271
99,31,-33,-57,-91,-118,-90,-88,-347
141,161,34,-159,45,-135,-84,16,19
-25,16,-96,-115,-109,-65,-133,-47,-574
-11,-26,-25,-64,-66,-25,-30,16,-231
-42,38,-50,-147,-50,-95,-88,31,-403
-1,1,-34,-32,-72,-53,-53,-32,-276
-12,8,-17,-90,-56,-33,-32,7,-225
-80,-20,-89,-166,-103,-75,-129,-26,-688
-62,2,-60,-157,-93,-86,-125,-22,-603
-76,-4,-77,-159,-93,-90,-136,-24,-659
-73,-41,-76,-153,-124,-90,-141,-21,-719
-40,51,-38,-92,-86,-56,-71,26,-306
6,13,6,-23,28,-21,-29,-4,-24
-24,-4,-34,-45,-15,-9,-22,-26,-179
-10,-8,-56,-79,-92,-94,-106,-40,-485
-76,-5,-81,-159,-89,-76,-133,-4,-623
7,16,3,-47,-78,-49,-71,-13,-232
47,40,-2,-69,-13,-46,-66,-7,-116
21,31,-61,-129,-122,-180,-121,-80,-641
-38,-31,-48,-103,-103,-23,-38,39,-345
10,26,-24,-89,2,-62,-34,-12,-183
7,14,-29,-65,-80,-77,-57,-19,-306
-125,-21,-137,-300,-185,-139,-227,-11,-1145
-11,-6,-37,-79,-64,-65,-78,-36,-376
-13,13,-19,-55,-46,-40,-27,-6,-193
-33,9,-26,-106,-74,-49,-48,27,-300
2,24,-32,-47,-32,-60,-53,-14,-212
-16,17,-12,-47,-38,-37,-14,-6,-153
-74,-15,-89,-135,-80,-66,-109,7,-561
29,42,11,19,28,7,6,13,155
-46,-37,-58,-97,-28,-25,-64,-10,-365
4,21,-11,-56,-49,-64,-52,-42,-249
-85,-47,-82,-160,-90,-54,-121,13,-626
-50,-31,-45,-150,-124,-120,-120,-3,-643
-19,-1,-9,-41,-18,-11,-8,12,-95
-92,112,-120,-303,-101,-96,-47,91,-556
5,32,4,-65,-57,-35,6,0,-110
-63,-45,-65,-66,-77,-58,-98,-4,-476
-45,61,-58,-218,-110,-124,-84,-45,-623
-18,16,-36,-112,-87,-43,-28,15,-293
-35,9,-25,-109,-91,-78,-49,-30,-408
-14,11,-25,-38,-95,-25,-57,19,-224
-39,-13,-31,-137,-141,-139,-104,-40,-644
4,9,1,-14,-34,-23,5,5,-47
-37,-5,-38,-79,-120,-56,-76,-13,-424
-14,-16,-6,-82,-80,-121,-61,-41,-421
-31,11,-17,-72,-56,-30,-60,-31,-286
-38,17,-53,-107,-79,-73,-94,-10,-437
45,25,-2,-15,-60,-55,-36,-24,-122
-42,5,-41,-68,-37,-23,-27,6,-227
-76,-19,-92,-194,-125,-130,-170,-18,-824
-19,182,-26,-265,-185,-176,-56,138,-407
-82,-30,-106,-184,-99,-136,-181,-19,-837
20,73,-67,-155,-109,-168,-124,-106,-636
-19,-3,-36,-61,-64,-64,-46,-2,-295
-17,44,-28,-70,-9,-21,-19,2,-118
12,21,-24,-63,-105,-78,-72,-85,-394
-46,-33,-102,-130,-204,-107,-197,0,-819
-6,27,-12,-21,-31,-3,-19,-4,-69
56,33,13,-42,40,-66,-55,17,-4
1,8,-11,-68,-80,-82,-66,-29,-327
-1,37,-23,-99,1,-52,-91,31,-197
8,-16,-7,-49,-39,-60,-42,11,-194
20,25,6,-98,-62,-69,-37,13,-202
-3,42,-39,-94,-35,-57,-69,14,-241
-23,3,-30,-136,-127,-147,-105,-36,-601
-61,30,-58,-114,-78,-40,-65,-18,-404
-8,21,-32,-59,-24,-34,-51,-18,-205
-42,-37,-26,-67,-57,-47,-44,-16,-336
-28,15,-47,-45,-22,-23,-54,6,-198
-26,39,-62,-109,-84,-85,-69,2,-394
-30,9,-27,-67,-12,-27,-42,-10,-206
-5,-1,-29,-37,-31,-19,-12,-3,-137
23,50,-9,-17,-17,-47,-27,27,-17
-2,21,-9,-106,-73,-91,-35,18,-277
77,0,-4,11,-32,-76,-51,11,-64
-19,-9,-28,-40,-43,-12,-13,-9,-173
-23,-22,-45,-122,-122,-143,-162,-72,-711
37,13,-24,-63,-51,-96,-60,-39,-283
33,27,-9,-19,-6,-15,-16,-4,-9
-16,23,-13,-82,-63,-24,-37,31,-181
-6,21,-19,-68,-62,-76,-64,14,-260
19,21,-20,-21,-77,-47,-44,0,-169
18,30,3,-8,-40,-31,-16,21,-23
43,117,38,-153,-16,-103,-130,14,-190
-78,-24,-107,-217,-172,-139,-173,-13,-923
-4,24,-3,-98,-54,-77,-52,-1,-265
3,53,-32,-71,-23,-56,-21,60,-87
-25,10,-31,-74,-49,-28,-42,-16,-255
-2,38,-13,-66,-14,-38,-28,29,-94
-80,22,-85,-179,-89,-70,-114,-58,-653
56,51,-17,-94,-17,-87,-64,18,-154
-5,16,-30,-136,-149,-153,-85,-116,-658
-26,18,-51,-91,-19,-47,-41,7,-250
-47,-4,-20,-76,-21,-25,-30,-15,-238
-19,-2,-18,-39,-65,-34,-39,3,-213
-24,40,-33,-152,-74,-81,-54,11,-367
34,57,-23,-215,-88,-187,-74,-21,-517
-8,65,-48,-179,-61,-138,-92,-6,-467
-21,67,-71,-144,-34,-93,-84,39,-341
-46,20,-21,-145,-46,-28,-56,-22,-344
-3,16,-2,-35,2,1,-9,-12,-42
-106,6,-123,-300,-187,-194,-206,-75,-1185
-23,-11,-41,-62,-27,-27,-31,-5,-227
-61,12,-55,-119,-56,-77,-66,-53,-475
-8,34,-22,-60,-28,-46,-56,-17,-203
9,46,-57,-115,-10,-93,-75,-32,-327
87,1,57,-206,-210,-246,-201,-1,-719
53,99,-18,-116,-55,-125,-88,-76,-326
-39,13,-29,-56,-48,-18,-87,61,-203
-50,-11,-73,-96,-114,-80,-101,-45,-570
-10,-5,-24,-53,-99,-35,-66,-9,-301
-82,-21,-74,-176,-108,-38,-116,9,-606
7,5,-24,-89,-139,-67,-95,-20,-422
-2,26,-30,-78,-86,-67,-43,-26,-306
128,159,-23,-249,1,-251,-160,60,-335
2,-31,-33,-172,-85,-135,-80,13,-521
10,-8,3,-23,-45,-28,-38,21,-108
123,23,46,-223,-174,-211,-151,106,-461
-87,58,-76,-218,-116,-110,-132,-1,-682
54,127,-34,-206,-167,-210,-159,70,-525
35,-17,8,-149,14,-96,-71,48,-228
77,38,-15,-65,-59,-121,-83,-46,-274
-20,10,-34,-59,-31,-32,-24,-16,-206
-41,102,-45,-97,-52,-53,33,3,-150
-147,25,-210,-444,-262,-282,-290,-121,-1731
-33,0,-43,-119,-154,-105,-132,-24,-610
-42,58,-33,-213,-97,-72,-108,-9,-516
8,15,3,-24,-11,-13,-13,-11,-46
0,28,-13,-87,-53,-92,-48,-38,-303
-27,31,-12,-110,-99,-58,-83,-49,-407
-14,-33,-33,-93,-214,-127,-118,-10,-642
245,295,101,-271,-54,-148,-172,67,63
-9,39,-49,-139,-95,-94,-130,40,-437
71,39,-39,-241,-32,-150,-141,29,-464
70,38,5,-128,-23,-74,-33,58,-87
-92,23,-84,-180,-135,-50,-74,-24,-616
128,76,132,-22,38,6,-79,20,299
-13,67,-47,-209,-90,-91,-92,71,-404
22,150,-31,-147,-8,-49,-11,39,-35
-98,97,-30,-133,-79,-56,-51,24,-326
-10,7,-15,-73,-55,-42,-45,9,-224
7,-1,-17,-12,-31,-22,-24,-19,-119
-33,-13,-41,-86,-92,-35,-62,-7,-369
2,20,-19,-28,-35,-39,-47,-20,-166
-41,-13,-42,-96,-67,-52,-73,-19,-403
-6,4,-13,-22,-9,-9,-18,-4,-77
-39,22,-79,-156,-38,-35,-106,30,-401
-6,-20,-23,-34,-34,-10,-51,-1,-179
-3,2,-31,-54,-74,-52,-58,-45,-315
-59,43,-60,-174,-84,-47,-101,-28,-510
11,32,-40,-79,-89,-88,-73,-4,-330
-22,-22,-14,-22,-23,-13,6,11,-99
-27,8,-37,-119,-140,-71,-72,-17,-475
-7,7,-26,-43,-53,-35,-40,-23,-220
-45,-32,-37,-84,-88,-45,-78,18,-391
-10,9,-19,-30,-59,-24,-39,-10,-182
-20,-12,-15,-52,-58,-55,-37,-5,-254
20,19,6,-117,-109,-62,-10,5,-248
-165,-26,-156,-298,-179,-135,-245,-88,-1292
-11,9,-25,-68,-39,-19,-60,-4,-217
119,29,79,-28,-122,-97,27,19,26
-36,5,-28,-77,-17,-26,-38,-10,-227
23,14,-3,-122,-9,-91,-103,39,-252
-5,9,-39,-63,-29,-3,-29,-3,-162
7,51,-53,-143,-117,-136,-84,-7,-482
6,1,-25,-66,-40,-65,-47,-5,-241
-7,82,-51,-245,-80,-183,-127,-26,-637
-18,-4,-7,-39,-32,-14,-33,-3,-150
37,-29,-10,-10,-74,-52,-53,-6,-197
-1,9,-37,-74,-8,-21,-34,8,-158
-25,-11,-19,-25,-20,-11,-34,-2,-147
-20,21,-25,-57,-14,-19,-24,0,-138
10,-28,-26,-15,-92,-49,-74,-53,-327
-35,103,-52,-168,-58,-70,-62,-6,-348
5,20,-16,-68,-90,-63,-37,-47,-296
-54,28,-126,-292,-32,-126,-132,-25,-759
25,65,-70,-222,-163,-163,-108,59,-577
-64,34,-100,-204,-145,-86,-135,100,-600
-30,45,-3,-55,-4,-18,-17,12,-70
85,40,21,0,-24,-71,-41,29,39
47,160,-27,-190,34,-137,-93,53,-153
-4,21,-22,-51,-1,5,-12,-27,-91
59,38,18,-50,-37,-64,-53,4,-85
-75,-15,-120,-228,-131,-114,-196,-58,-937
-5,57,-65,-136,-82,-67,-101,-68,-467
32,94,-34,-108,-43,-88,-48,67,-128
-20,23,-22,-70,-79,-32,-47,1,-246
-12,385,-22,-475,-93,-211,-342,276,-494
-32,8,-55,-99,-58,-62,-67,-18,-383
-74,137,-219,-580,-215,-391,-399,-34,-1775
-21,-6,-34,-41,-13,-9,-22,-27,-173
-45,6,-63,-118,-52,-61,-53,-28,-414
43,23,-45,-196,-146,-193,-156,-20,-690
221,103,41,-44,-20,-170,-109,23,45
-37,0,-70,-168,-147,-163,-115,-61,-761
-50,-22,-66,-108,-70,-61,-85,-16,-478
-27,-20,-114,-143,-144,-154,-164,-73,-839
32,-11,11,6,2,-8,-17,-1,14
-79,-38,-101,-258,-205,-179,-193,-85,-1138
-21,6,-28,-70,-48,-34,-48,7,-236
-19,20,-20,-34,-12,-18,-20,-13,-116
26,71,-8,-11,21,2,62,76,239
0,33,-44,-48,-60,-30,-26,30,-145
-14,5,-13,-23,-10,-10,-15,-16,-96
-10,-10,-11,-28,-14,-10,5,8,-70
-69,128,-114,-461,-282,-296,-254,76,-1272
-24,-2,-95,-166,-161,-149,-125,-41,-763
12,81,-9,-86,-78,-57,4,-50,-183
-15,49,-15,-39,-72,-44,-63,-16,-215
-11,37,-14,-59,-79,-70,-51,-21,-268
18,95,-33,-222,-54,-121,-119,-22,-458
9,12,6,-21,-39,-19,-22,-26,-100
13,19,-40,-58,-114,-77,-90,-56,-403
22,30,-40,-74,-110,-123,-83,-46,-424
17,18,-6,-17,-19,-34,-14,-5,-60
-15,31,-24,-66,-26,-23,-44,5,-162
-7,10,-19,-51,-19,-11,-32,15,-114
-22,-4,-20,-35,-16,-11,-23,-17,-148
-76,-2,-91,-134,-112,-46,-105,16,-550
-24,37,-53,-120,-78,-46,-42,-16,-342
-4,-7,-2,-36,-5,-9,-2,-14,-79
25,-26,-14,-128,-38,-89,-86,-9,-365
-21,0,-31,-86,-78,-80,-47,-10,-353
63,24,-18,-81,-54,-75,-69,-27,-237
58,99,-39,-99,-21,-38,-112,60,-92
-57,-12,-55,-99,-87,-60,-74,-58,-502
-64,-38,-108,-208,-171,-100,-174,2,-861
-17,25,-20,-95,-37,-41,-40,-6,-231
-46,-20,-59,-103,-104,-70,-79,-21,-502
-41,-31,-50,-91,-50,-37,-48,-25,-373
-88,-12,-75,-161,-116,-86,-129,-8,-675
1,10,-18,-125,-150,-129,-74,17,-468
4,0,-17,-9,-21,-28,-12,-18,-101
49,53,-65,-59,-57,-99,-88,-64,-330
91,89,4,-150,32,-144,-114,-5,-197
23,12,-12,-51,-22,-36,-26,0,-112
-65,-20,-83,-127,-87,-102,-154,-61,-699
-82,-25,-77,-150,-73,-67,-127,-21,-622
-76,-23,-72,-146,-62,-66,-125,-27,-597
-62,-41,-69,-115,-82,-60,-138,-17,-584
-65,-21,-81,-139,-105,-76,-118,-19,-624
44,-20,-34,-158,-114,-183,-128,-25,-618
22,17,-11,-32,-40,-32,-3,36,-43
-62,7,-108,-220,-160,-150,-162,-38,-893
-76,7,-117,-232,-157,-144,-179,-5,-903
-4,9,-43,-123,-93,-73,-81,-10,-418
-2,-27,-37,-60,-79,-26,-86,-4,-321
11,24,-75,-136,-122,-166,-155,-89,-708
-68,-17,-112,-174,-136,-131,-160,-52,-850
54,2,-20,-79,-117,-120,-67,-52,-399
-96,-32,-84,-160,-92,-33,-102,14,-585
9,12,3,-11,-11,4,12,2,20
-167,-48,-317,-824,-903,-503,-531,351,-2942
-6,32,-113,-258,-142,-206,-231,11,-913
186,217,-183,-569,-686,-703,-584,-533,-2855
-76,-46,-75,-137,-133,-90,-125,-39,-721
-21,83,-36,-165,-74,-107,-84,-66,-470
-65,21,-83,-196,-126,-95,-98,-32,-674
-42,-14,-106,-210,-225,-202,-188,-124,-1111
-89,6,-125,-278,-195,-173,-177,-69,-1100
-21,2,-18,-62,-7,-50,-53,-17,-226
-110,1,-133,-220,-118,-107,-150,-63,-900
0,7,-7,-17,-14,-6,-8,4,-41
-16,12,-47,-118,-120,-77,-74,-10,-450
47,42,13,-35,-55,-90,-47,-19,-144
-18,36,-36,-84,-34,-74,-64,-12,-286
-13,-33,-7,-127,-72,-111,-71,3,-431
-50,31,-64,-144,-64,-52,-35,0,-378
-24,31,-104,-224,-228,-238,-226,-113,-1126
-36,-4,-69,-135,-164,-95,-118,-19,-640
61,42,11,-41,-17,-62,-44,17,-33
-38,-21,-76,-77,-86,-50,-81,-32,-461
-110,-82,-106,-154,-123,-69,-131,-35,-810
-117,-25,-88,-184,-98,-92,-149,-13,-766
-30,-36,-40,-83,-98,-56,-84,-33,-460
393,365,121,-459,-3,-602,-173,187,-171
-5,71,-29,-227,-145,-181,-157,76,-597
-6,-12,-24,-87,-121,-82,-96,-45,-473
27,98,-28,-188,-105,-143,-62,79,-322
-63,34,-31,-134,-33,-34,-58,-40,-359
-111,140,-92,-358,-119,-67,-85,-5,-697
32,84,-29,-99,-41,-67,7,143,30
-24,29,-38,-128,-59,-76,-53,-37,-386
10,28,-9,-32,-24,-38,-20,-17,-102
-8,-5,-10,-17,-8,8,-16,8,-48
-101,17,-131,-197,-116,-62,-147,12,-725
-2,22,-31,-72,-21,-46,-24,-24,-198
35,47,14,-24,3,-41,-21,12,25
-20,24,-22,-74,-32,-23,-17,-3,-167
-111,-31,-130,-209,-195,-102,-159,26,-911
-30,32,-24,-70,-39,-32,-31,-26,-220
40,45,-107,-194,-296,-271,-195,-193,-1171
-95,41,-49,-245,-112,-118,-156,-74,-808
-35,-17,-51,-60,-40,-32,-55,-35,-325
-12,34,-25,-101,-23,-33,-44,5,-199
-5,-2,0,-59,-102,-61,-69,-40,-338
-76,51,-232,-341,-239,-239,-272,-140,-1488
38,100,-61,-172,-19,-121,-60,81,-214
-25,7,-27,-88,-83,-54,-52,-15,-337
-16,19,-6,-65,-45,-27,-47,-2,-189
-54,15,-36,-152,-131,-108,-170,15,-621
29,34,-7,-104,-105,-139,-70,-42,-404
-45,-18,-51,-88,-51,-3,-25,8,-273
21,99,-2,-122,2,-66,-65,55,-78
-176,18,-187,-429,-225,-232,-314,-105,-1650
-101,22,-103,-264,-175,-100,-151,-10,-882
-9,11,-37,-70,-58,-17,-31,0,-211
-15,2,-6,-25,-7,-4,-13,-5,-73
-79,62,-86,-165,-57,4,-97,30,-388
-15,17,-90,-186,-181,-158,-151,-38,-802
-31,14,-61,-97,-39,-53,-92,-1,-360
60,13,1,-54,-21,-57,-40,-15,-113
4,24,-24,-70,-48,-52,-48,-37,-251
62,127,-51,-253,-124,-190,-174,-97,-700
7,38,-41,-87,-24,-45,-58,-23,-233
90,90,7,-218,-177,-214,-167,157,-432
29,34,-3,8,-29,-42,-30,-7,-40
-98,59,-137,-321,-248,-218,-251,-18,-1232
34,406,-42,-355,-83,-229,-103,224,-148
-41,62,-86,-209,-126,-103,-199,35,-667
110,14,45,17,-43,-86,-62,-29,-34
-27,-5,-31,-85,-100,-58,-79,-9,-394
28,-13,5,-25,-10,-19,-47,32,-49
-31,-35,-39,-113,-98,-24,-71,0,-411
37,206,52,-187,28,-78,-21,121,158
-1,25,-86,-97,-145,-114,-139,-63,-620
7,35,-84,-148,-74,-128,-130,-75,-597
67,82,12,-27,44,-10,17,61,246
80,114,12,-38,66,-2,14,81,327
35,35,12,-14,6,-28,4,25,75
-3,75,-25,-197,-175,-182,-170,-15,-692
28,59,-24,-209,-97,-149,-135,8,-519
-131,-35,-222,-355,-265,-284,-338,-115,-1745
26,64,-19,-174,-51,-130,-129,39,-374
-31,-20,-18,-50,-80,-31,-95,57,-268
-102,-57,-102,-153,-114,-86,-147,-53,-814
-89,-48,-74,-144,-113,-85,-132,-33,-718
-89,-43,-86,-154,-92,-59,-127,-17,-667
-65,-17,-68,-121,-114,-98,-116,-37,-636
-93,-41,-76,-135,-94,-75,-108,-26,-648
-83,-46,-67,-128,-111,-92,-137,-20,-684
-74,-36,-103,-136,-132,-94,-143,-65,-783
78,60,-14,-146,16,-104,-123,3,-230
-35,-13,-21,-61,-31,-7,-24,-4,-196
41,-10,11,-74,-132,-92,-50,10,-296
-13,-9,-17,-18,-33,-22,-19,-9,-140
-77,100,-78,-142,-67,-54,-78,0,-396
17,36,-4,-176,-30,-104,-104,71,-294
-101,-4,-126,-260,-172,-140,-162,-68,-1033
-21,25,-42,-81,-72,-56,-39,-20,-306
-20,-21,-45,-86,-77,-37,-101,10,-377
-35,12,-35,-122,-91,-76,-67,-28,-442
58,24,-3,-24,-91,-80,-35,-28,-179
-91,-24,-128,-203,-99,-64,-151,-46,-806
35,54,6,-12,6,5,43,-7,130
-25,11,-2,-49,-11,-6,-15,-15,-112
-9,0,-40,-87,-104,-91,-104,-25,-460
-5,5,-3,-24,-12,-16,-19,-10,-84
-4,3,-13,-54,-59,-42,-41,4,-206
-75,-12,-81,-174,-120,-103,-119,-37,-721
-24,19,0,-99,-62,-32,-49,54,-193
-25,31,-45,-91,-41,-39,-35,10,-235
-19,18,-34,-74,-48,-30,-54,8,-233
-72,5,-77,-161,-122,-114,-144,27,-658
65,39,-18,-144,-26,-106,-109,-30,-329
21,54,-32,-105,-53,-59,-39,17,-196
85,79,19,-44,-29,-79,-32,38,37
-17,-14,-55,-136,-98,-124,-91,-60,-595
-47,1,-41,-179,-171,-130,-98,96,-569
-94,-31,-138,-289,-128,-113,-185,-39,-1017
19,100,-48,-123,-48,-76,-96,66,-206
-26,26,-15,-49,-11,-6,-61,-8,-150
14,47,-64,-177,-166,-148,-137,-27,-658
2,50,-39,-81,-93,-108,-107,-30,-406
-38,-4,-28,-87,-51,-17,-59,-18,-302
-103,-76,-142,-188,-148,-132,-178,-81,-1048
206,-27,-42,-341,-162,-290,-358,-95,-1109
89,65,-6,-200,-117,-222,-145,-36,-572
100,44,-5,-179,-142,-175,-164,-8,-529
0,75,-98,-224,-255,-236,-224,-183,-1145
-53,-17,-97,-133,-147,-80,-158,-52,-737
-6,45,-5,-63,-24,-20,-40,0,-113
-44,2,-55,-98,-52,-35,-77,-8,-367
-106,18,-126,-262,-80,-97,-99,-54,-806
-5,-19,-12,-24,-41,-67,-74,-3,-245
10,-2,-64,-149,-78,-130,-97,-45,-555
30,23,-4,-12,-9,-39,-26,18,-19
-21,10,-37,-26,-39,-26,-31,-22,-192
10,15,-37,-136,-129,-143,-96,-56,-572
17,14,-26,-68,-69,-111,-71,-53,-367
-11,64,-29,-101,-27,-51,-55,0,-210
17,98,-44,-305,-119,-168,-164,101,-584
47,49,11,-68,-16,-52,-7,33,-3
24,41,-16,-39,-45,-50,-37,9,-113
-1,5,-27,-102,-99,-112,-92,-20,-448
15,37,-10,-34,-35,-26,-26,-18,-97
-10,32,-24,-53,-29,-18,-23,11,-114
52,50,-6,-53,-138,-141,-157,-56,-449
12,13,-1,-39,-38,-28,-13,-8,-102
6,38,-45,-94,-84,-113,-72,-60,-424
5,16,-24,-60,-97,-50,-67,-5,-282
8,16,1,-10,1,-18,3,-3,-2
12,8,-14,-74,-57,-45,-54,-24,-248
-4,-24,-17,-85,-43,-75,-71,-17,-336
36,16,-10,-90,-104,-90,-17,-31,-290
-124,-109,-150,-205,-156,-103,-185,-55,-1087
-15,-9,-11,-37,-18,-16,-3,13,-96
-7,-6,-14,-50,-6,-31,-25,-19,-158
-40,13,-59,-133,-73,-87,-102,-54,-535
373,506,80,-528,-91,-314,-322,397,101
18,-17,-38,-136,-111,-130,-133,-45,-592
-40,18,-19,-89,-44,-50,-34,-29,-287
-19,16,-20,-86,-82,-77,-56,-50,-374
1,51,-51,-131,-71,-112,-118,-34,-465
-33,23,-75,-134,-98,-90,-79,-65,-551
5,2,-64,-192,-115,-182,-117,-44,-707
9,-19,19,-60,-27,-62,-41,26,-155
-3,0,-11,-75,-105,-57,-51,31,-271
-9,72,-72,-183,-53,-126,-126,-16,-513
-60,12,-43,-188,-203,-126,-88,72,-624
-10,32,-24,-119,-55,-60,-50,53,-233
-24,-3,-29,-32,-36,-17,-30,-12,-183
-1,76,-33,-157,-28,-91,-87,-57,-378
-31,4,-7,-82,-74,-82,-78,10,-340
-7,63,5,-83,-15,-13,-47,12,-85
4,67,-17,-192,-119,-131,-64,44,-408
-17,11,-40,-44,-19,-27,-35,-11,-182
21,17,0,-6,-7,-6,5,8,32
4,2,-5,-6,-3,8,-3,19,16
41,72,-35,-144,-99,-124,-126,5,-410
-18,45,-64,-133,-45,-47,-79,13,-328
51,111,-41,-172,-126,-127,-89,33,-360
-24,2,-22,-119,-102,-76,-63,-21,-425
-15,22,-43,-85,-49,-55,-94,-7,-326
-4,6,-18,-33,-40,-29,-25,8,-135
-20,14,-15,-117,-64,-50,-38,-49,-339
30,29,-9,-65,-72,-50,-71,-13,-221
2,33,7,-158,-45,-110,-64,27,-308
-40,72,-66,-204,-87,-133,-85,46,-497
-67,109,-138,-263,-99,-89,-108,46,-609
-23,-8,-33,-57,-42,-28,-32,-21,-244
122,120,33,-262,60,-212,-132,3,-268
-24,9,-16,-129,-93,-35,-74,-17,-379
-8,-1,-24,-78,-72,-74,-41,8,-290
150,88,-2,-63,-65,-165,-98,-58,-213
19,10,-28,-67,-84,-67,-58,-17,-292
9,9,8,-19,14,-2,-7,13,25
36,27,7,-28,-4,-68,-65,-4,-99
-47,29,-30,-91,-34,-52,-25,-50,-300
38,42,-11,-88,-31,-71,-78,64,-135
30,24,-9,-5,-30,-40,-13,-3,-46
-31,-17,-39,-93,-46,-65,-48,-38,-377
132,130,-4,-205,-128,-294,-173,74,-468
-28,0,-65,-207,-69,-153,-105,14,-613
-57,118,-91,-140,-70,7,23,62,-148
-18,-11,-20,-19,-28,-11,-18,-17,-142
-20,8,-29,-99,-159,-120,-130,-1,-550
9,8,5,-10,11,6,-13,-10,6
-37,6,-45,-133,-106,-92,-90,-31,-528
-29,-19,-51,-85,-91,-75,-57,-40,-447
-4,12,-19,-101,-55,-61,-70,-9,-307
-76,13,-100,-202,-107,-97,-137,-47,-753
-36,163,-87,-267,-77,-138,-63,82,-423
-366,17,-513,-832,-435,-388,-623,-276,-3416
-21,2,-28,-65,-49,-36,-43,20,-220
-39,-12,-98,-131,-158,-77,-169,-38,-722
-1,7,3,-21,25,0,-20,21,14
47,138,29,-103,85,-47,-28,82,203
-34,13,-41,-88,-72,-28,-48,15,-283
-465,-55,-513,-991,-625,-361,-629,63,-3576
66,51,6,-101,-35,-144,-99,21,-235
-38,-39,-34,-59,-66,-34,-95,-5,-370
-15,28,-6,-68,-21,-17,14,33,-52
-40,16,-36,-102,-36,-69,-80,-28,-375
-147,-4,-137,-312,-188,-174,-193,-44,-1199
14,19,-6,-18,-38,-37,-40,-7,-113
26,120,-5,-148,-66,-119,-110,-82,-384
90,136,6,-289,-141,-249,-119,47,-519
-46,-20,-50,-154,-70,-84,-67,-63,-554
-44,6,-36,-142,-69,-62,-49,-18,-414
34,65,-6,-78,3,-67,-55,27,-77
-66,61,-75,-255,-79,-77,-99,72,-518
-29,19,5,-41,-40,-1,-14,27,-74
-32,7,-23,-72,-25,-30,-19,-11,-205
-105,64,-142,-326,-17,-132,-169,-66,-893
-74,-39,-61,-196,-212,-115,-149,-17,-863
1,85,-30,-131,-7,-94,-58,22,-212
10,34,-13,-80,3,-52,-34,-25,-157
32,18,0,-64,11,-44,-38,-12,-97
16,8,-8,-25,-23,-21,-12,3,-62
32,53,-27,-205,-182,-179,-114,-57,-679
-46,-1,-32,-64,-48,-36,-32,-1,-260
1,12,1,-40,-34,-51,-19,-10,-140
-34,25,-57,-113,-52,-74,-68,-39,-412
35,47,-43,-109,3,-100,-98,-41,-306
-40,6,-62,-104,-92,-58,-82,-14,-446
-36,-2,-53,-95,-96,-93,-67,-56,-498
3,11,-11,-26,-33,-63,-35,-5,-159
71,162,-17,-202,-105,-173,-151,55,-360
-59,2,-74,-157,-69,-52,-66,-5,-480
104,174,-121,-543,-240,-511,-501,-43,-1681
15,22,-14,-84,-42,-57,-62,-4,-226
-16,37,-21,-108,-65,-78,-41,9,-283
-44,-5,-60,-129,-57,-99,-100,-27,-521
-49,-4,-113,-164,-96,-155,-156,-114,-851
-50,42,-50,-120,-66,-69,-102,-75,-490
-15,11,-4,-68,-34,-49,-17,32,-144
-26,13,-38,-83,-31,-23,-26,-22,-236
118,118,-13,-221,-119,-224,-154,-61,-556
-34,12,-54,-67,-47,-46,-73,-13,-322
42,61,22,-101,40,-38,4,33,63
-25,-12,-28,-67,-82,-71,-61,13,-333
100,17,33,18,-8,-80,-64,-24,-8
-9,4,-42,-85,-57,-85,-83,-7,-364
42,20,9,-26,-8,-5,-18,48,62
2,-4,-14,-45,-57,-39,-57,-35,-249
637,102,66,-350,94,-512,-409,24,-348
-33,-32,-48,-105,-81,-49,-75,-6,-429
2,-3,-26,-60,-44,-62,-47,-20,-260
23,68,-74,-134,-63,-91,-75,-32,-378
-88,174,-50,-310,-134,-114,-219,-236,-977
39,62,5,-47,-97,-79,-70,-18,-205
-11,40,-27,-96,-44,-85,-53,-5,-281
15,25,-28,-95,-125,-101,-69,-44,-422
-30,-6,-56,-188,-162,-134,-118,-19,-713
-3,11,-19,-113,-195,-90,-126,2,-533
-36,29,-133,-374,-231,-299,-296,-159,-1499
-79,-34,-51,-114,-96,-56,-101,-20,-551
-74,92,-89,-266,-126,-150,-145,-3,-761
-52,70,-98,-393,-281,-259,-209,-40,-1262
-33,65,-47,-134,-24,-53,-76,-33,-335
18,39,-20,-174,-43,-103,-77,19,-341
35,7,-39,-202,-182,-182,-159,-67,-789
-3,41,-77,-132,-82,-60,-52,-40,-405
3,110,-4,-229,-96,-115,-134,115,-350
-65,-67,-118,-209,-158,-139,-184,-49,-989
-47,-10,-74,-122,-63,-39,-54,-41,-450
39,11,-36,-152,-169,-205,-105,-55,-672
-9,-10,-62,-156,-91,-98,-85,-1,-512
-5,23,-25,-57,-32,-44,-37,25,-152
66,101,-15,-109,-118,-162,-90,38,-289
1,42,-12,-58,-102,-55,-46,-5,-235
62,37,12,-63,-57,-94,-37,-1,-141
5,-2,-34,-104,-59,-78,-59,-4,-335
128,96,11,-50,-46,-105,-35,36,35
-22,-18,-28,-48,-68,-29,-44,-17,-274
0,82,-39,-238,-26,-110,-128,68,-391
-44,46,-32,-82,-28,-47,-47,-7,-241
-23,54,-71,-168,-103,-110,-143,68,-496
-77,14,-132,-216,-151,-150,-182,-45,-939
-20,10,-34,-41,-15,-36,-42,-3,-181
-63,31,-97,-163,-26,-58,-71,-9,-456
1,25,-48,-74,-78,-84,-71,-47,-376
-30,12,-12,-61,-10,-25,-21,11,-136
16,14,-6,-37,-45,-53,-15,-24,-150
-17,22,-13,-98,-79,-13,-54,-20,-272
-37,37,-45,-119,-51,-61,-74,-54,-404
-15,25,-37,-90,-74,-65,-79,-48,-383
81,196,-76,-388,-82,-243,-150,159,-503
-200,259,-368,-954,-294,-473,-470,69,-2431
-51,18,-18,-83,-26,-19,-30,-9,-218
-62,12,-57,-120,-80,-59,-95,-42,-503
-24,-6,-15,-51,-21,-37,-24,-11,-189
1,62,-19,-124,-62,-49,-58,-41,-290
0,22,4,-23,-21,-4,-14,12,-24
-213,-30,-243,-631,-305,-276,-356,-29,-2083
14,88,-17,-101,-126,-105,-114,-37,-398
63,105,33,-100,32,-14,23,72,214
26,4,16,-29,-46,-49,-15,-16,-109
-202,-70,-178,-395,-347,-178,-300,34,-1636
-97,-52,-97,-177,-121,-92,-122,-56,-814
8,13,-43,-139,-75,-108,-65,-55,-464
55,3,10,-47,-77,-102,-27,-10,-195
-22,26,-21,-79,-69,-50,-73,11,-277
-10,24,-22,-88,-34,-36,-48,-15,-229
-19,13,-106,-308,-248,-281,-268,-164,-1381
2,18,-40,-90,-64,-102,-46,-8,-330
227,239,101,-273,-35,-355,-78,185,11
-5,-10,1,-82,-58,-64,-30,46,-202
184,181,-8,-374,-10,-314,-244,0,-585
-99,77,-34,-146,-59,-58,-73,0,-392
-92,17,-48,-141,-26,-36,-77,-29,-432
225,114,51,71,42,-127,-129,14,261
-117,-18,-155,-341,-205,-131,-183,105,-1045
66,45,39,-19,-40,-85,-38,22,-10
15,59,1,-63,-11,-49,-20,11,-57
76,160,22,-104,67,-69,-15,147,284
-16,21,-38,-64,-59,-59,-54,23,-246
-46,-5,-39,-87,-72,-63,-59,-6,-377
8,9,-4,-26,-53,-35,-21,5,-117
46,74,20,-34,-47,-77,-33,-10,-61
-16,24,-23,-32,-15,-3,-29,14,-80
-18,13,-57,-145,-101,-113,-89,-42,-552
-63,84,-113,-287,-135,-184,-152,-60,-910
-46,-11,-48,-116,-78,-66,-60,-7,-432
14,-4,-39,-57,-124,-101,-78,-54,-443
35,64,-14,-123,-66,-85,-60,33,-216
-38,-6,-36,-101,-71,-50,-74,21,-355
50,60,-7,-56,-51,-31,0,37,2
-42,31,-41,-193,-86,-119,-88,-28,-566
-37,2,-27,-69,-51,-50,-48,-1,-281
-19,4,-24,-58,-40,-32,-42,5,-206
28,15,1,-35,-10,-32,-79,6,-106
-3,-8,-7,-38,-27,-32,-23,-14,-152
-58,-36,-82,-124,-122,-59,-124,-1,-606
-31,27,-73,-204,-178,-93,-112,-38,-702
-27,2,-22,-64,-50,-69,-57,2,-285
-39,-32,-62,-156,-122,-116,-126,-59,-712
-15,16,-22,-69,-44,-27,-42,-10,-213
11,28,-31,-234,-32,-102,-80,-4,-444
-27,28,-50,-98,-66,-63,-65,-36,-377
6,25,15,-28,-5,-15,-11,-1,-14
-43,59,-104,-201,-162,-136,-198,-128,-913
-10,8,-15,-46,-37,-57,-44,-8,-209
-34,41,-37,-211,-128,-123,-126,55,-563
-77,28,-68,-151,-77,-32,-54,-43,-474
37,104,5,-23,-8,-19,-34,37,99
-107,33,-118,-244,-116,-79,-155,-17,-803
-20,81,-12,-217,-110,-162,-126,6,-560
-43,-33,-55,-83,-56,-37,-62,-23,-392
6,83,-58,-152,-28,-84,-89,29,-293
-21,81,-56,-134,-22,-72,-59,-5,-288
62,93,-40,-156,-164,-174,-189,-116,-684
-44,10,-32,-89,-74,-62,-58,-14,-363
14,83,-34,-106,-56,-80,-32,8,-203
-56,52,-80,-245,-154,-136,-188,-35,-842
-24,64,-87,-120,-77,-67,-95,-26,-432
-13,11,-17,-60,-32,-46,-32,1,-188
92,55,18,-64,-24,-116,-60,43,-56
-55,-32,-83,-127,-79,-74,-116,-41,-607
-22,2,-23,-61,-19,-27,-26,-8,-184
14,28,-47,-108,-88,-123,-97,-68,-489
-20,-15,-34,-44,-33,-10,-40,5,-191
-13,-25,-6,-60,-29,-31,-35,22,-177
4,77,-3,-67,1,-27,-22,34,-3
-108,41,-95,-333,-131,-134,-128,-6,-894
27,15,-1,-42,-50,-63,-12,-17,-143
22,23,1,-48,-7,-38,-10,15,-42
0,36,-6,-55,-17,-20,26,5,-31
-21,13,-25,-54,-52,-30,-18,17,-170
-50,69,-32,-129,-89,-52,-84,-37,-404
-31,7,-54,-147,-63,-88,-76,-25,-477
13,20,-11,-18,-3,-34,-30,-4,-67
-51,1,-46,-102,-82,-58,-91,-10,-439
28,36,-53,-231,-115,-185,-119,-41,-680
30,37,-59,-180,-149,-207,-65,-95,-688
51,73,13,-149,8,-56,-74,40,-94
-91,25,-100,-216,-95,-87,-88,-33,-685
-5,10,-22,-51,-51,-49,-58,-8,-234
-18,-4,-28,-83,-119,-37,-43,2,-330
51,34,22,-24,26,-19,10,32,132
-66,-47,-64,-94,-110,-59,-109,-20,-569
-35,68,-49,-128,-45,-43,-5,-13,-250
17,7,-49,-73,-107,-83,-84,-45,-417
-20,9,-33,-77,-43,-48,-64,-30,-306
3,5,-18,-16,-45,-7,-41,7,-112
-20,7,-19,-28,3,-5,-9,-10,-81
-34,42,-26,-173,-110,-100,-58,48,-411
37,73,-35,-104,-37,-101,-46,7,-206
-39,33,-59,-128,-53,-53,-78,-35,-412
10,-2,-36,-50,-121,-73,-58,-10,-340
-39,35,-42,-130,-105,-89,-69,-28,-467
304,55,44,-179,0,-199,-139,85,-29
57,212,19,-169,-53,-198,-69,161,-40
-58,-1,-89,-140,-66,-69,-96,-46,-565
-10,29,-33,-90,-88,-36,-58,-10,-296
-4,39,-115,-134,-101,-109,-99,-48,-571
-61,99,-127,-249,-50,-113,-101,-96,-698
-22,83,-86,-180,-50,-68,-60,37,-346
99,131,3,-141,-211,-229,-125,15,-458
-26,-34,-26,-71,-85,-55,-53,-9,-359
-29,11,-57,-127,-83,-110,-74,-13,-482
63,107,-15,-157,7,-150,-72,-41,-258
-9,36,-45,-69,-49,-41,-44,0,-221
-52,21,-71,-232,-156,-146,-195,-87,-918
17,19,-76,-149,-87,-108,-107,-34,-525
-56,-61,-23,-214,-172,-91,-134,36,-715
60,11,-1,-94,6,-57,-66,-13,-154
50,27,26,-1,-15,-35,-24,30,58
-14,19,-52,-107,-64,-65,-62,-44,-389
124,158,-12,-186,-65,-270,-91,43,-299
-27,51,-54,-124,-65,-78,-139,15,-421
9,46,-13,-80,-14,-29,-28,8,-101
-26,48,-45,-131,-54,-93,-76,-8,-385
4,5,4,-58,-19,-42,-35,10,-131
-16,23,-21,-48,-23,-10,-51,13,-133
88,58,33,-69,-52,-149,-140,1,-230
-7,13,-18,-90,-113,-54,-61,14,-316
-8,19,-43,-70,-68,-48,-50,-33,-301
2,29,-28,-79,-24,-58,-65,-30,-253
22,20,3,-32,-20,-22,-1,-2,-32
27,66,4,-35,37,-27,-29,77,120
-55,-13,-94,-150,-167,-67,-139,-21,-706
-57,-6,-67,-112,-66,-35,-68,-38,-449
52,-24,-61,-116,-197,-161,-96,-86,-689
-56,-5,-32,-146,-156,-114,-96,-25,-630
-23,4,-28,-51,-19,-4,-27,-16,-164
12,-25,-8,-49,-99,-85,-44,-8,-306
-27,-7,-22,-92,-76,-58,-26,9,-299
-17,-22,-57,-60,-72,-82,-90,-49,-449
-60,19,-103,-302,-219,-169,-216,-7,-1057
14,25,11,4,-19,-4,-7,0,24
43,33,12,-19,8,-36,-7,20,54
-25,-7,-11,-72,-54,-25,-50,14,-230
32,29,1,-28,-38,-36,-45,-7,-92
-6,44,-82,-227,-61,-155,-150,-24,-661
-35,-27,-76,-97,-102,-72,-77,-41,-527
-1,15,-48,-70,-189,-121,-123,-45,-582
-43,-22,-73,-145,-57,-101,-98,-48,-587
61,80,-18,-140,-147,-198,-114,-116,-592
41,33,-21,-95,-106,-138,-85,-93,-464
10,21,-12,-29,-24,-39,-23,-17,-113
14,28,-100,-157,-120,-158,-149,-98,-740
18,-15,-42,-66,-89,-71,-71,-32,-368
-4,5,-21,-69,-82,-22,-96,-18,-307
-4,3,-15,-61,-35,-64,-16,-38,-230
-32,35,-56,-150,-104,-83,-77,-30,-497
-15,7,-36,-48,-17,-1,-24,-13,-147
14,26,4,-14,-7,-27,8,16,20
-43,94,-15,-96,-33,-47,-29,-7,-176
117,-6,8,-70,6,-110,-60,-47,-162
-28,25,-19,-86,-30,-71,-61,62,-208
-5,9,-13,-40,-23,-30,0,11,-91
43,50,-14,-78,-34,-76,-74,58,-125
-36,18,-37,-71,-71,-47,-33,-6,-283
82,24,-34,-249,-14,-143,-203,73,-464
14,24,-3,-50,-59,-43,-40,-12,-169
-61,29,-57,-211,-130,-98,-118,-3,-649
-101,30,-156,-312,-300,-237,-317,35,-1358
4,53,-47,-96,-28,-61,-51,-4,-230
-89,4,-135,-232,-189,-128,-195,-12,-976
-25,-23,-23,-58,-58,-48,-54,-24,-313
31,47,-17,-112,-66,-138,-127,-44,-426
-11,15,-41,-116,-97,-74,-112,18,-418
-5,21,-8,-65,-68,-15,-37,25,-152
-58,107,-26,-259,-119,-152,-68,49,-526
-72,14,-40,-222,-103,-95,-102,-8,-628
-102,86,-106,-336,-83,-109,-103,-65,-818
-33,21,-28,-58,-30,-12,-36,12,-164
36,-31,-91,-172,-168,-202,-210,-59,-897
5,30,12,-31,-96,-63,-62,7,-198
-134,30,-184,-380,-233,-243,-319,-139,-1602
1,54,-22,-64,-20,-39,-37,25,-102
-10,16,-13,-63,-38,-24,-47,-39,-218
-16,64,-27,-139,-68,-96,-70,-17,-369
74,301,-105,-248,-5,-84,-8,104,29
-56,-22,-73,-156,-137,-90,-137,-31,-702
-60,-26,-66,-141,-125,-100,-116,-26,-660
-63,-30,-72,-152,-131,-97,-124,-27,-696
2,13,-24,-79,-74,-56,-42,-39,-299
-62,-35,-53,-118,-145,-79,-91,24,-559
-106,4,-29,-147,-122,-127,-64,11,-580
143,99,16,-189,-39,-180,-142,42,-250
-62,-47,-56,-98,-76,-24,-94,-6,-463
-7,11,-23,-105,-74,-101,-72,-34,-405
6,22,-16,-127,-40,-117,-70,-39,-381
-30,8,-53,-117,-130,-86,-98,-20,-526
-23,8,-58,-150,-169,-144,-130,-57,-723
-9,21,-15,-100,-48,-37,-68,30,-226
-29,30,-20,-84,-37,-60,-51,8,-243
-4,17,-6,-68,-58,-29,-42,57,-133
-93,-20,-93,-185,-143,-72,-111,10,-707
18,23,7,-26,-13,-59,-32,6,-76
-10,19,-28,-65,-62,-58,-93,-4,-301
-88,-31,-98,-171,-70,-57,-109,-54,-678
-46,59,-31,-179,-60,-88,-60,32,-373
-14,28,-7,-79,-79,-9,-99,-13,-272
5,35,-19,-106,-61,-87,-36,8,-261
-31,28,-6,-59,-23,10,-18,4,-95
-10,68,-128,-328,-187,-286,-211,-186,-1268
-51,2,-41,-142,-138,-135,-161,-54,-720
-10,5,-41,-68,-105,-49,-76,21,-323
0,84,-92,-181,-55,-140,-104,-122,-610
-97,-37,-136,-253,-161,-145,-193,-28,-1050
-5,-3,-22,-89,-83,-62,-54,34,-284
168,69,49,-114,-30,-128,-174,87,-73
31,104,-50,-256,-108,-181,-167,59,-568
48,76,-2,-81,-62,-132,-91,-11,-255
-32,9,-13,-57,-20,-38,-26,9,-168
17,57,-39,-91,6,-83,-97,33,-197
-60,17,-65,-145,-129,-109,-108,-17,-616
-11,-1,-14,-30,-18,-15,-20,-9,-118
-85,-54,-123,-289,-190,-113,-224,-20,-1098
-127,-27,-187,-301,-324,-178,-203,-56,-1403
-36,53,-37,-176,-88,-65,-112,90,-371
-12,2,-24,-37,-35,-27,-42,-14,-189
-9,-10,-28,-67,-59,-85,-53,-18,-329
7,26,-41,-101,-88,-80,-71,-28,-376
-11,19,-3,-34,-3,-15,-13,-4,-64
16,24,-38,-96,-87,-70,-67,6,-312
-36,6,-64,-120,-42,-56,-77,-59,-448
-61,-5,-56,-134,-67,-71,-84,-44,-522
-3,-3,-6,-34,-19,-22,-13,-7,-107
-65,-39,-82,-187,-90,-88,-139,-63,-753
-20,-5,-2,-35,-35,-37,-55,30,-159
-55,83,-122,-251,-49,-124,-122,-14,-654
-28,-22,-32,-58,-67,-32,-43,-8,-290
-14,27,-35,-76,-104,-53,-60,-38,-353
330,186,84,-184,-47,-279,-289,195,-4
-20,40,-68,-125,-47,-80,-65,-72,-437
-22,2,-10,-41,-25,-15,-35,-20,-166
-10,10,-14,-73,-73,-58,-49,-35,-302
-59,64,-117,-240,-77,-141,-130,-51,-751
-28,-4,-29,-60,-35,-27,-37,-22,-242
8,-9,-21,-52,-31,-17,-26,20,-128
22,24,11,-5,-3,1,-7,4,47
129,94,-11,-166,-165,-138,-130,-49,-436
9,7,-50,-135,-179,-104,-129,80,-501
-132,34,-83,-198,-79,-78,-80,-36,-652
-58,53,-40,-115,-20,-72,-53,3,-302
43,39,-6,-48,-30,-39,-8,-30,-79
-25,-42,-61,-120,-111,-76,-96,-12,-543
-12,19,-65,-125,-46,-100,-108,-33,-470
-61,-37,-47,-105,-102,-72,-82,-2,-508
-19,30,-45,-80,-74,-30,-55,17,-256
-66,-13,-70,-155,-142,-143,-142,-44,-775
-60,18,-85,-191,-97,-130,-138,-26,-709
-133,-2,-147,-210,-177,-90,-196,35,-920
-37,-14,-25,-60,-19,-30,-43,0,-228
15,88,-167,-278,-128,-234,-225,-163,-1092
-156,-40,-165,-300,-116,-77,-199,24,-1029
-80,-40,-107,-179,-180,-119,-150,-44,-899
18,9,-44,-92,-31,-63,-68,-27,-298
77,111,34,-75,-14,-67,-86,132,112
-24,-29,-61,-96,-117,-48,-94,-35,-504
-96,34,-143,-469,-308,-192,-215,71,-1318
-62,-51,-49,-98,-69,-68,-68,-11,-476
-26,-7,-52,-70,-100,-72,-78,-26,-431
-18,19,-10,-51,-16,-35,-24,-20,-155
-52,-17,-92,-116,-80,-58,-111,-49,-575
-30,70,-175,-312,-247,-331,-265,-219,-1509
-25,92,-68,-208,-177,-100,-99,73,-512
11,20,-36,-104,-96,-81,-38,-12,-336
17,24,-28,-23,-59,-43,-46,-23,-181
69,117,10,-66,47,-50,-9,57,175
-19,-7,-26,-41,-12,-11,-27,-2,-145
33,77,20,-68,-57,-90,-18,-33,-136
14,66,-94,-244,-137,-112,-90,155,-442
28,9,-17,-52,-24,-56,-24,-20,-156
-95,-14,-94,-185,-192,-106,-175,3,-858
-55,74,-30,-182,-44,-79,-62,20,-358
-12,-1,-35,-61,-74,-44,-75,16,-286
-30,207,-81,-333,-61,-59,-35,22,-370
30,120,11,-144,-46,-111,-101,103,-138
503,1388,262,-1229,-361,-863,-1910,891,-1319
10,31,-46,-161,-126,-174,-103,-52,-621
-53,-21,-60,-112,-117,-108,-118,-68,-657
-23,-18,-24,-77,-40,-45,-58,-13,-298
-40,63,7,-160,-104,-126,-71,61,-370
19,-20,-23,-70,-190,-64,-82,-3,-433
28,6,-14,-60,-71,-81,-64,-39,-295
-87,-17,-124,-225,-121,-137,-185,-97,-993
68,72,-50,-111,-171,-189,-143,-65,-589
47,53,43,-103,-70,-159,-32,17,-204
109,206,-87,-479,-224,-431,-331,117,-1120
-270,44,-441,-828,-417,-561,-669,-212,-3354
-64,16,-95,-359,-159,-208,-155,-102,-1126
-31,148,-75,-285,-135,-178,-115,84,-587
-12,44,-13,-88,-49,-45,-23,2,-184
-4,106,-118,-334,-240,-250,-220,-30,-1090
-56,37,-45,-208,-80,-94,-111,-20,-577
89,89,-80,-280,-187,-288,-216,-91,-964
-143,39,-217,-526,-360,-290,-305,6,-1796
-135,35,-53,-195,-64,-47,-84,-40,-583
21,-10,-16,-93,-143,-164,-163,-23,-591
-71,103,-61,-239,-103,-159,-65,58,-537
359,248,93,-219,223,-223,-221,28,288
-12,-19,-40,-115,-105,-60,-84,42,-393
11,160,-28,-202,-23,-100,-35,68,-149
122,82,-11,-223,-11,-156,-171,102,-266
-115,-26,-147,-255,-176,-126,-135,-48,-1028
-43,105,-47,-179,-45,-87,-87,31,-352
502,456,247,69,234,-116,-192,263,1463
-67,-39,-102,-138,-182,-116,-150,-31,-825
-101,14,-71,-224,-100,-80,-129,-5,-696
59,72,-21,-107,-82,-144,-106,-42,-371
-3,32,-78,-255,-284,-268,-305,-113,-1274
4,33,-29,-72,-84,-18,-47,-10,-223
-23,44,-48,-102,-24,-56,-55,7,-257
-77,330,-104,-546,-137,-242,-80,339,-517
111,104,33,-249,-114,-106,-123,190,-154
-45,-57,-9,-170,-132,-80,-119,51,-561
10,213,-93,-584,-300,-358,-286,87,-1311
-34,86,-89,-315,-183,-168,-150,129,-724
-101,7,-133,-306,-194,-157,-178,-15,-1077
-132,-15,-40,-160,-104,-71,-78,-31,-631
32,317,-79,-377,49,-105,-1,184,20
-165,58,-197,-502,-324,-189,-302,43,-1578
174,212,-4,-603,-186,-373,-319,297,-802
-28,41,-61,-178,-128,-129,-92,-13,-588
270,64,58,-173,-25,-268,-149,-49,-272
-77,20,-71,-199,-125,-91,-104,-58,-705
33,37,2,-31,-20,-23,-11,2,-11
-27,-5,-84,-216,-146,-219,-187,-8,-892
-25,6,-26,-80,-100,-53,-87,13,-352
25,29,-26,-93,-51,-90,-57,16,-247
20,42,4,-24,-30,-28,-40,6,-50
-22,0,-25,-92,-68,-54,-39,-14,-314
-42,-52,-93,-138,-155,-123,-159,-79,-841
-19,-6,-39,-140,-173,-142,-97,3,-613
-6,20,-11,-55,-5,-27,-16,-4,-104
-55,12,-79,-196,-204,-159,-198,-67,-946
-88,-41,-93,-189,-107,-107,-145,-54,-824
107,48,39,-95,32,-114,-103,17,-69
-44,28,-30,-164,-84,-99,-25,51,-367
-38,-62,-72,-200,-263,-226,-199,-89,-1149
-7,1,-5,-52,-56,-51,-38,5,-203
122,38,-7,-108,-96,-157,-161,-13,-382
158,214,-116,-586,-357,-467,-517,104,-1567
12,45,-57,-106,-103,-86,-65,-52,-412
-2,8,-10,-34,-11,-23,-4,-14,-90
-3,60,-17,-66,-25,-34,-23,-5,-113
-67,62,-53,-155,-79,-102,-112,-11,-517
-104,-33,-143,-243,-198,-138,-185,-14,-1058
0,17,-13,-28,-19,-16,-9,-11,-79
-126,28,-57,-178,-31,-30,-42,5,-431
33,26,8,-21,-27,-60,-22,1,-62
-108,-10,-191,-397,-319,-259,-264,-142,-1690
-37,30,-84,-172,-97,-109,-107,-64,-640
5,64,-32,-73,-89,-63,-75,-46,-309
-28,-1,-27,-89,-46,-57,-35,-28,-311
-13,-19,-3,-28,-30,-26,-16,5,-130
-2,-11,-11,-78,-46,-67,-62,-35,-312
-30,29,-52,-121,-131,-89,-97,-11,-502
13,21,15,-13,-36,-28,-41,0,-69
38,141,31,-161,-155,-131,-189,142,-284
-108,-79,-81,-137,-181,-60,-154,55,-745
14,-5,-15,-51,-24,-42,-29,-17,-169
-13,8,-1,-16,-4,2,2,-2,-24
-93,112,-154,-508,-313,-275,-276,38,-1469
-29,-14,-26,-44,-28,-16,-43,-12,-212
-8,26,-12,-28,-35,-21,-41,-17,-136
10,70,1,-72,30,-40,-49,36,-14
15,104,-21,-135,-99,-77,-95,101,-207
-14,0,-21,-57,0,-13,-25,23,-107
55,51,-23,-94,-45,-63,-60,-7,-186
99,129,38,-2,-19,-40,-43,58,220
-3,40,-10,-119,-57,-57,-71,16,-261
-11,-19,-20,-38,-34,-13,-28,12,-151
-54,41,-107,-255,-53,-160,-163,-24,-775
-62,35,-114,-263,-71,-176,-170,-43,-864
-7,62,-49,-287,-309,-246,-238,-82,-1156
-24,36,-28,-103,-81,-80,-74,-34,-388
10,40,-53,-97,-7,-42,-49,-36,-234
62,74,11,-24,37,-13,11,49,207
9,6,-18,-67,-16,-70,-40,-3,-199
7,53,-1,-14,27,8,10,12,102
116,45,15,-10,-78,-99,-52,-25,-88
51,2,-13,-95,-26,-74,-55,-10,-220
-3,22,-12,-37,-22,-21,-6,21,-58
-23,39,-58,-116,-40,-59,-72,-72,-401
-50,6,-61,-134,-73,-97,-87,-67,-563
-69,-29,-137,-278,-260,-211,-243,-89,-1316
-83,9,-99,-186,-176,-114,-181,-29,-859
-87,49,-100,-219,-95,-105,-112,-5,-674
48,88,-8,-72,-43,-73,-61,66,-55
44,51,2,-56,31,-43,-41,51,39
-38,40,-16,-48,-34,4,8,15,-69
-7,49,-2,-86,-46,-59,-37,-11,-199
112,22,34,-51,73,-45,-65,16,96
104,8,15,-295,12,-192,-151,16,-483
-15,20,-15,-31,-57,-23,-28,-17,-166
54,27,-15,-149,-20,-149,-173,134,-291
-39,48,1,-115,-3,-33,-17,40,-118
-25,-7,-19,-51,-28,-18,-29,16,-161
-50,2,-116,-242,-245,-166,-217,-19,-1053
23,-18,-15,-34,-48,-36,-77,-14,-219
-94,38,-87,-223,-146,-115,-121,-1,-749
-4,34,-35,-141,-94,-99,-77,-43,-459
2,27,-26,-51,-31,-51,-45,-22,-197
-20,41,-24,-132,-66,-85,-91,-18,-395
5,10,-3,-28,-30,-10,-21,-19,-96
18,50,-41,-149,-103,-130,-82,-47,-484
-9,11,-17,-34,-41,-23,-15,-7,-135
-63,-12,-125,-183,-172,-131,-203,-34,-923
-40,-69,-51,-111,-132,-97,-102,-37,-639
-7,35,-74,-93,-104,-88,-112,-68,-511
6,30,-14,-48,-30,-49,-27,-12,-144
-18,-6,-7,-26,-21,-4,-14,4,-92
69,83,44,20,26,4,-7,35,274
-27,13,-30,-77,-32,-23,-51,19,-208
-2,29,-12,-54,-40,-31,-30,32,-108
-34,1,-37,-76,-54,-41,-53,-20,-314
87,-22,20,-89,-38,-124,-82,12,-236
9,0,2,-15,-5,-29,-36,15,-59
-14,1,-10,-26,-23,-15,-26,-26,-139
23,11,-30,-36,-33,-28,-33,-23,-149
-1,-9,-30,-61,-78,-53,-30,-20,-282
7,21,-5,-34,-35,-46,-39,-4,-135
20,31,5,-93,-67,-97,-52,11,-242
-68,27,-69,-204,-103,-74,-94,18,-567
-80,-57,-75,-126,-116,-54,-106,9,-605
17,34,-66,-119,-115,-142,-124,-89,-604
-57,-13,-49,-98,-107,-68,-107,17,-482
-20,19,-9,-81,-6,-30,-57,7,-177
-44,-20,-44,-117,-70,-86,-89,-43,-513
27,4,5,-46,6,-19,-3,33,7
-32,97,-61,-152,-74,-64,-62,3,-345
24,33,-5,-68,0,-59,-46,-21,-142
22,18,-26,-33,-97,-71,-48,-43,-278
-86,61,-120,-201,-137,-66,-190,22,-717
-6,9,-29,-33,-26,-30,-45,-33,-193
-1,-20,-13,-44,-11,-31,-26,-13,-159
11,52,-3,-82,-28,-65,-25,9,-131
-9,-12,-1,-12,-9,-10,-4,4,-53
18,35,-14,-104,-37,-71,-69,30,-212
18,81,-19,-65,0,-64,-63,-15,-127
-65,-27,-41,-107,-64,-64,-58,2,-424
-25,0,0,-82,-122,-56,-56,-18,-359
1,-6,-19,-109,-90,-78,-41,-60,-402
-2,17,-21,-58,-8,-47,-41,-26,-186
-30,-3,-37,-106,-89,-67,-28,-38,-398
-124,-40,-83,-249,-183,-148,-187,-8,-1022
-8,4,-22,-45,-43,-50,-40,-15,-219
141,233,-68,-159,-26,-157,-122,-13,-171
36,119,-123,-341,-174,-275,-177,-59,-994
-95,-35,-89,-156,-99,-69,-141,-45,-729
-24,-9,-46,-114,-64,-82,-90,-20,-449
-2,25,-44,-134,-96,-99,-96,-20,-466
-78,0,-81,-195,-131,-67,-97,36,-613
-110,-38,-106,-213,-111,-89,-126,-15,-808
-11,11,-7,-36,-28,-17,-21,-14,-123
-41,14,-38,-65,-29,-25,-63,-13,-260
-47,-25,-53,-75,-46,-24,-72,-12,-354
-16,82,-27,-138,-52,-39,-46,1,-235
9,10,-7,-47,-11,-50,-34,10,-120
31,79,-41,-154,-48,-131,-86,10,-340
-44,25,-3,-71,-2,-17,19,14,-79
7,33,-30,-122,-55,-114,-61,-70,-412
-63,-29,-43,-127,-143,-77,-117,25,-574
-88,57,-102,-228,-102,-135,-170,-78,-846
-14,5,-6,-29,-44,-26,-30,-15,-159
28,16,-1,-9,21,-6,14,26,89
29,46,1,-66,-4,-44,-38,-13,-89
1,-4,-11,-26,-22,-12,-18,6,-86
-5,-20,-37,-63,-88,-43,-44,-23,-323
-100,71,-201,-359,-189,-192,-246,-109,-1325
-37,24,-34,-158,-104,-149,-111,-76,-645
-19,52,-85,-271,-94,-156,-160,6,-727
-59,18,-104,-172,-108,-87,-127,-7,-646
6,-7,-5,-13,-13,-16,-19,11,-56
80,147,12,-28,43,-10,-106,39,177
-2,-23,-3,-90,-73,-47,-68,-2,-308
68,39,2,2,-38,-75,-57,-15,-74
-93,-2,-157,-425,-309,-290,-301,-80,-1657
-49,29,-49,-106,-58,-45,-42,14,-306
-19,69,12,-119,-105,-105,-25,-26,-318
3,37,-9,-26,-18,-16,-21,3,-47
8,20,-3,-15,-45,-32,-34,7,-94
4,36,-19,-121,-39,-108,-67,-45,-359
-10,-5,-4,-55,1,-37,-30,21,-119
-31,-3,-45,-73,-43,-49,-58,-19,-321
-16,31,-37,-75,-33,-47,-44,-34,-255
-27,171,-24,-117,-12,-10,-101,44,-76
-43,124,-33,-164,-83,-34,-60,-94,-387
-8,10,0,-48,-29,-41,-13,-23,-152
-60,9,-104,-193,-129,-131,-176,-59,-843
-17,24,-43,-85,-40,-32,-66,-48,-307
-17,-8,-5,-76,-2,-13,-42,-32,-195
17,41,-2,-115,-72,-80,-24,13,-222
-7,54,-34,-74,-28,-32,-44,38,-127
-70,76,-70,-305,-107,-123,-157,-5,-761
11,39,-6,-85,-56,-69,-56,-10,-232
36,91,-48,-245,-65,-146,-113,27,-463
58,93,9,-52,26,-19,45,91,251
71,16,1,-54,-156,-63,-62,73,-174
-13,-12,-77,-99,-106,-87,-132,-18,-544
-69,35,-74,-182,-88,-92,-103,6,-567
58,23,1,-93,-54,-98,-56,14,-205
-9,30,-19,-72,-44,-39,-42,-21,-216
-70,31,-64,-178,-100,-100,-102,-53,-636
-60,-7,-121,-254,-184,-128,-191,21,-924
50,33,11,-1,7,-18,-13,29,98
26,-5,-4,-83,-155,-96,-87,-27,-431
51,31,-9,-78,-11,-63,-48,10,-117
-71,4,-121,-266,-200,-175,-217,-82,-1128
54,49,0,-146,31,-106,-87,19,-186
23,91,-3,-167,-44,-157,-118,30,-345
42,118,-150,-302,-124,-162,-154,71,-661
-52,100,-112,-240,-79,-102,-134,34,-585
-3,26,-57,-66,-18,-41,-27,26,-160
43,59,-40,-105,-96,-133,-132,-38,-442
-19,9,-17,-50,-50,-33,-34,-9,-203
0,16,-16,-52,-28,-49,-58,-2,-189
-5,-7,-7,-17,-16,-15,-3,-8,-78
-10,44,-36,-97,-41,-56,-85,-34,-315
-12,18,-48,-133,-107,-120,-109,-46,-557
27,65,-60,-163,-93,-163,-133,-46,-566
-22,-3,-33,-122,-84,-73,-67,4,-400
84,102,42,-56,-43,-41,-29,91,150
-39,-17,-35,-110,-97,-56,-58,39,-373
57,43,-19,-131,-32,-122,-61,24,-241
-6,30,-11,-30,-16,-9,-8,19,-31
-73,-26,-60,-130,-107,-70,-127,-7,-600
-8,5,-5,-22,-22,0,-13,8,-57
-43,31,-108,-171,-93,-96,-141,-85,-706
45,48,-2,-41,-83,-50,-18,-18,-119
-6,-2,-13,-58,-78,-36,-47,1,-239
103,132,28,-164,-199,-215,-102,-102,-519
-75,-35,-86,-138,-96,-64,-129,-17,-640
92,101,33,17,28,-15,8,35,299
-19,1,-68,-163,-110,-65,-69,28,-465
-48,-26,-72,-140,-145,-97,-114,-26,-668
32,114,18,-223,-2,-122,-50,11,-222
4,24,-14,-58,-65,-53,-48,-22,-232
0,27,-2,-46,-76,-4,-45,18,-128
-66,6,-47,-141,-108,-109,-103,-10,-578
-20,127,-80,-385,-275,-315,-273,10,-1211
30,72,12,-176,-30,-147,-117,25,-331
-28,26,-21,-103,-62,-54,-57,2,-297
-27,91,-37,-251,-92,-144,-124,56,-528
-55,116,-16,-221,-89,-145,-61,24,-447
150,139,60,-2,-44,-119,-90,-29,65
71,130,-71,-335,-43,-234,-233,-18,-733
20,6,5,-40,-67,-61,-12,46,-103
-5,181,-69,-260,-108,-200,-71,52,-480
-26,-16,-33,-124,-156,-97,-98,-30,-580
-66,-23,-106,-234,-124,-82,-73,-34,-742
60,41,-21,-48,-37,-107,-67,19,-160
-76,58,-57,-144,-77,-73,-40,-7,-416
-9,37,-32,-222,-185,-130,-105,3,-643
-210,24,-212,-559,-320,-251,-335,-46,-1909
43,22,-19,-86,-31,-89,-62,-32,-254
-71,30,-45,-97,-65,-52,-47,-26,-373
-20,-20,-22,-66,-84,-43,-53,8,-300
-18,11,-28,-72,-30,-31,-44,-36,-248
-1,52,-16,-102,-66,-86,-11,20,-210
128,-108,21,-7,-34,96,-51,206,251
-24,6,-12,-92,-57,-73,-60,31,-281
-17,11,-17,-46,-26,-26,-38,-29,-188
-24,-13,-59,-152,-144,-117,-123,-35,-667
-34,71,-20,-102,-4,0,-43,0,-132
-10,-4,-4,-20,-22,-17,-14,-3,-94
-165,484,-609,-1381,-782,-1121,-991,-238,-4803
-81,83,-65,-136,-17,-48,-51,38,-277
81,12,-16,-60,-53,-72,-66,0,-174
-28,207,-63,-223,-296,-137,-196,-4,-740
-34,-38,-46,-137,-147,-59,-112,21,-552
-48,19,-48,-139,-63,-59,-47,-27,-412
-32,-21,-19,-49,-61,-10,-44,35,-201
-48,-19,-22,-85,-60,-31,-60,35,-290
-31,-14,-70,-104,-53,-61,-68,-41,-442
-19,15,-10,-65,-63,-53,-62,-6,-263
-17,98,-26,-152,-86,-20,13,16,-174
-17,15,-35,-65,-44,-21,-38,-22,-227
30,4,-7,-4,-49,-27,-10,-14,-77
35,12,-48,-142,-113,-120,-100,-36,-512
-20,12,-24,-65,-58,-3,-45,-19,-222
18,18,-24,-82,-78,-92,-81,-57,-378
-145,391,-174,-865,-169,-422,-247,141,-1490
-58,25,-45,-118,-105,-71,-90,-1,-463
13,6,-4,-28,3,-17,-13,-7,-47
34,-31,-2,-33,-89,-108,-66,-35,-330
31,139,9,-45,15,-17,-106,21,47
-48,38,-47,-189,-109,-94,-112,-53,-614
25,63,-26,-106,-99,-128,-158,-5,-434
-13,12,-19,-128,-155,-85,-161,72,-477
2,-13,-44,-58,-59,-58,-71,-38,-339
-44,3,-33,-157,-119,-163,-123,-42,-678
-20,67,-60,-168,-64,-116,-85,-13,-459
-32,98,-77,-261,-233,-242,-191,-14,-952
79,26,7,-76,-42,-117,-72,-12,-207
118,-138,36,56,16,85,-34,157,296
-60,63,-149,-380,-116,-302,-246,-204,-1394
-146,47,-220,-384,-94,-163,-166,-64,-1190
-34,236,-13,-796,-322,-331,-360,244,-1376
106,75,-34,-194,-80,-222,-134,-93,-576
-27,23,-27,-122,-32,-19,-47,5,-246
-42,4,-98,-155,-162,-112,-131,-34,-730
106,140,-5,-266,-23,-215,-37,35,-265
-31,-48,-40,-110,-110,-117,-85,-22,-563
-44,-26,-92,-170,-142,-138,-167,-66,-845
149,361,-281,-1031,-910,-1095,-937,-817,-4561
-26,49,-2,-125,-105,-120,-67,-39,-435
-7,-9,-15,-11,-36,-1,-21,15,-85
-43,-14,-48,-97,-50,-63,-56,-22,-393
-15,-40,-19,-41,-56,-44,-48,-8,-271
-19,5,-41,-92,-129,-59,-88,-35,-458
-101,-37,-165,-440,-276,-287,-330,-66,-1702
-140,-33,-146,-508,-346,-328,-332,-54,-1887
-11,-25,-6,-37,-24,-25,-59,11,-176
18,185,-57,-198,-5,-156,-105,91,-227
137,122,31,-131,-23,-150,-95,41,-68
-62,-5,-67,-177,-128,-55,-102,-1,-597
8,18,-10,-10,-12,-5,6,-3,-8
-6,13,-18,-21,-21,-14,-15,4,-78
-23,6,-37,-65,-59,-39,-35,8,-244
-45,6,-52,-104,-78,-59,-58,-27,-417
31,13,-8,-52,-88,-58,-51,-16,-229
-12,29,-46,-186,-77,-123,-100,-33,-548
0,31,-33,-51,-35,-41,-35,-16,-180
2,115,-35,-133,-90,-124,-107,16,-356
-31,3,-39,-110,-108,-96,-82,11,-452
41,148,-22,-185,-107,-213,-189,-74,-601
1,-1,-12,-6,-8,-7,-11,-6,-50
-3,4,-9,-11,-3,-8,-14,-9,-53
-9,6,-8,-30,-34,-42,-24,-13,-154
-2,20,-15,-65,-20,-50,-33,-13,-178
-16,2,-7,-28,-40,-36,-23,-9,-157
98,138,0,-357,-122,-227,-172,116,-526
-48,22,-88,-213,-115,-116,-119,-27,-704
-33,49,-72,-235,-130,-136,-113,2,-668
39,58,-66,-186,-195,-212,-178,-80,-820
-79,169,-105,-453,-156,-209,-113,56,-890
89,70,-7,-75,-108,-123,-128,-9,-291
-42,1,-82,-193,-160,-127,-138,-37,-778
260,79,139,-102,331,34,15,256,1012
-63,9,-60,-137,-53,-51,-59,-13,-427
-69,20,-38,-151,-72,-28,-106,41,-403
138,30,7,-142,-67,-175,-159,21,-347
14,15,3,-64,-87,-60,-69,-27,-275
-16,-23,-26,-71,-48,-19,-26,-19,-248
-18,0,-13,-47,-44,-30,-31,-11,-194
-32,-2,-29,-59,-38,-26,-47,-2,-235
-20,2,-12,-25,-6,-11,-7,-20,-99
3,14,-2,-24,-15,-28,-9,-7,-68
-57,111,-236,-483,-208,-349,-362,-197,-1781
12,-6,2,-61,-24,3,-48,57,-65
-21,-1,-2,-21,-20,-12,-19,-1,-97
-21,-25,-29,-61,-25,-44,-29,-17,-251
22,54,-11,-76,-27,-40,-71,-1,-150
8,4,17,1,-4,1,-4,22,45
-31,-39,-73,-375,-127,-259,-189,7,-1086
106,66,37,-60,27,-97,-117,20,-18
66,75,-25,-180,-64,-164,-115,24,-383
-1,14,11,-9,-6,-8,0,6,7
-17,-7,-31,-71,-93,-42,-74,12,-323
8,7,-28,-77,-35,-66,-37,-51,-279
48,89,-70,-261,-172,-202,-181,-71,-820
17,8,5,-21,-30,-15,-19,4,-51
-10,15,-13,-54,-55,-25,-32,14,-160
-19,-20,-25,-42,-20,-15,-25,11,-155
-15,-5,-24,-43,-56,-39,-36,-14,-232
-79,8,-86,-185,-129,-82,-113,-5,-671
3,1,5,-68,-72,-44,-33,-23,-231
-4,10,-14,-58,-47,-54,-44,-31,-242
-11,-7,-17,-21,-23,-20,-6,-14,-119
-1,-15,-5,19,-52,-21,-12,10,-77
-89,-7,-123,-158,-137,-102,-161,1,-776
-23,-17,-25,-24,-31,-18,-37,-12,-187
10,9,-17,-15,-19,-28,-7,-15,-82
-130,44,-149,-437,-195,-205,-246,17,-1301
-11,87,-58,-116,-61,-52,-79,-9,-299
26,10,-16,-69,-50,-43,-41,-24,-207
-24,6,-43,-89,-53,-8,-38,28,-221
-83,-13,-85,-146,-93,-78,-92,-25,-615
-48,0,-94,-147,-84,-71,-91,-62,-597
-104,46,-99,-275,-106,-89,-94,-39,-760
-34,-19,-46,-50,-44,-38,-74,-17,-322
108,178,40,-88,5,-32,-121,90,180
-3,17,-21,-23,-49,-27,-34,-1,-141
-16,14,-25,-112,-72,-63,-60,-47,-381
3,5,8,-17,3,-14,11,15,14
2,13,3,-16,6,-4,4,17,25
-20,15,-19,-62,-34,-16,-36,0,-172
85,90,17,-2,-27,-87,-33,-8,35
16,51,-2,-172,-131,-209,-130,-37,-614
-114,54,-144,-355,-207,-222,-162,37,-1113
-15,149,1,-257,-158,-239,-26,210,-335
-6,15,-28,-65,-26,-42,-32,-4,-188
-2,66,-19,-240,-62,-137,-91,64,-421
-15,-6,-19,-32,-40,-20,-39,-7,-178
-45,-61,-54,-90,-137,-99,-121,-58,-665
9,3,-75,-87,-155,-132,-124,-104,-665
7,53,-18,-86,-38,-56,-77,-9,-224
14,19,-19,-34,-23,-20,-26,-10,-99
9,6,-9,-4,-5,5,-27,27,2
-13,14,-21,-95,-50,-41,-28,-15,-249
-89,-30,-90,-158,-98,-84,-113,-15,-677
-72,-14,-114,-186,-138,-114,-158,-18,-814
10,0,-41,-143,-166,-175,-119,-90,-724
-46,-12,-32,-101,-32,-34,-45,28,-274
-27,20,-43,-114,-98,-88,-106,-43,-499
-108,190,-143,-453,-110,-117,-245,-131,-1117
-56,62,-64,-136,-54,-66,-35,31,-318
-91,-18,-111,-208,-137,-84,-146,8,-787
31,29,-27,-161,-154,-126,-120,-14,-542
-46,35,-95,-178,-145,-136,-196,-54,-815
41,28,-21,-50,-19,-60,-41,-17,-139
-14,50,-73,-201,-166,-153,-156,31,-682
3,10,5,-19,-13,-17,-5,6,-30
34,72,23,-48,-103,-37,-123,-12,-194
-7,65,-23,-105,-90,-59,-97,-42,-358
-7,31,-13,-78,-73,-38,-37,-8,-223
164,279,-34,-239,28,-212,-174,146,-42
49,23,-1,-41,-88,-70,-45,-54,-227
-4,31,-22,-152,-87,-114,-81,-24,-453
-22,57,-22,-100,-42,-96,-44,-38,-307
-83,-35,-137,-189,-150,-118,-188,-33,-933
-23,6,-64,-134,-135,-116,-141,-39,-646
-59,-45,-95,-166,-177,-58,-79,-34,-713
10,-5,-20,-90,-48,-75,-50,-7,-285
-61,23,-69,-237,-212,-166,-168,18,-872
-129,15,-176,-308,-174,-175,-269,-140,-1356
6,9,-16,-67,-59,-69,-50,-31,-277
-9,70,-24,-128,-40,-66,-52,39,-210
-92,295,-95,-545,-360,-417,-150,217,-1147
17,79,-13,-42,17,-12,-24,55,77
-70,34,-48,-85,-48,10,-19,-34,-260
41,108,-53,-126,-116,-159,-102,-77,-484
5,10,-7,-4,-33,-32,-48,-39,-148
-49,-8,-55,-127,-113,-80,-105,-14,-551
-18,11,-30,-67,-41,-61,-56,-34,-296
3,7,5,-22,-17,-7,-4,-5,-40
-26,41,-54,-180,-53,-102,-98,-24,-496
35,24,-55,-94,-55,-116,-88,-49,-398
-117,29,-143,-391,-121,-150,-186,-97,-1176
-50,-19,-50,-150,-120,-109,-91,-79,-668
95,162,-7,-195,-19,-114,-84,158,-4
-5,11,-5,-51,-28,8,-39,27,-82
76,146,-45,-195,-119,-218,-177,-116,-648
-25,-10,-17,-46,-79,-34,-49,-13,-273
-4,241,-141,-514,-402,-341,-376,184,-1353
19,67,-1,-113,-79,-103,-141,-43,-394
-311,-22,-318,-768,-488,-437,-530,27,-2847
25,24,-7,-105,-67,-80,-81,-11,-302
-132,-11,-178,-378,-357,-186,-256,-94,-1592
-148,51,-177,-421,-212,-199,-259,-72,-1437
30,55,20,-49,33,-20,-29,12,52
-140,29,-168,-375,-260,-96,-255,-86,-1351
5,1,-101,-254,-210,-225,-188,-105,-1077
-60,-36,-76,-153,-162,-89,-112,-3,-691
33,27,13,-61,0,-63,-40,8,-83
-50,-14,-32,-89,-107,-9,-46,-18,-365
4,30,-11,-78,-91,-59,-58,0,-263
-31,-9,-73,-104,-106,-43,-110,-19,-495
35,69,-66,-229,-147,-220,-169,-30,-757
-55,-19,-48,-80,-71,-53,-69,-13,-408
10,49,-2,-38,-4,-33,-22,-5,-45
-7,18,-30,-52,-41,-24,-33,18,-151
-60,71,-63,-153,-114,-110,-86,-19,-534
9,60,-26,-96,-47,-36,-44,-40,-220
21,54,-12,-61,-66,-84,-43,17,-174
20,60,-4,-86,-7,-64,-22,9,-94
190,66,116,-69,43,-60,-60,97,323
-11,6,-102,-143,-198,-86,-95,-90,-719
-55,-14,-50,-163,-105,-97,-60,-7,-551
-308,420,-727,-1635,-866,-1040,-1097,-474,-5727
-14,2,-3,-25,-16,-16,-11,-9,-92
90,34,21,-87,-56,-108,-42,-6,-154
-47,21,-46,-123,-53,-38,-45,32,-299
-33,42,-15,-125,-37,-73,-44,15,-270
-89,94,-126,-315,-192,-179,-180,-89,-1076
-1,-24,-30,-92,-234,-106,-129,-13,-629
10,33,-30,-66,1,-45,-48,-45,-190
40,31,-22,-18,-7,-48,-38,41,-21
54,35,8,-41,-105,-61,-15,-36,-161
-59,23,-28,-135,-46,-55,-72,8,-364
-72,-37,-139,-188,-98,-147,-168,-91,-940
-4,22,-26,-101,-47,-44,-94,15,-279
82,76,18,-51,-77,-128,-78,-10,-168
-17,9,-3,-39,-8,0,-10,-16,-84
-1,7,-16,-13,-28,-12,-40,-4,-107
10,-5,-15,-62,-123,-78,-72,-44,-389
-33,2,-32,-94,-96,-66,-62,-20,-401
-45,15,-69,-159,-94,-95,-121,-64,-632
-30,-2,-43,-106,-55,-87,-63,-40,-426
26,-27,-8,-63,-42,-58,-62,-16,-250
62,42,-5,-98,-9,-52,-28,37,-51
2,36,13,-41,-22,-34,-16,27,-35
-32,40,-55,-217,-142,-157,-102,-30,-695
-23,23,-59,-85,-109,-84,-112,-36,-485
-31,12,-21,-72,-52,-6,-45,47,-168
-130,-32,-171,-217,-177,-108,-193,-15,-1043
-92,-41,-73,-124,-75,-62,-100,-4,-571
41,32,-13,-22,-61,-65,-45,-10,-143
-46,11,-71,-116,-110,-78,-69,-72,-551
10,14,-2,-48,-46,-31,-24,-11,-138
-67,-34,-66,-122,-100,-82,-80,-34,-585
-16,58,-25,-132,-61,-51,-73,-63,-363
39,62,-15,-83,-12,-61,-20,0,-90
-50,-29,-50,-118,-84,-58,-119,-5,-513
-19,50,-77,-189,-166,-142,-111,-48,-702
-28,8,-34,-88,-65,-60,-76,-33,-376
24,27,-8,-62,-34,-67,-34,-3,-157
-14,16,-42,-74,-29,-61,-56,-60,-320
-11,57,-75,-242,-179,-187,-208,-87,-932
-63,-15,-44,-110,-76,-70,-92,-22,-492
-24,4,-46,-130,-95,-40,-53,-30,-414
-30,2,-54,-113,-144,-86,-114,-15,-554
-14,21,-19,-90,-68,-38,-64,-22,-294
-4,18,-53,-106,-49,-96,-69,7,-352
-65,50,-100,-221,-106,-78,-134,13,-641
-41,22,-86,-159,-131,-111,-125,-2,-633
-25,-27,-31,-108,-153,-95,-140,-48,-627
-62,-24,-12,-101,-114,-60,-56,1,-428
-19,3,-55,-65,-44,-56,-60,-50,-346
-19,7,-16,-74,-42,-39,-22,-3,-208
-24,6,-18,-52,-47,-26,-41,9,-193
-21,-14,-18,-70,-51,-46,-40,-13,-273
-2,19,-10,-31,-22,-6,-19,5,-66
24,-20,-4,-36,-34,-58,-27,3,-152
4,23,-9,-22,-6,-29,-31,-10,-80
15,26,4,-33,-30,-21,7,15,-17
-27,139,-41,-131,-147,-127,-112,63,-383
-84,-43,-118,-194,-104,-129,-168,-68,-908
-51,27,-87,-132,-155,-90,-101,-31,-620
-70,54,-109,-250,-173,-107,-170,-55,-880
-60,63,-53,-133,-27,-56,-49,-14,-329
-41,10,-32,-107,-70,-57,-44,-1,-342
-70,-5,-69,-211,-83,-106,-138,9,-673
37,9,-17,-43,-64,-58,-62,15,-183
-30,-7,-49,-102,-34,-34,-50,27,-279
-35,0,-24,-85,-60,-50,-54,2,-306
-39,28,-30,-96,-62,-8,-36,-28,-271
-84,-36,-91,-151,-130,-84,-116,-19,-711
-61,-13,-88,-134,-175,-98,-134,-38,-741
-25,31,-46,-155,-97,-105,-100,10,-487
-60,0,-71,-148,-84,-97,-112,-31,-603
-38,-10,-46,-143,-59,-59,-65,-18,-438
-56,64,-108,-328,-51,-198,-161,-70,-908
-42,129,-158,-339,-167,-173,-168,-77,-995
11,29,-76,-162,-196,-143,-133,-100,-770
18,31,-6,-93,-45,-80,-55,3,-227
-28,-53,-67,-86,-108,-94,-64,-37,-537
-43,-14,-58,-129,-72,-74,-98,-41,-529
-34,65,-69,-205,-60,-121,-74,-51,-549
-45,33,-60,-152,-124,-98,-103,-37,-586
-54,45,-169,-310,-232,-231,-248,-57,-1256
-62,-21,-74,-120,-103,-92,-82,-39,-593
-157,155,-252,-477,-203,-227,-297,-124,-1582
23,18,-11,-119,-162,-164,-150,-120,-685
-26,-1,-21,-62,-43,-9,-35,0,-197
-22,28,-17,-90,-46,-44,-59,-47,-297
4,32,-5,-39,-15,-51,-38,-7,-119
-23,21,-7,-78,-25,-43,-19,-10,-184
-6,19,-13,-61,-35,-56,-46,-21,-219
-60,-42,-47,-159,-178,-141,-119,-38,-784
0,35,-4,-65,-51,-51,-52,-47,-235
-72,12,-68,-196,-119,-102,-96,-24,-665
-70,11,-103,-169,-93,-115,-91,-95,-725
-42,35,-19,-121,-87,-57,-72,-41,-404
-39,101,-52,-152,-36,-35,-50,17,-246
-9,-24,-9,-44,-21,-11,-26,20,-124
-1,63,-71,-159,-88,-115,-85,-15,-471
-16,1,-23,-23,-64,-6,-27,-4,-162
-35,-21,-21,-126,-174,-125,-152,8,-646
-63,-24,-95,-198,-142,-121,-133,-91,-867
106,100,-1,-128,-104,-148,-69,15,-229
-90,7,-64,-203,-98,-115,-126,-24,-713
-10,10,-17,-80,-26,-43,-20,-12,-198
2,5,-20,-65,-27,-45,-21,-7,-178
2,20,-19,-70,-63,-62,-50,0,-242
-6,38,-45,-167,-115,-131,-82,-8,-516
-106,22,-90,-196,-127,-87,-114,-45,-743
-29,-11,-27,-66,-64,-37,-69,-6,-309
14,8,-2,-42,-15,-50,-19,-5,-111
-44,54,-67,-218,-81,-105,-64,4,-521
-52,-19,-64,-87,-68,-39,-88,-11,-428
-41,-8,-16,-70,-7,-33,-26,-4,-205
81,176,33,-92,-5,-178,-18,157,154
-34,-18,-45,-74,-62,-37,-72,-27,-369
9,30,-31,-105,-147,-117,-86,-25,-472
-37,5,-80,-138,-149,-96,-140,-17,-652
47,17,20,-24,-39,-26,-14,19,0
123,70,1,-65,7,-156,-94,18,-96
-86,23,-63,-288,-257,-150,-163,-13,-997
-6,108,-26,-141,-87,-37,-2,-15,-206
-115,-42,-139,-227,-160,-123,-191,-45,-1042
-47,-10,-62,-133,-53,-77,-82,-31,-495
-16,2,-9,-42,-35,-19,-18,0,-137
33,-20,9,-76,-28,-59,-33,6,-168
15,46,-24,-82,-28,-56,-48,16,-161
29,110,48,-85,-6,-70,17,80,123
-12,15,-35,-58,-56,-64,-31,-33,-274
-8,87,22,-108,-79,-20,-35,62,-79
10,37,-21,-55,-17,-50,-18,11,-103
12,-8,-2,-51,3,-24,-13,3,-80
93,-9,27,23,-75,-62,-64,29,-38
-19,68,23,-115,-15,-39,17,-8,-88
-13,44,-37,-133,-85,-63,-74,-20,-381
-52,-24,-69,-106,-65,-49,-113,-23,-501
-43,-12,-35,-82,-72,-56,-80,9,-371
1,-5,7,-15,-7,-4,18,7,2
0,40,-100,-177,-96,-142,-169,-80,-724
13,29,-51,-195,-26,-73,-52,8,-347
24,25,-22,-16,-35,-23,-25,-15,-87
-46,33,-25,-118,-48,-91,-63,41,-317
61,249,52,-118,-68,-67,50,29,188
-21,39,-35,-118,-58,-27,-6,-19,-245
-54,42,-88,-196,-138,-109,-80,-11,-634
4,53,-17,-107,-111,-85,-65,31,-297
78,31,30,-19,17,-76,-36,11,36
-25,8,-42,-62,-27,-12,-32,-17,-209
-3,79,-10,-138,-68,-92,-44,69,-207
19,66,4,-99,-59,-106,-18,50,-143
40,104,-12,-69,-19,-72,-28,32,-24
-5,5,-20,-47,-8,-31,-26,-11,-143
-44,-10,-38,-108,-66,-38,-73,-21,-398
14,26,-27,-79,-26,-41,-30,-10,-173
-62,48,-71,-167,-79,-88,-87,-20,-526
-28,8,-34,-75,-88,-64,-70,-26,-377
-80,2,-48,-159,-86,-56,-111,-43,-581
64,56,6,-92,15,-69,-53,-18,-91
-52,20,-43,-91,-87,-43,-45,-4,-345
10,-7,-17,-69,-33,-22,-30,11,-157
-10,28,-9,-54,-7,-31,-34,-6,-123
24,24,-9,-81,-132,-74,-69,-13,-330
-11,8,-35,-54,-36,-40,-47,-47,-262
-24,-14,-19,-65,-47,-42,-44,-12,-267
0,16,-11,-15,-26,-12,-10,-2,-60
2,40,-21,-74,-21,-30,-15,32,-87
13,17,-10,-46,3,-41,-33,-18,-115
-59,-36,-75,-132,-89,-78,-101,-41,-611
-22,7,-7,-45,-26,-26,-39,17,-141
-35,62,-55,-163,-106,-79,-81,4,-453
-6,-4,-18,-30,-64,-36,-38,-11,-207
-27,-1,-79,-139,-100,-125,-95,-82,-648
-23,-37,-15,-55,-79,-36,-48,12,-281
-21,3,-34,-61,-46,-2,-43,-21,-225
-36,19,-51,-105,-72,-56,-72,1,-372
-38,-23,-23,-138,-146,-105,-85,-3,-561
-6,-15,3,-26,-55,-70,-58,3,-224
22,12,-10,0,-55,-62,-53,-24,-170
-13,-10,-17,-31,-25,-11,-29,15,-121
-101,68,-172,-348,-185,-205,-225,-202,-1370
-17,-8,-34,-61,-50,-59,-54,-32,-315
94,74,-27,-226,-57,-207,-174,-33,-556
19,4,2,-2,-27,-8,-53,45,-20
-14,-1,-34,-58,-23,-29,-47,-17,-223
14,66,-13,-83,-4,-76,-53,7,-142
14,-1,-13,-31,-24,-35,-27,5,-112
-23,10,-26,-61,-23,-38,-42,-16,-219
-2,-6,-4,-65,-49,-30,-22,-25,-203
-13,-8,-5,-33,-33,-13,-6,-3,-114
20,84,9,-52,-22,-65,-28,42,-12
-69,-29,-28,-110,-68,-44,-45,-1,-394
-29,3,-29,-66,-30,-30,-23,6,-198
9,13,-10,-61,-21,-35,-10,16,-99
-35,37,-56,-121,-86,-80,-91,-7,-439
39,33,-2,-24,-92,-99,-91,-11,-247
-40,-25,-23,-74,-98,-65,-70,-27,-422
-48,-20,-66,-86,-102,-50,-83,-30,-485
-6,20,-4,-30,-19,-10,-17,-12,-78
3,3,-9,-31,-57,-51,-36,-10,-188
-22,39,-7,-66,-16,5,15,4,-48
-42,-11,-107,-192,-119,-152,-183,-117,-923
3,15,-36,-54,-99,-65,-53,-24,-313
-17,10,1,-46,-59,-46,-42,-35,-234
20,107,-11,-135,-33,-98,-24,23,-151
36,19,-10,-3,-8,-42,-50,-9,-67
-25,0,-27,-122,-139,-127,-90,-50,-580
-33,0,-50,-76,-56,-32,-66,-15,-328
-79,-40,-77,-152,-99,-106,-122,-13,-688
-65,-7,-128,-209,-160,-137,-169,-76,-951
30,30,-26,-64,5,-42,-51,20,-98
24,128,-25,-149,-22,-127,-105,74,-202
12,5,-15,-70,-70,-52,-45,-5,-240
-47,41,-33,-177,-119,-98,-60,26,-467
-55,-14,-52,-81,-55,-47,-90,-12,-406
-20,5,-23,-102,-104,-57,-94,-24,-419
-47,37,-83,-195,-148,-142,-151,-76,-805
-65,31,-77,-226,-78,-101,-123,-20,-659
-50,-35,-129,-298,-140,-211,-242,-102,-1207
-27,91,-5,-123,-7,-44,-5,-24,-144
-176,18,-200,-387,-185,-231,-256,-130,-1547
-17,32,-31,-76,-6,-49,-34,1,-180
-61,10,-54,-98,-63,-54,-64,-6,-390
-109,188,-104,-478,-132,-152,-210,-84,-1081
18,58,-24,-52,-44,-28,-6,11,-67
-8,8,-26,-90,-117,-90,-86,-35,-444
-3,20,-4,-51,-15,-35,-14,13,-89
-1,-4,-18,-128,-136,-146,-102,-66,-601
4,-2,-43,-123,-154,-153,-90,-54,-615
-34,9,-49,-84,-49,-86,-74,-35,-402
-3,28,-35,-63,-54,-33,-68,38,-190
-12,1,-4,-39,-40,-26,-37,14,-143
-52,-28,-75,-109,-102,-85,-110,-27,-588
-63,25,-55,-157,-71,-114,-89,-69,-593
-90,65,-123,-243,-102,-131,-193,-57,-874
-99,-81,-142,-199,-197,-122,-231,68,-1003
-50,131,-57,-310,-124,-188,-147,70,-675
-45,-3,-75,-134,-119,-90,-87,9,-544
-81,-6,-61,-135,-96,-45,-84,13,-495
29,55,10,-86,-23,-55,-62,-18,-150
39,75,-9,-60,-71,-71,-75,-4,-176
-11,-13,-43,-103,-52,-57,-58,-22,-359
57,92,-3,-27,-24,-50,-62,45,28
-15,3,-35,-172,-66,-130,-101,-46,-562
-57,-25,-76,-113,-150,-101,-134,-8,-664
-54,64,-43,-129,-46,-81,-61,5,-345
-9,2,-35,-55,-35,-42,-40,-8,-222
2,26,-15,-49,-44,-47,-31,6,-152
91,168,-21,-131,-56,-150,-39,84,-54
39,19,21,-27,-63,-60,-54,-2,-127
2,24,-13,-100,-52,-75,-34,-12,-260
-17,-3,-21,-122,-66,-69,-32,2,-328
-3,41,24,-120,-171,-167,-106,74,-428
-34,46,-25,-158,-133,-43,-80,8,-419
83,80,69,36,68,75,21,20,452
138,344,-38,-271,-275,-213,-469,-70,-854
-24,-1,-29,-40,-20,-9,-27,21,-129
-5,37,-94,-109,-57,-92,-132,-93,-545
32,132,6,-78,29,-11,7,83,200
-72,9,-93,-206,-138,-134,-145,-108,-887
-33,0,-15,-62,-31,-24,-13,14,-164
17,22,-84,-176,-146,-141,-115,-56,-679
-44,-16,-65,-86,-69,-60,-76,-12,-428
-64,5,-81,-172,-68,-38,-75,33,-460
55,41,7,-80,-16,-115,-53,6,-155
-220,-8,-318,-605,-362,-147,-445,89,-2016
-27,-33,-124,-202,-211,-163,-178,-26,-964
-4,15,-8,-41,-28,-10,-17,-4,-97
-41,22,-42,-108,-63,-64,-65,-22,-383
36,25,-50,-97,-112,-108,-111,-13,-430
26,77,-17,-103,-70,-88,-42,18,-199
-7,4,-99,-115,-156,-132,-168,-79,-752
-13,-17,-28,-79,-106,-56,-75,4,-370
-26,-14,-36,-63,-42,-26,-30,19,-218
-17,175,-33,-192,-33,-76,13,117,-46
-3,-30,-43,-116,-106,-72,-82,15,-437
-3,11,2,-17,-1,-12,1,17,-2
-124,-21,-133,-212,-223,-118,-253,-30,-1114
-33,27,-66,-196,-117,-125,-101,-84,-695
-58,-5,-59,-112,-43,-44,-69,-3,-393
2,20,-18,-112,-115,-66,-101,-4,-394
-12,15,-56,-109,-76,-82,-81,-47,-448
4,116,-43,-176,-19,-77,-90,-66,-351
-5,97,-71,-270,-77,-206,-173,10,-695
9,26,-19,-73,-78,-55,-26,1,-215
-105,23,-158,-236,-156,-101,-177,46,-864
79,1,9,-57,14,-70,-87,118,7
-387,-104,-557,-1266,-900,-757,-926,-491,-5388
18,30,0,-45,-7,-69,-18,6,-85
98,185,5,-155,-39,-166,-66,-6,-144
57,58,19,-96,41,-92,-41,38,-16
-55,127,-133,-275,-64,-96,-86,38,-544
40,206,65,-160,8,-102,36,202,295
-63,-24,-58,-92,-68,-38,-79,-19,-441
-18,-6,-11,-10,-7,-4,-12,-1,-69
16,9,-43,-122,-73,-99,-115,-33,-460
-72,-13,-68,-137,-156,-96,-160,-89,-791
14,165,-40,-189,-97,-97,-75,7,-312
0,-2,3,4,-12,-19,-9,5,-30
82,77,-9,-98,-99,-123,-118,-23,-311
48,97,15,-90,22,-55,-68,127,96
-181,46,-217,-398,-41,-136,-198,-58,-1183
-38,-1,-22,-91,-72,-29,-62,5,-310
-23,30,-34,-82,-26,-47,-18,-12,-212
-18,68,-17,-171,-67,-83,-101,66,-323
-23,1,-37,-71,-31,-44,-51,-32,-288
-74,-7,-102,-155,-72,-61,-100,-55,-626
-2,30,-48,-81,-33,-38,-31,-46,-249
-76,-66,-88,-166,-98,-98,-142,-34,-768
1,8,-7,-19,-29,-26,-26,-4,-102
-13,10,-31,-73,-67,-71,-50,-34,-329
6,27,-41,-172,-71,-128,-76,-12,-467
-66,-31,-53,-101,-60,-39,-96,3,-443
-33,3,-48,-84,-46,-49,-53,-10,-320
-8,63,-23,-63,-17,-46,-49,-25,-168
-32,-11,-38,-121,-119,-79,-78,-36,-514
44,161,-140,-603,-562,-532,-537,84,-2085
220,291,-59,-603,-642,-732,-587,12,-2100
-113,22,-299,-986,-815,-569,-639,379,-3020
-17,5,-32,-94,-92,-77,-62,-16,-385
-16,24,-12,-55,-39,-26,-23,9,-138
-10,23,-16,-56,-22,-23,-24,-14,-142
-26,52,-39,-128,-56,-94,-65,-15,-371
-14,42,-38,-98,-64,-55,-54,-15,-296
-58,97,-34,-152,5,-13,-41,13,-183
-193,-74,-235,-418,-350,-201,-310,-82,-1863
-104,-49,-166,-374,-330,-207,-237,-3,-1470
129,285,9,-384,36,-281,-169,107,-268
-85,-20,-97,-221,-146,-91,-119,-22,-801
-121,-42,-86,-161,-86,-74,-140,-40,-750
-100,-15,-92,-155,-112,-65,-125,-3,-667
-101,-44,-107,-163,-96,-62,-115,-32,-720
-113,-31,-113,-156,-111,-33,-133,8,-682
-109,-41,-113,-181,-106,-50,-116,-12,-728
-124,-78,-112,-169,-125,-47,-142,-20,-817
-100,-47,-92,-156,-101,-78,-139,-42,-755
-66,-23,-88,-163,-77,-85,-132,-29,-663
-95,-28,-102,-162,-92,-71,-116,9,-657
-91,-3,-84,-165,-89,-84,-118,-27,-661
-102,-50,-121,-163,-115,-52,-144,-21,-768
-84,78,-83,-136,11,-61,-81,55,-301
23,0,-9,-28,-47,-54,-19,-42,-176
-28,10,-39,-66,-42,-49,-51,-35,-300
-60,25,-46,-187,-98,-122,-124,-29,-641
-130,-12,-118,-238,-153,-152,-172,-65,-1040
-42,-3,-31,-74,-76,-40,-50,2,-314
4,-11,-10,-35,-90,-88,-74,-5,-309
95,107,-4,-160,-51,-169,-55,27,-210
23,108,-25,-118,-44,-96,-81,25,-208
-49,-41,-68,-106,-71,-54,-81,-17,-487
-88,31,-129,-242,-149,-131,-190,-10,-908
39,104,-35,-124,-11,-56,-60,-6,-149
26,32,-20,-84,-67,-108,-74,-17,-312
-51,-6,-71,-154,-96,-85,-86,-37,-586
-17,10,-13,-58,-17,-30,-16,2,-139
-20,-19,-26,-50,-32,-25,-34,-5,-211
-10,20,-33,-75,-47,-64,-77,-38,-324
-14,-14,-11,-8,-38,-17,-15,-1,-118
60,43,-69,-228,-16,-141,-128,-4,-483
92,156,-56,-144,5,-96,-63,18,-88
428,182,57,-475,42,-401,-204,42,-329
-11,28,4,-56,-31,-29,9,-4,-90
90,31,-67,-231,-210,-270,-175,-35,-867
-7,31,-11,-50,-1,-6,-11,-26,-81
38,-8,14,11,16,-21,8,26,84
14,-12,-24,-127,-153,-121,-147,44,-526
-5,22,-40,-63,-67,-55,-40,10,-238
121,44,30,-111,-112,-141,-193,8,-354
-6,3,-28,-174,-150,-144,-131,-42,-672
-2,20,-39,-79,-50,-75,-47,-36,-308
-44,-8,-41,-94,-84,-64,-86,-31,-452
-5,20,-26,-47,-17,-44,-33,-13,-165
-11,-5,-19,-83,-127,-86,-64,-17,-412
37,50,-71,-232,-111,-174,-118,12,-607
-74,-13,-101,-131,-101,-74,-116,-41,-651
-14,-16,-33,-55,-53,-30,-55,-33,-289
-1,0,-22,-27,-2,-18,-11,-9,-90
-27,-18,-51,-85,-69,-54,-56,-22,-382
-26,5,-13,-70,-52,-44,-40,-9,-249
-5,5,0,-7,-26,-11,-29,7,-66
-12,-12,-29,-48,-40,-34,-53,-13,-241
-48,1,-87,-158,-116,-94,-141,-68,-711
5,31,-12,-56,3,-26,-17,-9,-81
-1,22,-16,-50,-16,-29,-12,4,-98
-7,27,-26,-36,-1,-24,-8,16,-59
-14,26,-17,-43,-28,-23,-8,-3,-110
-13,5,-25,-42,-39,-19,-12,-4,-149
-14,-8,-18,-43,-36,-19,-28,3,-163
-30,14,-45,-136,-106,-62,-22,67,-320
-25,-2,-34,-105,-62,-59,-49,-3,-339
-8,28,-14,-92,-60,-64,-80,42,-248
5,-6,-17,-97,-122,-68,-73,7,-371
59,128,-23,-151,-23,-90,-70,101,-69
-535,33,-689,-1472,-752,-640,-825,-216,-5096
-16,99,-68,-267,-201,-199,-122,77,-697
-26,17,-29,-99,-72,-62,-62,6,-327
12,24,-36,-65,-77,-103,-103,-12,-360
-5,15,-6,-37,-36,-26,-13,7,-101
-71,-30,-56,-147,-136,-71,-130,-38,-679
-25,7,-17,-26,-30,-13,-30,-19,-153
-77,88,-28,-130,-1,-46,-58,-30,-282
12,62,-24,-88,-51,-80,-95,-49,-313
-51,74,-70,-220,-97,-139,-137,54,-586
-8,-8,-20,-78,-83,-56,-37,-17,-307
-123,21,-178,-487,-307,-217,-246,36,-1501
46,256,-96,-405,-11,-123,-198,-38,-569
540,109,62,-230,45,-350,-294,6,-112
5,51,3,-113,-82,-92,-38,-32,-298
-130,-64,-148,-208,-154,-67,-193,27,-937
-84,14,-78,-215,-144,-107,-126,7,-733
-28,-14,-37,-121,-96,-56,-66,-26,-444
-5,27,-43,-123,-96,-78,-94,-51,-463
-32,151,-40,-401,-167,-233,-199,9,-912
91,73,22,-65,50,-52,-35,79,163
-15,13,-35,-102,-62,-69,-103,-26,-399
-85,-47,-95,-148,-108,-64,-120,0,-667
-94,-37,-88,-142,-113,-78,-114,-11,-677
-113,-38,-93,-148,-114,-74,-147,-16,-743
201,154,76,-276,24,-182,-170,182,9
28,39,-7,-65,-70,-62,-62,28,-171
-25,-1,-21,-40,-71,-30,-22,13,-197
33,40,-72,-168,-177,-207,-190,-75,-816
-49,-5,-41,-84,-73,-35,-42,6,-323
-82,5,-182,-333,-293,-246,-270,-161,-1562
-2,11,-7,-76,-46,-52,-24,-7,-203
4,22,-30,-82,-34,-13,-8,-45,-186
-334,323,-344,-643,-762,-213,-519,249,-2243
82,81,12,-46,-27,-87,-46,-11,-42
-30,24,-35,-63,-34,-25,-42,10,-195
-71,-23,-91,-166,-101,-109,-104,-55,-720
24,12,-1,3,-40,-25,-18,-16,-61
162,81,54,-15,22,-72,-40,59,251
-61,34,-71,-237,-80,-131,-93,-7,-646
-11,34,-61,-180,-146,-156,-124,-76,-720
-25,31,-16,-80,-44,-47,-44,-14,-239
75,42,16,-68,-54,-104,-54,-35,-182
-122,128,-151,-250,-77,1,-128,19,-580
-23,38,-23,-115,-46,-116,-52,15,-322
-50,-16,-61,-175,-185,-111,-119,68,-649
710,776,1,179,378,-346,-341,901,2258
-44,14,-75,-144,-100,-56,-64,-31,-500
8,39,-9,-35,-14,-42,-22,-31,-106
11,16,-5,-26,-47,-32,-34,-2,-119
-11,22,-29,-60,-44,-54,-60,-23,-259
-49,-15,-52,-63,-36,-32,-65,-18,-330
9,20,-8,-37,-36,-29,1,-17,-97
3,4,-20,-85,-42,-48,-18,-23,-229
3,25,-10,-35,-21,-24,-13,-3,-78
-9,20,-7,-7,-10,-8,-5,-6,-32
-27,31,3,-56,-9,14,-3,20,-27
-15,-3,-24,-54,-21,-13,-10,-11,-151
-99,-60,-76,-144,-93,-50,-107,-16,-645
-74,-13,-96,-140,-77,-80,-127,-50,-657
3,8,-4,-18,-22,-28,-31,-21,-113
-17,17,-19,-35,-4,-15,-19,-18,-110
-3,17,-6,-60,-51,-48,-44,-5,-200
-20,1,-24,-59,-18,-21,-65,-8,-214
-17,0,-10,-42,-29,-35,-29,-19,-181
-22,-32,-63,-123,-115,-109,-97,-40,-601
-21,-6,-19,-47,-27,-24,-21,-15,-180
26,81,-11,-61,-54,-105,-53,23,-154
-29,129,-37,-176,-90,-52,-103,49,-309
-18,172,-78,-278,-100,-142,-169,-70,-683
148,52,38,-31,88,-61,-91,89,232
58,-7,-2,-5,-82,-76,-52,2,-164
-26,16,-6,-56,-24,-9,-19,4,-120
-16,125,-44,-155,18,-91,-75,-20,-258
12,82,3,-190,-106,-121,-79,62,-337
-63,-17,-84,-221,-164,-104,-190,-16,-859
-31,46,-36,-79,-36,-13,-9,-3,-161
-8,8,-22,-67,-44,-72,-52,-39,-296
22,66,-28,-77,-67,-54,-50,-3,-191
-7,-8,-7,-33,-35,-20,-16,2,-124
-25,8,-53,-76,-34,-34,-52,-29,-295
-43,13,-48,-97,-58,-65,-68,-45,-411
-41,2,-34,-95,-53,-59,-62,-22,-364
-18,12,-17,-44,-16,-38,-22,-11,-154
-36,26,-27,-81,-24,-31,-42,-3,-218
9,18,-15,-19,-25,-27,-26,-7,-92
-10,16,-13,-34,-6,0,-8,-8,-63
-23,-10,-34,-56,-24,-42,-33,-9,-231
0,11,-18,-9,-37,-29,-30,-6,-118
-5,14,-7,-52,3,-38,-27,27,-85
-30,-14,-22,-53,-39,-36,-33,-20,-247
-4,10,-13,-27,-3,-6,-10,1,-52
-33,90,-48,-163,-47,-109,-101,52,-359
-59,20,-15,-165,-82,-132,-60,-6,-499
-37,42,-90,-270,-111,-123,-162,-11,-762
-23,10,-37,-93,-60,-76,-54,-12,-345
-53,39,-40,-129,-66,-14,-50,-4,-317
-47,-15,-43,-82,-32,-32,-53,-16,-320
7,27,-6,-75,-33,-33,-37,-44,-194
-38,103,-64,-152,-37,-81,-53,49,-273
-21,71,-209,-545,-398,-485,-575,-23,-2185
-34,2,-27,-113,-82,-74,-69,-19,-416
-34,-8,-20,-83,-76,-74,-38,-12,-345
94,70,-17,-234,-69,-214,-168,-34,-572
-79,-50,-89,-145,-107,-67,-91,-17,-645
-32,20,-32,-84,-79,-10,-47,44,-220
-30,-4,-31,-43,-27,-32,-35,-5,-207
1,82,-1,-61,10,-64,2,31,0
-8,14,-31,-100,-60,-90,-90,37,-328
81,151,10,-145,-65,-256,-144,52,-316
-11,-1,-10,-23,-11,-17,-15,-9,-97
11,17,10,-23,-4,-21,-11,4,-17
-8,3,-13,-16,-16,-8,-19,-11,-88
5,9,3,-38,2,-20,-14,14,-39
-6,10,-9,-11,-4,-11,-4,-2,-37
-80,-51,-70,-127,-67,-37,-122,0,-554
-80,-37,-62,-125,-81,-53,-120,3,-555
-121,22,-128,-312,-172,-175,-240,-62,-1188
-70,-19,-60,-120,-97,-53,-106,-2,-527
4,60,-10,-17,-38,-32,-17,0,-50
-4,4,3,-20,-15,0,-24,16,-40
-47,-52,-34,-116,-148,-59,-82,11,-527
0,124,-75,-177,29,-12,32,2,-77
-159,-83,-146,-312,-215,-154,-246,-12,-1327
-9,17,-36,-107,-43,-50,-55,14,-269
11,2,-24,-102,-47,-83,-57,-36,-336
155,40,-32,-257,-127,-313,-202,-61,-797
179,249,92,-361,-170,-403,-102,207,-309
223,90,86,-72,-45,-195,-143,64,8
51,75,-7,-165,-70,-111,-143,-54,-424
-8,-8,-64,-252,-178,-221,-198,-43,-972
-170,203,-188,-556,-188,-188,-295,-81,-1463
100,142,34,-191,-91,-192,-179,-8,-385
12,32,-48,-268,-168,-274,-184,-25,-923
288,154,94,-192,121,-254,-165,142,188
36,142,-56,-196,-45,-169,-118,-54,-460
-99,218,-220,-586,-292,-334,-278,121,-1470
4,45,-1,-127,-75,-94,-75,15,-308
-25,33,-100,-315,-268,-324,-278,-154,-1431
166,127,6,-254,-188,-243,-200,5,-581
80,355,-159,-598,-123,-366,-379,-280,-1470
-483,-191,-525,-1324,-919,-767,-961,-351,-5521
209,133,27,-323,-191,-439,-186,51,-719
-10,78,-42,-211,-142,-43,-93,135,-328
-129,-10,-182,-438,-306,-268,-298,-35,-1666
94,118,32,-148,55,-141,-96,82,-4
-84,89,-119,-283,-234,-202,-160,-41,-1034
52,12,-17,-206,-225,-221,-182,-50,-837
-38,58,-56,-216,-95,-127,-141,12,-603
-14,-16,-116,-250,-259,-272,-233,-181,-1341
-89,41,-54,-115,-62,-30,-58,-66,-433
45,73,32,-51,-104,-52,-45,2,-100
-61,98,-152,-356,-185,-268,-255,-142,-1321
-62,78,-99,-397,-381,-272,-303,-1,-1437
232,250,90,-210,83,-184,-27,188,422
207,240,65,-295,113,-186,-128,175,191
127,137,43,-107,66,-106,-31,125,254
8,62,4,-97,-42,-42,-51,57,-101
-58,215,-130,-521,-479,-274,-349,237,-1359
81,181,-1,-190,-58,-187,-145,62,-257
69,162,-27,-228,-150,-211,-178,18,-545
480,412,73,-402,-177,-616,-339,-32,-601
22,126,-34,-187,-88,-188,-174,53,-470
48,73,-3,-136,-24,-155,-111,76,-232
-16,27,-43,-67,-36,-19,-21,23,-152
-8,23,-47,-93,-63,-43,-53,9,-275
1,44,-46,-81,-87,-56,-73,-29,-327
-17,2,-77,-92,-135,-131,-128,-75,-653
-12,-6,-4,-23,-42,-35,-31,2,-151
5,8,-31,-46,-40,-25,-23,1,-151
86,24,3,-97,-23,-76,-74,8,-149
-37,13,-59,-196,-214,-190,-150,48,-785
54,127,-1,-163,22,-79,-104,-8,-152
2,120,-25,-117,14,-90,-11,63,-44
-45,-35,-95,-199,-109,-118,-164,-17,-782
-105,113,-144,-304,-203,-176,-224,7,-1036
210,301,-17,-501,-115,-304,-172,145,-453
-96,63,-298,-585,-587,-612,-636,-322,-3073
-90,203,-196,-475,-176,-217,-247,93,-1105
-396,-64,-458,-1266,-748,-637,-877,-224,-4670
-230,80,-353,-808,-396,-528,-576,-132,-2943
12,69,-56,-241,-158,-148,-118,4,-636
-236,72,-188,-586,-285,-216,-320,-112,-1871
34,16,-58,-218,-176,-230,-175,-102,-909
45,69,-20,-177,-138,-141,-103,100,-365
8,18,-43,-107,-41,-92,-93,-25,-375
232,272,34,-102,-64,-22,-14,-209,127
5,168,6,-222,-56,-174,-57,68,-262
7,155,-80,-312,-57,-212,-162,44,-617
67,227,-37,-318,-182,-261,-217,140,-581
-28,27,-77,-118,-32,-114,-66,-77,-485
4,81,-97,-212,-118,-213,-179,-64,-798
-27,7,-58,-126,-67,-94,-147,-7,-519
8,154,-60,-250,-52,-156,-73,55,-374
-24,-3,-16,-73,-157,-87,-117,19,-458
-27,186,-95,-304,-57,-110,-64,99,-372
-91,-36,-99,-190,-222,-109,-142,-28,-917
-35,103,-104,-344,-194,-257,-159,-88,-1078
-41,47,-79,-202,-152,-108,-126,-34,-695
88,55,-20,-311,-149,-294,-184,33,-782
-30,-13,-40,-80,-142,-59,-122,14,-472
-82,8,-91,-287,-176,-74,-187,-62,-951
-140,80,-68,-212,-60,-59,-88,-29,-576
-38,-4,-60,-109,-116,-152,-135,-64,-678
-75,-21,-69,-485,-218,-246,-158,44,-1228
-93,-28,-127,-242,-187,-149,-134,-63,-1023
56,29,2,-87,-46,-63,-34,41,-102
99,134,107,44,-19,9,3,49,426
-18,5,-50,-126,-72,-89,-94,-23,-467
-108,61,-168,-464,-324,-302,-276,-9,-1590
-61,12,-160,-401,-319,-296,-323,-42,-1590
-107,8,-164,-245,-315,-122,-234,-62,-1241
0,-25,-48,-32,-89,-60,-72,-53,-379
-43,28,-79,-195,-114,-130,-108,-56,-697
80,287,1,-316,-94,-207,-146,-152,-547
-26,33,-35,-171,-128,-120,-86,22,-511
-64,232,18,-231,-192,-76,-185,145,-353
20,185,-17,-269,-7,-132,-108,82,-246
50,127,-45,-260,-132,-243,-192,21,-674
-43,0,-49,-110,-142,-68,-130,18,-524
51,98,-153,-498,-241,-395,-305,-138,-1581
93,155,-60,-321,-221,-309,-175,127,-711
334,791,-14,-983,-286,-970,-480,241,-1367
38,157,-26,-221,-96,-234,-189,61,-510
12,48,-170,-231,-265,-266,-225,-191,-1288
267,99,54,-261,25,-308,-231,11,-344
6,6,-7,-62,-153,-39,-60,-29,-338
136,203,-18,-334,-238,-279,-260,-16,-806
-63,-11,-68,-131,-113,-118,-97,-37,-638
-21,94,-72,-232,-110,-153,-194,-74,-762
-17,16,-27,-121,-35,-92,-23,9,-290
1,17,-16,-53,-106,-35,-52,17,-227
-20,8,-35,-116,-169,-77,-108,51,-466
-15,20,-37,-106,-180,-72,-105,41,-454
-3,37,-66,-200,-147,-149,-113,-66,-707
1,16,-14,-42,-43,-21,-22,-14,-139
-2,4,-1,-1,2,-1,-9,-8,-16
28,17,-3,-28,-18,-50,-23,-5,-82
-33,-21,-16,-126,-69,-77,-64,-12,-418
-55,0,-23,-98,-74,-58,-58,-1,-367
2,4,-23,-20,-29,-35,-33,-28,-162
-24,-6,-37,-77,-64,-36,-28,-9,-281
6,2,-9,-3,-20,-10,-16,-12,-62
-6,22,-10,-18,1,-19,-19,3,-46
195,103,-2,-119,-3,-190,-78,-3,-97
-21,58,-69,-193,-117,-111,-90,-27,-570
12,24,-5,-36,-55,-54,-28,17,-125
-121,-74,-96,-233,-182,-118,-155,-49,-1028
3,17,-15,-76,-37,-35,-21,-5,-169
-67,13,-95,-165,-108,-97,-84,-74,-677
81,99,89,26,31,-17,15,26,350
14,26,-123,-204,-179,-212,-220,-170,-1068
-38,22,-76,-156,-109,-79,-88,-10,-534
36,67,20,-69,15,-126,-73,-6,-136
29,46,13,-82,-74,-129,-37,-30,-264
167,136,16,-134,92,-115,-132,29,59
8,85,-28,-179,-121,-137,-90,65,-397
-103,16,-129,-271,-223,-172,-208,-45,-1135
9,9,-14,-22,-8,-26,-30,-27,-109
4,26,16,-43,56,42,9,47,157
38,-10,-1,-61,-18,-71,-65,36,-152
-12,17,-9,-46,-39,-38,-27,3,-151
-119,3,-149,-273,-128,-133,-181,-91,-1071
-41,-47,-71,-136,-135,-77,-133,1,-639
7,-10,-34,-68,-21,-64,-68,-60,-318
-9,14,-20,-60,-82,-42,-39,-19,-257
-21,-14,-61,-104,-109,-122,-124,-21,-576
7,46,-48,-96,-52,-55,-72,57,-213
-88,-23,-109,-225,-213,-169,-206,-27,-1060
-3,7,-7,1,-15,-14,-18,10,-39
-49,65,-77,-234,-167,-165,-111,22,-716
42,56,-25,-75,-37,-65,-25,45,-84
42,76,-65,-199,-82,-190,-262,61,-619
113,158,87,-3,-48,-13,-4,84,374
5,41,-19,-114,-85,-87,-88,21,-326
4,17,-18,-40,-16,-19,-25,-1,-98
-117,-93,-147,-250,-211,-147,-183,-52,-1200
-8,8,-28,-49,-33,-42,-39,-15,-206
30,29,-26,-97,-54,-74,-94,-35,-321
-13,-4,-3,-25,-19,-18,-14,0,-96
37,33,-29,-21,-114,-112,-53,-44,-303
-94,-34,-88,-199,-216,-163,-212,-63,-1069
19,141,-29,-179,13,-146,-69,132,-118
1,13,-15,-27,-18,-31,-33,-10,-120
-14,-8,-19,-32,-47,-17,-19,18,-138
-63,52,-74,-190,-152,-122,-145,-50,-744
-12,14,-22,-54,-32,-34,-40,-27,-207
132,192,24,-106,64,-48,-54,150,354
79,83,-8,-40,-60,-68,-45,25,-34
-27,-9,-29,-128,-172,-115,-108,-3,-591
8,1,-32,-99,-85,-53,-82,31,-311
-25,-21,-44,-68,-57,-61,-64,-30,-370
-13,19,-47,-133,-32,-79,-50,-18,-353
-54,-75,-73,-99,-159,-87,-138,-44,-729
-81,-25,-71,-137,-88,-61,-98,30,-531
-40,-1,-45,-104,-92,-78,-74,15,-419
-116,-49,-179,-352,-245,-200,-208,-78,-1427
-15,52,-21,-103,-60,-62,-56,15,-250
63,90,-54,-204,-229,-272,-258,-54,-918
55,69,-23,-121,-90,-120,-113,-56,-399
24,55,-28,-63,-44,-48,-80,-24,-208
22,45,-18,-71,-78,-114,-78,-23,-315
-10,-20,-21,-72,-66,-54,-38,-23,-304
23,-3,4,-5,-22,-26,-6,-11,-46
-15,12,-1,-83,-13,-20,-31,-7,-158
-21,-11,-19,-53,-44,-7,-33,-3,-191
-16,-4,-33,-49,-48,-34,-48,-21,-253
-32,-18,-36,-76,-56,-50,-55,16,-307
-4,3,-31,-88,-105,-83,-51,-38,-397
8,-19,-19,-63,-86,-57,-52,-16,-304
12,7,-7,-5,-69,-49,-35,13,-133
33,46,8,-56,-67,-93,-48,-21,-198
-43,-25,-41,-70,-45,-26,-58,-20,-328
22,11,-35,-150,-76,-87,-65,-28,-408
11,13,11,-9,-6,-10,-18,28,20
-8,22,-2,-85,-33,-6,-13,20,-105
-93,10,-82,-270,-186,-176,-173,-20,-990
-9,43,-66,-126,-36,-75,-75,-20,-364
-25,178,-92,-313,-101,-167,-146,132,-534
-31,9,-53,-134,-150,-67,-59,-9,-494
-10,33,-5,-65,-31,-32,-24,-26,-160
-60,62,-60,-231,-113,-115,-84,14,-587
-46,87,-110,-188,-167,-115,-178,-88,-805
-12,47,-3,-22,-11,-32,-31,-2,-66
9,11,-7,-25,-4,-16,-9,-16,-57
45,-31,-34,-63,-97,-95,-109,-12,-396
-60,99,-85,-204,-21,-39,-43,28,-325
-30,-8,-11,-72,-37,-46,-44,-20,-268
-6,29,-53,-145,-67,-97,-70,10,-399
49,17,-46,-47,-186,-153,-163,-33,-562
-25,50,-14,-61,-70,-52,-49,-15,-236
-30,-13,-28,-94,-79,-79,-57,-28,-408
81,21,27,54,-7,-32,-42,37,139
53,92,-33,-127,-28,-73,-58,67,-107
-22,205,-44,-258,-1,-68,-116,153,-151
9,14,-28,-65,-64,-63,-40,-40,-277
-5,9,-15,-56,-1,-20,-7,5,-90
17,42,-34,-85,-71,-96,-68,-13,-308
138,26,24,-5,-41,-94,-50,-31,-33
0,5,-39,-70,-84,-72,-84,-43,-387
-9,10,-28,-61,-45,3,-68,64,-134
-10,30,-13,-70,-46,-53,-50,-15,-227
-45,-24,-40,-98,-47,-32,-63,43,-306
-113,-27,-153,-318,-205,-141,-176,-6,-1139
-77,-15,-73,-150,-110,-87,-115,14,-613
-51,-41,-77,-98,-74,-82,-117,-59,-599
19,12,3,-32,-39,-49,-25,21,-90
3,18,-32,-103,-60,-94,-94,-1,-363
17,114,-42,-257,-125,-142,-153,21,-567
-30,61,-29,-124,-25,-52,-47,-7,-253
-65,67,-14,-113,-67,-62,-26,11,-269
66,20,25,-17,-56,-68,-39,-14,-83
14,40,-17,-55,14,-24,17,37,26
-39,37,-96,-214,-228,-170,-179,-64,-953
64,202,-34,-235,-132,-130,-163,-162,-590
5,110,-22,-153,-21,-78,-63,7,-215
70,74,19,-113,24,-79,-55,-5,-65
-9,-3,-15,-16,-20,-10,-18,-3,-94
-6,7,-14,-53,-19,-42,-29,-14,-170
-17,-1,-47,-118,-38,-44,-62,-19,-346
-32,-20,-35,-103,-45,-42,-40,-25,-342
-21,-18,-29,-46,-81,-70,-48,-11,-324
47,109,11,-243,-170,-202,-86,86,-448
-6,16,3,-60,-30,-7,4,16,-64
-71,3,-40,-175,-121,-84,-104,-22,-614
-36,47,-111,-198,-107,-122,-142,-32,-701
-7,32,-23,-117,-65,-65,-60,-13,-318
33,91,4,-30,7,6,23,26,160
-43,-89,-110,-235,-196,-206,-223,-58,-1160
-28,136,-56,-248,22,-138,-97,-24,-433
48,125,-31,-170,-31,-152,-75,73,-213
18,10,-8,-71,-74,-54,-50,7,-222
-17,35,-30,-84,-26,-43,-58,-20,-243
34,19,14,-1,17,-2,16,21,118
191,180,105,49,86,55,-2,63,727
4,-6,-55,-102,-139,-94,-81,-43,-516
-38,34,-33,-193,-82,-95,-90,37,-460
-37,16,-54,-96,-60,-58,-77,9,-357
-1,-10,-21,-45,-62,-52,-46,-1,-238
-8,63,-66,-157,-120,-169,-152,-71,-680
-82,-26,-113,-267,-265,-158,-165,46,-1030
-31,12,-41,-33,-25,-18,-38,-18,-192
28,51,-60,-144,-118,-147,-134,-47,-571
169,140,79,-296,-28,-295,-148,152,-227
21,104,-47,-141,-24,-83,-24,20,-174
-17,48,-78,-158,-157,-151,-124,-56,-693
149,221,-12,-369,-198,-414,-252,-98,-973
-107,133,-101,-333,-93,-83,-167,-89,-840
-2,20,-47,-73,-34,-29,-42,2,-205
17,-7,2,-17,-23,-25,-17,-7,-77
-444,-173,-595,-1250,-1014,-689,-1039,-445,-5649
-11,-19,-26,-36,-59,-57,-55,-20,-283
26,53,-31,-185,-80,-171,-98,-57,-543
-1,41,-19,-67,-25,-53,-35,-17,-176
-2,22,-14,-55,5,-26,-16,2,-84
-9,4,-6,-43,-32,-35,-15,-7,-143
-28,-14,-179,-300,-546,-311,-354,-237,-1969
-43,29,-48,-107,-70,-61,-91,-28,-419
-24,17,-33,-137,-57,-71,-67,-21,-393
-45,22,-45,-166,-123,-85,-126,-81,-649
0,3,-5,-9,-6,-6,-9,-3,-35
-15,-32,-22,-44,-40,-32,-50,-3,-238
-19,23,-19,-60,-7,-26,-28,2,-134
-32,32,-27,-116,-79,-63,-62,-24,-371
-75,-24,-79,-136,-116,-86,-135,-21,-672
-91,-26,-87,-158,-101,-61,-118,-12,-654
-82,-36,-86,-134,-94,-78,-128,-42,-680
-70,20,-105,-190,-161,-103,-149,-17,-775
-41,15,-66,-163,-153,-153,-125,0,-686
-37,44,-91,-265,-95,-171,-194,20,-789
-25,15,-31,-51,-55,-18,-35,-28,-228
-23,10,-54,-165,-113,-129,-105,-44,-623
0,6,-25,-128,-50,-106,-106,52,-357
-64,34,-97,-227,-120,-159,-184,-81,-898
-2,21,-20,-93,-19,-24,-61,-8,-206
34,75,2,-34,-75,-35,-67,-3,-103
-102,56,-153,-440,-215,-285,-285,-164,-1588
33,52,15,26,11,-7,-12,27,145
-51,-46,-73,-128,-145,-71,-137,6,-645
319,476,79,-71,-353,-302,-369,404,183
-6,42,-48,-80,-32,-61,-58,5,-238
-27,10,-28,-92,-100,-68,-97,-26,-428
-7,13,-34,-78,-57,-53,-55,2,-269
-18,31,-48,-111,-78,-74,-85,-44,-427
129,119,27,-60,55,-86,-127,7,64
14,25,-28,-133,-138,-114,-73,-34,-481
-61,28,-77,-187,-96,-55,-74,10,-512
-3,-8,-34,-37,-58,-51,-60,-29,-280
-14,14,-108,-168,-164,-159,-184,-94,-877
6,78,-68,-217,-78,-135,-160,-64,-638
72,59,-6,-111,-86,-155,-211,23,-415
455,444,164,-117,237,-216,-87,302,1182
-1,155,-77,-114,-9,-63,-50,8,-151
3,17,-26,-88,-41,-52,-62,14,-235
-8,41,7,-71,-29,-46,-16,-14,-136
-53,-3,-33,-118,-51,-26,-25,-10,-319
-20,-63,-54,-92,-81,-82,-81,-7,-480
-20,20,-60,-107,-93,-63,-47,-23,-393
-11,8,-45,-68,-83,-60,-58,-12,-329
0,5,-5,-30,-17,-30,2,-6,-81
-44,55,-63,-137,-28,-24,-72,-97,-410
42,32,-15,-93,-62,-71,-83,62,-188
-26,10,-27,-74,-167,-73,-144,-2,-503
-36,82,-48,-183,-92,-103,-94,-18,-492
-9,13,-12,-59,-68,-51,-38,19,-205
32,80,-40,-175,-132,-205,-149,-16,-605
-7,-4,-13,-18,-16,-21,-14,-7,-100
-31,-9,-2,-37,-24,8,-16,4,-107
-10,-6,-15,-41,-35,-19,-27,-4,-157
-12,14,-26,-45,-21,-22,-22,-12,-146
-12,20,-55,-192,-111,-119,-116,-24,-609
29,132,-10,-130,-37,-72,14,75,1
219,333,31,-120,183,-140,-40,231,697
7,33,-45,-149,-86,-87,-86,-81,-494
-58,225,-114,-388,-124,-175,-147,55,-726
3,-20,-28,-119,-94,-133,-119,-14,-524
16,61,-39,-145,-164,-98,-172,162,-379
-7,54,2,-32,-79,-42,-49,34,-119
-67,14,-281,-388,-317,-359,-400,-127,-1925
-48,-16,-38,-60,-43,-39,-53,-21,-318
-29,46,-38,-72,-29,8,-26,-1,-141
-103,-1,-100,-260,-185,-100,-142,-65,-956
-10,30,-22,-68,-25,-57,-57,-20,-229
-8,16,-2,-132,-118,-86,-36,28,-338
144,69,41,-39,28,-41,-115,57,144
-28,8,-44,-91,-72,-62,-73,-30,-392
-89,-58,-81,-139,-92,-70,-97,-46,-672
-3,20,-14,-31,-1,-21,-12,5,-57
3,37,-2,-30,-23,-40,-52,-5,-112
-19,20,-43,-83,-75,-61,-69,-33,-363
-33,43,-71,-152,-48,-75,-82,53,-365
-12,1,-5,-58,-1,-29,-37,-1,-142
59,163,-60,-203,10,-111,-32,61,-113
41,69,2,-73,-56,-25,7,42,7
67,10,-24,-50,-85,-100,-44,-71,-297
-36,39,-59,-131,-113,-81,-129,8,-502
-50,26,-46,-111,-92,-42,-63,-3,-381
-59,-23,-109,-150,-136,-71,-153,-33,-734
-5,51,-51,-195,-138,-148,-99,22,-563
-93,-23,-99,-221,-181,-122,-146,-40,-925
41,130,-25,-125,-56,-54,-104,41,-152
-58,19,-67,-221,-127,-142,-67,2,-661
30,12,-13,-76,-150,-118,-112,-10,-437
-59,-26,-67,-94,-73,-67,-91,-17,-494
16,24,-15,-106,-7,-64,-33,29,-156
10,32,-38,-86,-74,-70,-49,-25,-300
-55,10,-66,-156,-124,-54,-75,-6,-526
4,57,0,-42,-35,-45,-15,-2,-78
45,-15,-16,-59,-126,-116,-92,-86,-465
2,49,-45,-250,-120,-145,-120,-26,-655
-18,2,-74,-155,-142,-154,-151,-19,-711
-40,30,-63,-151,-22,-86,-88,-52,-472
7,39,-84,-265,-192,-79,-181,107,-648
-75,11,-135,-301,-174,-186,-147,-65,-1072
-33,0,-49,-103,-90,-66,-108,-55,-504
-19,-6,-27,-47,-51,-43,-39,-11,-243
11,-6,1,-15,12,1,18,13,35
-19,36,-37,-83,-123,-78,-59,-47,-410
-45,6,-31,-87,-42,-27,-52,-30,-308
-11,9,-12,-29,7,-6,5,1,-36
-34,-8,-39,-102,-50,-49,-53,-27,-362
-24,30,-37,-131,-66,-85,-94,6,-401
1,35,-13,-36,-64,-35,-32,33,-111
60,17,-48,-72,-108,-124,-76,-93,-444
-36,-26,-17,-32,-30,-10,-27,-5,-183
-3,-8,-5,-6,-8,0,-1,-4,-35
38,44,-37,-44,-19,-57,-61,-19,-155
1,40,-52,-175,-70,-125,-124,-37,-542
99,244,-84,-400,-80,-316,-323,170,-690
-29,-20,-10,-41,-41,-8,-21,37,-133
24,30,2,-21,-30,-27,-16,-13,-51
-35,-8,-35,-46,-56,-24,-53,33,-224
-128,15,-154,-328,-297,-222,-294,-32,-1440
39,12,-24,-102,-122,-81,-74,-17,-369
-78,92,-96,-196,-90,-125,-208,3,-698
-38,36,-52,-154,-73,-62,-66,8,-401
-11,-6,-19,-53,-90,-53,-55,2,-285
-26,54,-54,-103,-22,-68,-35,13,-241
82,30,34,-17,-8,-86,-50,51,36
-1,-5,-9,-19,-5,5,-12,16,-30
-17,35,-44,-161,-120,-129,-88,-11,-535
-44,-26,-63,-119,-115,-72,-96,-7,-542
-2,6,-35,-53,-59,-39,-50,-20,-252
14,14,-4,-17,-34,-30,-29,1,-85
4,48,-39,-172,-138,-86,-131,8,-506
3,22,-1,-12,1,-2,-11,17,17
-188,-27,-188,-365,-204,-170,-299,-123,-1564
0,11,-16,-44,-5,-21,-5,-15,-95
0,25,-47,-108,-107,-106,-117,-30,-490
-349,-83,-332,-664,-392,-216,-426,-2,-2464
152,169,36,-78,37,-141,-137,19,57
-31,18,-36,-113,-84,-82,-98,-17,-443
-92,-22,-99,-232,-193,-107,-181,-7,-933
11,7,-35,-49,-73,-58,-52,28,-221
-14,8,-19,-86,-72,-69,-47,-15,-314
-28,5,-25,-87,-99,-45,-53,40,-292
-64,1,-116,-230,-247,-196,-232,-88,-1172
-20,-9,-15,-32,-15,-9,-13,3,-110
-3,9,-6,-13,-12,-15,0,-8,-48
-55,-16,-26,-82,-50,-38,-44,-19,-330
-42,-30,-36,-121,-73,-69,-41,-19,-431
-165,24,-187,-402,-227,-270,-299,-84,-1610
-23,10,-37,-88,-75,-51,-51,39,-276
-45,4,-44,-84,-77,-69,-77,-38,-430
37,21,-75,-184,-202,-217,-181,-103,-904
-71,18,-83,-99,-72,-73,-64,15,-429
-54,62,-48,-114,-27,-34,-53,-15,-283
-19,11,-34,-122,-92,-103,-87,-88,-534
32,40,-29,-134,-149,-159,-90,-33,-522
95,441,-106,-440,-49,-199,-173,144,-287
106,260,-18,-497,-88,-278,-208,72,-651
-112,186,-108,-431,-149,-171,-148,-69,-1002
38,-8,8,-33,23,-21,-17,16,6
12,20,-12,-38,-10,-43,-26,-16,-113
-54,24,-101,-180,-143,-126,-188,-37,-805
57,60,23,-36,26,-41,-35,44,98
7,11,6,-14,-19,-20,-1,-17,-47
-86,56,-122,-292,-148,-125,-136,-67,-920
-116,51,-76,-183,-67,19,-45,-89,-506
-1,-15,-23,-45,-70,-54,-45,-12,-265
-66,-4,-71,-110,-48,-77,-85,-22,-483
-6,6,-13,-61,-47,-38,-30,-19,-208
-37,-6,-41,-134,-83,-62,-58,4,-417
-32,45,-26,-54,-50,-13,-64,32,-162
1,35,-1,-46,-15,-30,-31,4,-83
27,56,-28,-90,-109,-122,-71,-22,-359
-34,14,-33,-82,-56,-40,-47,-7,-285
35,63,-20,-69,-33,-56,-41,-59,-180
-73,30,-127,-276,-177,-148,-227,7,-991
-11,22,-34,-94,-85,-59,-63,24,-300
34,49,10,-127,-102,-128,-19,26,-257
107,154,-23,-157,-83,-127,-96,64,-161
-7,14,-28,-52,-34,-26,-42,-8,-183
-23,31,-57,-84,-57,-32,-43,7,-258
53,57,15,-54,-19,-93,-50,-18,-109
-89,94,-157,-491,-332,-300,-330,-20,-1625
-57,19,-81,-181,-138,-140,-136,-3,-717
-46,12,-50,-95,-37,-26,-35,-18,-295
57,47,17,-60,-76,-52,-3,-10,-80
58,52,-59,-174,-146,-187,-134,-72,-662
-8,-12,-35,-89,-64,-66,-79,-31,-384
-54,-9,-33,-124,-79,-64,-65,-10,-438
-124,-80,-117,-171,-103,-59,-130,-6,-790
337,-102,48,-181,-48,-268,-175,32,-357
11,16,14,-20,-8,-12,-21,8,-12
17,20,-29,-53,-116,-68,-77,-32,-338
3,4,-35,-69,-43,-26,-58,5,-219
-9,-23,-43,-50,-100,-57,-67,-14,-363
-14,146,-61,-158,-13,-57,-26,65,-118
-12,-28,-45,-100,-153,-70,-73,7,-474
20,24,-12,-19,-31,-35,-25,-24,-102
5,27,-25,-55,-15,-45,-43,-13,-164
7,57,-69,-149,-177,-178,-139,-76,-724
-52,104,-154,-380,-152,-242,-250,-61,-1187
68,24,-31,-127,-211,-138,-125,58,-482
-4,-39,-53,-63,-121,-105,-103,-45,-533
-45,84,-88,-234,-171,-111,-144,-13,-722
-1,54,-27,-108,-77,-55,-41,-5,-260
-43,-50,-80,-94,-99,-48,-99,0,-513
-77,49,-68,-205,-79,-73,-169,-114,-736
-4,-3,3,-16,-4,9,-6,24,3
15,62,10,-70,-55,-61,-46,24,-121
-28,148,-93,-350,-130,-193,-133,37,-742
-38,-13,-41,-77,-35,-22,-45,-17,-288
34,21,-20,-72,-89,-85,-50,-57,-318
-12,-8,-13,-100,-61,-93,-58,-26,-371
2,32,-40,-78,-30,-67,-53,-36,-270
55,31,-11,-49,-60,-88,-21,-35,-178
-78,64,-39,-158,-65,-62,-63,0,-401
50,39,15,-104,11,-77,-56,62,-60
-7,-1,-32,-88,-112,-90,-81,-25,-436
-34,76,-28,-96,10,-35,-22,10,-119
32,-3,-30,-78,-173,-141,-120,-44,-557
-24,-15,-34,-48,-78,-49,-56,-6,-310
97,167,-6,-174,-52,-98,-114,82,-98
-4,-1,-16,-27,-16,-6,-20,-8,-98
8,-13,-81,-148,-205,-111,-105,-51,-706
-31,36,-48,-125,-78,-76,-85,-14,-421
-10,2,-38,-82,-62,-54,-83,25,-302
50,125,-20,-151,-32,-139,-109,-70,-346
-49,36,-57,-180,-119,-141,-103,-15,-628
65,31,45,-19,39,-16,-42,49,152
-74,100,-41,-142,8,-21,-51,79,-142
173,55,37,38,-59,-79,-68,-7,90
24,33,8,-62,-77,-25,-13,24,-88
-61,7,-75,-199,-146,-113,-132,24,-695
9,53,16,-50,-48,-43,-8,4,-67
-39,35,-38,-161,-152,-73,-91,-34,-553
-45,14,-47,-119,-69,-68,-66,-10,-410
1,21,-36,-51,-58,-33,-56,28,-184
-55,13,-39,-101,-55,-55,-79,13,-358
-49,131,-5,-119,46,-3,-64,5,-58
-61,118,-50,-157,-43,-69,-44,62,-244
8,16,-25,-60,-2,-53,-41,-9,-166
9,14,-16,-107,-100,-112,-77,-7,-396
-52,-40,-106,-179,-173,-149,-174,-93,-966
-1,8,-77,-116,-114,-120,-147,-61,-628
-42,4,-146,-195,-173,-185,-190,-123,-1050
-77,56,-135,-266,-147,-154,-165,-13,-901
-77,35,-114,-300,-210,-234,-200,-96,-1196
27,26,16,-50,2,-14,-14,36,29
14,16,-61,-173,-27,-97,-103,-16,-447
17,55,-42,-210,-33,-125,-115,-5,-458
17,18,-8,-73,-102,-90,-71,-18,-327
1,19,-2,-39,-39,-46,-37,7,-136
-11,50,-11,-101,-69,-67,-62,9,-262
0,-12,-1,-8,-12,-12,-10,-12,-67
-103,100,-33,-165,-20,-83,-55,-31,-390
-70,60,-46,-118,-18,-56,-57,-17,-322
-58,59,-42,-102,-27,-40,-48,-22,-280
-53,103,-40,-108,38,-28,-48,-3,-139
-77,15,-76,-231,-155,-113,-154,56,-735
28,32,-12,-25,-35,-27,-18,-9,-66
44,87,-4,-71,-85,-88,-101,-17,-235
3,30,-41,-95,-48,-77,-62,-20,-310
-19,12,-50,-151,-133,-103,-112,-35,-591
32,3,-2,-49,6,-49,-28,6,-81
-7,2,-52,-142,-73,-121,-85,-22,-500
-22,-18,-11,-56,-63,-39,-51,-32,-292
-11,8,-17,-30,-18,5,-16,-9,-88
35,43,16,-42,-40,-47,-20,-1,-56
-36,9,-52,-142,-45,-59,-72,-22,-419
-47,66,-22,-181,-105,-155,-67,23,-488
-24,7,-46,-91,-119,-75,-70,14,-404
-68,167,-158,-442,-147,-221,-158,10,-1017
-39,-18,-115,-156,-213,-135,-125,-84,-885
29,36,7,-26,15,-32,3,30,62
4,56,-1,-169,-36,-139,-51,-11,-347
3,37,-29,-82,-34,-60,-41,-21,-227
-6,84,-60,-223,-190,-80,-123,72,-526
-64,-27,-40,-117,-109,-83,-84,3,-521
-88,-10,-49,-109,-121,-42,-82,47,-454
-60,94,-90,-185,-123,-129,-143,-48,-684
-54,19,-105,-210,-72,-139,-136,-40,-737
10,290,-132,-411,-137,-276,-268,141,-783
-17,13,-13,-45,-41,-15,-9,15,-112
31,24,-51,-95,-97,-97,-82,-14,-381
-86,-1,-75,-188,-168,-119,-105,3,-739
-14,20,-18,-44,-15,-27,-10,-7,-115
41,64,-17,-112,-61,-70,-62,40,-177
-66,61,-95,-183,-103,-106,-101,-74,-667
21,24,-34,-118,-123,-126,-103,-9,-468
-10,12,-13,-44,-19,-31,-20,-2,-127
-18,124,-42,-348,-134,-181,-117,84,-632
-63,89,-64,-153,-56,-54,-97,7,-391
-115,29,-51,-208,-75,-28,-131,44,-535
-58,-4,-70,-170,-170,-94,-134,-10,-710
-31,-1,-11,-80,-50,-39,-34,33,-213
-25,31,-59,-146,-89,-112,-104,25,-479
-105,12,-121,-243,-143,-100,-161,-30,-891
-61,-13,-44,-130,-100,-65,-99,-24,-536
-89,-17,-66,-194,-131,-125,-120,-5,-747
31,58,-21,-51,22,-25,-21,13,6
1,-11,-12,-23,-38,-37,-21,13,-128
-2,99,-34,-191,-38,-91,-95,16,-336
45,76,-2,-86,37,-66,-72,49,-19
-14,40,-7,-87,-24,-49,-54,2,-193
1,46,-7,-94,-32,-69,-66,23,-198
212,330,56,-242,-7,-274,-91,188,172
-34,21,-27,-72,-20,-12,-22,-10,-176
-74,54,-96,-153,-107,-56,-135,5,-562
-92,150,-159,-472,-203,-248,-268,-3,-1295
-5,-10,-13,-31,-26,-4,-16,26,-79
-6,14,-9,-45,-41,-25,-19,6,-125
56,23,-1,-17,-88,-58,-12,29,-68
-97,-76,-90,-146,-133,-68,-140,-17,-767
-95,434,-160,-467,-76,-237,-62,98,-565
-48,-1,-21,-88,-75,-29,-49,32,-279
-2,4,-18,-40,-38,-29,-29,-1,-153
-36,-9,-55,-199,-101,-134,-150,-53,-737
46,33,15,-10,-24,-10,-17,9,42
1538,2765,547,-1137,756,-1248,-1629,2002,3594
-17,85,-18,-160,-79,-135,-127,58,-393
210,11,-66,-802,-386,-805,-613,-74,-2525
-69,13,-83,-226,-145,-154,-119,-28,-811
4,62,-19,-56,-33,-39,-47,16,-112
156,151,31,-238,-40,-219,-257,59,-357
-41,97,-43,-163,-133,-97,-120,71,-429
-6,10,-53,-133,-119,-139,-139,-33,-612
-67,55,-58,-132,-75,-48,-106,7,-424
-4,8,-38,-47,-26,-37,-54,-29,-227
-1,40,-3,-48,-12,-10,-46,1,-79
-6,33,8,-67,10,-20,-53,-7,-102
-37,-11,-41,-68,-38,-43,-68,-21,-327
-19,53,-47,-65,-35,-26,-81,-7,-227
25,25,7,-58,-111,-94,-83,-62,-351
-24,59,-20,-99,-44,-77,-52,23,-234
-34,81,-61,-144,-49,-88,-58,-24,-377
-20,17,-43,-108,-69,-93,-52,-6,-374
-77,6,-75,-167,-96,-101,-97,4,-603
-56,18,-63,-146,-72,-107,-84,-29,-539
-63,36,-84,-132,-107,-85,-130,-57,-622
-15,41,-17,-97,-21,-90,-41,20,-220
-59,-30,-42,-156,-162,-65,-163,-54,-731
-83,-24,-118,-262,-248,-231,-206,-67,-1239
2,33,-1,-62,-126,-59,-74,-18,-305
-1,6,-29,-106,-40,-62,-72,10,-294
48,144,-10,-253,-49,-181,-159,28,-432
58,300,14,-375,-78,-229,-8,60,-258
-52,4,-83,-215,-129,-168,-160,-56,-859
-57,-65,-25,-210,-178,-109,-110,26,-728
-76,15,-121,-239,-160,-102,-128,-84,-895
-27,6,-26,-59,-49,-60,-53,-3,-271
-100,110,-112,-459,-354,-132,-350,-248,-1645
-107,157,-144,-445,-241,-119,-288,-154,-1341
-50,-11,-93,-263,-294,-171,-174,87,-969
74,107,6,-36,22,10,-11,36,208
-10,-13,-17,-37,-41,-31,-30,-27,-206
-11,116,-42,-188,-79,-63,-18,116,-169
9,11,-20,-47,-43,-51,-77,-21,-239
-61,-16,-107,-221,-170,-198,-229,-94,-1096
70,57,36,37,-26,-2,5,25,202
23,32,-35,-132,-35,-99,-119,-30,-395
-134,159,-123,-586,-465,-256,-404,186,-1623
12,26,2,-51,-47,17,-48,50,-39
-23,-73,-106,-183,-201,-147,-214,37,-910
-39,33,-61,-238,-82,-120,-124,7,-624
49,33,-25,-124,-250,-177,-168,-53,-715
-44,8,-58,-147,-97,-70,-89,-44,-541
-47,59,6,-166,-90,-56,-75,-88,-457
139,-5,57,13,33,-56,-56,76,201
-61,-81,-29,-196,-192,-60,-93,37,-675
-12,-3,-3,-27,-51,-29,-36,15,-146
7,22,-18,-32,-65,-29,-27,-22,-164
-22,-10,-20,-57,-61,-31,-38,-7,-246
-30,-18,-2,-32,-42,-21,-30,12,-163
6,272,-80,-396,-145,-244,-213,43,-757
6,11,-15,-38,-30,-43,-31,-21,-161
2,33,-26,-149,-113,-113,-56,-33,-455
-11,11,-30,-101,-88,-65,-67,-31,-382
-10,19,-19,-45,-18,-19,-38,-20,-150
-22,-10,-27,-64,-42,-27,-48,-28,-268
91,79,-1,-56,-94,-133,-51,-45,-210
77,-18,-36,-184,-123,-197,-192,35,-638
-45,-8,-30,-98,-121,-77,-93,4,-468
30,178,-97,-407,-176,-291,-235,-116,-1114
-70,55,-53,-136,-16,-38,-49,10,-297
-59,70,-42,-98,3,-27,-41,44,-150
-103,-15,-171,-339,-171,-207,-244,-38,-1288
-57,-3,-60,-147,-97,-85,-91,23,-517
59,237,18,-135,28,-89,-59,147,206
-28,4,-46,-122,-105,-82,-103,-40,-522
0,178,-81,-265,-200,-155,-186,54,-655
-22,-4,-55,-150,-177,-97,-88,54,-539
20,23,-38,-142,-168,-102,-105,66,-446
-10,88,-26,-107,-15,-22,-70,47,-115
-18,4,5,-35,-37,-8,-32,22,-99
-26,-17,-31,-48,-29,-18,-14,-12,-195
-68,-11,-97,-164,-139,-46,-129,-23,-677
-19,39,-44,-158,-86,-66,-90,29,-395
95,42,37,-158,-46,-120,-178,64,-264
-29,-25,-69,-223,-220,-158,-151,8,-867
28,236,-51,-292,-85,-155,-153,68,-404
-28,106,-97,-326,-89,-215,-108,14,-743
-30,108,-39,-255,2,-122,-93,14,-415
-69,90,-103,-279,-104,-148,-138,-4,-755
73,107,-83,-285,-151,-257,-264,-52,-912
202,344,37,-115,27,-134,-128,116,349
28,139,-52,-328,-195,-272,-197,-41,-918
-34,94,-47,-343,-32,-183,-107,14,-638
60,167,-1,-259,-89,-142,-182,-172,-618
-41,9,-68,-266,-185,-207,-188,-30,-976
-90,58,-129,-169,-75,-133,-144,-72,-754
-50,98,-150,-440,-260,-298,-256,-52,-1408
-33,54,-45,-121,-48,-47,-52,35,-257
-46,97,-47,-197,-43,-56,-67,29,-330
-32,151,-160,-455,-291,-322,-302,-46,-1457
32,147,-41,-301,-20,-173,-166,-14,-536
62,91,-19,-213,-132,-212,-163,-29,-615
126,167,-18,-304,27,-153,-83,103,-135
-92,144,-74,-405,-269,-276,-156,-1,-1129
-277,64,-300,-608,-475,-345,-406,-26,-2373
-21,33,-15,-96,-84,-56,-74,-22,-335
175,375,-29,-374,-86,-343,-232,173,-341
423,213,127,-179,-240,-491,-375,-43,-565
-96,91,-84,-218,-65,-43,-132,-111,-658
-11,105,-66,-287,-20,-150,-81,82,-428
262,64,88,-33,139,-66,-115,167,506
81,140,-138,-288,-323,-363,-227,-159,-1277
72,210,-7,-165,-48,-90,-66,111,17
-63,16,-124,-246,-229,-224,-246,-26,-1142
105,178,8,-215,25,-204,-113,105,-111
-197,-85,-257,-478,-251,-283,-312,-135,-1998
-61,22,-66,-166,-141,-125,-100,-30,-667
-33,1,-21,-81,-138,-66,-86,22,-402
167,329,21,-286,37,-168,-52,242,290
14,178,-80,-325,-111,-301,-155,93,-687
70,41,-151,-436,-396,-420,-378,-125,-1795
580,186,107,-200,148,-453,-323,-20,25
177,351,4,-283,44,-225,-161,84,-9
20,144,-80,-342,-190,-280,-214,3,-939
-76,76,-25,-145,-49,-67,-38,10,-314
80,162,-22,-280,-138,-100,-186,150,-334
-46,33,-81,-175,-60,-100,-91,-33,-553
103,107,11,-61,-148,-155,0,-42,-185
11,16,-24,-76,-71,-47,-43,21,-213
-40,-1,-56,-150,-148,-102,-129,-48,-674
-70,23,-97,-269,-106,-143,-131,-37,-830
-131,-26,-183,-293,-198,-181,-282,-15,-1309
7,36,-21,-55,-30,-5,1,-28,-95
14,40,-27,-114,-94,-111,-80,-17,-389
21,32,-8,-10,3,-11,11,20,58
-34,20,-38,-127,-90,-86,-98,-19,-472
-66,19,-85,-171,-111,-103,-132,10,-639
-18,68,-120,-232,-186,-219,-224,-163,-1094
96,141,32,-117,-47,-183,-124,92,-110
0,369,-200,-645,-436,-529,-425,54,-1812
69,215,-15,-242,-53,-120,-106,110,-142
-40,60,-51,-244,-205,-210,-236,-36,-962
-173,6,-204,-524,-350,-323,-391,-133,-2092
-69,24,-94,-155,-110,-81,-128,-27,-640
77,103,14,-211,46,-119,-30,114,-6
-37,8,-36,-96,-124,-40,-59,18,-366
47,59,-36,-155,-21,-123,-65,-45,-339
13,22,-56,-120,-77,-124,-83,-62,-487
-51,45,-57,-225,-42,-9,-8,-12,-359
-70,-10,-77,-156,-141,-103,-136,-36,-729
27,8,12,-47,-74,-63,-18,-9,-164
20,16,-2,-24,-66,-43,-46,-14,-159
-2,40,-40,-63,-56,-16,-27,25,-139
-56,-4,-44,-146,-138,-76,-96,2,-558
-37,12,-21,-113,-60,-53,-59,1,-330
22,84,-22,-123,-119,-172,-140,-107,-577
122,134,75,25,9,-38,-33,91,385
-14,21,-34,-88,-40,-67,-82,5,-299
1,28,-14,-41,-40,-51,-37,-28,-182
-18,15,-24,-54,-12,-10,-25,25,-103
7,12,-9,-33,-15,-36,-27,5,-96
3,18,2,-17,8,-17,-13,-6,-22
-61,12,-35,-110,-38,-30,-28,11,-279
9,11,-26,-41,-50,-51,-42,-36,-226
105,-9,13,-57,-84,-137,-110,-7,-286
-39,3,-22,-103,-55,-38,-38,-9,-301
-72,-58,-116,-186,-171,-128,-169,-10,-910
-22,39,-39,-168,-56,-29,-97,11,-361
-16,56,-17,-127,-81,-122,-40,-17,-364
-30,-2,-14,-48,-39,-20,-21,21,-153
-5,-3,-18,-43,-20,-1,-22,-12,-124
-84,-19,-111,-180,-105,-68,-90,-17,-674
-12,10,-20,-51,-33,-38,-30,13,-161
-24,42,-50,-103,-56,-52,-51,73,-221
326,381,69,-82,18,-170,-411,-36,95
-120,11,-119,-283,-218,-146,-140,-89,-1104
8,48,-41,-130,-30,-93,-71,-80,-389
64,213,-44,-284,-128,-211,-218,28,-580
-22,76,-59,-145,-81,-136,-118,6,-479
564,454,365,135,218,-101,-217,256,1674
97,91,-22,-160,-231,-237,-104,-28,-594
400,204,155,-595,-22,-465,-322,181,-464
-2,37,2,-78,-3,-36,-23,12,-91
-27,35,-58,-168,-120,-73,-128,11,-528
-16,4,-52,-125,-86,-43,-40,-40,-398
20,31,-9,-117,-30,-75,-78,36,-222
-20,-3,-65,-96,-77,-78,-70,-2,-411
-26,0,-35,-55,-24,-25,-33,2,-196
8,2,-10,-67,-45,-18,-25,15,-140
-37,14,-43,-124,-121,-96,-69,-10,-486
-147,23,-97,-288,-162,-127,-138,15,-921
202,131,74,-143,-1,-100,-76,163,250
-54,1,-54,-114,-72,-55,-65,-17,-430
118,113,40,-39,49,-58,-87,40,176
-3,29,-12,-115,-72,-86,-59,-11,-329
-35,-10,-26,-84,-49,-59,-48,-14,-325
-8,-3,-23,-66,-103,-75,-61,-40,-379
21,7,-4,-33,-50,-33,-16,-15,-123
1,1,-9,-33,-44,-15,-26,-8,-133
-65,-5,-83,-166,-129,-105,-166,-14,-733
4,33,3,-31,-35,-22,2,6,-40
-10,1,-20,-53,-32,-19,-3,2,-134
233,262,36,-132,-35,-169,-107,101,189
-210,-12,-218,-652,-362,-235,-328,379,-1638
-14,23,-32,-90,-50,-51,-45,-8,-267
-25,12,-20,-79,-27,-58,-53,22,-228
15,22,-15,-76,-63,-55,-56,29,-199
-12,23,-23,-97,-68,-65,-68,-44,-354
-20,-5,-46,-107,-44,-20,-28,56,-214
-17,74,-94,-218,-140,-133,-132,25,-635
-7,44,-85,-205,-164,-137,-128,10,-672
32,70,-56,-230,-201,-196,-127,5,-703
78,76,-67,-181,-146,-196,-136,38,-534
-6,54,-84,-240,-190,-161,-127,27,-727
4,47,-88,-207,-191,-171,-115,24,-697
0,74,-77,-216,-186,-154,-103,24,-638
-23,56,-93,-219,-187,-168,-124,39,-719
-104,-42,-137,-188,-165,-93,-182,-11,-922
49,62,4,-160,7,-112,-74,-3,-227
-28,24,-21,-108,-43,-50,-20,-8,-254
25,59,32,-93,6,-3,31,86,143
-49,5,-75,-178,-115,-113,-137,50,-612
20,93,-18,-133,-146,-93,-150,-18,-445
-43,36,-81,-237,-97,-126,-136,0,-684
-42,-6,-40,-133,-53,-84,-69,-6,-433
9,104,-59,-163,-53,-102,-74,48,-290
-35,-9,-23,-120,-50,-100,-93,-35,-465
-2,63,-43,-76,-53,-62,-82,18,-237
20,48,9,-61,-27,-74,-31,5,-111
-4,-2,-21,-43,-63,-56,-35,-43,-267
38,33,-8,-40,-59,-52,-69,-23,-180
68,74,4,-36,-162,-135,-84,-28,-299
-28,-1,-47,-64,-21,-18,-43,-2,-224
32,41,-31,-130,-67,-94,-66,55,-260
-38,-15,-44,-107,-71,-59,-87,-5,-426
1,4,-40,-85,-78,-56,-73,-46,-373
5,22,-7,2,-45,-12,-47,42,-40
0,37,-26,-73,-63,-68,-63,-28,-284
-20,14,-32,-85,-53,-51,-45,-28,-300
-16,5,-14,-15,-18,6,-29,-12,-93
-3,36,-92,-168,-99,-148,-109,-53,-636
-35,-7,-39,-66,-50,-33,-54,2,-282
-3,40,-13,-35,-19,-15,-31,2,-74
-33,-3,-42,-113,-76,-53,-64,-55,-439
16,77,-36,-102,-60,-39,-22,55,-111
11,39,-35,-151,-87,-89,-92,3,-401
-14,7,-33,-67,-56,-53,-68,-7,-291
-30,-17,-46,-114,-82,-65,-68,-27,-449
23,18,-2,-26,-34,5,-15,21,-10
-71,3,-87,-199,-142,-79,-162,-22,-759
-45,-2,-24,-115,-60,-58,-47,-19,-370
-39,78,-178,-370,-234,-265,-203,-112,-1323
-30,7,-74,-88,-65,-57,-104,-23,-434
-11,-9,-16,-29,-48,-18,-21,17,-135
-48,5,-54,-155,-82,-92,-150,-59,-635
-11,11,-64,-113,-78,-115,-111,-58,-539
-70,-24,-88,-133,-151,-110,-125,-19,-720
97,42,-10,-7,-155,-120,-86,-60,-299
-31,4,9,-46,-23,-3,11,23,-56
-83,60,-100,-269,-225,-136,-155,-57,-965
8,12,-40,-115,-121,-100,-89,-37,-482
-44,192,-106,-334,-81,-177,-101,-40,-691
-30,55,-18,-105,-9,-54,-32,-9,-202
30,28,-7,-49,-78,-56,-19,2,-149
8,16,2,-8,-20,-3,2,-7,-10
6,7,-57,-129,-119,-99,-143,-37,-571
47,5,-42,-188,-144,-186,-162,-24,-694
-27,13,-64,-134,-133,-118,-112,-57,-632
67,112,-66,-148,-67,-104,-100,-34,-340
0,15,-97,-192,-203,-194,-220,-32,-923
-113,-10,-152,-303,-300,-229,-301,-94,-1502
1021,653,325,-355,72,-654,-465,350,947
-115,-10,-100,-184,-109,-80,-127,40,-685
24,55,-12,-66,-77,-106,-109,-14,-305
2,33,-14,-116,-3,-103,-92,-36,-329
-73,-11,-118,-156,-147,-115,-143,12,-751
13,21,-16,-66,-67,-97,-67,-7,-286
-89,112,-194,-358,-147,-187,-296,-89,-1248
20,4,-7,-27,-12,14,-25,38,5
-365,725,-696,-2194,-1243,-1271,-1459,-811,-7314
81,187,9,-280,-110,-207,-170,-94,-584
112,74,52,-316,3,-95,1,193,24
71,111,-56,-197,-41,-155,-133,14,-386
94,91,-11,-170,-108,-146,-160,68,-342
55,123,-19,-212,-104,-160,-72,57,-332
122,93,-53,-247,-188,-279,-190,-65,-807
72,341,-22,-192,19,-112,13,166,285
18,203,-42,-264,-38,-136,-60,10,-309
3,88,-47,-192,-137,-211,-121,59,-558
-31,4,-35,-110,-106,-100,-110,-56,-544
-19,112,-74,-272,-180,-247,-156,-51,-887
-105,-12,-137,-234,-197,-137,-215,-44,-1081
610,499,311,142,464,-20,-86,370,2290
-57,67,-84,-233,-166,-100,-141,48,-666
-29,87,-118,-283,-122,-230,-204,-33,-932
-38,-2,-102,-216,-301,-131,-223,-40,-1053
152,58,40,-101,-104,-238,-168,1,-360
341,203,69,-423,97,-338,-248,252,-47
-79,300,-145,-425,-97,-149,-151,-123,-869
-60,44,-96,-217,-106,-121,-157,-42,-755
50,151,-20,-236,-163,-160,-217,124,-471
350,220,174,5,187,-147,-45,188,932
-52,29,-49,-123,-96,-66,-108,-13,-478
-16,65,-111,-270,-307,-241,-174,31,-1023
-118,140,-345,-719,-415,-520,-555,-102,-2634
-29,54,-81,-259,-92,-147,-158,-19,-731
31,95,-4,-141,-30,-141,-87,4,-273
50,303,-95,-420,-57,-250,-210,-90,-769
0,38,-10,-109,-102,-90,-55,-20,-348
12,156,-43,-305,-95,-179,-172,-3,-629
68,107,10,-66,34,-88,-93,113,85
-103,81,-174,-325,-189,-145,-141,76,-920
-9,11,-47,-186,-90,-152,-67,-5,-545
-66,63,-147,-335,-283,-215,-272,19,-1236
111,80,17,-302,-69,-198,-207,121,-447
-2,86,-61,-193,-10,-116,-45,50,-291
201,117,31,-304,-67,-210,-120,159,-193
-177,30,-221,-536,-314,-309,-297,17,-1807
-113,-32,-107,-207,-168,-106,-178,-7,-918
82,-7,10,-76,-18,-105,-81,46,-149
6,-6,-26,-47,-13,-13,-34,-1,-134
-97,123,-184,-394,-164,-243,-227,-73,-1259
-75,238,-56,-255,-125,-56,-118,105,-342
2,13,-28,-186,-40,-110,-99,23,-425
-67,2,-43,-142,-73,-70,-43,7,-429
-26,73,-107,-365,-149,-260,-269,-49,-1152
-36,7,-42,-129,-51,-53,-43,-19,-366
-1,13,-24,-70,-91,-44,-52,-30,-299
-59,97,-127,-241,-6,-97,-107,-84,-624
-30,-4,-69,-253,-155,-137,-130,-14,-792
-38,186,13,-367,-98,-246,-88,136,-502
434,837,352,-955,126,-1101,-60,852,485
-28,30,-43,-142,-84,-87,-60,-3,-417
-48,34,-87,-274,-161,-47,-117,141,-559
-69,-17,-92,-180,-96,-102,-101,-35,-692
-20,2,-35,-87,-56,-36,-58,18,-272
-36,3,-49,-124,-64,-41,-71,37,-345
0,17,-17,-67,-83,-9,-33,-6,-198
12,126,-75,-187,-96,-100,-74,63,-331
-30,136,-54,-219,-32,-67,-13,21,-258
19,24,-35,-187,-168,-150,-132,-78,-707
143,181,-18,-195,-148,-330,-207,34,-540
63,75,-28,-77,-62,-116,-97,-28,-270
-16,-5,-40,-118,-71,-76,-52,-48,-426
82,88,40,-118,18,-90,-43,136,113
-33,36,-99,-199,-160,-92,-153,70,-630
-286,-79,-289,-606,-442,-197,-430,53,-2276
-106,67,-78,-350,-187,-88,-174,-107,-1023
-60,38,-35,-171,-64,-85,-126,9,-494
109,54,16,-87,-62,-132,-92,100,-94
-135,-90,-92,-267,-197,-94,-156,-18,-1049
-25,-5,-17,-61,-39,-14,-31,26,-166
72,170,8,-267,-73,-201,-186,7,-470
-40,0,-50,-135,-126,-99,-86,-42,-578
-3,28,16,-23,-12,-12,-30,18,-18
-20,165,21,-202,-233,-142,-59,86,-384
44,33,-36,-140,-166,-132,-123,-1,-521
57,39,-36,-134,-71,-181,-103,-6,-435
13,95,-8,-130,-17,-46,-50,63,-80
28,109,-9,-132,-55,-86,-49,78,-116
50,23,-13,-69,-55,-36,-86,50,-136
-100,-57,-99,-255,-214,-127,-154,-49,-1055
-9,6,1,-21,-21,-20,-7,-15,-86
-77,-7,-152,-253,-181,-134,-193,-32,-1029
135,100,68,-2,115,33,-37,42,454
-62,-6,-65,-168,-85,-120,-84,-6,-596
-96,-7,-96,-197,-88,-121,-110,-44,-759
73,157,11,-21,-36,-8,-165,20,31
-21,-13,-12,-37,-55,-26,-34,-5,-203
-42,70,-69,-209,-148,-152,-72,59,-563
-73,26,-84,-186,-221,-130,-162,-79,-909
-23,-20,-27,-51,-66,-47,-38,-59,-331
-34,-18,-35,-72,-26,-15,-27,-20,-247
-38,7,-111,-195,-133,-134,-166,-72,-842
-36,-39,-57,-153,-164,-100,-111,17,-643
-47,86,-39,-185,-27,-120,-69,-52,-453
-39,3,-17,-125,-162,-83,-91,-14,-528
-52,-17,-69,-112,-47,-43,-66,19,-387
-2,50,-4,-115,-99,-68,-60,18,-280
-85,-3,-114,-208,-193,-119,-140,-56,-918
-53,-1,-58,-124,-72,-53,-64,-35,-460
8,-6,-27,-30,-36,-11,-9,-1,-112
-42,19,-48,-135,-110,-70,-76,14,-448
26,15,11,9,-28,-16,0,-4,13
-77,149,-149,-565,-202,-287,-289,48,-1372
-69,31,-156,-326,-150,-220,-197,-161,-1248
65,30,-13,-41,-68,-97,-49,-75,-248
-5,3,-8,-10,-33,-13,-22,8,-80
24,21,17,-73,-14,-63,-54,5,-137
-39,6,-33,-129,-77,-58,-33,-19,-382
2,34,-21,-51,2,-17,-7,-3,-61
-31,14,-11,-85,-82,-61,-40,-34,-330
-20,-7,-14,-54,-17,-30,-38,-30,-210
40,147,-20,-148,24,-88,-80,-39,-164
-11,39,-62,-173,-62,-109,-86,-30,-494
-21,136,2,-209,-99,-203,-16,79,-331
21,113,-30,-167,-85,-125,-107,8,-372
-2,-15,-2,-47,-44,-39,-22,-6,-177
-33,10,-73,-128,-86,-97,-115,-70,-592
-9,2,-58,-105,-112,-107,-116,-68,-573
-14,16,-8,-30,-9,-20,-22,0,-87
-20,14,-54,-92,-33,-77,-77,-37,-376
110,41,44,65,-8,-112,-80,17,77
-62,-71,-85,-139,-109,-83,-114,23,-640
-17,45,-60,-153,-127,-66,-147,-7,-532
6,60,-32,-121,-59,-102,-101,-11,-360
-23,20,-38,-118,-113,-54,-77,-38,-441
2,47,-8,-51,-20,-14,-8,-20,-72
-95,-9,-123,-226,-170,-127,-183,-69,-1002
-98,-35,-74,-127,-105,-50,-107,11,-585
-28,-12,-14,-68,-55,-44,-41,4,-258
-48,-44,-59,-108,-69,-40,-71,-34,-473
-8,38,-45,-74,-38,-38,-50,-12,-227
-26,-1,-43,-115,-97,-103,-73,-25,-483
21,54,-21,-12,-29,-9,-21,-10,-27
-18,-17,-24,-140,-73,-81,-65,-16,-434
-18,43,-26,-79,-55,-42,-70,26,-221
-25,5,-19,-43,-41,-13,-15,-5,-156
-20,-13,-22,-73,-73,-41,-65,-14,-321
15,68,-59,-196,-161,-222,-140,-103,-798
-21,-6,-11,-24,-7,-26,-32,13,-114
17,28,-29,-111,-66,-79,-65,-18,-323
7,84,-14,-121,-65,-81,-88,26,-252
-41,-49,-55,-64,-82,-32,-43,-7,-373
-60,19,-100,-235,-164,-170,-225,-18,-953
-5,18,-1,-30,-9,-15,-14,-14,-70
-4,-19,-23,-33,-31,-7,-19,33,-103
-34,-1,-38,-98,-83,-41,-66,-21,-382
-5,5,-38,-63,-43,-42,-46,-33,-265
-85,-1,-72,-183,-179,-131,-110,-25,-786
-96,87,-31,-141,-46,-71,-102,-9,-409
-182,-41,-193,-355,-255,-258,-331,-89,-1704
-28,-32,-56,-115,-62,-82,-92,-25,-492
-16,19,-22,-53,-52,-40,-37,-8,-209
-52,6,-61,-115,-92,-52,-66,-28,-460
-27,11,-31,-88,-62,-53,-77,-13,-340
-38,34,-14,-109,-19,-47,9,12,-172
34,58,-70,-187,-109,-185,-165,-93,-717
17,26,0,-7,-12,-15,2,13,24
-57,-29,-42,-156,-22,-64,-63,5,-428
-36,-3,-28,-92,-19,-38,-60,7,-269
5,18,-17,-65,-62,-35,-45,4,-197
-35,0,-125,-154,-161,-115,-167,-17,-774
-157,-8,-161,-337,-86,-127,-154,-35,-1065
-25,-14,-22,-82,-38,-37,-55,1,-272
86,21,5,-93,18,-81,-51,-48,-143
-51,8,-94,-121,-70,-62,-124,-24,-538
-90,-3,-99,-250,-143,-156,-162,-67,-970
103,126,12,-153,-11,-123,-78,73,-51
-76,102,-60,-194,-46,-96,-96,-1,-467
-67,59,-17,-152,-4,-56,-38,44,-231
-59,62,-72,-385,-358,-318,-290,-18,-1438
7,-13,-59,-220,-237,-227,-205,-17,-971
15,44,-26,-149,-43,-77,-90,58,-268
-83,-7,-120,-219,-129,-72,-158,-47,-835
68,395,-110,-562,-117,-342,-299,77,-890
5,17,-33,-71,-86,-52,-62,27,-255
-95,9,-131,-271,-223,-183,-192,-68,-1154
136,92,-4,-240,-47,-213,-194,95,-375
-38,7,-48,-121,-66,-60,-65,6,-385
-169,-38,-187,-407,-302,-182,-302,-38,-1625
35,68,-33,-142,-133,-152,-97,-93,-547
-44,-28,-54,-125,-94,-102,-63,-26,-536
-119,31,-38,-152,-73,-71,-67,-42,-531
-90,2,-125,-251,-144,-131,-131,-2,-872
108,96,-68,-308,-282,-319,-226,-7,-1006
146,148,11,-170,-13,-212,-106,103,-93
-40,17,-28,-128,-81,-50,-58,-23,-391
-44,86,-112,-282,-166,-184,-148,27,-823
114,47,57,-192,-14,-197,-71,123,-133
-10,46,-40,-250,-82,-58,-137,161,-370
-59,87,-50,-143,-11,-15,-5,1,-195
146,200,-41,-432,-159,-366,-252,82,-822
-43,87,-204,-445,-275,-310,-282,-78,-1550
-57,23,-58,-105,-50,-50,-131,-9,-437
88,275,-81,-361,-163,-287,-255,-231,-1015
-77,132,-134,-573,-211,-364,-310,96,-1441
-23,76,-6,-131,-145,-98,-67,27,-367
15,71,-34,-202,-125,-174,-93,-3,-545
82,75,18,-56,-26,-78,-47,27,-5
25,153,-26,-275,-134,-154,-124,26,-509
126,130,11,-168,-96,-229,-139,-94,-459
-49,3,-77,-185,-128,-63,-93,16,-576
-45,62,-56,-129,-106,-111,-62,42,-405
133,101,4,-242,-44,-286,-237,32,-539
-118,170,-198,-525,-298,-201,-363,-274,-1807
159,166,32,-143,81,-93,-97,161,266
-14,3,-42,-179,-130,-146,-137,15,-630
-88,82,-54,-336,-148,-175,-143,4,-858
-56,86,-78,-307,-172,-144,-173,89,-755
-96,-34,-98,-255,-216,-166,-137,-32,-1034
-92,72,-184,-407,-222,-241,-257,-11,-1342
11,141,-39,-240,-106,-169,-158,69,-491
-70,91,-71,-217,-56,-98,-49,6,-464
-66,48,-116,-221,-63,-149,-140,-40,-747
-64,85,-85,-301,-191,-201,-174,-49,-980
-34,23,-27,-85,-59,-43,-65,-11,-301
-42,4,-22,-108,-150,-121,-128,13,-554
39,56,-39,-167,-76,-182,-144,7,-506
-1,64,-29,-66,-53,-110,-77,-2,-274
-95,-17,-108,-214,-154,-85,-154,-33,-860
-15,23,-84,-183,-189,-151,-164,-103,-866
-90,85,-52,-152,-19,-92,-119,33,-406
-40,18,-51,-122,-69,-66,-57,-19,-406
-128,-27,-168,-363,-314,-168,-256,-50,-1474
-107,11,-57,-134,-78,-43,-54,-71,-533
-8,-5,-39,-72,-50,-57,-58,-46,-335
12,3,-12,-14,-31,-29,-29,-21,-121
-5,19,-5,-46,-31,-20,-34,-3,-125
7,1,0,-20,-37,-34,-8,-13,-104
-18,84,-56,-206,-37,-90,-66,90,-299
-40,36,-45,-161,-120,-55,-53,-25,-463
-24,-2,-8,-48,-38,-23,-29,-12,-184
-26,-24,-18,-69,-62,-29,-53,-32,-313
-34,-12,-37,-84,-74,-54,-80,-27,-402
8,26,5,-6,12,9,13,-12,55
-7,11,-23,-101,-89,-89,-42,0,-340
17,112,22,-162,-24,-135,-99,41,-228
-47,-7,-50,-127,-82,-16,-61,48,-342
-37,15,-47,-131,-103,-74,-76,-17,-470
-51,-16,-46,-111,-98,-69,-59,5,-445
-104,-29,-69,-166,-120,-105,-144,4,-733
-95,-34,-79,-146,-96,-57,-99,3,-603
98,8,66,-18,23,31,-7,84,285
33,51,-75,-104,-78,-115,-103,-79,-470
3,36,-15,-161,-59,-94,-87,24,-353
67,106,-41,-195,-157,-243,-100,-13,-576
2,27,1,-38,-42,-34,-40,42,-82
-44,-23,-66,-87,-62,-72,-69,-34,-457
-19,7,5,-45,-5,-13,-14,25,-59
96,37,27,-71,12,-96,-49,7,-37
-49,7,-61,-180,-155,-165,-193,-93,-889
135,245,107,-154,72,-105,74,209,583
118,68,50,-106,4,-98,-30,46,52
32,57,-63,-246,-116,-224,-201,6,-755
-7,52,-38,-148,-120,-93,-79,22,-411
-11,-4,-21,-51,-47,-36,-49,-17,-236
-81,63,-121,-307,-202,-250,-234,-118,-1250
-62,12,-62,-136,-101,-73,-91,-37,-550
16,44,-47,-175,-115,-209,-150,-32,-668
-13,-22,-9,-28,-2,-12,-31,-3,-120
75,225,15,-124,20,-92,-76,136,179
-10,7,-28,-44,-38,-21,-43,-8,-185
-9,1,-10,-18,-26,-22,-13,-7,-104
57,67,-5,-128,-5,-135,-61,-10,-220
-22,0,-31,-68,-70,-68,-60,-21,-340
7,12,-9,-19,-23,-3,-26,14,-47
54,21,8,-35,-60,-87,-33,-5,-137
9,14,-44,-63,-63,-40,-20,-21,-228
-54,40,-64,-232,-158,-124,-135,-15,-742
3,30,-62,-125,-94,-100,-87,-53,-488
5,-2,-16,-68,-169,-124,-115,-11,-500
15,24,-27,-84,-149,-98,-91,-65,-475
-54,19,-32,-124,-66,-61,-82,-12,-412
-30,-22,-59,-91,-72,-59,-68,-37,-438
-13,17,15,-82,-64,-60,-46,-14,-247
-23,-8,-45,-82,-133,-91,-98,-52,-532
-16,-3,-30,-51,-66,-63,-68,13,-284
-38,-4,-50,-98,-58,-35,-58,-13,-354
-49,-13,-25,-69,-54,-26,-26,-3,-265
-22,-21,-27,-49,-31,-33,-31,5,-209
4,41,-23,-89,-62,-95,-97,-35,-356
-16,6,-5,-24,-16,-14,-21,0,-90
82,46,-62,-255,-97,-218,-177,-46,-727
18,65,13,-107,-55,-65,-95,60,-166
-9,6,5,-52,-24,-18,-37,13,-116
-14,-12,-49,-52,-76,-66,-72,-24,-365
-27,-2,-42,-81,-25,-35,-30,-12,-254
-58,-45,-119,-196,-211,-115,-190,16,-918
-24,-5,-10,-52,-48,-51,-39,3,-226
-25,6,-51,-113,-76,-40,-64,19,-344
4,31,-35,-83,-59,-54,-69,-34,-299
-9,1,-30,-61,-45,-29,-42,12,-203
-47,-18,-67,-109,-58,-35,-70,-40,-444
-20,71,3,-135,-89,-99,-14,-19,-302
25,26,-10,-60,-46,-47,-36,12,-136
-35,57,-17,-90,-46,-42,19,16,-138
-59,24,-54,-122,-82,-52,-67,-42,-454
-50,1,-58,-123,-33,-30,-67,4,-356
-13,-11,-28,-94,-75,-63,-62,-2,-348
-8,12,-26,-97,-66,-90,-55,-57,-387
-50,-6,-5,-84,-43,-4,-19,-27,-238
-13,-16,-28,-54,-50,-40,-28,5,-224
-11,3,-21,-67,-63,-46,-32,0,-237
-48,-8,-22,-73,-46,-9,-34,-9,-249
-10,-1,-38,-60,-41,-19,-44,9,-204
-13,5,-14,-49,-48,-38,-38,-1,-196
-25,3,-13,-55,-50,-23,-27,23,-167
-5,3,-26,-52,-43,-27,-46,14,-182
-18,-23,-14,-25,-25,-7,1,1,-110
-7,-11,-33,-39,-62,-48,-42,-43,-285
10,9,-7,-32,-46,-30,-20,-20,-136
-9,10,-18,-43,-44,-29,-36,-19,-188
15,46,0,-21,-37,-15,-10,25,3
9,17,-2,-37,-27,-21,-13,24,-50
-16,-20,-6,-33,-42,-31,-11,-3,-162
-34,-2,-29,-64,-35,-16,-29,-12,-221
-3,2,-9,-44,-14,-25,-24,8,-109
-6,-5,-5,-11,-36,-13,-22,6,-92
-10,-17,-24,-25,-25,-22,-26,-21,-170
-20,0,-24,-42,-41,-26,-19,-29,-201
-6,6,-10,-43,-41,-30,-20,-10,-154
16,33,6,-23,2,-24,-26,-4,-20
-7,11,-7,-45,-41,-34,-36,-30,-189
-15,-1,-11,-44,-31,-19,-15,-7,-143
1,14,-30,-30,-29,-19,-44,-25,-162
12,4,-4,-22,-33,-26,-20,-12,-101
-12,5,-21,-49,-38,-10,-18,-3,-146
9,4,5,-48,-35,-36,-11,0,-112
-32,-10,-30,-58,-49,8,-51,-5,-227
37,60,1,-5,13,0,31,28,165
10,19,-9,-35,-25,-46,-18,-21,-125
-4,23,-21,-34,-45,-37,-39,-18,-175
-18,27,-12,-36,-40,-14,-42,-5,-140
-16,-7,-13,-32,2,-10,-25,2,-99
9,16,-21,-54,-84,-33,-39,-21,-227
12,-14,10,-45,-170,-68,-63,-3,-341
25,50,-34,-188,-2,-87,-89,14,-311
88,28,-21,-159,-79,-190,-158,-50,-541
-23,11,-12,-45,-41,-17,-29,12,-144
-1,36,-9,-44,3,-25,-13,0,-53
-13,92,-66,-256,-101,-216,-135,19,-676
-80,135,-52,-216,-53,-111,-29,4,-402
-84,-10,-76,-147,-87,-69,-139,-25,-637
42,69,-55,-119,-42,-138,-132,-102,-477
20,18,-8,-42,-26,-49,-40,-8,-135
-115,68,-122,-319,-136,-129,-158,-36,-947
-23,-21,-77,-157,-164,-96,-138,26,-650
-13,0,-19,-48,-42,-26,-41,7,-182
182,95,-15,-236,-108,-244,-262,70,-518
-31,59,-102,-118,-92,-27,-112,54,-369
111,66,14,-68,4,-98,-55,-3,-29
26,178,-36,-250,-183,-175,-166,75,-531
6,-8,-4,-60,-63,-90,-88,-13,-320
-180,118,-385,-811,-371,-556,-551,-167,-2903
451,160,51,-479,-156,-414,-357,105,-639
-5,55,-5,-15,-43,-30,-22,7,-58
4,50,-12,-114,-38,-62,-53,-23,-248
-37,66,-98,-203,-135,-158,-127,-22,-714
-13,9,6,-26,-26,-24,-12,-8,-94
-37,27,-42,-99,-39,-32,-52,-20,-294
89,92,71,-49,25,-71,30,20,207
59,76,49,-25,-21,-48,-4,-1,85
136,39,50,26,92,-1,-14,85,413
-84,-48,-69,-158,-129,-84,-70,-34,-676
-18,10,-10,-23,-9,-4,-2,-28,-84
17,79,-59,-180,-101,-130,-115,19,-470
-12,10,-12,-44,-21,-35,-42,24,-132
58,92,-48,-171,-164,-242,-158,-66,-699
-8,51,-5,-95,-20,-49,-60,-41,-227
11,73,-46,-141,-130,-57,-58,26,-322
20,72,0,-102,12,-53,-36,87,0
-79,69,-36,-146,-159,-58,-78,7,-480
70,26,9,-122,-55,-146,-138,3,-353
-21,-8,-54,-95,-88,-85,-83,-28,-462
187,179,9,-157,-12,-189,-95,61,-17
47,60,-8,-118,-20,-132,-110,67,-214
-46,-9,-55,-150,-46,-46,-51,-25,-428
-89,82,-67,-148,-45,-51,-58,-5,-381
-6,15,-19,-64,-18,-29,-32,2,-151
-29,78,-34,-134,-91,-85,-62,1,-356
-35,33,-50,-102,-69,-53,-52,4,-324
-88,297,-345,-749,-496,-524,-569,64,-2410
-146,-32,-167,-317,-164,-138,-254,-40,-1258
287,75,-116,-265,-751,-594,-550,-385,-2299
21,426,-82,-526,-96,-143,-401,230,-571
-60,59,-25,-158,-90,-56,-49,-27,-406
-32,-3,-65,-128,-98,-69,-46,-13,-454
-438,-191,-518,-1203,-889,-794,-951,-392,-5376
65,113,-28,-103,-70,-140,-77,-16,-256
-78,-10,-85,-129,-98,-77,-141,-35,-653
47,130,-48,-378,-139,-230,-192,63,-747
200,334,27,-409,-54,-378,-269,-135,-684
-63,26,-169,-370,-287,-274,-267,-35,-1439
7,222,-66,-333,-242,-183,-233,92,-736
-70,85,-143,-354,-155,-183,-145,-49,-1014
-45,10,-100,-260,-214,-137,-167,-55,-968
-40,56,-209,-390,-188,-277,-254,-198,-1500
27,-23,-13,-95,-124,-132,-104,-50,-514
28,122,-49,-189,-108,-76,-38,18,-292
-80,46,-125,-336,-137,-133,-175,-81,-1021
-58,54,-129,-340,-250,-238,-243,-55,-1259
-54,3,-167,-502,-431,-365,-403,-81,-2000
-142,284,-419,-1137,-757,-832,-842,-135,-3980
174,234,15,-118,-65,-79,2,138,301
-98,44,-109,-233,-152,-91,-139,24,-754
-88,40,-168,-437,-388,-317,-335,-45,-1738
18,52,-38,-152,-46,-74,-82,39,-283
-43,27,-106,-301,-155,-165,-161,-32,-936
-97,192,-194,-518,-158,-314,-264,-37,-1390
26,272,-141,-511,-135,-334,-292,-14,-1129
299,206,106,-271,-78,-391,-133,115,-147
-2,142,-98,-316,-155,-211,-234,-8,-882
-2,97,-127,-297,-181,-238,-199,-72,-1019
192,52,-145,-289,-726,-586,-580,-274,-2356
17,180,-25,-335,-186,-227,-204,110,-670
411,193,91,-29,-11,-305,-246,157,261
22,23,-3,-47,6,-43,-23,-7,-72
-257,25,-209,-590,-335,-268,-373,-152,-2159
26,82,-47,-98,0,-57,-52,-43,-189
-26,46,-41,-171,-70,-151,-147,-22,-582
-12,45,6,-72,-132,-28,-81,34,-240
118,280,-42,-347,-29,-151,-88,222,-37
-48,9,-47,-131,-63,-70,-73,-3,-426
-31,2,-70,-204,-133,-102,-98,-15,-651
53,54,-16,-185,-156,-108,-98,-29,-485
22,30,5,-53,-14,-52,-38,7,-93
26,9,7,-14,-11,-48,-24,-2,-57
-17,3,-25,-79,-69,-55,-81,0,-323
7,32,-21,-95,-102,-73,-59,-29,-340
-2,27,-65,-103,-112,-91,-65,-2,-413
7,10,4,-54,-13,-53,-33,4,-128
-38,0,-39,-214,-137,-125,-116,-39,-708
3,59,-110,-261,-196,-247,-246,-146,-1144
-5,-29,-17,-67,-47,-59,-37,-7,-268
-22,94,-81,-189,-81,-124,-108,-29,-540
28,55,-18,-181,-149,-46,-96,-42,-449
19,62,16,-26,-15,-74,-58,0,-76
-69,-39,-83,-156,-111,-57,-110,-27,-652
-19,6,-20,-46,-8,-23,-22,-25,-157
5,50,-9,-94,-36,-72,-29,73,-112
-38,-1,-33,-41,-90,-23,-60,-6,-292
-8,7,-14,-33,-17,-10,-16,-3,-94
14,35,11,-21,-7,6,4,4,46
16,10,-3,-50,-29,-83,-32,-18,-189
-8,-7,-10,-33,-24,-20,-34,18,-118
16,57,-3,-107,-71,-47,-72,9,-218
-43,-23,-69,-112,-143,-89,-136,-7,-622
510,429,185,-413,211,-245,-28,372,1021
-20,10,-16,-38,-42,-30,-26,-12,-174
8,0,0,-46,-3,-8,-10,38,-21
-18,6,-23,-43,-42,-19,-31,9,-161
1,8,-1,-22,-33,1,-13,4,-55
16,13,-21,-40,-32,-70,-44,-23,-201
-29,41,-56,-123,-71,-76,-63,-38,-415
-20,-5,-14,-50,-33,-21,-17,9,-151
-25,-25,-64,-87,-93,-58,-85,-2,-439
0,76,-53,-153,-101,-102,-73,82,-324
594,305,207,-194,81,-414,-337,154,396
-1,41,-11,-74,-54,-58,-35,1,-191
46,70,12,-91,10,-67,-54,24,-50
-52,-9,-79,-118,-158,-82,-123,8,-613
-59,-29,-82,-119,-138,-112,-114,-69,-722
-37,-3,-114,-141,-138,-126,-118,-82,-759
-18,-1,-26,-93,-75,-101,-67,-52,-433
-22,58,-23,-127,-39,-60,-73,-15,-301
43,38,13,-15,9,-43,-28,63,80
-22,26,-24,-76,0,-36,-20,0,-152
22,26,-8,1,-60,-26,-43,-21,-109
-62,-18,-68,-107,-97,-49,-118,-6,-525
-31,11,-38,-110,-72,-80,-67,-20,-407
-31,-10,-33,-43,-41,-8,-38,10,-194
-64,85,-48,-259,-30,-52,-123,-128,-619
5,107,-16,-180,-146,-99,-82,66,-345
-19,73,-34,-101,9,-49,-45,-16,-182
-40,28,-75,-171,-131,-110,-97,-85,-681
140,77,40,34,29,-16,-28,102,378
129,139,-11,-195,-102,-178,-83,14,-287
-14,93,-56,-218,-79,-113,-97,40,-444
-17,-39,-31,-59,-110,-42,-75,-26,-399
-111,68,-102,-223,-173,-45,-119,29,-676
-58,22,-67,-156,-19,-26,-65,10,-359
-10,64,-81,-213,-159,-134,-134,29,-638
-32,64,-103,-247,-175,-153,-139,-4,-789
-29,58,-82,-220,-155,-137,-136,19,-682
-17,33,-94,-201,-160,-139,-148,-2,-728
-45,44,-109,-248,-154,-121,-121,8,-746
-13,59,-84,-221,-153,-118,-144,30,-644
-23,49,-89,-220,-165,-122,-152,13,-709
-11,74,-83,-228,-135,-133,-117,24,-609
-27,47,-101,-233,-168,-139,-127,1,-747
-37,41,-115,-237,-151,-153,-147,-1,-800
-48,50,-104,-221,-160,-117,-144,37,-707
-53,55,-100,-251,-179,-123,-129,53,-727
-35,20,-66,-216,-135,-113,-121,84,-582
64,60,-34,-179,-119,-194,-121,27,-496
69,56,-51,-192,-128,-221,-125,41,-551
49,45,-59,-164,-168,-172,-139,53,-555
27,42,-56,-186,-173,-195,-142,43,-640
59,74,-70,-188,-123,-168,-122,30,-508
58,52,-69,-157,-150,-176,-119,29,-532
32,29,-60,-174,-147,-177,-136,35,-598
52,66,-54,-163,-146,-192,-137,43,-531
10,52,-86,-224,-188,-203,-140,58,-721
20,50,-82,-208,-155,-192,-108,38,-637
22,50,-83,-201,-134,-174,-148,57,-611
44,64,-80,-215,-172,-192,-139,60,-630
38,93,-69,-208,-152,-195,-127,37,-583
42,65,-60,-207,-162,-229,-148,45,-654
26,66,-95,-217,-142,-179,-144,20,-665
52,44,-84,-187,-169,-197,-147,43,-645
47,105,-80,-191,-149,-171,-133,77,-495
52,77,-52,-197,-174,-198,-120,66,-546
63,69,-69,-176,-122,-157,-127,53,-466
-11,86,-96,-220,-175,-163,-127,37,-669
-4,83,-78,-207,-175,-173,-123,29,-648
-13,62,-92,-241,-197,-159,-127,45,-722
-3,103,-62,-208,-163,-148,-108,61,-528
-3,105,-81,-216,-194,-175,-132,58,-638
-9,78,-83,-228,-183,-156,-127,21,-687
8,94,-80,-196,-162,-165,-92,17,-576
-29,57,-96,-224,-167,-175,-128,34,-728
-4,69,-119,-230,-210,-198,-146,2,-836
-7,76,-82,-214,-182,-133,-103,77,-568
-39,-9,-58,-78,-110,-92,-101,-27,-514
8,48,-28,-91,-92,-57,-28,33,-207
39,32,-4,-81,-50,-89,-64,-20,-237
-2,13,-4,-45,-33,-22,-15,-20,-128
-2,-10,-14,-21,-22,-34,-19,-10,-132
-9,-4,-4,-23,-7,-4,-11,-10,-72
2,3,1,-14,-14,-12,-14,-8,-56
-57,8,-57,-118,-93,-84,-87,-16,-504
0,22,-32,-39,-25,-31,-56,-2,-163
-20,3,-16,-100,-80,-72,-55,44,-296
-14,6,-32,-73,-75,-12,-51,2,-249
-18,105,-43,-169,11,-18,-16,13,-135
-17,2,-15,-56,-75,-27,-51,-28,-267
-123,-24,-180,-311,-231,-221,-279,-146,-1515
-14,14,-9,-33,-2,-20,-18,-5,-87
37,21,-33,-71,-77,-104,-110,-25,-362
8,13,9,3,-15,-17,-12,4,-7
-6,-2,-8,-26,-5,-4,-10,-17,-78
15,13,3,-3,-14,-33,-11,3,-27
-20,-6,-25,-35,-10,-13,-30,-3,-142
-11,41,-32,-88,-75,-76,-68,-33,-342
4,-8,-69,-106,-97,-127,-142,-32,-577
8,10,-28,-47,-42,-33,-31,-25,-188
-10,14,-18,-72,-54,-42,-49,-27,-258
-92,-35,-79,-144,-101,-79,-140,-2,-672
-108,-54,-97,-163,-124,-95,-148,-32,-821
17,0,-1,-36,5,-12,-4,-10,-41
62,37,-19,-135,16,-43,-41,45,-78
-29,24,-41,-107,-108,-88,-62,33,-378
-38,16,-35,-113,-107,-40,-69,-4,-390
20,-15,-44,-104,-108,-93,-111,-3,-458
-38,-54,-77,-111,-110,-109,-122,-70,-691
40,44,-5,-54,14,-75,-42,28,-50
-76,144,-126,-228,-86,-77,-161,39,-571
-6,28,-17,-36,-15,-22,-23,1,-90
-34,-4,-40,-135,-88,-97,-44,18,-424
-78,32,-163,-237,-170,-160,-177,-61,-1014
31,-52,-3,-94,-94,-79,-41,22,-310
-21,34,-36,-137,-61,-95,-66,-22,-404
48,43,9,-124,-25,-97,-54,15,-185
90,42,30,-17,26,-68,-51,58,110
-30,-10,-14,-55,-32,-26,-29,-7,-203
-64,4,-160,-227,-143,-184,-231,-102,-1107
-96,139,-147,-494,-228,-269,-286,-113,-1494
-108,-28,-96,-212,-168,-109,-140,-12,-873
15,25,8,-19,-31,-23,-6,9,-22
-2,0,-9,-25,-44,-37,-24,-16,-157
-73,81,-100,-199,-70,-58,-42,-13,-474
87,70,22,-58,-1,-58,-19,47,90
-30,-19,-44,-52,-66,-34,-65,7,-303
13,58,-5,-37,-2,2,-41,-22,-34
-10,-23,-8,-13,-33,-17,-25,-11,-140
-12,6,-13,-33,-8,-15,-25,-1,-101
11,7,9,0,0,1,6,3,37
122,-60,0,-84,-117,-118,-95,10,-342
90,24,13,-37,-13,-90,-79,-19,-111
-6,27,-12,-42,-19,31,-50,-6,-77
-159,-24,-191,-383,-168,-148,-200,-91,-1364
-100,-37,-124,-266,-214,-187,-187,-46,-1161
-6,38,-1,-89,-6,-53,-38,22,-133
-13,9,-19,-46,-14,-39,-22,18,-126
36,40,9,-36,-66,-55,-64,26,-110
-18,7,-54,-127,-105,-119,-106,-45,-567
-33,11,-42,-110,-74,-61,-92,-23,-424
26,38,-20,-74,-44,-83,-88,-22,-267
-113,-42,-75,-171,-147,-112,-125,-3,-788
-53,9,-29,-103,-91,-69,-78,30,-384
-33,12,-107,-167,-132,-89,-145,-36,-697
11,30,-22,-59,-67,-49,-45,-13,-214
-94,-26,-81,-174,-144,-111,-131,-8,-769
-57,-4,-87,-178,-147,-169,-159,-49,-850
-43,20,-57,-147,-58,-114,-84,-54,-537
8,69,-41,-153,-105,-57,-100,85,-294
0,29,-32,-79,-51,-19,-51,22,-181
-223,-72,-279,-585,-413,-237,-444,41,-2212
31,14,-65,-112,-125,-78,-100,12,-423
22,14,-4,-15,-17,-5,-2,27,20
-66,-36,-35,-100,-41,-39,-63,27,-353
-2,82,-17,-142,-96,-93,-106,88,-286
-34,4,-76,-122,-93,-95,-122,-59,-597
-17,28,-45,-110,-120,-107,-102,-61,-534
-11,3,-25,-90,-51,-62,-47,-57,-340
4,7,-2,-22,-25,-6,-20,-5,-69
22,49,-30,-90,-71,-85,-48,-20,-273
25,129,-26,-169,-117,-146,-134,2,-436
84,68,-65,-339,-238,-298,-245,-67,-1100
13,43,-42,-93,-84,-66,-76,-40,-345
-19,22,-29,-102,-87,-43,-65,-17,-340
-75,47,-109,-206,-87,-106,-95,-28,-659
-3,19,-29,-55,-85,-28,-62,-5,-248
285,246,55,-543,-23,-462,-318,70,-690
-11,11,-34,-60,-60,-42,-70,-16,-282
-126,61,-159,-330,-126,-76,-147,-28,-931
-117,119,-120,-445,-317,-125,-352,-224,-1581
-9,38,-16,-82,-46,-29,-42,46,-140
-20,14,-42,-123,-90,-97,-113,-10,-481
-28,5,-24,-80,-102,-62,-35,37,-289
4,-6,-12,-102,-62,-86,-69,-11,-344
-9,0,-38,-99,-139,-77,-84,7,-439
76,1,-4,27,-74,-73,-37,-50,-134
-75,47,-133,-283,-128,-183,-203,-32,-990
-11,-4,-12,-34,-52,-11,-34,23,-135
43,-9,-22,-112,-33,-94,-73,-11,-311
8,-17,-46,-113,-69,-102,-72,-35,-446
3,23,-35,-99,-84,-93,-65,-37,-387
1,51,-49,-108,-74,-80,-62,-9,-330
-56,-1,-134,-254,-300,-232,-272,-75,-1324
-130,-43,-154,-244,-102,-101,-186,-55,-1015
-34,-9,-50,-95,-97,-43,-64,-33,-425
-2,-1,12,-21,-15,-16,-1,-2,-46
6,1,1,-70,-5,-51,-29,9,-138
-71,0,-93,-225,-207,-166,-201,-46,-1009
-18,24,-25,-168,-88,-123,-93,-27,-518
-25,-9,-26,-34,-45,0,-26,0,-165
-37,1,-24,-63,-65,-22,-49,-4,-263
-44,16,-46,-89,-31,-43,-72,-3,-312
-12,34,-25,-138,-102,-51,-68,61,-301
-12,36,-36,-30,-62,-53,-61,-30,-248
4,44,-85,-196,-131,-162,-159,-72,-757
-17,10,-38,-73,-33,-36,-27,-7,-221
-11,-14,-15,-97,-141,-105,-86,-8,-477
-23,11,-34,-87,-100,-76,-74,15,-368
-85,-34,-140,-215,-192,-189,-223,-69,-1147
-21,3,-43,-164,-81,-75,-112,-33,-526
-51,-19,-30,-72,-49,-22,-31,11,-263
107,163,20,-120,-11,-121,-69,-6,-37
2,6,-15,-41,-40,-46,-26,-10,-170
48,46,12,2,-5,-19,-2,29,111
-18,23,-36,-60,-41,-30,-45,-20,-227
-90,-3,-123,-248,-178,-179,-181,-86,-1088
235,213,-10,-161,-97,-262,-220,-108,-410
-6,-9,-195,-345,-286,-336,-373,-218,-1768
-24,0,-23,-44,-14,-32,-33,-16,-186
-25,24,-16,-98,-54,-57,-82,-3,-311
-169,26,-216,-496,-424,-315,-391,-102,-2087
-167,36,-205,-477,-390,-282,-369,-72,-1926
-28,127,-48,-250,-117,-129,-192,-123,-760
-11,44,-42,-110,-63,-74,-50,-17,-323
-29,11,-49,-105,-90,-56,-117,-74,-509
-11,5,-21,-93,-55,-55,-57,-2,-289
1,23,-31,-108,-51,-42,-71,-8,-287
87,146,-18,-237,-11,-171,-94,-6,-304
-32,33,-11,-94,-129,-54,-89,-1,-377
-38,34,-22,-104,-128,-57,-89,0,-404
25,29,-11,-70,-76,-111,-56,-44,-314
-15,4,-24,-21,-33,-20,-42,-10,-161
-31,-13,-9,-38,-6,-10,-22,-10,-139
-17,10,-41,-60,-37,-28,-57,-24,-254
29,48,-10,-90,-54,-64,-58,14,-185
45,3,-2,5,-35,-34,-21,0,-39
-10,-17,-18,-40,-51,-48,-23,-24,-231
62,211,-54,-200,-22,-153,-98,76,-178
-17,1,-6,-29,-17,-27,-30,-5,-130
33,-11,-71,-109,-86,-101,-103,-31,-479
7,13,-6,-26,-16,-9,0,8,-29
136,34,36,-15,24,-90,-117,-7,1
-46,57,-62,-113,-79,-61,-72,0,-376
-10,11,-12,-86,-87,-75,-54,8,-305
-14,-16,-57,-74,-60,-60,-66,-13,-360
6,55,-31,-89,-37,-67,-60,3,-220
66,113,-173,-545,-231,-434,-425,-118,-1747
9,-4,-12,-27,6,-21,-1,17,-33
-23,-17,-17,-27,-39,-21,-25,0,-169
-42,-18,-67,-98,-65,-31,-64,-16,-401
18,14,-5,-145,-114,-197,-159,-46,-634
-98,-37,-82,-143,-141,-63,-131,-3,-698
24,75,-19,-141,-150,-84,-56,34,-317
14,16,-104,-245,-195,-238,-208,-114,-1074
-17,35,-43,-153,-107,-58,-74,-18,-435
-11,38,-21,-106,-47,-77,-82,-69,-375
-93,46,-131,-213,-130,-51,-207,59,-720
17,64,-20,-84,-193,-108,-123,79,-368
9,3,-23,-46,-52,-43,-52,-3,-207
7,12,-30,-126,-120,-80,-91,3,-425
-15,-11,-2,-84,-59,-51,-41,-8,-271
-27,23,-47,-134,-94,-65,-126,-22,-492
-138,82,-188,-416,-212,-218,-262,-60,-1412
-14,-22,-16,-34,-29,-41,-30,-22,-208
-6,-27,-17,-52,-61,-37,-25,-2,-227
-27,-18,-24,-70,-55,-29,-45,17,-251
-3,-6,-16,-74,-113,-48,-51,-7,-318
131,253,-29,-204,-110,-230,-317,-98,-604
170,85,59,-195,-155,-128,-100,245,-19
-59,-3,-72,-194,-159,-114,-116,60,-657
-28,50,-14,-137,-111,-38,-60,-7,-345
-48,-17,-37,-86,-95,-68,-107,-14,-472
-100,-3,-62,-185,-98,-63,-88,-5,-604
-14,45,-64,-197,-20,-83,-75,68,-340
-44,138,-46,-117,0,-47,-29,-45,-190
-43,22,-50,-137,-76,-42,-46,39,-333
77,134,-2,-32,9,-53,-75,34,92
268,292,139,-129,160,-141,-90,254,753
150,31,16,-100,-35,-118,-98,32,-122
-129,6,-161,-309,-184,-128,-241,-8,-1154
-45,92,-162,-426,-279,-300,-256,-46,-1422
-121,33,-115,-223,-46,-55,-43,-72,-642
431,592,-54,-65,-508,-197,-999,113,-687
52,92,12,-109,-61,-138,-71,5,-218
11,68,-16,-164,-99,-173,-110,-61,-544
-85,36,-86,-201,-64,-47,-87,-11,-545
20,41,-39,-95,-153,-41,-52,28,-291
21,20,-70,-107,-93,-130,-94,-80,-533
493,892,17,-1210,7,-564,-565,710,-220
-41,-7,-56,-151,-143,-82,-84,-50,-614
-50,-2,-78,-169,-155,-82,-105,15,-626
47,-1,-25,-145,25,-116,-46,50,-211
-10,34,-27,-114,-65,-74,-81,2,-335
-43,-1,-45,-64,-32,-21,-54,-1,-261
115,260,52,-308,86,-174,-102,177,106
-7,-5,-7,-12,-20,-6,-10,5,-62
12,70,-21,-192,-5,-111,-137,2,-382
-50,-23,-108,-168,-136,-161,-191,-107,-944
26,162,-57,-138,-15,-81,-27,59,-71
-59,-16,-79,-132,-56,-81,-87,6,-504
22,108,-174,-495,-149,-360,-359,-26,-1433
14,77,-48,-175,-109,-112,-68,11,-410
-85,-4,-57,-301,-204,-128,-108,-13,-900
-4,21,-55,-105,-89,-91,-99,37,-385
65,239,19,-293,-160,-241,-242,151,-462
23,70,-39,-220,-64,-87,-101,85,-333
-30,-11,-37,-57,-36,-8,-22,27,-174
8,6,-6,-7,-8,-14,-14,-7,-42
14,19,0,-8,-28,-41,-28,-5,-77
56,55,42,31,-93,-60,-26,7,12
-1,42,-3,-42,-16,24,-21,13,-4
43,31,-6,-117,-16,-34,-51,19,-131
-8,4,-6,-12,-4,-5,-9,-2,-42
-7,2,-8,-13,-5,-8,-10,-2,-51
12,-11,-16,-67,-105,-109,-71,-73,-440
-19,-7,-35,-77,-102,-56,-79,-60,-435
-2,33,-10,-34,-12,-22,-13,-10,-70
