protein-water,protein-carbon,hydrogen bond (long-range),pi-pi (long-range),disorder (long),K-Beta similarity,disorder (short),electrostatic (short-range),8-feature sum
11,28,-7,-14,-27,-22,2,42,13
4,25,-6,-2,-19,-28,-3,41,12
1,14,-7,1,-17,-34,-6,35,-13
-4,29,3,11,-22,-26,-5,44,30
9,22,-1,2,-33,-19,-13,38,5
5,25,3,5,-16,-25,-8,54,43
12,38,0,6,-20,-28,-4,47,51
12,24,-11,8,-24,-20,-3,54,40
7,29,8,17,-28,-9,-5,56,75
4,17,-4,-2,-23,-23,-11,37,-5
-2,17,-1,7,-26,-15,-10,35,5
14,26,4,4,-20,-24,-10,47,41
14,23,4,9,-34,-13,-16,50,37
5,16,-4,-2,-23,-27,-10,36,-9
16,27,5,15,-25,-9,-6,52,75
-5,23,-20,-2,-31,-19,0,32,-22
3,1,-10,2,-25,-14,-7,33,-17
3,17,-19,4,-36,-18,2,28,-19
5,5,-9,1,-28,-13,-7,46,0
1,16,-12,0,-18,-24,-9,41,-5
8,3,-10,-7,-23,-21,-2,23,-29
1,21,-12,-3,-22,-24,-5,35,-9
8,8,-13,-7,-20,-24,-2,27,-23
-10,19,-10,-13,-22,-19,-7,21,-41
11,29,8,8,-17,-19,4,46,70
-4,7,-15,11,-34,-22,6,29,-22
2,9,-11,-1,-33,-28,-8,36,-34
3,17,-10,5,-23,-18,-10,48,12
13,30,9,4,-13,-21,7,47,76
-6,1,-5,-3,-4,-7,-3,1,-26
8,31,4,-2,-16,-20,6,43,54
8,11,-9,1,-18,-29,5,48,17
9,16,-8,0,-30,-26,-4,33,-10
9,27,14,-2,-8,-13,8,44,79
8,26,-4,1,-24,-24,-3,46,26
10,16,-11,4,-28,-21,-5,32,-3
4,12,-20,-9,-24,-38,-12,26,-61
2,13,-7,-5,-17,-18,-3,28,-7
5,12,-2,8,-14,-15,-3,27,18
-5,15,-15,-3,-20,-25,-14,27,-40
12,9,-20,-1,-24,-11,6,32,3
1,24,-8,-4,-24,-28,-17,28,-28
-3,4,-1,-2,-8,-1,-1,8,-4
-2,5,-2,3,-3,-2,-1,7,5
-1,1,-2,-3,-1,-3,1,3,-5
4,9,-12,-4,-20,-5,-8,27,-9
2,12,-15,-15,-22,-8,-9,26,-29
14,21,-9,7,-32,-20,-10,48,19
-2,13,0,16,-27,-13,-14,48,21
-1,11,-10,4,-34,-26,3,47,-6
-4,9,-8,6,-28,-31,-6,35,-27
-1,20,-11,0,-28,-18,-10,31,-17
-12,18,-15,-4,-25,-13,-3,35,-19
-11,5,-14,-2,-26,-23,-7,21,-57
-9,-2,-13,-23,-33,-18,-12,18,-92
-17,-14,-23,-3,-46,-26,-14,21,-122
-9,10,-12,-9,-29,-36,0,35,-50
252,1384,-152,-318,10,-615,308,846,1715
12,13,-39,-50,-54,-23,15,44,-82
-4,5,-23,-9,-20,-18,1,27,-41
68,105,14,-39,-18,-51,13,101,193
17,28,6,-6,-14,-19,5,36,53
4,13,-3,-16,-6,1,10,33,36
112,89,-6,25,-42,-12,68,116,350
86,110,-33,-18,-62,-43,44,132,216
67,103,13,-38,-18,-49,14,100,192
5,10,-5,-6,-14,-11,13,20,12
64,105,12,-40,-20,-49,13,102,187
18,58,-27,-67,-59,-129,-1,101,-106
63,103,8,-39,-22,-51,14,102,178
-6,2,-9,-11,-5,-14,-11,10,-44
1,14,-9,-6,-21,-3,2,14,-8
216,331,24,23,-40,-62,149,301,942
-4,24,-3,-13,2,-31,-5,20,-10
4,21,4,-15,-10,-21,3,38,24
8,29,5,1,-19,-28,3,37,36
6,18,-6,9,-25,-31,1,43,15
11,28,5,11,-23,-18,-6,49,57
-3,5,-10,-7,-37,-9,-5,30,-36
3,-3,-19,0,-28,-26,2,24,-47
-12,5,-19,6,-33,-18,0,29,-42
9,20,-4,-1,-26,-17,2,38,21
-3,2,-1,-1,-7,-5,-5,6,-14
-3,13,5,-8,0,-6,1,13,15
-2,0,1,-1,-4,-4,2,0,-8
-2,1,0,0,-5,-2,-3,5,-6
-3,0,-5,-2,-2,-1,2,1,-10
-5,4,-3,-2,0,-4,-2,3,-9
-3,1,2,1,-2,-3,-1,2,-3
-1,-1,2,-1,-3,-5,-1,2,-8
10,19,-11,5,-20,-19,-3,35,16
12,14,0,-7,-8,-32,-11,26,-6
4,10,0,0,-27,-20,1,28,-4
5,7,-5,8,-30,-29,0,27,-17
-7,9,-3,-1,-23,-28,-5,32,-26
-1,9,-11,0,-15,-34,-3,35,-20
-6,14,-18,-10,-19,-21,-7,24,-43
6,-7,-19,-17,-40,-28,-3,28,-80
73,136,-1,11,-79,-83,0,129,186
15,16,-8,5,-36,-29,-6,53,10
2,9,-15,-15,-27,-33,-12,27,-64
-4,17,1,-3,-18,-26,-12,31,-14
4,9,-8,-6,-33,-28,-3,35,-30
3,8,-13,7,-26,-21,-3,25,-20
7,10,-8,10,-37,-24,-7,38,-11
-4,15,-20,-12,-33,-37,-12,25,-78
-7,6,-22,7,-39,-24,2,37,-40
3,-2,-14,20,-24,-3,-4,35,11
-3,8,-8,8,-30,-20,-4,36,-13
0,8,-10,10,-26,-21,1,29,-9
2,29,5,6,-21,-13,-8,56,56
1,9,-13,10,-29,-25,-6,28,-25
1,8,-11,6,-32,-24,2,32,-18
-3,-1,0,-5,-5,-5,-2,-1,-22
-1,4,-11,-2,-27,-29,-10,41,-35
0,3,-12,-2,-33,-17,-5,29,-37
-4,17,-16,-5,-16,-38,-11,29,-44
-2,10,-1,2,-15,-23,-18,27,-20
-4,13,-13,-11,-25,-21,-18,28,-51
-1,2,-19,-15,-27,-21,-8,26,-63
7,9,-11,-5,-26,-25,3,34,-14
7,6,-2,-3,-18,-18,-14,38,-4
-7,11,-7,12,-25,-23,-19,25,-33
8,17,-10,-3,-18,-29,-14,22,-27
-2,10,-8,-5,-22,-37,-5,35,-34
8,18,-7,3,-20,-32,-16,30,-16
8,2,-21,-3,-32,-25,3,33,-35
-1,13,0,-9,-24,-20,-11,37,-15
-11,8,-11,-2,-28,-17,-5,40,-26
0,3,-11,-15,-26,-16,-13,32,-46
10,20,-6,-1,-20,-19,-6,31,9
4,4,-9,-2,-20,-30,-12,24,-41
0,34,-23,10,-25,-15,-7,26,0
-7,20,-13,-2,-5,-28,-11,16,-30
7,14,-5,2,-35,-20,-9,41,-5
-1,12,-13,-7,-18,-12,-4,27,-16
2,15,-7,-7,-25,-30,-12,29,-35
8,28,-5,11,-26,-30,-13,39,12
4,24,2,3,-27,-12,-4,38,28
2,6,-14,-8,-18,-6,-13,29,-22
16,-8,-49,-7,-105,-45,9,66,-123
6,21,-6,6,-28,-27,-3,44,13
-2,13,-8,-17,-12,-20,1,25,-20
-1,10,-5,8,4,-5,2,11,24
59,177,-21,-50,-78,-160,-5,209,131
-9,-7,-23,12,-49,-11,4,37,-46
7,23,-2,0,-20,-18,0,37,27
3,25,-2,6,-28,-35,-2,35,2
1,11,-8,-2,-30,-19,-3,31,-19
5,13,-9,1,-24,-27,-6,34,-13
-2,16,-12,-3,-33,-29,-6,33,-36
2,-3,-26,11,-36,-16,7,35,-26
8,14,-3,3,-24,-14,7,35,26
2,-1,-23,12,-49,-14,0,29,-44
0,11,0,26,-24,-7,-2,35,39
-1,7,-22,-6,-31,-15,11,23,-34
2,12,-7,10,-25,-24,-17,41,-8
4,11,-4,10,-28,-18,-4,38,9
0,12,-6,8,-30,-14,-1,39,8
-2,15,-13,13,-39,-5,2,41,12
0,4,-18,2,-42,-5,7,31,-21
0,12,0,12,-26,-17,-15,47,13
-6,9,-6,9,-39,-17,-4,34,-20
-3,4,-20,-18,-29,-42,-11,17,-102
3,14,-6,1,-18,-28,1,40,7
-2,14,17,8,-15,-26,-10,41,27
-5,0,-2,-6,-4,-6,-3,5,-21
-1,11,-10,10,-30,-23,-5,38,-10
10,29,12,5,-14,-20,8,46,76
5,17,-7,6,-27,-26,-4,44,8
7,20,-9,6,-23,-27,-6,39,7
10,21,-6,9,-29,-23,8,47,37
-1,-1,-2,-4,2,0,0,-2,-8
3,30,-6,-9,-27,-51,-13,35,-38
-16,78,-21,-49,-31,-156,-69,74,-190
-5,4,-34,-6,-38,-19,5,22,-71
12,24,-8,-2,-21,-24,-8,48,21
-3,-11,-27,12,-34,-18,-4,36,-49
274,334,7,-97,64,-67,230,375,1120
-8,-2,-6,-8,-8,-6,-7,3,-42
-2,0,3,-4,-5,-8,-1,3,-14
-6,2,-2,-2,-7,-6,-4,1,-24
-2,8,-8,7,-38,-24,-3,34,-26
0,7,-2,2,-27,-21,-2,29,-14
92,107,-47,63,-168,-75,53,111,136
-4,-1,-5,-2,-1,-5,-2,2,-18
-2,4,2,3,-1,-5,-2,7,6
0,4,3,-2,0,-2,-2,5,6
83,112,-85,119,-215,-64,65,88,103
2,11,-13,7,-29,-12,-3,40,3
3,13,-1,-1,-11,-23,-5,30,5
136,180,32,-11,-9,30,127,206,691
2,11,-2,1,-22,-25,-10,21,-24
5,21,6,5,-26,-20,2,36,29
-1,30,2,2,-17,-26,-2,36,24
11,11,-12,2,-23,-31,-2,23,-21
2,16,-9,-11,-16,-20,4,30,-4
7,13,-1,1,-22,-22,1,37,14
6,25,-3,-1,-16,-20,3,22,16
-8,11,-4,-7,-13,-19,-8,23,-25
-6,6,-16,-17,-23,-27,-9,10,-82
-8,35,-11,-17,-30,-40,-4,53,-22
25,28,-13,-18,-51,-59,1,76,-11
18,19,0,6,-12,10,19,28,88
116,325,18,204,-202,15,-139,370,707
25,27,-26,30,-55,-38,27,61,51
22,46,5,-18,-34,-11,37,84,131
51,26,-25,26,-29,-45,36,50,90
17,29,2,-5,10,-10,7,26,76
26,41,-15,-6,-56,-22,45,76,89
30,41,-12,4,-17,-3,35,40,118
24,35,8,-4,16,4,17,31,131
-7,4,-1,-10,2,-14,-2,12,-16
14,26,-9,-39,-14,-44,-2,30,-38
8,36,14,-1,12,18,21,32,140
2,-3,-9,-10,-19,-41,-20,12,-88
5,-5,0,-26,8,-29,-4,33,-18
129,228,-14,-30,-27,-126,7,319,486
40,46,-12,-7,-17,-44,33,75,114
-31,-10,-15,-35,-23,-86,-48,35,-213
-8,33,0,-10,-21,-40,-8,59,5
1,8,-10,-9,0,-19,0,21,-8
19,34,-23,-11,-44,-24,9,53,13
4,32,0,4,-3,-34,-12,12,3
-14,28,-11,-20,-2,-38,-18,31,-44
26,55,-10,2,5,13,30,36,157
7,66,19,-21,42,8,34,22,177
79,74,21,-3,-25,-28,11,129,258
102,226,-92,-68,-101,-63,112,234,350
-9,-2,-17,-19,-6,-20,-9,7,-75
12,185,42,16,-57,-157,-33,212,220
-21,12,-24,-21,-13,-38,-18,42,-81
38,81,-16,11,-30,-67,-2,69,84
5,46,8,-10,9,-45,-1,55,67
11,9,4,-4,1,-4,4,23,44
8,29,-2,-12,-14,-23,2,16,4
3,10,-20,6,-32,-41,-10,14,-70
49,63,-19,11,-43,-13,19,71,138
-1,15,-14,-13,-21,-53,-27,34,-80
53,78,-4,11,-14,-23,31,53,185
31,32,-2,-15,-4,-25,12,30,59
12,26,-5,-3,-18,-8,3,21,28
21,53,-23,-12,-19,-19,30,46,77
0,4,-4,-7,2,-20,3,19,-3
48,59,15,-18,11,-49,8,76,150
28,5,-8,-18,7,-12,15,22,39
14,41,12,-1,-10,2,18,40,116
54,88,-55,8,-137,-214,-9,133,-132
32,16,0,-8,-4,-18,0,34,52
291,340,50,-32,67,-76,64,420,1124
-10,-5,-12,-12,-21,-12,-9,10,-71
38,30,-9,-10,12,-36,16,36,77
78,148,49,65,30,55,31,197,653
176,280,-30,53,-52,-19,148,49,605
0,4,-4,-7,2,-20,3,19,-3
83,115,-19,-23,-75,-80,19,173,193
-4,3,-15,-7,-11,-20,-11,12,-53
-1,2,-2,-4,-13,-40,-15,31,-42
74,29,-22,15,-50,-35,33,45,89
21,52,9,-17,16,10,19,31,141
1,9,-1,-17,-15,-40,-5,58,-10
45,52,-34,-30,-41,-45,33,78,58
15,51,-77,-105,-31,-53,25,85,-90
13,17,-3,-6,-6,-10,-1,2,6
12,17,-3,3,-1,-8,9,20,49
-4,40,-7,-10,-8,-4,13,26,46
37,29,-45,-16,-26,-57,-17,50,-45
-12,4,-20,-9,-25,-10,-2,20,-54
63,85,20,-8,16,-2,33,73,280
2,22,-8,9,-9,-7,9,23,41
22,43,-10,-11,-19,-47,-18,37,-3
-6,12,-7,-10,-15,-24,-9,16,-43
-13,15,-4,2,-14,-27,-23,15,-49
-20,-5,-11,-23,-16,-20,-19,8,-106
-9,14,-7,3,4,-15,4,15,9
4,17,-3,-3,-9,-4,5,6,13
37,55,0,-12,-19,-26,34,61,130
-32,-12,-33,-17,-59,-83,-56,47,-245
5,-1,-26,-21,-25,-53,-19,33,-107
4,1,-12,0,-15,-19,-3,28,-16
4,33,6,-30,0,-9,2,39,45
56,39,1,9,-2,-51,11,68,131
-6,4,-11,-15,-9,-35,-8,18,-62
76,76,21,-3,-26,-27,12,129,258
9,16,-16,-6,-6,-31,8,19,-7
5,22,-3,2,-17,-18,2,23,16
0,7,-5,-1,-29,-19,-9,20,-36
4,22,-5,1,-15,-21,2,30,18
3,9,-24,4,-32,-26,0,36,-30
-6,5,-19,-20,-21,-27,-1,24,-65
10,11,-11,-11,-3,-23,3,19,-5
7,31,-2,-3,-22,-16,7,31,33
1,19,-6,0,-18,-18,4,25,7
4,30,5,-12,0,-18,-1,18,26
52,49,-4,-15,3,-60,23,82,130
5,-2,-22,9,-22,-16,6,5,-37
68,89,16,61,-15,-40,30,119,328
38,51,22,-14,-25,-83,-15,88,62
17,19,-27,-8,-27,-73,-13,34,-78
15,80,7,-22,-84,-67,21,132,82
25,88,-2,-32,13,-49,14,72,129
14,19,-7,-1,0,-25,-4,54,50
-30,30,37,43,-55,54,-7,9,81
-22,10,21,34,-36,31,-1,4,41
-21,26,21,20,-46,44,-9,3,38
-25,28,32,33,-48,51,-6,8,73
-21,22,24,16,-42,42,-6,1,36
57,94,9,37,-44,-53,19,144,263
-28,28,30,30,-48,49,-8,5,58
-25,32,34,37,-50,60,-7,6,87
-35,36,47,52,-64,73,-5,11,115
-28,33,36,39,-53,60,-6,10,91
-10,6,-5,-6,-2,-12,-7,11,-25
10,20,-12,-34,-2,-33,4,34,-13
13,35,-1,3,-17,-24,-10,33,32
-23,41,0,-35,-15,-42,-6,65,-15
2,13,-12,-15,-39,-34,-19,69,-35
79,84,10,44,-41,-38,45,79,262
0,23,-5,5,1,-32,-9,32,15
5,3,-10,-9,-16,-32,-15,23,-51
-1,24,-7,5,-8,-28,0,30,15
1,29,16,-2,-8,-11,1,51,77
5,13,-13,8,-23,-22,3,26,-3
-2,29,-5,6,0,-32,-4,32,24
-3,14,10,-4,-15,-18,-3,31,12
2,13,11,-1,-15,-28,-9,30,3
3,18,11,5,-9,-27,-8,37,30
3,5,-17,-3,-21,-24,-8,20,-45
-3,15,1,-4,-13,-16,2,29,11
3,14,-7,-12,-12,-22,4,25,-7
5,32,-7,-11,-24,-26,-1,40,8
11,15,-17,-1,-29,-35,4,42,-10
153,243,-52,-29,-96,-214,43,293,341
-59,57,-75,1,-163,-178,-71,191,-297
59,-29,-65,-2,-187,-65,59,104,-126
8,-10,-87,-21,-118,-169,-51,88,-360
71,121,-127,-232,-111,-442,-66,343,-443
-19,-6,-62,-42,-125,-114,-16,40,-344
132,216,-45,-63,-76,-75,94,303,486
17,49,-152,-116,-194,-256,-28,191,-489
50,199,-36,-79,-134,-165,13,262,110
27,166,-66,-128,-82,-197,-37,229,-88
5,6,-24,-2,-32,-23,3,32,-35
-1,-1,-17,-8,-31,-8,-8,26,-48
-9,-15,-17,-26,-21,-26,-16,20,-110
23,83,7,2,45,-25,29,91,255
161,245,-109,-112,-236,-313,-65,457,28
73,152,8,25,-73,-78,-1,139,245
10,22,-22,4,-30,-11,23,28,24
99,201,-40,-25,-85,-95,31,158,244
0,23,-9,-45,-31,-50,-21,78,-55
20,23,-27,-6,-59,-63,-1,75,-38
-75,-24,-120,-51,-196,-218,-97,110,-671
-1,23,-13,-15,-18,-60,-8,33,-59
18,14,-18,-7,-13,-9,14,17,16
11,-2,-1,-22,-7,-65,-11,33,-64
9,34,18,17,-9,-37,8,80,120
5,41,-12,-15,-22,-29,-9,63,22
-33,81,-18,-12,-65,-146,-67,84,-176
48,73,-6,-22,-2,-57,30,161,225
-2,6,-19,-12,-46,-43,-19,27,-108
46,43,-20,-19,-19,-90,1,109,51
-20,9,-31,-4,-40,-112,-49,60,-187
-20,36,-38,-18,-58,-86,-30,62,-152
-40,-15,-53,-20,-85,-77,-37,46,-281
-6,-1,-9,-5,-30,-24,-13,28,-60
-14,-12,-19,-22,-30,-36,-23,19,-137
22,63,10,-17,23,-13,36,36,160
87,109,-78,-67,-57,-149,-19,174,0
16,53,-14,-13,-21,-104,3,74,-6
15,9,-15,0,-49,-38,1,42,-35
18,130,-12,-9,-23,-9,69,116,280
-4,20,9,8,-17,-10,-16,18,8
-58,-7,-134,-144,-137,-244,-79,129,-674
-32,20,-54,-16,-125,-188,-118,146,-367
88,172,-4,30,-92,-112,6,109,197
46,61,-5,6,-4,-49,31,88,174
49,110,-57,-45,-133,-181,-21,139,-139
40,-4,7,4,-11,9,20,59,124
93,135,-81,-122,-204,-310,-13,322,-180
37,65,0,4,-106,-13,34,151,172
12,22,-83,-32,-172,-161,-19,110,-323
-35,-1,-50,-22,-74,-76,-53,31,-280
44,45,-17,-6,-19,-36,-6,34,39
17,24,-9,-17,-17,-37,5,33,-1
21,37,1,-6,-27,-14,20,35,67
64,89,15,4,-6,-34,26,91,249
10,-2,-16,4,-30,-12,12,15,-19
17,12,-5,-2,-8,-32,-2,3,-17
0,34,-30,-21,-27,-28,12,51,-9
178,339,-26,-55,-105,-166,127,421,713
-52,-53,-48,-40,-45,-102,-53,33,-360
-3,15,-1,5,-23,6,-4,-4,-9
29,37,5,-3,16,16,38,25,163
146,257,32,-20,23,-50,97,251,736
-20,31,-16,-5,-74,-69,-16,68,-101
346,429,94,-55,55,-197,-16,386,1042
65,78,-68,-70,-101,-133,27,155,-47
-27,10,-6,-27,-32,-27,-15,32,-92
10,38,-7,8,-30,-23,20,53,69
164,236,-14,-84,39,-49,140,244,676
63,30,-35,-21,-65,-70,-5,56,-47
72,76,-23,-48,6,-180,4,145,52
68,91,-13,-3,-71,-29,35,106,184
91,121,23,-48,1,-79,21,117,247
-2,25,-14,-7,-31,-38,-17,46,-38
-19,71,-86,-70,-45,-135,-13,134,-163
89,171,-127,-27,-187,-259,-47,138,-249
38,57,-43,-32,-58,-60,15,77,-6
48,103,-64,-48,-127,-152,21,146,-73
89,94,-29,53,-124,-104,28,128,135
85,109,-72,-43,-132,-189,33,227,18
96,123,-11,-71,32,-4,92,174,431
62,105,-47,-31,-67,-136,-3,131,14
59,72,-20,15,-84,-94,13,89,50
8,35,2,-3,-18,-20,7,41,52
101,146,-178,-119,-270,-306,-55,344,-337
-25,48,-62,-70,-8,-22,25,109,-5
19,99,-74,-22,-204,-161,-11,204,-150
15,17,-8,8,-27,-37,-6,27,-11
31,231,-275,-154,-507,-689,-116,391,-1088
13,46,-83,-66,-121,-158,-28,113,-284
24,76,-76,-53,-72,-150,-5,74,-182
-36,-7,-35,-27,-48,-53,-36,33,-209
64,126,-4,-51,10,-88,34,158,249
16,38,15,0,-16,-10,9,36,88
-5,11,-60,-21,-75,-57,-34,32,-209
3,30,-50,-11,-100,-90,-11,93,-136
53,76,41,21,2,-15,29,103,310
23,102,-46,-37,-139,-148,-25,176,-94
199,153,-17,-37,-92,-172,0,249,283
141,289,-110,-25,-95,-121,58,243,380
18,8,-47,-33,-40,-81,12,35,-128
-27,-10,-33,-21,-40,-46,-33,28,-182
18,20,-56,-35,-56,-50,12,56,-91
2,28,8,-5,-24,-16,17,52,62
234,388,-69,-12,-175,-300,-20,300,346
37,140,-99,-126,-141,-288,-44,261,-260
-10,33,-6,-9,-21,-21,-10,37,-7
-5,24,-2,1,-1,-20,-13,24,8
39,70,0,-16,-36,-44,26,107,146
6,0,-25,-16,-45,-55,-8,5,-138
138,285,-75,-81,-183,-260,-8,478,294
345,1379,785,330,140,86,90,1342,4497
-75,-39,-64,-57,-79,-106,-74,62,-432
94,216,-114,-202,-352,-384,-74,409,-407
201,212,-146,-78,-235,-243,39,342,92
-16,87,-9,-71,-49,-127,-58,96,-147
10,67,-21,-32,-58,-170,-62,81,-185
141,309,86,-22,-215,-134,-128,412,449
-4,11,-9,-4,-13,-34,10,19,-24
-12,-2,-8,-1,-24,-25,-13,15,-70
-18,88,-100,-122,-94,-186,-51,220,-263
6,3,-13,5,-16,-11,0,17,-9
1,58,-61,-54,-131,-98,-18,68,-235
24,65,-4,6,-32,-38,28,36,85
-25,40,-51,-95,-155,-274,-84,239,-405
186,321,-61,-110,-87,-210,21,422,482
-2,29,-26,-25,-78,-56,-25,91,-92
35,120,-56,-36,-154,-271,-141,233,-270
2,30,-5,-18,-10,-30,-3,39,5
63,127,-51,-3,-98,-129,-2,175,82
63,91,-8,24,-13,-59,53,121,272
-5,1,-31,-24,-74,-53,-15,38,-163
-8,9,-23,-29,-43,-44,-7,53,-92
11,30,-14,-31,-66,-78,7,100,-41
-4,4,-17,-9,-21,-25,3,42,-27
15,41,18,7,-14,-35,6,67,105
17,-25,-41,-60,-74,-108,-41,87,-245
87,60,9,-60,7,-60,7,109,159
7,42,7,5,-70,-11,16,78,74
23,90,-9,-30,-43,-26,44,161,210
-74,-13,-60,-46,-74,-120,-77,56,-408
143,180,20,-11,-25,-155,-1,187,338
178,340,-29,-45,-96,-258,7,394,491
51,147,44,-40,-47,-161,1,177,172
152,182,5,-20,-12,-159,-10,194,332
140,240,-11,-31,38,-39,129,177,643
130,216,-159,-163,-217,-284,21,309,-147
39,54,-23,-35,-99,-93,21,76,-60
-46,13,-78,-41,-112,-130,-65,138,-321
20,27,7,-22,6,-13,5,34,64
-7,9,-9,-17,-14,-19,-13,5,-65
13,-18,-33,-39,-62,-65,-6,26,-184
20,12,-52,-61,-97,-114,1,87,-204
443,704,-382,-312,-465,-289,319,833,851
90,202,-51,-26,-149,-160,14,224,144
-36,10,-23,-14,-71,-115,-55,60,-244
8,17,-2,16,-74,-71,-17,80,-43
98,146,97,7,27,-26,33,128,510
74,131,-76,7,-130,-129,-14,100,-37
23,85,-126,-74,-252,-199,-44,187,-400
9,37,-5,33,-80,-64,7,54,-9
210,260,65,-1,-49,-161,38,332,694
239,414,150,24,140,-25,103,396,1441
22,77,-102,-128,-121,-256,-34,234,-308
98,120,-13,-39,-37,-86,11,160,214
-26,-9,-44,-41,-34,-84,-37,40,-235
137,198,14,24,-73,-102,57,250,505
7,54,-39,-50,-80,-100,-4,105,-107
-24,32,-39,-54,-30,-131,-58,110,-194
102,133,-288,-189,-470,-733,-172,428,-1189
84,157,-10,7,-52,-35,95,144,390
2,118,-66,-30,-173,-273,-50,156,-316
-6,264,238,159,-36,144,-64,234,933
18,110,-57,-74,-136,-200,-44,236,-147
416,766,-203,-199,-336,-188,373,720,1349
55,95,-10,-36,3,-45,45,107,214
19,31,-10,-13,7,-30,1,35,40
0,12,-13,-3,-12,-39,9,12,-34
-40,-3,-31,-20,-60,-94,-45,42,-251
126,181,-79,-32,-181,-211,16,182,2
11,15,-3,-1,-12,-16,11,20,25
112,198,-33,41,-39,-94,61,178,424
-20,35,-17,-1,-24,-10,-9,43,-3
-5,24,-50,-33,-38,-76,-4,82,-100
262,502,-79,124,-260,-288,113,262,636
113,184,-16,58,-60,-104,30,167,372
0,20,-7,-15,-16,-13,1,27,-3
32,82,-21,2,-103,-167,-1,129,-47
29,74,-52,-17,-61,-51,12,66,0
39,166,-121,-84,-208,-288,-48,261,-283
-19,0,-9,-14,-11,-42,-29,16,-108
223,303,-32,2,-115,-93,118,351,757
38,17,3,-16,-13,-47,10,32,24
3,39,-49,-68,-52,-124,-24,88,-187
66,42,-21,-9,-24,-79,4,83,62
-13,58,17,-2,0,-14,-10,45,81
97,110,-24,-40,-61,-78,84,93,181
29,182,-111,-101,-123,-170,14,93,-187
43,19,-50,-10,-103,-72,-16,19,-170
49,57,18,-20,32,-48,18,104,210
32,58,-5,-32,-14,-38,-1,70,70
40,77,52,42,-24,13,40,86,326
63,61,-64,15,-116,-60,46,56,1
-46,-9,-64,-55,-83,-133,-71,52,-409
52,91,-43,-6,-87,-124,-6,126,3
52,86,-42,-8,-85,-120,4,125,12
-10,13,1,-7,-1,-51,-4,49,-10
161,184,38,-46,-15,-76,98,224,568
-61,-29,-61,-40,-88,-120,-62,69,-392
24,37,-10,-6,-69,-59,2,83,2
-6,63,-49,-34,-122,-162,-34,132,-212
94,230,-22,44,-66,17,123,157,577
7,47,-4,18,-20,-43,-3,70,72
135,136,81,60,3,2,21,158,596
30,37,4,-3,17,16,38,22,161
27,18,-20,-3,-103,-80,-4,58,-107
-61,-34,-71,-58,-79,-118,-81,57,-445
-15,43,-30,-44,-48,-119,-45,73,-185
127,229,-60,34,-94,-102,56,171,361
0,-10,-48,-34,-50,-93,-40,50,-225
-66,-10,-80,-63,-87,-104,-47,62,-395
122,223,-68,27,-96,-103,50,166,321
6,11,-6,2,-28,-21,-3,19,-20
-59,-42,-75,-15,-109,-110,-42,52,-400
44,33,13,2,-18,-34,13,84,137
64,106,15,-38,-19,-55,16,100,189
11,33,-15,6,-40,-85,-38,66,-62
-32,14,-27,-35,-83,-156,-49,104,-264
-13,27,4,-5,-6,-41,-14,45,-3
15,94,-68,-50,31,-26,38,201,235
27,45,2,3,-25,-30,38,77,137
108,162,8,2,26,-16,87,145,522
32,50,-3,-17,-23,-29,27,56,93
256,635,-279,-23,-326,-397,278,583,727
38,22,-37,6,-147,-165,-46,72,-257
118,166,14,3,22,-15,90,151,549
67,367,-3,-149,-198,-462,-41,405,-14
35,54,-2,-14,-19,-30,28,57,109
33,3,-83,-58,-104,-121,-14,72,-272
28,59,-16,28,-109,-67,19,62,4
62,132,-57,13,-65,-94,17,95,103
155,270,15,107,-81,-26,12,88,540
-1,28,-40,-9,-19,-44,0,26,-59
32,57,8,-17,19,-6,28,71,192
13,35,-27,-55,-63,-73,-5,88,-87
177,228,-20,-11,-58,-99,114,254,585
16,32,-3,8,-27,-40,-1,34,19
95,160,-7,70,-68,-34,9,92,317
5,23,-24,-16,-23,-36,5,34,-32
137,133,81,60,3,1,23,156,594
80,87,22,59,-58,-71,25,119,263
64,102,13,-40,-22,-50,15,101,183
33,40,5,-2,19,16,37,23,171
-29,119,-234,-151,-405,-545,-140,293,-1092
-67,-41,-74,-60,-84,-125,-65,41,-475
47,76,20,-8,3,-51,22,105,214
117,164,8,1,12,-16,88,150,524
127,240,13,82,-50,-20,6,54,452
12,1,-24,-8,-18,-50,-9,28,-68
267,263,-9,118,-3,-69,53,389,1009
31,136,6,-83,-30,-108,13,194,159
13,40,-18,-7,-31,-36,3,19,-17
15,30,20,-4,20,-11,17,23,110
-57,-18,-70,-62,-60,-117,-75,56,-403
28,74,-28,-18,-54,-48,11,90,55
78,59,-9,-30,-24,-142,-20,121,33
-26,19,-18,9,-63,-79,-36,73,-121
-43,43,-17,-39,-35,-95,-25,83,-128
50,26,5,-9,6,-65,10,49,72
32,56,-41,-17,-44,-118,-46,58,-120
9,11,-12,-5,-9,-32,-4,12,-30
1,14,-18,8,-23,-23,-1,18,-24
3,28,-20,-23,-36,-9,13,33,-11
91,211,58,54,-13,-66,112,263,710
17,36,-11,-12,-19,-17,10,74,78
61,-2,3,-8,-31,-13,12,63,85
13,52,-73,-41,-83,-107,-11,83,-167
15,54,-56,-29,-178,-207,-11,221,-191
6,35,5,-18,13,-20,10,58,89
52,124,9,-35,24,-42,14,154,300
54,63,-55,3,-82,-95,-7,30,-89
-42,-3,-40,-57,-59,-83,-26,56,-254
4,27,-14,-23,-44,-29,4,35,-40
-28,33,-100,-41,-133,-126,-34,128,-301
-52,-44,-71,-52,-107,-142,-46,58,-456
24,41,14,-9,-5,-3,11,37,110
-2,11,-20,-7,-28,-23,-7,15,-61
-6,-8,-53,-44,-74,-91,-44,88,-232
-21,20,-33,-31,-28,-82,-37,64,-148
38,99,-10,-10,-69,-111,-7,46,-24
9,39,-20,17,-64,-94,-14,64,-63
180,188,117,-50,109,-57,55,232,774
-24,31,-25,-13,-59,-101,-56,81,-166
56,160,-26,-31,6,-29,59,148,343
63,77,-13,-44,-106,-81,15,171,82
28,26,-20,0,-44,-40,5,12,-33
2,11,1,-6,-4,5,4,21,34
303,499,46,-9,0,-78,179,456,1396
60,71,-26,-9,-50,-85,-9,67,19
-11,10,-43,-33,-120,-129,-37,76,-287
24,48,-22,-59,-84,-109,-13,79,-136
25,45,11,3,11,18,39,29,181
6,79,-25,-33,-44,-163,-61,93,-148
20,26,-18,-19,-95,-60,-4,104,-46
17,16,-8,-21,-14,-43,16,24,-13
65,163,-38,-14,-130,-213,-11,142,-36
2,46,9,2,-3,-26,4,38,72
13,6,-76,-36,-174,-132,-17,108,-308
7,15,2,-6,7,-3,4,23,49
35,331,-35,-56,-196,-598,-154,384,-289
56,80,-14,-9,-24,-13,42,102,220
8,35,-13,-3,-21,-13,2,45,40
-82,-24,-57,-62,-107,-126,-74,69,-463
-12,9,-9,0,-17,-35,-22,31,-55
-40,-29,-52,-28,-80,-131,-63,52,-371
26,39,-12,5,-44,-80,13,58,5
28,34,-1,22,-21,-7,20,46,121
-78,14,-82,-42,-130,-169,-56,117,-426
-12,-23,-36,-20,-47,-71,-20,47,-182
-21,-21,-27,-32,-47,-47,-21,28,-188
-61,-38,-54,-59,-90,-104,-77,58,-425
33,33,-63,-10,-108,-155,-29,123,-176
4,10,-19,2,-31,-29,1,43,-19
-53,-28,-65,-37,-84,-129,-86,58,-424
1,82,-76,-72,5,-35,57,149,111
7,37,-32,-38,-84,-88,-5,85,-118
-2,39,26,-76,-56,-126,-46,113,-128
18,117,70,40,39,113,40,198,635
58,102,-27,-70,23,-82,24,119,147
31,77,3,-44,32,-56,26,132,201
-18,38,20,33,-93,21,22,117,140
114,137,45,-10,84,-8,50,144,556
29,70,-29,-53,5,-76,13,48,7
95,206,-257,-283,-276,-334,-9,416,-442
16,36,-1,-3,2,-13,13,20,70
20,55,-21,-58,-55,-71,-35,101,-64
109,45,-43,21,-49,-86,60,92,149
-12,21,-50,-47,-71,-85,-12,87,-169
47,22,-60,-15,-120,-175,-30,97,-234
-4,10,-11,-11,-15,-7,-3,13,-28
32,70,-25,-48,-101,-191,-20,75,-208
22,54,-22,-54,-81,-113,-24,79,-139
24,63,15,15,-21,-14,2,62,146
59,140,-106,-75,-129,-145,-33,210,-79
65,107,3,15,-47,-61,28,120,230
113,201,-55,39,-185,-166,18,94,59
-41,-13,-36,-7,-42,-83,-31,28,-225
42,49,-36,-54,-14,-47,32,87,59
18,55,-10,-9,-42,-53,1,93,53
31,88,-48,-19,-67,-59,-8,58,-24
137,233,2,96,-79,-18,7,79,457
52,58,0,-8,-18,-53,10,72,113
16,23,-29,-28,-87,-108,-27,72,-168
-11,20,17,-24,-59,-58,-11,80,-46
23,-5,-40,-29,-52,-49,4,53,-95
102,167,13,-11,7,-16,86,155,503
-64,-25,-71,-60,-87,-104,-81,71,-421
19,88,17,-30,-6,-81,-15,55,47
0,5,-17,-17,-20,-27,-8,30,-54
-99,-11,-91,-71,-130,-231,-110,127,-616
27,38,-13,-15,-45,-31,21,27,9
85,144,-51,-25,-143,-109,6,194,101
6,14,-1,-4,0,-13,-3,7,6
3,90,-33,-27,-41,-198,-66,132,-140
48,113,40,22,-46,-27,23,112,285
34,84,10,-41,30,-42,36,130,241
20,17,-31,-17,-46,-34,6,31,-54
32,50,-2,-16,-23,-27,30,59,103
42,49,9,30,-16,-22,-2,87,177
54,90,-52,-50,-12,-75,35,88,78
-3,3,-7,-3,-12,-6,-2,16,-14
26,24,-31,-18,-88,-99,3,54,-129
82,57,-57,-58,-120,-129,-14,179,-60
86,125,57,-45,42,-33,39,144,415
42,44,-10,11,-75,-79,4,70,7
69,58,-15,-20,-16,-73,-4,104,103
13,44,-5,-8,-16,2,23,34,87
13,23,-23,-21,-22,-91,-23,55,-89
25,60,-13,-25,-14,-94,-3,67,3
68,129,5,-42,16,-41,50,151,336
116,167,12,3,14,-17,86,151,532
5,29,-17,-29,-3,-62,0,69,-8
130,125,37,45,-13,-51,70,175,518
377,412,54,-210,230,-220,66,338,1047
17,20,19,-6,18,-35,10,45,88
-3,44,8,-7,-72,-58,-12,73,-27
-3,35,-17,-21,-32,-41,-5,51,-33
-38,7,-58,-28,-79,-86,-49,69,-262
-26,6,-11,0,-19,-44,-34,18,-110
-61,-14,-66,-54,-88,-110,-64,66,-391
256,429,-49,-53,-240,-256,117,388,592
12,73,-42,-49,-62,-65,-11,104,-40
26,11,-61,-21,-111,-151,-13,103,-217
5,20,-14,-32,-2,-22,2,26,-17
19,157,31,-4,-27,1,49,190,416
-10,35,-11,-26,-57,-59,-9,36,-101
16,13,-70,-45,-136,-202,-61,81,-404
-17,64,-99,-31,-26,-17,28,92,-6
91,160,-10,-40,-82,-85,9,141,184
-43,1,-99,-9,-153,-171,-51,91,-434
8,297,-149,-198,-378,-436,-112,633,-335
110,159,10,0,26,-13,93,146,531
75,101,30,5,-28,-49,11,105,250
29,20,-29,-21,-72,-79,24,71,-57
90,130,16,23,-62,-64,11,115,259
66,92,-29,-39,-66,-101,25,70,18
65,111,11,14,-19,-74,31,119,258
17,60,15,-6,-4,-54,-11,50,67
100,183,-76,-129,-161,-360,8,333,-102
-4,9,-22,-12,-26,1,8,16,-30
-59,-30,-72,-54,-71,-118,-69,66,-407
167,169,-30,27,-58,-58,67,239,523
17,13,-9,2,-13,-1,20,14,43
0,40,-22,-27,-89,-92,-8,83,-115
5,43,1,-40,-8,-28,15,38,26
233,285,-191,-29,-310,-362,10,413,49
55,139,-8,-38,24,-101,13,130,214
-2,1,-22,5,-39,-34,-22,42,-71
4,20,13,-12,-6,-15,3,37,44
-17,105,-36,3,-110,-219,-78,129,-223
16,45,-16,-22,-33,-22,38,26,32
-65,-6,-71,-64,-80,-118,-61,68,-397
-30,-28,-62,-27,-91,-120,-72,70,-360
64,135,31,-13,26,-27,49,128,393
17,19,-5,-25,2,-36,-1,24,-5
67,121,90,110,-30,-74,6,191,481
-50,8,-33,-22,-83,-92,-30,109,-193
35,54,-6,-16,-19,-25,16,64,103
31,39,-27,-10,-36,-29,36,37,41
-3,22,-14,-3,-36,-41,-2,38,-39
160,141,-3,10,-29,-22,98,153,508
17,32,-31,-59,-80,-105,-18,72,-172
72,115,23,-14,-25,-49,40,97,259
45,31,-23,-3,-55,-54,13,19,-27
3,35,-35,-20,-34,-15,-1,63,-4
61,19,-40,6,-74,-74,12,89,-1
24,25,-8,-5,-20,-19,30,64,91
20,28,-12,-16,1,-50,5,70,46
-1,17,-12,-12,-33,-51,-5,37,-60
-60,-3,-55,-31,-92,-134,-80,49,-406
11,24,-44,9,-67,-122,-36,69,-156
247,446,-85,-126,-43,-269,143,585,898
28,96,-31,-11,-33,-6,58,124,225
-1,69,4,-23,-17,-108,-19,103,8
15,56,-90,-7,-147,-166,-26,101,-264
-17,14,-20,2,-38,-87,-44,27,-163
188,277,-65,-45,-119,-280,-1,376,331
-4,31,3,-12,-10,-15,0,28,21
-50,-8,-62,-58,-84,-108,-58,64,-364
19,19,-2,-23,-20,-48,-24,23,-56
39,101,-2,-38,-52,-78,1,177,148
131,133,2,82,-102,-128,45,139,302
25,18,-28,-12,-24,-51,0,54,-18
118,197,-36,41,-40,-96,61,182,427
5,17,-13,-9,21,-21,-2,11,9
111,154,-10,-27,-11,-63,55,193,402
-33,-25,-24,-13,-58,-63,-39,26,-229
36,70,-15,-14,-25,-29,32,67,122
-74,-52,-75,-57,-84,-129,-73,49,-495
243,447,-95,-118,-37,-274,130,582,878
62,100,39,-7,26,-33,43,142,372
-101,-50,-78,-91,-94,-115,-77,35,-571
10,18,-34,-11,-54,-51,-1,51,-72
36,19,-53,-43,-82,-74,-20,32,-185
17,20,-13,-11,-23,-32,-4,42,-4
-74,-34,-69,-69,-75,-123,-93,52,-485
119,286,-103,-109,-391,-226,-28,655,203
10,30,30,-5,23,0,19,41,148
-80,104,-314,-92,2,40,82,193,-65
115,197,-28,43,-24,-39,53,155,472
86,156,8,-28,-40,-98,88,154,326
-61,-46,-55,-50,-50,-63,-42,39,-328
172,299,72,-1,87,92,153,301,1175
54,56,2,5,-15,-33,11,81,161
2,0,-28,-16,-24,-57,-29,13,-139
307,331,24,25,-92,-90,96,352,953
-47,-45,-68,-55,-103,-153,-73,58,-486
27,64,-9,-38,-36,-55,26,116,95
-26,122,-150,-79,-11,20,54,106,36
136,179,20,20,57,-5,92,162,661
115,166,9,1,16,-17,87,150,527
138,282,25,-5,46,-97,68,273,730
-1,2,1,-5,-25,-34,6,36,-20
254,431,-51,-54,-241,-252,123,391,601
65,124,-61,-72,-90,-131,32,166,33
-92,13,-91,-63,-139,-148,-61,99,-482
31,41,-6,3,-22,-34,19,41,73
-15,-10,-60,-37,-86,-73,-16,47,-250
207,253,-79,-49,-142,-250,33,223,196
8,34,-11,-31,0,-61,3,80,22
20,91,-86,-46,-131,-143,-16,154,-157
7,5,-9,-4,-3,-28,-1,16,-17
10,51,-28,-41,-32,-75,-16,107,-24
29,12,2,-11,-88,-86,-9,119,-32
-4,91,-71,-42,-13,6,21,100,88
33,82,-3,-21,13,9,44,78,235
91,125,-22,-78,-107,-156,16,169,38
2,16,6,2,2,-18,1,28,39
-12,14,-13,-7,-19,-25,-7,47,-22
4,38,-116,-80,-79,-144,-19,116,-280
7,29,-25,-10,-25,-23,14,41,8
36,116,-86,-34,-221,-319,-51,244,-315
339,503,-241,-124,-383,-230,123,389,376
21,40,-20,-21,-63,-67,2,64,-44
9,5,-8,-30,-4,-29,-2,8,-51
113,231,-41,27,-82,-79,46,163,378
31,18,-43,-19,-81,-57,-11,40,-122
44,30,-9,6,-1,-6,21,89,174
220,329,22,51,-219,-291,61,536,709
301,275,-243,88,-483,-461,56,273,-194
401,504,-26,-84,-120,-276,153,633,1185
102,284,-27,-48,-115,-398,-66,379,111
142,197,16,-31,-31,-121,36,175,383
197,374,0,-17,28,63,138,313,1096
201,239,109,-19,64,-57,91,297,925
356,409,-5,92,-24,-100,85,558,1371
7,25,-16,-11,-25,-24,16,41,13
127,241,-12,-2,-104,-117,54,253,440
62,50,20,-4,-9,-46,14,103,190
79,114,-25,-41,-31,-78,50,150,218
75,98,-139,-118,-282,-298,-32,362,-334
-3,16,-29,-21,-28,-25,1,39,-50
15,14,7,-8,2,-32,1,41,40
30,67,8,-13,11,-42,2,48,111
61,68,-112,-65,-199,-157,-49,232,-221
35,26,-10,-1,-24,-46,-10,44,14
28,42,-67,-68,-103,-127,-17,124,-188
106,141,-193,-81,-310,-350,-9,220,-476
10,79,7,-56,31,-20,56,92,199
71,162,-54,-48,-69,-68,32,235,261
34,144,-116,-34,-208,-191,46,199,-126
19,46,-13,8,-74,-81,-6,60,-41
21,67,-81,-68,-106,-107,2,172,-100
-6,-14,-59,-76,-81,-119,-18,112,-261
17,27,24,-3,1,15,-3,41,119
16,23,-11,-32,10,-11,8,50,53
-107,207,-167,-66,40,45,103,253,308
101,123,-24,-41,-68,-92,14,153,166
46,89,-5,-19,4,-21,42,58,194
110,206,-48,55,-92,-75,57,154,367
298,382,78,-211,202,-204,99,362,1006
0,3,-9,-15,-14,-11,7,13,-26
33,50,-88,-5,-127,-183,-27,115,-232
39,78,-30,9,-50,-56,11,31,32
-3,71,-51,-44,-44,-47,36,124,42
23,22,-8,-15,1,-32,-1,62,52
14,14,-11,4,-15,-24,-6,21,-3
131,228,-37,-20,-95,-142,26,247,338
12,63,24,-27,39,-51,14,93,167
23,36,-7,-51,-69,-66,-14,89,-59
-4,78,11,-29,-49,-78,-7,84,6
12,10,-50,-34,-91,-80,-16,43,-206
108,84,8,43,-39,-69,39,166,340
-15,-16,-12,-14,-59,-26,-6,31,-117
40,84,1,-2,-15,-27,16,106,203
0,-1,-21,-12,-39,-39,-19,22,-109
35,57,-1,-13,-33,-35,33,83,126
-4,7,-15,3,-5,-13,-6,10,-23
18,30,8,4,4,-10,4,29,87
-27,52,-122,-40,-34,-7,34,89,-55
-40,35,2,-32,-45,37,-50,7,-86
17,27,-6,5,-12,-14,10,11,38
52,56,4,-21,-7,-45,2,84,125
1,33,3,-7,-9,4,10,30,65
145,158,-57,46,-68,-29,112,87,394
63,138,35,-5,18,-28,41,121,383
25,48,-5,-6,-21,3,32,50,126
65,127,23,-10,19,-28,60,123,379
53,78,-48,-44,-69,-49,35,115,71
58,133,18,-3,3,-42,47,135,349
63,90,-39,-11,-84,-116,8,126,37
22,22,-10,-1,-20,-44,2,37,8
-10,-7,-19,-32,-31,-37,-11,34,-113
10,23,-3,-14,-10,-6,16,46,62
-1,33,9,1,-37,-70,-11,56,-20
2,33,-12,-5,-43,-67,-4,77,-19
2,8,-19,-13,-21,-16,-4,6,-57
253,249,-34,-89,-4,-104,55,204,530
-22,66,-76,-65,-4,-18,14,72,-33
27,216,-1,-86,-91,109,32,145,351
-2,64,-26,-23,-9,-37,-3,71,35
-3,24,-40,-20,-64,-115,-23,112,-129
13,12,18,-8,-18,-21,-3,37,30
1,11,-7,-4,-26,-11,-15,35,-16
45,89,14,3,9,-43,14,106,237
52,126,33,0,12,-24,47,120,366
0,9,-11,-7,-22,-8,-3,25,-17
-38,32,8,-16,-47,39,-46,13,-55
48,26,-33,-27,-34,-73,-15,43,-65
71,92,-57,-53,-35,-137,-13,194,62
0,54,-26,-35,-11,-38,-2,65,7
28,41,-8,-7,-24,-44,-14,85,57
48,59,-34,-44,-9,-44,30,81,87
122,222,-16,-9,-78,-139,12,258,372
3,43,-51,-65,-88,-38,-5,95,-106
125,203,-73,10,-78,-149,80,190,308
17,22,-27,-16,-55,-52,23,47,-41
178,243,-89,-68,-59,-123,75,246,403
54,44,-34,6,-91,-108,-16,100,-45
30,90,-36,-21,-55,-121,-40,109,-44
0,64,-31,-36,-6,-36,-9,72,18
117,168,-1,7,24,-25,97,142,529
-1,5,-5,2,-7,-8,7,19,12
21,34,-13,-4,-27,-40,10,16,-3
-20,-14,-69,-54,-53,-138,-52,95,-305
10,-25,-40,-7,-64,-73,-30,33,-196
-19,0,-23,7,-31,-37,-3,25,-81
67,108,37,3,46,10,50,102,423
1,33,9,23,-23,-34,-2,41,48
4,20,-23,1,-42,-37,-1,27,-51
87,127,-22,-41,-21,-71,48,151,258
67,95,-67,-56,-88,-54,-15,267,149
121,171,2,8,13,-24,93,152,536
17,116,26,-24,-44,69,-8,101,253
9,78,-70,-43,-67,-178,-25,122,-174
60,139,30,-1,20,-30,50,127,395
3,48,-11,-19,-28,-22,5,92,68
-23,-15,-47,-58,-57,-89,-31,86,-234
118,166,9,-3,14,-20,86,145,515
-19,10,-30,-23,-55,-29,1,58,-87
3,37,12,23,-23,-28,0,39,63
74,119,-65,-33,-145,-132,44,51,-87
67,72,-27,1,-28,-37,30,98,176
-15,10,-9,-17,4,-6,1,19,-13
24,63,-4,-58,13,-112,-29,89,-14
14,51,-24,-4,-55,-43,15,86,40
-55,48,-214,-61,-21,6,33,144,-120
115,167,7,5,19,-21,88,145,525
-69,65,7,-60,-78,60,-83,9,-149
27,46,-38,-31,-71,-183,-29,90,-189
168,188,51,22,39,33,111,204,816
14,53,-30,-11,-63,-89,-39,56,-109
63,82,-54,27,-171,-188,-14,78,-177
49,54,11,-1,8,14,18,78,231
-42,57,-145,-183,-227,-300,-156,290,-706
28,40,-55,-54,-43,-30,49,57,-8
5,25,-2,12,-27,-12,4,57,62
11,33,-21,-24,-65,-91,-19,110,-66
2,1,-14,-12,-40,-23,-6,15,-77
153,100,-42,28,-40,-98,37,139,277
26,58,11,-3,33,16,40,59,240
-1,5,-26,-26,-8,-64,-36,21,-135
50,67,-5,9,-57,-34,32,44,106
33,34,-1,-1,-21,-15,14,55,98
2,29,-31,-30,-34,-21,5,51,-29
123,300,-16,71,-64,35,130,14,593
74,102,21,-21,10,-7,63,129,371
22,51,29,9,18,-23,13,55,174
-22,-12,-18,-29,-15,-25,-17,13,-125
129,261,-132,-126,-401,-351,-88,747,39
4,28,-72,-41,-152,-155,-29,118,-299
17,23,-27,-15,-64,-71,-10,21,-126
99,174,8,-38,-13,-99,61,196,388
111,300,-83,-184,-133,-369,6,455,103
10,37,-14,-18,-61,-58,-25,75,-54
44,52,-128,-150,-205,-250,-34,170,-501
-26,-1,-71,-36,-74,-84,-23,44,-271
0,23,17,2,-9,-21,-5,30,37
8,17,-17,0,-24,-33,-5,28,-26
234,432,-141,-44,-271,-221,64,303,356
204,255,10,-22,-66,-163,49,230,497
15,25,-14,-5,-15,-14,2,32,26
93,76,12,-12,-3,-78,1,113,202
136,292,8,-9,39,-97,73,271,713
42,96,-31,-7,-72,-88,5,123,68
5,14,0,-9,1,-16,6,8,9
19,24,10,-10,12,-15,2,32,74
17,139,-85,-157,-120,-206,-12,246,-178
33,62,24,22,-3,-59,7,72,158
44,64,-19,-28,-26,-57,9,83,70
39,60,51,-21,9,-11,30,126,283
14,42,-7,-14,4,-16,18,53,94
40,25,-22,-3,-38,-15,21,16,24
62,93,-45,-4,-101,-113,-8,197,81
25,31,-25,-12,-41,-43,0,42,-23
-71,-20,-59,-42,-75,-114,-60,67,-374
16,80,63,23,30,60,-16,125,381
50,56,-44,8,18,-10,40,36,154
230,369,-277,-262,-411,-543,-7,585,-316
67,134,13,13,-55,-67,10,133,248
-3,25,4,-40,-7,21,7,33,40
-18,7,-13,-10,-22,-11,-12,10,-69
27,10,-12,-27,-23,-21,-9,36,-19
-7,52,-16,-13,-36,-98,-15,105,-28
47,129,12,-52,21,-65,13,107,212
25,50,16,3,-55,-48,3,137,131
96,240,12,-51,-10,-90,51,237,485
95,47,-15,-5,-49,-24,27,93,169
73,103,46,26,6,-14,50,121,411
1,1,-24,3,-31,-18,1,7,-60
1,1,-24,3,-31,-18,1,7,-60
1,1,-24,3,-31,-18,1,7,-60
-19,-16,-14,-20,-16,-27,-30,11,-131
317,468,78,-32,80,145,219,428,1703
168,199,53,13,-23,-50,32,166,558
-14,20,-33,-6,-50,-86,-39,48,-160
60,286,-38,-72,-74,-182,56,190,226
-6,-11,-26,-19,-38,-32,-18,19,-131
71,67,-7,-16,-2,-65,-23,87,112
-32,96,-62,-44,-28,-3,42,169,138
-18,59,-60,-65,17,-18,11,51,-23
-12,55,-98,-47,-13,9,56,97,47
201,383,9,-15,15,-184,116,407,932
38,63,-17,-14,-42,-103,-19,77,-17
23,33,-20,-4,-45,-65,11,32,-35
16,50,-16,-19,-51,-88,-14,65,-57
23,142,-269,-224,-388,-483,-74,414,-859
6,-1,-35,-25,-60,-43,0,46,-112
84,83,-112,-51,-166,-186,3,154,-191
2,35,-22,-14,-55,-50,-9,73,-40
27,32,11,-19,-70,-72,-56,128,-19
17,32,-3,-27,-75,-70,-41,134,-33
2,7,-48,-51,-78,-98,-12,94,-184
56,113,68,-27,30,-51,22,124,335
21,49,34,1,1,24,25,52,207
-37,207,-50,-10,37,63,99,283,592
4,23,-37,-25,-21,-20,7,42,-27
41,69,-36,8,-46,-39,-3,32,26
-87,-34,-103,-84,-106,-143,-92,88,-561
63,88,-49,1,-43,-62,59,99,156
76,129,-91,-62,-184,-200,-10,205,-137
82,57,-16,-7,-47,-22,20,81,148
106,92,38,21,25,-45,30,117,384
-20,12,-42,-42,-47,-38,-7,41,-143
17,69,-2,-5,-14,-27,17,77,132
70,107,17,-42,-19,-47,12,104,202
-41,-11,-39,-22,-65,-83,-33,67,-227
105,128,-8,12,-10,-25,83,101,386
79,118,-22,-44,-29,-64,58,143,239
213,198,19,-53,36,-126,64,232,583
-12,36,-28,-53,-47,-99,-43,89,-157
-5,25,-21,-16,-18,-60,-10,46,-59
58,84,-43,-13,-87,-128,4,121,-4
14,31,4,-15,-6,-18,10,34,54
13,20,-4,-3,-15,-30,-3,22,0
24,40,-4,-15,-16,-16,22,45,80
11,69,21,-14,-7,-35,6,72,123
7,43,-7,-22,-20,-40,13,39,13
37,119,-67,-60,-145,-163,9,176,-94
24,19,-6,-13,-12,-45,-10,32,-11
7,-5,-21,-26,-39,-31,2,14,-99
62,99,18,-32,6,-28,60,117,302
16,11,1,8,-11,-16,2,11,22
-29,16,-21,-15,-45,-83,-32,43,-166
13,16,-9,-25,-3,-20,-7,41,6
40,119,-38,-26,-35,-160,-25,154,29
7,37,45,15,14,11,3,50,182
323,394,60,-215,217,-205,86,355,1015
107,264,34,40,-39,-262,-38,268,374
42,28,-43,0,-54,-48,13,49,-13
8,19,-33,-28,-81,-91,-33,63,-176
57,89,-38,-17,-78,-114,7,125,31
51,95,-64,-10,-82,-117,-10,139,2
62,82,-34,-6,-87,-116,17,124,42
119,203,54,-5,-25,-38,99,223,630
14,22,-13,-17,-14,-7,8,20,13
-1,84,-81,-32,-11,7,74,139,179
57,85,-40,-9,-80,-118,11,122,28
0,29,-101,-61,-96,-185,-61,118,-357
-12,-9,-23,-27,-31,-35,-29,42,-124
32,20,-41,11,-122,-134,-36,64,-206
3,-15,-40,-55,-48,-85,-12,55,-197
144,188,8,5,2,-70,39,218,534
64,74,-14,12,-78,-75,45,96,124
-3,26,-1,-16,-3,-39,5,44,13
58,81,-43,-11,-88,-120,3,122,2
22,41,19,5,-4,-12,17,51,139
11,31,8,-1,0,-33,-5,30,41
8,9,9,-16,19,-14,4,30,49
-13,16,-17,-17,-32,-43,-34,50,-90
59,83,-40,-7,-82,-119,11,125,30
60,83,-45,-9,-88,-119,5,123,10
57,84,-41,-11,-86,-121,10,121,13
27,26,-10,1,-26,-49,9,43,21
60,80,-43,-9,-90,-122,11,122,9
55,84,-42,-10,-86,-116,8,121,14
72,121,-50,5,-121,-60,75,64,106
123,194,-21,47,-36,-91,66,167,449
84,76,11,-18,-37,-94,-10,101,113
109,165,-6,-10,14,-17,89,143,487
415,463,-63,54,-246,-103,262,662,1444
60,84,-42,-11,-85,-121,5,124,14
1,8,-7,2,-4,-15,-6,6,-15
167,433,-540,-110,-901,-22,-80,547,-506
79,63,-10,-38,-27,-18,30,41,120
-14,33,-6,-15,-27,-32,2,49,-10
322,388,103,-208,236,-213,68,379,1075
10,37,-14,-18,-61,-58,-25,75,-54
15,19,-9,-8,-11,-14,13,25,30
25,80,-47,16,-109,-110,14,60,-71
-5,14,-18,-2,-19,-40,-6,40,-36
35,66,-18,-27,-7,-40,24,74,107
6,105,2,5,-15,18,26,122,269
13,18,-36,-18,-28,-23,-3,19,-58
286,347,109,-22,97,-21,167,403,1366
712,695,-63,-116,84,-31,321,907,2509
26,7,-10,-28,-33,-54,-3,25,-70
69,81,-7,-6,-25,-85,27,92,146
39,67,18,-25,4,-43,26,91,177
36,61,-38,-64,-25,-99,-21,63,-87
47,89,-28,-75,10,-66,18,122,117
35,52,-34,-66,-27,-104,-21,63,-102
22,51,-26,-58,-23,-95,-16,63,-82
-3,8,-10,-27,-4,-33,-7,2,-74
48,88,-21,-72,16,-78,9,121,111
-22,-29,-19,-12,-18,-52,-30,15,-167
17,46,-14,-9,-12,-2,17,46,89
19,34,-24,-14,-45,-51,-6,51,-36
-1,13,-6,-7,-26,-22,-2,31,-20
6,41,16,-2,18,-8,6,46,123
0,4,-6,5,-1,-36,-13,36,-11
60,128,25,-11,-1,-68,24,133,290
4,7,-12,-5,-19,-3,-6,29,-5
0,49,14,12,-36,-41,-1,72,69
71,86,-44,-36,-26,-94,18,141,116
-7,-2,-4,-7,-10,-16,-1,10,-37
6,37,-30,-20,-30,-16,1,63,11
61,96,-12,-65,23,-65,29,130,197
112,188,-16,57,-66,-107,29,166,363
30,54,-3,8,-16,-31,28,68,138
31,53,-35,-60,-28,-94,-20,53,-100
3,25,-5,-3,-8,-9,5,20,28
-81,18,-99,-74,-136,-138,-98,173,-435
1,6,-10,-14,-2,-19,1,23,-14
168,221,-66,-60,-67,-145,20,241,312
6,6,-14,-4,-22,-15,3,11,-29
-18,-6,-14,-37,-34,-29,-12,28,-122
-1,53,-26,-29,-44,-126,-65,73,-165
149,253,1,104,-82,-15,7,72,489
1,45,2,-6,2,-19,10,36,71
-30,-6,-13,-20,-22,-53,-24,28,-140
145,381,-37,127,-93,97,178,-5,793
5,17,-5,2,0,-2,10,22,49
-4,24,-6,-15,-3,-38,-11,34,-19
22,39,26,8,13,-18,5,69,164
-6,-4,-43,-10,-47,-65,-20,43,-152
114,188,-25,32,-49,-89,56,161,388
5,7,-9,2,-26,-22,0,35,-8
36,89,-19,-24,-34,-16,33,75,140
1,24,-6,-10,-12,-26,-13,32,-10
126,212,-22,45,-43,-94,59,178,461
23,36,-4,-2,-14,-12,32,40,99
-1,17,-7,-8,-14,-26,6,29,-4
23,14,0,-21,8,-23,8,31,40
-13,6,-14,-24,-47,-75,-29,37,-159
122,205,-26,48,-42,-90,58,184,459
1,31,-12,1,-16,-36,-10,35,-6
-1,17,-3,-10,3,-5,13,19,33
73,136,-1,11,-79,-83,0,129,186
112,185,-21,56,-66,-113,27,160,340
95,109,13,-23,18,-57,49,137,341
404,500,-191,117,-495,-437,56,213,167
-32,-29,-40,-27,-51,-62,-32,39,-234
37,118,36,18,-19,-65,-9,108,224
46,101,41,-12,34,21,52,101,384
-32,50,-48,-79,-78,-113,-38,58,-280
24,55,6,-4,-12,-16,20,68,141
37,70,35,-4,25,-12,16,62,229
155,169,22,-66,80,-92,20,182,470
19,101,-26,4,-13,-43,31,53,126
113,177,-17,45,-56,-107,19,172,346
-7,29,8,-11,-9,-26,3,32,19
3,22,2,-10,-3,-21,1,25,19
-7,14,-10,-5,-3,-23,-14,20,-28
26,39,-15,-14,-37,-44,9,46,10
15,25,-15,15,-24,-28,-5,16,-1
19,32,-4,-3,-3,-15,5,26,57
11,13,-7,-1,-8,-16,-5,14,1
65,113,21,-26,34,-51,29,121,306
84,251,-211,-137,-321,-311,46,405,-194
-19,12,-24,-24,-28,-17,-16,34,-82
10,44,26,-12,17,-17,11,57,136
48,56,9,29,-40,-61,3,82,126
32,37,-71,-45,-163,-106,-21,112,-225
-21,63,-30,-15,-47,-54,7,61,-36
91,114,-84,-82,-130,-118,27,149,-33
17,31,-40,-56,-25,-116,-22,89,-122
2,33,-10,-35,-35,-53,4,62,-32
-32,16,-74,-19,-129,-127,-34,108,-291
25,35,-63,-62,-67,-75,13,94,-100
32,48,-38,-11,-53,-47,9,92,32
18,67,-16,-29,-83,-6,44,89,84
-15,25,-37,-27,-95,-142,-32,86,-237
11,50,-142,-132,-224,-264,-46,220,-527
88,122,-57,-99,-155,-129,47,238,55
36,31,-11,5,-43,-7,-4,30,37
43,77,50,-32,65,-30,10,85,268
75,56,19,11,-70,-82,-43,163,129
-13,16,-6,-9,-6,-12,-13,24,-19
36,23,-50,-25,-60,-75,-4,30,-125
0,11,-15,-19,-25,1,6,28,-13
36,134,-58,-47,-129,-79,33,186,76
-43,12,-68,-52,-84,-89,-44,76,-292
30,36,29,-26,-5,-18,6,149,201
24,37,-76,-76,-125,-130,-13,80,-279
-4,56,-39,-43,-66,-89,-42,132,-95
6,117,9,-37,-44,-103,-6,150,92
175,203,-12,-32,-150,-156,29,223,280
54,69,3,-7,7,-17,14,47,170
18,2,-20,-6,-40,-55,-5,20,-86
15,4,1,1,-15,-23,5,24,12
91,180,-140,-78,-252,-196,1,292,-102
28,30,-16,-60,-22,-61,-3,107,3
-27,76,-47,-65,-129,-290,-120,232,-370
-2,-9,-32,-38,-45,-42,1,34,-133
107,138,8,52,-75,-137,42,231,366
11,21,-23,-54,-43,-36,-10,100,-34
17,-8,-29,-15,-33,-39,12,25,-70
-79,-31,-92,-45,-148,-161,-72,82,-546
37,59,-15,-28,-104,-57,16,131,39
64,139,40,19,-58,-93,12,141,264
-65,-2,-144,-151,-235,-145,-32,168,-606
8,20,-12,4,-18,-26,3,21,0
29,37,-75,5,-129,-143,-44,70,-250
12,55,-63,-51,-106,-125,-35,44,-269
24,42,-33,-15,-70,-33,14,50,-21
8,44,-49,-45,-101,-183,-54,142,-238
-7,78,-37,-77,-64,-86,-8,98,-103
21,35,-27,-22,-105,-78,-5,100,-81
1,15,-9,2,-11,-14,-1,6,-11
13,28,-11,0,-14,-30,-6,26,6
-82,-72,-82,-69,-104,-164,-93,59,-607
63,82,-56,-13,-102,-111,1,143,7
87,132,-59,-31,-15,-46,81,156,305
-11,-21,-48,-31,-68,-54,-17,30,-220
36,40,-2,-18,5,-40,-17,39,43
169,211,52,-37,-82,-19,32,325,651
293,262,-92,49,-174,-142,130,374,700
-45,0,-52,-34,-95,-148,-65,63,-376
56,75,-35,-6,-90,-91,-5,64,-32
55,74,0,48,-59,-16,27,101,230
147,173,-107,12,-259,-268,-36,210,-128
20,78,-14,-28,-64,-82,16,84,10
83,127,-39,-40,-4,-31,80,157,333
70,101,17,-24,-27,-102,18,145,198
15,8,-25,-9,-48,-74,1,55,-77
-6,60,-46,-27,-34,-77,-7,76,-61
52,5,-55,-19,-90,-86,9,101,-83
77,105,-33,-54,-106,-85,16,156,76
110,151,11,-39,-22,-96,5,237,357
64,67,-67,-31,-99,-81,29,143,25
42,62,21,42,-29,-33,12,73,190
-40,-14,-47,-23,-71,-64,-35,29,-265
67,84,-33,-67,-67,-72,2,148,62
27,110,-114,-79,-166,-334,-63,176,-443
55,51,-47,-62,-69,-52,18,123,17
-60,-10,-107,-43,-180,-214,-79,117,-576
15,13,-26,-48,-21,-38,9,44,-52
21,119,-70,-45,-168,-113,-28,168,-116
-51,-1,-130,-88,-169,-148,-50,116,-521
73,23,-26,62,-71,-42,34,86,139
5,6,-251,-188,-208,-279,-86,186,-815
90,52,-75,-9,-147,-202,21,161,-109
-55,-53,-90,-53,-108,-115,-42,61,-455
1,6,-25,-38,-53,7,-1,50,-53
-35,11,-86,-49,-134,-194,-79,89,-477
145,142,63,-46,34,-73,22,183,470
45,38,-104,-95,-198,-289,-77,160,-520
106,130,15,-2,15,-58,35,161,402
53,2,-155,-49,-283,-390,-105,151,-776
84,221,-83,-73,-198,-297,40,233,-73
96,92,-36,-13,-60,-169,-12,144,42
-35,-7,-58,-49,-55,-128,-59,73,-318
3,27,-14,-25,-6,-19,9,33,8
34,120,-32,-47,-161,-89,-6,224,43
42,73,-81,-50,-125,-67,27,152,-29
23,60,-99,-88,-196,-157,-9,140,-326
-25,10,-53,-37,-111,-50,12,59,-195
116,188,-159,-167,-261,-407,-90,386,-394
115,124,-68,-85,-125,-169,-3,262,51
23,48,-46,-44,-63,-74,9,66,-81
34,72,7,-17,-69,-80,7,121,75
8,26,0,-3,-5,-20,-3,24,27
35,32,-54,-12,-94,-110,1,61,-141
114,131,-58,-50,-87,-170,17,144,41
146,197,-93,-17,-74,-157,60,165,227
-3,-8,-49,-80,-132,-195,-39,220,-286
17,67,-54,-51,-55,-110,-2,130,-58
188,481,104,-16,-200,-56,48,480,1029
12,-35,-64,-80,-103,-129,-80,128,-351
81,65,44,5,-3,-42,1,120,271
12,41,-91,-72,-156,-196,-65,137,-390
96,149,-34,-42,-79,-95,28,161,184
-56,35,-70,-39,-123,-106,-31,104,-286
24,62,-65,-27,-115,-108,15,122,-92
45,46,-12,12,6,14,33,27,171
3,59,-68,-23,-86,-86,-1,103,-99
68,95,-8,-23,-66,-122,-14,113,43
1,3,-8,0,-4,-23,-9,3,-37
8,28,-21,-28,-50,-78,-21,66,-96
34,32,2,-11,9,-18,15,30,93
149,113,-29,7,-27,-94,45,171,335
-16,-7,-49,-8,-78,-71,-36,27,-238
28,5,-68,-63,-154,-160,-51,124,-339
-1,60,-47,-52,-39,-74,-7,106,-54
171,94,-160,-213,-428,-693,-227,499,-957
466,496,385,97,259,97,216,696,2712
126,226,-48,14,-60,-31,137,170,534
17,77,-21,-8,-105,-143,-15,121,-77
13,60,-96,-74,-122,-165,-22,129,-277
-21,27,-25,-30,-51,-47,-14,66,-95
52,100,-94,-137,-145,-135,17,333,-9
59,96,-71,-53,-130,-157,1,208,-47
40,51,-68,-29,-89,-111,42,82,-82
65,124,83,52,-16,27,-57,157,435
198,251,-141,-168,-172,-443,-8,608,125
29,37,-14,-1,-22,-20,19,51,79
5,22,-48,-38,-90,-43,-1,77,-116
171,173,-64,-17,-228,-192,81,352,276
115,195,-92,-41,-68,-124,52,158,195
21,85,-93,8,-111,-97,38,181,32
74,33,22,126,-90,-36,57,102,288
50,89,20,0,-111,-60,8,174,170
-51,-21,-74,-59,-82,-126,-59,69,-403
25,34,-17,-18,-10,-55,-12,27,-26
12,48,-10,6,-2,-6,13,35,96
10,47,10,-31,-10,-98,-39,69,-42
-49,-5,-47,-38,-94,-158,-76,92,-375
-17,-2,-55,-61,-104,-134,-48,94,-327
123,150,-70,-35,-84,-78,-7,180,179
33,42,4,45,-34,-27,-2,82,143
3,77,-26,-36,-28,4,21,87,102
15,31,-49,-36,-69,-110,-28,85,-161
-92,8,-93,-58,-149,-130,-68,88,-494
16,64,-4,-9,-6,-13,22,90,160
-1,7,-13,-19,-9,-24,-10,21,-48
0,7,-35,-29,-79,-79,-12,49,-178
26,26,-39,-52,-141,-162,-56,129,-269
-9,-6,-5,-8,-12,-15,-16,4,-67
58,123,15,0,-44,-45,18,133,258
-17,89,-37,-35,-52,-74,-4,94,-36
74,107,3,-64,19,-38,20,123,244
54,104,-30,42,-74,-94,-4,136,134
-1,-21,-23,-46,-47,-73,-31,28,-214
14,76,42,-13,-20,-63,-5,94,125
4,30,3,-4,-38,-15,16,53,49
31,53,-9,-13,-79,-128,-9,154,0
99,183,-91,-169,-199,-399,-75,331,-320
88,42,-24,-40,-152,-271,-39,197,-199
0,13,-28,-12,-78,-15,-5,58,-67
7,11,-65,-26,-101,-59,-16,51,-198
19,4,-19,-6,-26,-33,-2,34,-29
52,140,-260,-276,-518,-507,-49,481,-937
6,23,-24,-40,-82,-61,-6,71,-113
-5,-40,-54,-64,-69,-126,-54,54,-358
188,213,-25,-30,-128,-134,63,288,435
123,99,-51,-6,-125,-113,40,185,152
-17,2,-40,-11,-88,-62,-26,31,-211
-31,-5,-52,-45,-55,-75,-36,48,-251
-28,-12,-56,-43,-83,-72,-29,49,-274
712,673,391,377,90,-2,244,903,3388
27,61,1,-9,-39,-126,-25,142,32
63,111,-8,-14,8,-51,18,117,244
-2,28,-11,-13,-37,-39,-10,32,-52
208,232,24,7,-88,-84,63,279,641
80,177,73,-38,38,-97,51,202,486
438,765,-7,-36,-51,-123,181,705,1872
105,258,-5,-3,-181,-238,-7,374,303
24,20,-5,9,-32,-15,1,28,30
-47,7,-39,-20,-85,-75,-24,114,-169
-3,7,-21,-8,-46,-62,-15,29,-119
81,85,-64,-114,-323,-211,1,341,-204
98,203,-39,-35,-92,-117,52,218,288
-83,2,-73,-63,-118,-92,-51,96,-382
47,214,-49,-130,-143,-233,-49,298,-45
179,200,-52,-24,-97,-178,54,244,326
272,428,3,29,-92,-248,80,447,919
25,41,-17,-29,-6,-58,-8,35,-17
45,17,-47,-49,-149,-70,33,123,-97
38,62,0,-29,1,-35,16,74,127
93,119,7,-34,-48,-70,28,170,265
95,137,22,-17,-13,-68,47,183,386
-1,7,-34,-9,-21,-25,0,2,-81
51,28,-48,-66,-85,-45,5,104,-56
21,20,-32,-18,-30,-34,23,52,2
248,440,150,-9,64,-168,67,454,1246
13,28,-19,-24,-31,-45,1,27,-50
56,40,-64,-13,-61,-41,40,56,13
-26,24,-35,-5,-48,-93,-43,59,-167
76,106,-30,-37,-100,-64,21,145,117
256,401,-158,-72,-356,-451,13,379,12
34,23,-32,-8,-74,-103,-13,27,-146
-52,-14,-53,-37,-81,-128,-77,54,-388
29,32,-32,-15,-64,-81,-17,56,-92
217,286,9,-33,-36,-110,141,417,891
-1,27,-33,-33,-34,-71,-10,50,-105
41,62,-5,12,15,10,44,51,230
-1,24,3,-18,-13,-28,4,29,0
26,23,-8,-12,-17,-21,0,30,21
4,28,9,-3,-14,-28,-11,38,23
14,21,1,8,4,3,13,2,66
156,167,-52,4,-237,-282,-54,371,73
-31,-25,-39,-37,-55,-65,-39,26,-265
9,18,-14,4,-2,-5,12,3,25
4,61,22,-18,24,-33,-3,76,133
70,230,-182,-82,-193,-227,38,257,-89
4,34,12,1,-48,-24,4,67,50
-7,6,-20,-6,-26,1,9,21,-22
-64,-51,-87,-72,-96,-108,-60,57,-481
31,48,33,28,-44,9,18,110,233
-7,112,-64,-62,-8,-30,18,110,69
-4,49,39,15,-2,18,15,40,170
62,41,7,-97,-10,-174,-28,159,-40
83,181,-13,-70,-16,-28,20,166,323
124,147,43,-13,-73,-87,55,252,448
129,195,103,-1,-18,-58,47,279,676
37,67,-22,-22,-48,-50,21,44,27
296,429,-115,-123,-135,-245,66,411,584
276,439,-89,-96,-84,-200,112,426,784
-28,-2,-37,3,-108,-95,-40,93,-214
7,18,-12,-26,-38,-56,-21,48,-80
304,253,52,88,-108,-83,170,465,1141
-8,0,-53,-38,-68,-106,-49,45,-277
0,-7,-60,-16,-69,-91,-21,59,-205
26,56,-41,-40,-82,-92,-22,76,-119
-5,11,-17,-45,-15,-52,-13,55,-81
2,41,8,-20,-9,-65,-4,53,6
52,106,2,-50,-20,-47,-5,183,221
-27,55,-67,-67,-104,-188,-74,100,-372
-29,0,-61,-41,-75,-118,-31,91,-264
-5,3,-28,-17,-133,-141,-42,116,-247
-26,3,-40,-14,-45,-53,-30,38,-167
-11,-8,-34,-18,-31,-56,-11,20,-149
1255,2166,347,-15,361,-627,542,2105,6134
-4,190,-110,-82,-15,-80,71,245,215
28,37,-24,-5,-56,-37,-3,55,-5
224,299,-191,-51,-299,-352,13,399,42
4,51,-26,-43,-61,-97,-16,104,-84
-32,-33,-63,-48,-120,-92,-46,52,-382
37,119,-110,-125,-262,-302,-81,235,-489
56,41,-71,-38,-68,-125,24,76,-105
-15,7,-38,-23,-91,-76,-15,34,-217
34,83,-26,-55,-29,-73,13,86,33
5,25,-4,-8,-27,-54,23,85,45
-28,-10,-39,-14,-53,-93,-36,47,-226
43,23,-11,2,-32,-21,10,18,32
-3,5,-53,-71,-87,-154,-16,127,-252
81,80,-22,-1,-52,-40,36,100,182
28,185,-75,-142,-138,-280,-17,254,-185
19,74,-2,-24,0,-29,19,64,121
-15,2,-35,-28,-85,-87,-33,46,-235
37,47,-31,-49,-41,-99,-2,96,-42
29,89,-29,-33,-75,-33,33,122,103
15,-11,-84,-25,-138,-130,-10,104,-279
103,95,64,27,6,-38,13,163,433
57,124,27,-8,3,-14,68,130,387
10,58,-67,-46,-124,-149,-25,112,-231
28,88,30,27,-79,-89,-8,196,193
22,49,-21,-4,-106,-80,2,73,-65
223,235,-130,-71,-81,-108,166,221,455
70,93,-70,-17,-128,-143,-29,115,-109
111,166,-59,-14,-110,-108,47,181,214
23,92,-26,-61,-103,-40,-12,220,93
15,20,-123,-96,-167,-291,-108,125,-625
17,38,-10,-17,-37,-47,-11,80,13
32,49,-53,0,-111,-100,-26,91,-118
23,30,-23,-31,-3,-92,5,56,-35
1,44,-33,-53,-44,-52,-19,81,-75
163,159,-148,-142,-250,-331,-18,282,-285
-4,19,-11,-21,-7,-33,-6,25,-38
44,66,-47,-36,-13,-4,31,94,135
19,118,-171,-145,-277,-281,-31,263,-505
-72,-55,-74,-63,-93,-148,-69,44,-530
10,5,-38,-44,-46,-36,5,29,-115
12,26,-20,-3,-20,-9,30,4,20
60,60,3,41,-26,-32,6,85,197
41,10,-67,-43,-73,-169,-30,119,-212
-37,-25,-50,4,-71,-72,-66,33,-284
11,4,-40,-22,-72,-35,-3,29,-128
95,101,-127,-128,-194,-314,-63,263,-367
32,-11,-43,-11,-67,-98,-8,85,-121
1,22,-39,-86,-102,-147,-56,143,-264
46,75,-62,-61,-133,-174,-30,143,-196
9,19,-28,-39,-37,-40,4,66,-46
13,78,0,-21,-1,-9,30,79,169
6,144,16,-45,-303,-167,5,330,-14
-28,13,-41,12,-86,-118,-43,64,-227
-43,14,-17,-33,-86,-107,-34,64,-242
37,31,-71,-33,-68,-57,15,65,-81
-11,22,-73,-52,-111,-123,-57,107,-298
92,196,-36,-38,-87,-125,25,192,219
4,20,-37,-44,-83,-123,-21,70,-214
63,46,-52,13,-82,-128,11,84,-45
-36,-3,-24,-4,-43,-28,-17,27,-128
20,47,-10,-12,-36,-69,8,55,3
-36,4,0,9,-51,-37,-35,36,-110
34,86,-9,-46,-15,-49,35,115,151
61,157,-48,-56,-27,-67,29,154,203
9,44,-25,-9,-66,-43,11,68,-11
24,58,-30,9,-51,-64,-5,70,11
4,21,2,-4,-19,-1,9,32,44
12,48,-3,-8,-45,-57,-12,66,1
28,29,-60,-28,-59,-36,25,55,-46
135,147,-69,-128,-224,-208,12,323,-12
29,113,-37,-67,-123,-176,-51,139,-173
9,16,-16,-12,-27,-19,4,31,-14
244,392,45,24,-153,-136,103,453,972
-4,11,1,36,-46,-54,-33,35,-54
31,71,-6,0,-71,-81,14,107,65
2,-9,-54,-65,-50,-114,-28,32,-286
-17,41,-8,-19,-37,-30,4,66,0
17,7,0,-24,9,-44,-1,38,2
42,72,-104,-110,-170,-195,-50,167,-348
32,87,-43,-118,-118,-236,-68,174,-290
-9,24,-10,-21,-34,-25,-5,32,-48
30,71,-32,-38,-59,-91,-6,55,-70
-3,-4,-16,-19,-9,-17,0,8,-60
32,7,-27,-15,-19,-45,5,9,-53
-7,-12,-15,-7,-18,-16,-11,-6,-92
32,32,-66,-78,-40,-130,-43,51,-242
6,15,-11,-7,-36,1,9,43,20
164,178,-47,59,-84,-89,103,210,494
49,77,-26,-24,-41,-56,36,101,116
17,16,-20,-17,-50,-48,-17,35,-84
64,65,-56,-80,9,-102,25,114,39
-15,11,-38,-48,-52,-58,-9,76,-133
208,296,-137,-22,-230,-114,81,242,324
-2,-23,-92,-81,-126,-151,-31,77,-429
192,226,-45,-23,-127,-238,30,334,349
1,-14,-60,-24,-122,-109,-13,107,-234
17,208,19,-41,52,-64,61,194,446
82,83,22,1,-57,6,39,123,299
-7,0,-153,-125,-249,-339,-103,196,-780
84,175,-205,-186,-435,-569,-105,316,-925
23,29,-162,-101,-306,-218,-52,170,-617
42,63,-63,-39,-67,-122,-16,139,-63
47,64,-21,8,-48,-13,29,59,125
124,141,-14,-29,-45,-55,55,202,379
168,240,-96,-55,-212,-242,31,366,200
332,474,-65,42,-139,-19,198,455,1278
238,485,148,0,29,-84,164,584,1564
174,357,1,-46,-27,-152,115,421,843
539,851,-15,-1,-313,-166,281,1079,2255
437,324,-313,-48,-626,-663,-9,209,-689
593,927,18,-68,-33,-228,323,977,2509
666,623,247,121,-21,-276,232,878,2470
99,191,-93,-164,-308,-341,-31,425,-222
-19,39,-87,-92,-116,-176,-31,205,-277
169,213,-31,-79,-111,-119,64,266,372
68,137,33,21,-71,-66,23,157,302
115,272,-90,-68,-237,-228,25,426,215
26,46,-19,-57,-69,-127,-28,148,-80
170,292,-82,-41,32,-139,118,273,623
476,514,39,-95,9,-149,199,576,1569
77,166,-16,27,-40,-92,23,117,262
108,251,-362,-273,-465,-774,-130,496,-1149
436,514,112,-33,66,-144,111,575,1637
243,308,-14,-29,-69,-156,100,396,779
200,244,-83,-85,-120,-273,0,377,260
57,103,-13,-54,-68,-166,-25,204,38
272,380,-92,-4,-345,-84,176,364,667
122,159,2,-20,-61,-69,50,264,447
203,223,-27,29,-100,-139,23,306,518
75,163,-68,-34,-126,-68,69,156,167
94,169,-11,-30,-177,-262,25,297,105
115,204,-125,-58,-204,-244,-16,236,-92
480,482,-80,24,-161,-354,200,505,1096
89,166,0,-101,-79,-77,19,306,323
84,128,-51,-89,-111,-76,18,195,98
303,599,-328,28,-542,-591,-112,367,-276
71,134,1,-20,-68,-57,18,140,219
126,276,-109,17,-158,-224,-25,154,57
89,24,-103,-5,-328,-372,-83,228,-550
263,415,-25,-104,-131,-249,28,427,624
227,375,-12,63,-18,-154,82,378,941
26,39,-46,-59,-82,-142,-31,116,-179
33,95,23,-2,-34,-49,10,121,197
-1,118,-54,-55,-132,-181,-61,145,-221
2,22,-5,-20,-27,-20,-9,37,-20
210,267,-5,-33,53,-19,88,231,792
-38,-5,-123,-120,-269,-337,-139,285,-746
147,107,-65,28,-138,-173,82,179,167
-17,6,-46,-32,-70,-73,-15,49,-198
-23,-46,-46,-50,-42,-110,-45,31,-331
52,60,-30,5,-106,-92,-35,115,-31
13,-3,-44,-6,-57,-104,-4,65,-140
-3,-11,-42,-21,-71,-100,-11,84,-175
24,38,11,15,4,-20,8,42,122
29,17,-62,-60,-138,-138,-13,127,-238
15,22,-44,15,-86,-50,16,100,-12
25,-4,-57,-36,-48,-79,-14,60,-153
13,22,-27,-19,-15,-38,-2,28,-38
25,45,-97,-114,-186,-201,-12,188,-352
71,104,-29,-41,-74,-97,4,103,41
0,21,-10,5,-20,-13,-20,30,-7
69,114,31,-8,-6,-84,7,150,273
23,7,-25,-59,-77,-72,2,69,-132
29,57,19,-30,-21,3,-1,79,135
187,257,-31,-64,-62,-130,54,315,526
41,62,16,-32,2,-28,-4,118,175
104,215,-12,-51,-52,-71,78,239,450
0,3,-5,-7,-20,-11,7,20,-13
28,40,-10,17,-49,-36,-7,43,26
89,80,15,22,-32,-44,12,149,291
21,24,-29,-30,-20,-45,-6,7,-78
11,34,-28,-55,-23,-62,-5,59,-69
70,76,-66,-31,-153,-126,11,209,-10
58,170,-4,-14,-152,-170,17,283,188
65,91,27,-57,-14,-64,33,141,222
9,53,-52,-42,-71,-94,-26,120,-103
4,31,-27,-19,-34,-27,-3,27,-48
91,167,81,28,-33,-5,56,254,639
89,205,32,-34,-81,-110,-20,257,338
29,36,-18,18,-29,-18,11,26,55
45,107,-19,-45,-72,-61,32,157,144
8,2,-34,-29,-35,-64,-12,38,-126
-75,-9,-60,-63,-82,-156,-61,119,-387
-7,22,0,0,-5,-14,7,19,22
79,87,-73,-52,-97,-72,24,160,56
-12,47,-108,-73,-139,-198,-32,136,-379
-5,-2,-41,-65,-51,-125,-25,118,-196
275,651,147,32,-421,-406,-53,833,1058
167,217,-35,-14,-64,18,115,220,624
29,70,-19,-21,-94,-71,-22,102,-26
186,210,129,10,83,51,117,275,1061
-15,31,-7,-16,-2,-4,0,41,28
-9,-1,-7,-9,-10,-17,0,14,-39
196,185,23,23,0,-87,86,178,604
-31,-19,-40,-20,-54,-44,-26,15,-219
-62,-22,-74,-59,-121,-176,-66,91,-489
-56,7,-71,-47,-122,-198,-65,98,-454
26,12,-30,-20,-13,-75,-7,32,-75
16,56,-73,-27,-148,-184,-16,145,-231
18,78,36,-31,14,-50,-15,63,113
-23,-17,-45,-43,-26,-55,-15,24,-200
38,106,-68,-53,-90,-165,9,180,-43
-42,-21,-49,-20,-51,-99,-58,29,-311
-21,5,1,-8,-6,1,-8,12,-24
27,31,-49,-25,-41,-73,7,52,-71
254,360,74,-5,49,-8,130,403,1257
52,39,-8,17,-36,-56,26,70,104
-29,22,-63,-19,-123,-107,-34,95,-258
5,-3,-72,-24,-143,-96,-34,95,-272
14,43,2,-3,-16,-23,27,26,70
48,121,-48,-7,-134,-231,-62,95,-218
54,-45,-141,-76,-277,-318,-46,130,-719
14,52,-52,-70,-93,-210,-27,139,-247
75,114,-36,-47,-82,-76,67,177,192
-7,35,-102,-60,-219,-165,-27,161,-384
9,37,-21,-8,-44,-17,12,36,4
6,21,-15,-35,-32,-34,-10,40,-59
-23,54,-28,-10,-98,-106,-25,86,-150
53,51,-41,-27,12,-32,39,21,76
-98,-32,-51,-95,-121,-165,-91,123,-530
23,128,-93,-94,-130,-202,-56,210,-214
37,42,-7,-3,-35,-135,-38,92,-47
-28,-14,-25,-16,-18,-25,-15,10,-131
41,35,-74,-69,-140,-147,-31,171,-214
46,55,-45,-3,9,2,51,38,153
112,110,25,-28,-65,-56,13,183,294
136,186,100,4,72,-85,33,239,685
-11,59,-48,-47,-125,-131,-26,133,-196
69,132,-24,-7,-86,-50,24,139,197
161,297,-2,-117,-83,-208,14,365,427
30,204,-137,-89,-316,-491,-61,349,-511
76,75,6,3,-3,-27,46,77,253
69,55,-14,-36,-44,-82,19,114,81
33,57,-47,-8,-65,-74,-5,93,-16
-77,-15,-106,-46,-112,-148,-94,99,-499
-62,1,-90,-17,-119,-167,-54,100,-408
1,-8,4,-34,-50,-76,-43,85,-121
97,175,-97,-67,-188,-186,36,145,-85
-29,41,-21,-29,-52,-65,-11,80,-86
36,127,9,-19,-29,-104,-6,141,155
54,79,1,-16,1,-43,19,122,217
5,12,-17,-5,2,-30,9,20,-4
23,31,-15,4,-100,-23,-12,123,31
48,68,-87,-85,-177,-72,9,193,-103
-12,-6,-155,-137,-250,-334,-125,169,-850
178,214,14,-36,-117,-266,10,348,345
22,29,-48,-34,-93,-49,0,74,-99
-78,0,-109,-38,-145,-132,-59,109,-452
165,179,-79,-22,-63,-102,76,241,395
185,260,-106,-21,-98,-148,71,300,443
761,981,-57,54,-122,-327,420,937,2647
-68,16,-98,-28,-121,-140,-62,78,-423
21,26,24,3,9,5,17,34,139
-16,18,-29,-14,-32,-38,-38,49,-100
-26,-4,-36,-16,-39,-59,-32,31,-181
-34,58,-233,-142,-413,-473,-169,346,-1060
-69,50,-219,-148,-351,-387,-177,278,-1023
-40,101,-232,-155,-377,-369,-118,304,-886
11,17,12,-32,-29,-56,-14,81,-10
6,7,-17,-6,-45,-41,-3,45,-54
98,196,-33,10,33,24,162,194,684
14,68,-33,-53,-87,-355,-143,268,-321
54,71,-125,-57,-231,-216,-55,215,-344
42,43,-54,-27,-109,-147,-17,80,-189
-17,-4,-26,-57,-48,-88,-31,73,-198
5,13,-10,-16,-23,-30,-1,29,-33
51,71,-42,9,-40,-41,42,102,152
51,65,-50,0,-63,-46,22,83,62
52,88,-35,0,-59,-60,21,92,99
25,112,-28,-12,-70,-120,-19,99,-13
33,21,-28,-61,-95,-96,13,111,-102
50,86,-16,-25,-50,-114,-20,152,63
10,28,-23,11,-35,-54,1,44,-18
-21,16,15,14,-27,-27,-21,32,-19
17,21,-25,-9,-43,-43,-15,36,-61
37,59,-11,14,-27,-13,46,65,170
-4,15,-29,-14,-59,-73,-11,77,-98
99,112,38,88,-40,-35,34,194,490
28,16,-17,1,-41,-33,3,27,-16
16,23,-10,3,-24,-41,5,39,11
134,205,-55,-62,-119,-119,59,304,347
11,76,-36,-39,-67,-122,-21,96,-102
17,22,-15,-5,-28,-33,-6,62,14
51,63,4,0,-19,-37,26,81,169
36,92,16,-7,-94,-61,9,170,161
38,31,-1,-22,-15,-37,13,61,68
26,41,-31,-13,-46,-27,24,39,13
26,46,-24,-11,-56,-91,5,70,-35
8,63,-32,-45,-68,-146,5,97,-118
-49,15,-20,-40,-87,-112,-35,65,-263
58,68,-29,-43,-56,-107,4,111,6
46,85,-10,12,-27,-113,18,123,134
280,397,91,9,-73,-136,40,483,1091
-1,79,-9,-42,-19,-45,22,95,80
-2,16,-15,-12,-30,-24,-8,31,-44
20,33,-24,-2,-17,-47,2,28,-7
-5,3,-35,-23,-32,-14,-12,18,-100
42,63,-25,-25,-15,0,36,52,128
-11,59,13,-9,4,-31,-11,35,49
-4,6,-24,-28,-73,-76,-27,86,-140
211,217,-14,43,-236,-269,-22,426,356
-12,2,-54,-14,-86,-72,-33,27,-242
-49,8,-53,-53,-92,-105,-48,80,-312
52,188,-36,-35,-81,-63,16,193,234
-31,29,-55,-17,-112,-133,-37,80,-276
4,39,-56,-94,-96,-104,-38,132,-213
70,58,-86,-127,-128,-159,-4,106,-270
88,141,-64,-65,-118,-239,-11,209,-59
51,69,-46,-14,-72,-76,31,87,30
193,409,-255,-164,-511,-821,-79,588,-640
131,178,-82,-56,-123,-200,-22,258,84
313,471,27,78,-45,-150,182,534,1410
35,66,-5,-69,-77,-159,-70,197,-82
-7,102,-144,-94,-222,-388,-155,227,-681
165,341,-52,-197,-265,-406,3,508,97
71,100,-48,-23,-37,-73,74,119,183
131,159,-5,-26,-101,-101,60,224,341
308,406,-13,-65,-183,-199,105,601,960
56,152,-45,-40,-68,-73,29,226,237
10,18,-23,-14,-35,-35,-9,30,-58
9,53,-32,-38,-126,-90,-5,85,-144
-15,2,-35,-24,-23,-111,-30,93,-143
-26,52,-19,-71,-83,-120,-32,96,-203
6,52,-70,-23,-148,-114,-12,114,-195
22,11,-18,-10,-31,-23,15,49,15
212,296,-7,28,-90,-144,69,315,679
82,154,29,-36,-61,-91,3,235,315
87,67,-12,11,-23,-44,28,93,207
53,76,-48,-24,-94,-143,-3,135,-48
54,159,41,-2,26,-41,31,172,440
-18,37,-50,-58,-99,-116,-44,94,-254
-40,39,-69,-61,-105,-114,-31,133,-248
17,126,-83,-88,-155,-239,-48,165,-305
70,80,-5,-68,-20,-76,15,85,81
67,100,-37,-17,-67,-88,15,124,97
24,38,-5,-3,-53,-47,-1,64,17
59,23,-47,-38,-121,-143,-7,106,-168
-58,30,-93,-12,-164,-234,-88,167,-452
79,81,10,12,-20,-32,21,85,236
59,49,17,15,-25,-35,39,102,221
78,15,-19,27,-87,-44,28,95,93
29,21,-45,-58,-105,-127,5,80,-200
-2,42,-38,-15,-63,-62,2,92,-44
32,40,14,-7,2,-14,10,41,118
-1,16,-2,-11,-3,-25,-8,20,-14
20,86,-93,-50,-138,-245,-59,148,-331
60,57,-69,-25,-159,-166,-13,54,-261
18,46,-19,-32,-54,-61,-17,115,-4
28,52,-21,22,-57,-173,-54,103,-100
143,140,55,-15,2,-94,26,172,429
114,205,-37,-56,-118,-119,45,272,306
22,23,-3,-28,-19,-109,-15,81,-48
101,202,-64,-41,-95,-104,99,155,253
38,23,7,6,-40,-36,-13,73,58
-23,50,-70,-4,-139,-250,-86,147,-375
20,42,-50,-44,-83,-109,4,78,-142
50,118,36,-16,33,-32,13,140,342
147,187,-61,-94,-132,-194,11,280,144
-20,95,-49,-58,11,-5,61,177,212
53,56,-16,-34,-49,-75,29,144,108
35,137,-44,-49,-193,-279,-82,176,-299
-15,24,-31,-46,-46,-145,-72,122,-209
26,54,-121,-56,-173,-144,-11,100,-325
200,255,-72,-40,-166,-147,117,282,429
32,91,-52,-85,-115,-137,-2,161,-107
-5,13,-167,-87,-321,-323,-80,198,-772
34,7,-53,-62,-83,-116,-31,60,-244
14,135,-50,-42,-8,-15,47,113,194
80,130,16,-19,-24,-81,12,156,270
188,214,36,-14,-24,-46,58,255,667
174,210,-34,10,-108,-140,54,298,464
102,211,-82,-128,-164,-158,30,302,113
-55,-12,-64,-7,-89,-64,-27,66,-252
8,59,-24,-35,-58,-57,26,88,7
91,116,-52,-20,-127,-61,31,180,158
4,33,-2,-16,-6,-41,-6,49,15
31,32,-14,-33,-63,-104,0,84,-67
-6,9,-18,-9,-41,-52,-20,45,-92
1,19,-3,-22,-10,-14,-3,20,-12
-89,78,-350,-118,-37,48,150,114,-204
33,42,-24,19,-50,-53,23,94,84
45,90,-33,-53,-79,-117,-13,140,-20
-22,123,-60,-82,8,-30,36,175,148
65,84,7,-1,-10,-72,26,138,237
118,96,79,64,4,-24,35,163,535
34,122,-65,-62,-145,-165,11,173,-97
162,299,-30,-102,-167,-267,21,467,383
84,69,37,6,-83,-34,12,140,231
73,115,-89,-67,-58,-105,67,142,78
25,15,-42,-25,-37,-43,8,75,-24
37,49,-17,-6,-48,-38,3,49,29
10,0,-20,-35,-33,-62,-21,33,-128
0,19,-83,-19,-160,-61,12,140,-152
7,43,-22,-19,-26,-67,6,69,-9
21,40,-108,-102,-135,-234,-31,155,-394
30,74,14,9,6,-49,1,75,160
13,34,-102,-99,-234,-221,-60,219,-450
279,315,-33,-116,-113,-262,24,508,602
24,21,-32,-47,-62,-135,-53,42,-242
260,310,-74,-133,-169,-215,81,386,446
89,32,-28,-19,-40,-82,38,80,70
92,119,-5,-31,-56,-82,21,149,207
4,14,-6,-5,-24,3,-1,41,26
-4,37,-16,18,-98,-46,-7,93,-23
146,38,-15,-96,-217,-392,-151,377,-310
-39,-7,-72,-79,-134,-163,-71,145,-420
25,21,-33,-40,-70,-72,5,68,-96
27,61,-45,-43,-138,-74,35,125,-52
112,145,71,27,54,-36,5,179,557
5,41,-19,3,-52,-44,-1,59,-8
19,-9,-38,-1,-74,-110,-10,53,-170
-35,53,-103,-101,-189,-247,-145,195,-572
75,240,-100,-69,-169,-89,123,246,257
166,166,-37,17,-2,6,85,160,561
106,402,-113,-225,-313,-564,-190,683,-214
-14,33,-39,-52,-88,-102,-17,65,-214
-2,9,-13,-11,-26,-22,-11,20,-56
28,17,-41,-6,-53,-115,1,80,-89
-16,41,-34,-80,-94,-102,-64,162,-187
13,47,-11,1,-45,-51,1,88,43
-78,29,-157,-110,-268,-196,-66,165,-681
20,43,-5,-41,-20,-51,-10,36,-28
197,245,187,-12,78,-2,60,288,1041
-1,-55,-205,-167,-297,-337,-102,200,-964
49,41,23,4,6,-21,4,54,160
189,212,52,73,-63,-77,20,291,697
60,96,-47,-37,-115,-154,-10,179,-28
65,141,-19,-55,-91,-96,22,254,221
-18,-1,-47,-83,-20,-92,-8,53,-216
58,114,27,-18,-39,-43,21,139,259
26,73,-26,-23,-73,-107,3,69,-58
-11,36,-23,-25,-36,-81,-38,69,-109
60,66,-53,-49,-125,-128,-23,190,-62
32,43,3,4,-3,-29,10,39,99
18,13,-19,-68,-47,-68,-21,76,-116
-17,45,-8,-14,-45,-60,-24,54,-69
104,117,64,-31,37,-57,10,163,407
65,62,10,11,-16,-59,11,98,182
74,165,-9,2,-64,-99,37,172,278
27,44,-51,-58,-61,-83,-31,102,-111
28,27,-18,-25,-25,-72,-16,116,15
80,84,-50,-10,-109,-135,11,159,30
37,82,-36,-58,-37,-59,16,93,38
15,23,-42,-27,-40,-8,25,26,-28
53,50,-50,-19,-95,-63,6,44,-74
39,35,-140,-95,-241,-334,-80,145,-671
153,293,93,2,-5,-115,61,316,798
33,113,23,-29,-8,8,12,100,252
11,22,-23,-24,-48,-29,6,25,-60
86,86,-23,-11,-12,-39,20,120,227
-39,9,-47,-34,-119,-125,-44,88,-311
19,91,5,-21,-28,-1,2,101,168
15,91,-4,-27,-37,-38,5,78,83
8,37,-13,21,-23,-37,-2,43,34
-19,-20,-74,-60,-109,-143,-43,94,-374
-48,-15,-97,-90,-112,-127,-44,81,-452
39,68,-51,-35,-89,-93,-4,68,-97
14,21,-10,-11,-35,-45,-6,34,-38
22,54,-9,-23,-15,-44,-1,89,73
43,39,-22,1,-66,-53,12,37,-9
44,82,31,5,53,-1,32,117,363
49,37,-15,2,-57,-45,13,98,82
3,17,-10,5,-42,-27,-18,28,-44
-28,-22,-61,-21,-79,-69,-52,31,-301
51,42,-38,-54,-73,-60,19,125,12
61,137,-63,-33,-118,-136,-9,132,-29
37,39,-15,11,-1,-36,12,58,105
120,157,78,-7,47,44,70,172,681
-15,-9,-38,-21,-41,-44,5,20,-143
6,5,-24,2,0,-14,10,9,-6
6,15,-11,-10,-1,-24,1,21,-3
17,0,-11,-2,-25,-16,12,23,-2
49,53,-10,-50,-21,-76,-11,94,28
26,54,-9,-2,-31,-24,4,51,69
13,30,-47,-25,-61,-88,7,73,-98
132,149,-100,-46,-142,-225,30,280,78
25,24,8,-22,-42,-48,20,75,40
24,29,-6,-3,-21,-14,3,35,47
-17,-2,-51,-31,-74,-96,-49,55,-265
17,-21,1,-11,-44,-55,-30,50,-93
11,76,-2,-26,-43,-66,10,132,92
10,2,-45,-50,-23,-67,-6,40,-139
117,49,-113,-59,-226,-274,-64,111,-459
-2,14,-31,-19,-57,-47,-10,39,-113
18,49,2,-8,-32,-31,24,64,86
62,46,-2,-1,-11,-61,28,100,161
4,8,-8,-9,1,-3,2,9,4
17,21,-7,-22,-21,-40,8,27,-17
164,227,-16,16,5,-84,87,153,552
-45,-33,-47,-45,-54,-86,-59,32,-337
120,122,40,-59,31,-92,55,192,409
-3,5,-26,-50,-57,-56,-18,58,-147
15,16,-36,-63,-68,-91,-18,44,-201
24,48,-11,-43,-7,-48,14,82,59
21,33,-9,-26,-18,-42,7,43,9
49,74,-105,-106,-209,-232,-59,187,-401
-52,-21,-61,-50,-75,-150,-88,70,-427
28,37,-25,-23,-54,-84,-37,58,-100
20,-1,-27,8,-57,-48,-13,50,-68
10,-35,-45,-6,-66,-68,-23,33,-200
3,-2,-26,3,-62,-52,-10,52,-94
40,70,60,29,-2,-9,7,110,305
43,26,-26,29,-78,-78,3,78,-3
31,41,-27,-30,-38,-85,-7,36,-79
35,41,0,17,3,-5,29,30,150
-26,4,-36,-23,-39,-45,-17,51,-131
15,66,-33,-58,-50,-103,-15,93,-85
5,73,-46,-37,-61,-83,-10,158,-1
17,64,-30,6,-192,-55,-16,90,-116
51,29,-45,-4,-76,-90,24,68,-43
29,33,-197,-89,-238,-257,-44,227,-536
26,13,-17,14,-38,-19,-9,19,-11
-35,-10,-67,-35,-80,-95,-46,62,-306
-3,18,-24,-34,-11,-55,-12,36,-85
23,25,-6,-9,-14,-18,25,54,80
-20,-24,-43,-1,-77,-114,-37,49,-267
126,91,-71,-14,-144,-172,-9,151,-42
27,101,-36,-25,-112,-60,36,135,66
6,37,-4,-22,-35,-69,-2,42,-47
6,0,19,16,-61,-126,-15,81,-80
27,71,4,-7,-31,-50,7,82,103
166,121,22,54,-53,-36,50,168,492
45,88,-49,-39,-120,-110,19,127,-39
13,0,-15,-33,-26,-81,-51,113,-80
-44,3,-83,21,-114,-135,-47,103,-296
25,28,-3,2,-54,-54,-29,73,-12
43,62,-59,-30,-31,-58,21,70,18
18,-7,-57,-13,-128,-73,0,87,-173
57,63,-139,-80,-165,-309,-71,239,-405
65,15,-31,-45,-17,-78,-1,6,-86
26,51,23,-25,-50,1,3,106,135
-13,26,-180,-110,-297,-273,-56,228,-675
29,40,-82,-41,-158,-96,6,83,-219
15,76,13,-8,-45,7,10,84,152
-71,-21,-134,-34,-188,-190,-73,132,-579
-72,-34,-75,-51,-86,-143,-75,52,-484
31,129,-9,-19,-46,-122,-11,117,70
31,11,-56,-25,-160,-150,-10,103,-256
164,233,12,-69,-111,-139,84,252,426
10,58,-38,-98,-80,-81,-26,215,-40
56,164,-19,-62,16,-18,59,171,367
33,72,-12,-9,-19,-61,-1,77,80
-3,16,-13,-25,-28,-18,-2,41,-32
29,27,-48,-75,-126,-239,-38,214,-256
-4,23,-82,-75,-64,-144,-63,79,-330
-1,20,-9,-9,-29,-29,-9,22,-44
4,63,-21,-43,-22,-20,24,64,49
9,17,-44,-58,-62,-114,-40,75,-217
90,127,-26,-9,-30,-72,56,159,295
-1,10,-13,-16,-6,3,9,1,-13
10,13,11,-6,10,-44,-2,44,36
8,21,-16,-16,-18,-33,15,32,-7
-9,20,-8,-19,-20,-14,12,29,-9
-4,18,-42,-38,-94,-140,-32,128,-204
-5,-2,-33,-36,-29,-78,-3,37,-149
107,246,-85,-113,-226,-290,-21,343,-39
-63,-19,-88,-30,-133,-142,-72,134,-413
109,127,-22,-51,-27,-141,32,168,195
2,-11,-54,-39,-64,-83,-8,51,-206
16,21,-14,-4,-16,-23,-2,23,1
35,33,-12,-14,11,-12,25,33,99
39,29,-18,-11,11,-11,34,39,112
241,400,-307,-264,-579,-681,-93,637,-646
58,158,-155,-73,-232,-220,24,179,-261
54,34,-12,4,-33,-49,8,37,43
9,14,-14,-24,-15,-26,-1,20,-37
0,9,-18,-21,-130,-72,-31,102,-161
193,266,-83,-27,-185,-163,102,256,359
28,74,16,6,2,-20,9,103,218
99,112,-28,9,-89,-73,45,95,170
73,111,-57,-4,-107,-106,57,156,123
100,299,-31,12,-147,-248,-20,433,398
48,166,-88,-72,-222,-265,-66,373,-126
10,66,-14,-54,-13,-72,-24,57,-44
124,193,-48,-114,-200,-301,-36,410,28
118,158,-80,-85,-215,-139,4,311,72
61,70,28,19,-5,-24,23,84,256
-3,9,-72,-61,-129,-58,0,68,-246
24,34,-7,-15,-22,-14,20,67,87
16,64,3,3,-30,10,-16,63,113
17,60,13,-21,-48,-30,22,102,115
8,5,-13,2,-22,-12,3,10,-19
94,113,-116,-130,-145,-232,3,168,-245
7,12,-164,-138,-282,-315,-95,228,-747
49,68,-26,-12,-20,-73,11,76,73
83,129,0,52,-89,-60,64,145,324
177,321,-111,-44,-275,-153,35,349,299
61,146,3,-27,-71,-61,34,164,249
380,541,-253,-109,-406,-438,108,836,659
141,159,-119,-55,-208,-169,-26,152,-125
178,254,18,9,-27,-78,66,304,724
69,160,-34,-52,-67,-85,40,187,218
40,193,-276,-184,-544,-859,-265,433,-1462
61,145,-99,-119,-196,-255,50,207,-206
78,121,-36,-47,-53,-99,19,176,159
336,399,-3,-64,-68,-165,129,526,1090
305,434,-120,-82,-210,-415,5,545,462
27,72,-30,-21,-140,-172,6,158,-100
86,257,-24,-13,-142,-168,7,282,285
131,230,8,93,-102,-45,63,213,591
234,328,-22,-193,-93,-251,66,403,472
37,153,37,-32,32,-24,39,148,390
33,68,-187,-231,-219,-378,-67,316,-665
200,357,-2,-111,-85,-157,81,444,727
55,98,-145,-69,-208,-223,31,139,-322
236,436,-80,-113,-46,-264,143,563,875
34,164,-140,-126,-283,-381,-45,380,-397
34,89,-105,-113,-172,-201,-13,188,-293
240,328,-29,-55,-15,-147,117,371,810
226,472,-102,-87,-268,-409,53,557,442
90,114,9,-1,-54,-99,11,183,253
131,105,-51,-64,-225,-234,-15,247,-106
86,84,-96,-22,-99,-125,35,160,23
139,247,-176,-175,-329,-400,-22,432,-284
205,409,-52,-75,-212,-180,105,517,717
-86,-15,-129,-134,-231,-339,-130,185,-879
95,140,-45,0,-159,-131,44,228,172
143,290,-38,-63,-134,-243,29,361,345
292,418,-9,-18,-183,-320,67,564,811
65,133,-47,-28,-85,-146,36,164,92
-51,31,-100,-87,-125,-150,-31,117,-396
22,20,11,1,7,-6,10,31,96
-5,20,-35,-36,-47,-64,-13,81,-99
4,25,-18,-32,-7,-10,7,30,-1
98,112,16,-10,-26,-67,31,163,317
10,47,-17,-30,-45,-86,-11,109,-23
1,22,0,-12,6,8,12,34,71
88,163,-107,-57,-168,-320,5,246,-150
147,240,85,16,75,-38,74,244,843
-4,0,-22,-2,-27,-29,-14,23,-75
-61,0,-50,-31,-83,-118,-63,64,-342
-82,-38,-42,-54,-76,-125,-68,64,-421
-50,18,-40,-50,-66,-120,-68,70,-306
57,91,25,90,-88,-97,21,143,242
-2,58,-160,-131,-287,-330,-87,274,-665
-26,-33,-50,-35,-37,-158,-71,82,-328
-47,0,-62,-47,-65,-109,-31,69,-292
290,423,-214,-56,-406,-431,56,235,-103
14,77,-62,-47,-79,-130,-37,104,-160
62,154,-97,-54,-182,-224,-35,145,-231
55,69,-107,-91,-176,-317,-95,334,-328
48,113,-47,-97,-80,-117,-10,200,10
128,230,-169,-211,-451,-254,42,566,-119
-5,10,-47,-57,-98,-196,-63,76,-380
8,78,14,-55,-72,-140,-50,179,-38
-25,-22,-37,-52,-56,-157,-80,80,-349
79,64,34,15,-8,-47,8,103,248
76,86,0,40,7,-41,43,173,384
60,190,-140,-127,-285,-299,-38,351,-288
-15,-18,-38,-26,-40,-42,-18,36,-161
0,31,-75,-48,-133,-98,-13,138,-198
9,22,-8,-25,-11,-24,6,33,2
177,362,283,26,-401,-285,-327,1124,959
67,84,-26,-12,-27,-52,26,88,148
25,46,-40,-15,-74,-71,-1,49,-81
107,218,-19,-86,-210,-237,48,355,176
61,74,-131,-77,-153,-193,8,153,-258
6,132,-139,-93,-263,-316,-42,298,-417
139,160,86,-34,42,-19,56,201,631
94,66,17,9,-102,-41,-4,130,169
8,20,-44,-44,-48,-88,0,54,-142
56,57,-73,-34,-91,-76,40,95,-26
46,65,56,-8,6,-66,-8,112,203
-3,14,-9,-26,-28,-88,-15,63,-92
2,26,-2,-12,6,-12,5,20,33
33,26,-176,-107,-293,-395,-125,170,-867
27,32,-22,-3,-28,-8,23,25,46
88,282,-165,-205,-397,-431,-19,467,-380
100,172,-148,-73,-151,-193,29,216,-48
7,32,11,7,-17,-17,-2,31,52
2,24,-13,-27,-22,-50,-19,42,-63
8,-5,-64,-38,-77,-71,-19,62,-204
71,82,38,85,-68,-61,26,180,353
51,49,-44,-49,-53,-119,2,126,-37
135,175,-47,-32,-82,-126,39,245,307
7,37,-4,-6,0,-1,13,66,112
61,138,-93,-48,-148,-217,25,240,-42
25,37,-11,-89,-60,-176,-50,128,-196
40,25,-15,-19,-27,-16,-8,58,38
0,13,-14,-13,-17,-15,12,16,-18
134,211,-29,-20,-64,-90,23,269,434
-24,35,-40,-70,-105,-308,-141,228,-425
5,102,-35,-67,-115,-268,-91,190,-279
14,59,2,-28,-30,-140,-15,80,-58
208,320,-27,-60,-140,-335,24,275,265
-20,-26,-67,-6,-72,-80,-52,33,-290
-58,-8,-51,-18,-57,-38,-44,52,-222
-45,-35,-62,-38,-102,-66,-68,16,-400
272,138,-142,47,-145,-200,29,270,269
26,52,-125,-105,-186,-236,-45,73,-546
-21,-7,-75,-60,-105,-163,-64,94,-401
54,24,-99,-102,-171,-182,-15,162,-329
37,59,-81,-35,-120,-128,-27,116,-179
50,97,-18,-11,-15,-50,35,91,179
57,106,-65,-8,-144,-73,32,96,1
32,71,-15,-44,-36,-47,13,136,110
-33,0,-115,-34,-128,-122,-57,106,-383
0,4,-13,-30,-62,-60,-20,79,-102
429,639,-179,-259,-346,-549,85,928,748
27,28,-109,-115,-166,-257,-42,238,-396
18,35,-31,-15,-46,-24,14,40,-9
9,22,-14,1,-22,-35,-9,38,-10
8,31,-77,-51,-102,-122,-14,93,-234
25,54,13,14,-35,-20,24,56,131
-18,52,-26,-35,-56,-93,-17,52,-141
21,35,-67,-54,-164,-142,-28,119,-280
25,54,10,-23,-43,-32,-7,93,77
-5,2,-13,-7,-22,-17,-5,17,-50
7,-5,-66,-68,-148,-80,-7,90,-277
6,32,-31,-43,-76,-84,-9,67,-138
-109,14,-223,-167,-413,-491,-184,348,-1225
17,34,-24,-10,-10,-64,7,63,13
145,163,-8,-30,-134,-152,-13,206,177
50,196,-127,-116,-176,-171,27,330,13
-39,-8,-27,1,-51,-89,-42,68,-187
43,16,-42,-49,-83,-87,-6,122,-86
247,490,40,-79,29,-158,79,552,1200
39,15,-55,-68,-133,-199,-10,155,-256
11,11,-15,-12,-26,-13,-9,18,-35
94,97,-79,-69,-150,-136,-5,248,0
81,62,-88,-51,-100,-107,28,113,-62
-11,2,-72,-18,-124,-129,-16,69,-299
-6,0,-5,-4,-3,-28,-13,20,-39
47,107,19,4,-43,-61,-15,118,176
9,-13,-26,-33,-35,-69,-19,20,-166
-24,23,-17,-49,-61,-37,-15,44,-136
55,185,-92,-33,-228,-248,-78,241,-198
5,135,-50,-43,-22,-2,48,181,252
5,26,-44,-62,-56,-135,-38,100,-204
-76,-50,-113,-48,-173,-175,-71,104,-602
14,10,-1,-26,-18,-15,15,31,10
99,88,-24,-24,-87,-117,11,118,64
65,75,36,30,-61,-44,18,166,285
-18,75,-21,-53,-30,-162,-65,71,-203
-3,70,-25,-43,-48,-177,-67,87,-206
-53,70,-27,-42,-44,-166,-85,95,-252
93,52,-13,-4,-51,-27,31,89,170
2,71,-28,-43,-47,-169,-76,98,-192
8,20,-26,-2,-28,-8,22,28,14
44,30,-52,-62,-98,-106,5,75,-164
50,109,-67,-32,-156,-197,-33,82,-244
93,90,-8,-30,14,-36,41,34,198
32,34,0,-8,9,11,36,34,148
-8,13,-4,14,-42,-19,-1,44,-3
-9,16,-30,-14,-50,-74,-31,38,-154
16,77,-97,-55,-108,-64,11,105,-115
-69,121,-260,-265,-369,-472,-179,509,-984
146,322,-231,-41,-174,-36,154,248,388
-3,20,-2,0,-45,-14,-14,61,3
-8,27,-63,-61,-51,-119,-47,64,-258
58,99,-17,-14,-43,-61,6,92,120
32,31,-25,-4,-31,-8,24,23,42
-1,62,-70,-46,-58,-31,16,56,-72
132,185,-60,-57,-142,-286,-11,250,11
4,22,-23,-10,-25,-12,7,26,-11
23,14,-32,-15,-71,-90,-5,103,-73
-23,41,-66,-46,-101,-115,-35,99,-246
10,84,14,-14,-38,-4,24,103,179
431,521,-50,-125,125,-80,254,484,1560
6,14,-27,-22,-58,-46,-1,45,-89
54,123,-78,-98,-16,-114,1,179,51
-15,0,-23,-24,-27,-43,-11,19,-124
-3,-1,-15,-17,-16,-55,-11,32,-86
-14,9,-9,-24,-20,-41,-8,14,-93
50,45,-1,49,-65,-31,46,100,193
-11,8,-42,-12,-63,-133,-37,75,-215
68,36,-49,-9,-158,-95,19,149,-39
19,25,16,-56,7,-78,-14,100,19
22,26,-27,38,-55,-24,6,63,49
18,11,-22,-23,-54,-92,-23,73,-112
19,22,-22,1,-24,-19,7,18,2
11,43,-6,-18,0,2,21,36,89
-17,17,-47,-54,-67,-116,-22,75,-231
31,20,13,16,-42,2,31,85,156
-61,-30,-67,-57,-100,-108,-41,98,-366
95,160,-62,-44,-70,-93,25,214,225
60,76,19,18,10,-27,15,56,227
33,30,-6,-32,-23,-117,-22,92,-45
7,40,-15,-39,-21,-46,-9,60,-23
46,101,-9,-12,-64,-114,-4,137,81
54,71,-42,-81,-1,-81,33,118,71
41,68,-63,-97,-98,-131,17,166,-97
6,21,-34,-18,-36,-62,-19,67,-75
1,96,4,6,-84,-63,3,169,132
73,155,50,22,-33,-81,16,213,415
49,129,-10,-15,-68,-87,14,164,176
-7,-9,-116,-37,-227,-192,-39,168,-459
72,130,-60,-46,-73,-110,24,149,86
19,75,-41,-14,-83,-99,-20,73,-90
183,271,-180,-94,-435,-249,8,380,-116
237,350,24,-49,-97,-119,94,448,888
148,187,-113,-77,-175,-182,32,257,77
9,152,-111,-205,-355,-302,-67,449,-430
62,97,-47,-39,-49,-96,9,139,76
45,161,-83,-88,-216,-178,34,285,-40
88,100,-64,-24,-66,-70,35,123,122
156,180,19,-17,-35,-98,-1,273,477
21,16,-50,-60,-60,-110,-32,45,-230
114,315,-36,-118,-120,-372,16,406,205
109,169,-15,6,-125,-138,-9,216,213
74,130,-35,-9,-77,-112,2,138,111
-17,9,-60,-67,-28,-125,-19,88,-219
126,176,73,9,-7,-52,-2,211,534
42,98,-20,-4,-98,-48,-32,203,141
6,144,49,6,-56,-56,-6,213,300
130,150,-21,-6,-45,-105,31,143,277
19,44,-68,-28,-170,-47,-9,145,-114
-33,22,-39,-35,-97,-138,-42,90,-272
73,225,105,10,-157,-195,-74,377,364
33,247,11,-145,-174,-228,-76,373,41
41,431,345,292,-50,220,-52,288,1515
196,172,-30,-190,-275,-283,-74,319,-165
29,63,0,-67,-87,-189,-17,205,-63
-53,22,-148,-166,-272,-263,-97,212,-765
164,104,-19,-19,-72,-77,41,215,337
102,187,-34,-68,-97,-179,-8,232,135
192,278,-120,-50,-184,-282,-9,214,39
8,29,-64,-58,-109,-64,-11,76,-193
225,248,-73,-21,-276,-258,-23,369,191
-33,66,-32,-60,-8,-8,50,148,123
75,114,-47,-29,-69,-190,6,125,-15
256,389,25,-40,-71,-124,148,423,1006
59,247,-88,-94,-198,-268,-5,310,-37
26,14,-53,-58,-109,-96,-10,103,-183
118,256,-80,-83,-168,-258,41,324,150
174,191,-52,-103,-193,-301,-3,379,92
55,77,-23,-33,-73,-90,-11,159,61
8,43,-11,-30,-69,-68,-27,92,-62
195,342,-10,3,-163,-291,30,245,351
110,189,-140,-22,-296,-283,-21,198,-265
45,346,-129,-242,-354,-226,106,476,22
115,265,-110,8,-212,-171,34,146,75
230,279,-113,-36,-61,-144,102,284,541
89,239,-90,-76,-101,-40,110,245,376
94,149,-128,-106,-249,-336,-8,280,-304
140,219,-8,10,-71,-101,22,194,405
89,171,-160,-92,-324,-444,-81,189,-652
213,258,61,64,-75,-20,106,305,912
46,105,14,-35,-35,-89,22,149,177
64,252,-67,-148,-167,-233,57,423,181
71,122,-80,-75,-143,-134,101,246,108
46,78,-278,-154,-492,-637,-158,362,-1233
157,201,-64,-50,-44,-28,89,197,458
156,163,-114,-31,-163,-245,-2,217,-19
74,157,21,2,-40,-98,-1,226,341
197,182,-12,11,-40,-70,41,210,519
112,122,76,105,-51,42,43,175,624
540,563,-122,67,-494,-345,120,834,1163
102,190,-59,-83,-139,-220,6,271,68
-24,110,-146,-65,-234,-217,-33,188,-421
48,70,33,42,-1,-18,29,108,311
23,39,-23,-8,-136,-103,16,130,-62
-11,19,-32,-23,-60,-68,-36,48,-163
127,57,-82,-208,-283,-359,-88,202,-634
44,88,-15,-70,24,-76,13,121,129
-12,7,-29,-12,-64,-87,-15,57,-155
46,35,-23,-6,-54,-83,1,64,-20
16,15,-30,-5,-40,-11,-1,39,-17
9,14,-13,-6,-47,-13,5,48,-3
11,40,-22,13,-7,-31,4,26,34
-14,87,-80,-35,11,-27,99,149,190
1,4,-11,-7,-50,-48,-11,28,-94
18,116,-14,-33,-47,-118,-19,157,60
15,35,-34,-58,-66,-103,-3,72,-142
59,112,-68,-60,-122,-198,-7,238,-46
-9,-22,-79,-75,-92,-147,-29,89,-364
0,-25,-64,-68,-67,-119,-28,77,-294
58,49,-51,-44,-62,-87,19,84,-34
10,13,-26,-40,-49,-101,-28,69,-152
43,61,18,-25,10,-49,12,92,162
18,14,-4,-7,-40,-71,-7,50,-47
-11,12,-15,-16,-21,-9,1,23,-36
64,96,0,-49,-94,-240,-18,181,-60
55,59,-15,-47,-51,-89,18,169,99
127,223,-57,65,-128,-145,7,152,244
60,51,-22,-37,-11,-84,16,101,74
163,307,-71,-63,-236,-294,17,250,73
126,289,-63,-37,-169,-274,2,219,93
108,106,-61,-93,-133,-142,78,269,132
24,-4,-19,-17,-37,-33,-7,31,-62
-28,-20,-59,-117,-97,-200,-48,102,-467
-5,40,-62,-72,-114,-96,11,134,-164
34,32,-21,-27,-43,-99,-16,47,-93
-26,53,-70,-65,-4,-7,6,72,-41
9,25,-15,-6,-30,-13,12,6,-12
21,20,-19,4,-30,-11,14,27,26
44,62,-61,-31,-81,-80,6,96,-45
-33,16,-47,-13,-68,-103,-51,52,-247
-11,33,-74,-11,-112,-95,-9,98,-181
1,11,-48,-17,-86,-118,-48,123,-182
-20,37,-75,-31,-86,-100,-34,79,-230
58,73,41,-4,16,-23,28,78,267
191,264,-38,-46,-8,-106,78,313,648
172,187,-57,21,-42,3,97,179,560
80,58,-1,32,-54,-42,53,98,224
-11,12,-31,-43,-31,-23,-1,20,-108
80,23,-99,-49,-192,-166,3,134,-266
23,51,-79,-2,-101,-54,18,80,-64
30,-4,-14,3,-17,-16,14,24,20
144,267,-202,-195,-569,129,257,739,570
-36,48,-95,-74,-6,8,46,73,-36
530,663,-92,-165,-230,-125,402,802,1785
12,25,-16,-15,-10,-22,-3,35,6
-4,13,-11,-2,-31,-3,1,25,-12
78,117,-10,-25,-16,-35,38,132,279
38,105,-53,-46,-142,-70,28,187,47
159,274,74,0,-49,-154,9,364,677
82,89,-11,-28,-67,-78,30,128,145
-44,37,-78,-38,-113,-198,-68,105,-397
-57,-2,-60,-32,-102,-127,-54,92,-342
30,16,-42,0,-89,-123,-13,101,-120
24,43,-47,-11,-32,-30,35,38,20
-10,5,-4,-2,-5,-10,-1,23,-4
14,8,-42,-16,-52,-62,-20,45,-125
129,45,-96,8,-133,-88,59,143,67
145,216,-107,27,-102,-101,112,225,415
45,38,5,-5,-14,-16,8,27,88
155,201,-82,-16,-115,-94,71,194,314
-13,8,-18,-15,-38,-31,3,34,-70
216,470,-198,-183,-428,-477,-1,695,94
31,54,-42,-53,-98,-168,-50,110,-216
162,328,39,54,-8,-147,117,273,818
7,36,9,-34,-9,-39,-8,64,26
-10,72,-35,-66,-72,-97,16,119,-73
89,192,-3,-15,-55,-141,33,228,328
23,6,-36,-5,-58,-82,-23,48,-127
-8,23,-48,-41,-50,-43,12,65,-90
-33,82,-114,-63,-2,-9,20,90,-29
2,6,0,-11,1,-12,-2,9,-7
22,18,-45,-32,-145,-119,-20,80,-241
-45,139,-152,-157,-395,-179,-163,410,-542
62,73,24,80,-89,-39,34,124,269
79,552,-219,-444,-803,-616,-163,1398,-216
35,26,-13,-1,-39,-28,21,51,52
31,98,-136,-40,-234,-327,-79,167,-520
63,55,-67,-48,-108,-99,48,89,-67
-11,18,-40,-25,-87,-93,-19,43,-214
36,57,13,-4,3,3,42,47,197
49,141,-100,-151,-120,-195,1,235,-140
23,62,-21,-27,-55,-49,9,70,12
19,67,-19,-5,-58,-67,0,124,61
21,119,-17,-12,-25,-27,76,180,315
5,48,-30,-39,-60,-76,8,62,-82
-30,91,-46,-67,-153,-359,-118,238,-444
60,64,-13,16,-49,-32,28,66,140
117,170,-82,-22,-18,9,118,118,410
5,-2,-73,-17,-113,-76,-8,76,-208
25,34,-72,-72,-65,-134,-13,30,-267
27,24,-52,-10,-107,-84,-7,54,-155
89,53,-35,-10,-107,-115,11,124,10
14,11,-32,-51,-44,-72,11,26,-137
11,39,9,-10,-36,-86,-18,107,16
81,102,18,-28,-5,13,53,83,317
38,71,-21,-2,-40,-19,20,61,108
-4,-31,-47,-30,-26,-67,-8,54,-159
19,11,-12,-3,-19,-15,0,12,-7
-46,-18,-51,-37,-91,-52,-34,27,-302
67,161,-52,-49,-81,-79,6,181,154
37,31,-48,-25,-92,-79,-2,96,-82
54,70,-9,-8,-39,-37,-5,76,102
100,146,96,32,57,38,28,106,603
90,116,-28,-9,-6,-71,34,82,208
52,34,-5,-14,-120,-152,-35,160,-80
58,22,-22,-50,-34,-72,-20,87,-31
2,15,-11,-5,-3,-15,-11,3,-25
107,70,-151,-118,-220,-250,-52,174,-440
70,80,-92,-105,-134,-69,34,200,-16
77,115,-33,-4,-87,-83,43,93,121
145,125,-55,-21,-39,-37,60,166,344
50,107,-61,-17,-30,-9,58,93,191
10,5,-9,1,-12,-35,-13,15,-38
43,31,-27,-32,-82,-71,-20,29,-129
46,43,-47,-34,-42,-70,-5,38,-71
65,41,-61,17,-95,-95,70,119,61
2,37,-18,-2,-55,-42,17,92,31
17,46,-25,-68,-79,-92,-12,80,-133
16,29,-14,0,-28,-41,-9,37,-10
23,159,-51,-56,-151,-257,-66,317,-82
121,82,-73,-220,-302,-262,-84,270,-468
34,105,-97,-59,-120,-174,-29,170,-170
15,19,-36,-29,-41,-31,20,37,-46
279,804,-307,-152,-788,-652,17,1231,432
69,92,44,-7,25,-28,13,124,332
4,5,16,22,-41,-32,-4,58,28
9,17,-19,-21,-35,-34,-14,37,-60
0,14,-26,6,-103,-78,-30,89,-128
21,3,-105,-28,-197,-169,-25,88,-412
105,66,-2,-39,-33,-71,12,117,155
60,110,17,-11,-35,-104,-9,133,161
10,31,-15,-6,-19,-26,10,58,43
7,15,-8,2,-58,-53,10,57,-28
18,77,-12,-28,-50,-80,16,85,26
21,90,-18,-34,-60,-78,8,138,67
24,59,-3,-51,-17,-45,-10,64,21
107,144,-14,-31,-26,-123,48,256,361
49,56,-17,-25,-54,-52,-1,96,52
12,11,-9,-5,-29,-64,-5,46,-43
22,32,-33,-7,-66,-80,-22,78,-76
17,15,-47,-19,-70,-84,-24,77,-135
26,50,50,24,-8,-46,-16,95,175
27,68,38,39,-12,19,31,65,275
46,163,-251,-267,-425,-552,-112,354,-1044
13,1,-52,-45,-68,-97,-7,75,-180
0,38,-9,-40,-23,-64,9,46,-43
154,257,-98,-21,-169,-189,28,246,208
91,85,-49,-32,-67,-131,0,139,36
40,118,-60,-45,-119,-169,12,170,-53
1,48,-8,-38,-19,-58,-14,83,-5
25,69,1,-30,-32,-48,1,114,100
10,66,-8,-36,-20,-58,-10,85,29
80,111,-99,10,-88,-32,87,84,153
54,58,-23,-17,-109,-83,4,107,-9
31,14,-26,-33,-30,-54,26,55,-17
-17,81,35,38,-97,91,-14,38,155
-74,217,-434,-311,-545,-876,-276,536,-1763
74,158,-110,-118,-283,-373,-73,347,-378
12,15,-38,-60,-71,-52,3,67,-124
-9,3,-11,-16,-15,-27,-8,14,-69
-23,1,-37,-47,-51,-72,-30,44,-215
-1,24,-14,-18,-11,-32,4,46,-2
-5,23,-7,-32,-43,-84,-24,38,-134
98,140,-65,-53,-184,-172,7,312,83
29,-2,-57,-17,-58,-124,-19,54,-194
9,5,-137,-53,-170,-184,-6,106,-430
47,141,-130,-144,-205,-371,-93,368,-387
-82,10,-113,-70,-156,-158,-76,99,-546
-26,-33,-27,-61,-42,-117,-46,47,-305
-27,11,-113,-122,-218,-337,-145,188,-763
54,90,-43,-16,-33,-56,24,63,83
-9,51,-39,-17,-130,-84,-11,65,-174
79,105,-62,-6,-76,-25,63,76,154
-1,28,-28,-33,-70,-112,-22,89,-149
21,19,-48,-34,-85,-113,-32,103,-169
51,46,1,-14,3,-57,23,93,146
31,32,-29,-10,-64,-61,5,61,-35
10,19,-29,-59,-18,-89,-16,54,-128
-17,25,-85,-60,-102,-145,-38,85,-337
18,71,-34,-29,-66,-133,-27,73,-127
160,159,-50,-18,-34,-77,122,206,468
113,251,-13,-47,-105,-152,67,317,431
99,166,-28,-49,-60,-172,44,193,193
10,14,-4,-12,-35,-34,-4,39,-26
-7,30,-43,-46,-46,-103,-17,85,-147
-35,127,-62,-83,8,6,78,138,177
41,69,-29,-42,-22,-36,20,62,63
41,68,-40,15,-35,-31,24,47,89
20,15,-36,-47,-57,-70,0,39,-136
-4,21,-32,-36,-64,-24,6,74,-59
-4,27,-69,-37,-78,-91,-11,82,-181
14,0,-20,-3,-73,-67,-20,27,-142
8,-5,-25,-35,-13,-64,-17,23,-128
26,70,-28,-13,-45,-59,12,79,42
-16,-30,-33,-18,-53,-73,-62,42,-243
50,101,-69,-83,-193,-273,-48,177,-338
-43,1,-73,-59,-87,-157,-75,78,-415
-48,-40,-34,-63,-13,-88,-43,48,-281
145,194,19,-19,-23,-159,-10,208,355
-5,17,-18,-9,-13,-58,-26,28,-84
15,29,-24,-16,-66,-52,-15,64,-65
24,-12,-60,-17,-103,-45,12,58,-143
52,79,-36,-31,-106,-124,6,150,-10
-2,48,-37,-37,-34,-43,-3,46,-62
-52,39,-83,-69,-57,-151,-54,77,-350
78,130,19,59,-184,-150,-64,348,236
-4,-13,-14,-14,-34,-36,-1,20,-96
80,60,-38,-38,-110,-103,8,123,-18
7,34,-1,-8,-53,-43,2,71,9
39,46,-103,-98,-206,-142,8,176,-280
5,7,-6,-6,-19,-12,11,29,9
25,5,-49,-37,-12,-74,6,41,-95
1,63,-102,-108,-179,-221,-71,210,-407
18,13,-17,-40,-41,-104,-14,78,-107
42,85,-42,-30,-74,-104,-10,87,-46
-8,-44,-45,-23,-120,-172,-61,90,-383
-48,-8,-60,-71,-108,-193,-71,79,-480
135,129,17,-80,56,-106,53,176,380
-18,11,-44,-41,-77,-84,-31,46,-238
106,129,-52,-2,-168,-168,33,267,145
48,93,-46,-55,-78,-86,38,131,45
-14,-17,-29,-34,-42,-60,-36,41,-191
83,87,-39,-66,-67,-91,52,160,119
15,26,-5,2,-7,-4,21,32,80
125,193,-179,-293,-180,-447,4,391,-386
89,156,-49,-85,-59,-134,-5,201,114
64,150,-22,-93,-74,-106,15,198,132
30,1,-33,-13,-69,-55,0,32,-107
11,13,-31,-12,-71,-45,-7,29,-113
18,-2,-44,-43,-70,-94,-18,61,-192
27,50,-31,-16,-42,-25,35,26,24
39,62,-31,9,-47,-27,25,61,91
61,108,-31,-53,-76,-121,13,193,94
35,0,-33,-2,-35,-38,12,18,-43
27,90,5,-35,-15,-90,-22,107,67
0,6,1,-3,-26,-50,-39,38,-73
90,130,-80,-27,-121,-57,86,147,168
16,52,2,-40,-5,-27,20,84,102
-25,-14,-42,-15,-42,-69,-63,43,-227
46,15,-99,-11,-181,-83,24,54,-235
25,28,14,10,-9,5,7,44,124
265,523,-301,-184,-601,-633,-18,779,-170
-8,-8,-34,-14,-36,-33,-4,17,-120
115,110,-74,-28,-96,-136,27,206,124
188,385,-129,-113,-515,-254,19,625,206
17,44,11,5,-3,-24,7,40,97
10,34,22,21,-35,3,-10,88,133
106,138,-32,-94,-248,-195,-39,349,-15
66,119,-3,4,1,-41,31,129,306
-62,-2,-59,-50,-77,-103,-66,62,-357
-71,-7,-58,-63,-80,-128,-85,64,-428
-57,-3,-64,-61,-67,-130,-69,59,-392
7,50,-41,7,-60,-77,9,64,-41
48,90,-11,-19,-114,-90,-49,62,-83
34,105,2,-16,-116,-89,-49,82,-47
33,87,-19,-9,-145,-90,-28,89,-82
51,83,-12,-1,-122,-106,-40,86,-61
34,104,4,-12,-122,-97,-43,84,-48
48,145,-96,-18,-57,-39,64,147,194
-36,7,-124,-107,-160,-269,-47,175,-561
28,32,-51,-25,-108,-112,-26,64,-198
46,100,-72,-41,-151,-79,33,150,-14
7,25,-8,-27,-32,-51,-16,78,-24
44,20,-26,-12,-41,-76,-14,4,-101
188,291,15,-27,15,-135,53,374,774
172,122,-132,-52,-166,-128,85,172,73
-17,12,4,-6,-19,-34,-15,26,-49
29,120,-7,-59,-58,-90,0,151,86
19,40,-32,-44,-61,-82,1,62,-97
16,63,-11,-6,-28,-30,8,78,90
-26,20,-56,0,-66,-171,-48,56,-291
30,97,-48,-28,-77,-43,28,123,82
16,16,-41,11,-53,-3,25,28,-1
17,20,-33,-27,-71,-66,-24,57,-127
77,34,-96,-93,-161,-220,-12,184,-287
7,64,-3,-24,-34,-50,-4,66,22
-15,76,39,-13,13,4,6,64,174
52,74,10,20,-11,10,33,79,267
57,94,-4,-14,1,-85,7,84,140
-70,5,-77,-89,-128,-186,-61,100,-506
24,38,-73,-95,-91,-140,10,70,-257
32,40,4,-2,18,16,39,25,172
37,24,-51,-65,-33,-189,-44,135,-186
4,28,-29,-27,-23,-16,8,43,-12
87,90,-113,3,-147,-147,6,162,-59
0,26,-12,-11,-26,-11,1,37,4
-3,17,-15,-20,-19,-34,-15,23,-66
-66,-5,-50,-53,-77,-124,-82,65,-392
-58,-17,-59,-40,-86,-128,-68,74,-382
41,39,16,-21,16,-85,9,71,86
-7,106,-131,-197,-225,-352,-34,311,-529
26,30,-44,-34,-75,-82,-7,52,-134
134,254,15,-68,-128,-182,95,324,444
108,175,-51,2,-119,-120,63,224,282
103,94,-41,-59,-81,-98,26,131,75
19,60,-16,-11,-8,-77,-8,66,25
2,22,-34,-45,-63,-97,-15,82,-148
42,136,-10,-72,-46,-132,16,232,166
7,35,-9,2,-19,-33,-9,29,3
93,84,-54,-26,-128,-143,57,136,19
-28,-17,-30,-12,-28,-39,-25,14,-165
-36,0,-43,16,-79,-73,-32,47,-200
65,96,-112,-97,-263,-92,62,333,-8
91,172,-80,-44,-90,-114,9,213,157
24,8,-68,-34,-157,-83,24,76,-210
151,264,-162,-65,-144,-190,36,160,50
8,33,-23,-27,-79,-55,29,83,-31
50,128,-66,-129,-106,-142,34,257,26
-10,18,-103,-87,-176,-137,-57,119,-433
44,35,-22,-37,-61,-115,20,54,-82
33,41,-43,-8,-48,-21,29,37,20
88,169,-95,-56,-195,-351,-51,242,-249
65,208,39,-95,-177,-228,-115,350,47
10,20,-32,-16,-27,-21,-2,32,-36
142,147,8,-4,-115,-79,44,157,300
100,114,-47,29,-154,-106,53,121,110
-14,203,-200,-126,-307,-578,-197,357,-862
27,138,-111,-165,-237,-315,-63,317,-409
95,30,-80,20,-155,-131,-3,82,-142
151,327,-21,-52,-62,-195,40,296,484
21,66,-133,-94,-220,-344,-88,182,-610
33,89,-19,-71,-64,-97,10,169,50
27,11,-148,-166,-221,-214,-42,151,-602
134,164,-16,-28,-74,-94,61,216,363
29,26,-81,-74,-127,-172,10,98,-291
150,229,52,-9,-18,5,99,246,754
119,139,-69,-71,-132,-238,37,286,71
299,230,-270,-80,-265,-279,219,346,200
133,142,29,-11,-110,-154,-21,271,279
162,118,-80,-177,-166,-140,26,384,127
66,96,3,-28,-26,-62,24,147,220
167,127,-55,-33,-108,-154,31,193,168
37,74,-108,-71,-226,-186,-56,171,-365
228,283,40,-93,22,-94,82,338,806
88,117,-78,-7,-168,-118,31,165,30
176,264,-72,-23,-85,-90,70,232,472
253,428,14,-65,8,-125,88,394,995
-67,-6,-130,-112,-159,-252,-115,126,-715
49,155,-84,-103,-109,-234,-36,241,-121
61,104,-28,-38,-58,-82,41,106,106
24,38,-34,-10,-137,-109,-34,125,-137
-19,121,-67,-72,-49,-11,50,186,139
83,119,-49,-48,-187,-266,-54,289,-113
154,133,24,-15,9,-63,55,177,474
49,113,-61,-21,-168,-182,-7,193,-84
28,43,-29,-27,-65,-55,17,70,-18
-1,8,-64,-12,-105,-81,-3,66,-192
116,55,-107,-33,-236,-201,55,139,-212
8,50,-8,-3,-36,6,5,88,110
129,76,-29,-84,-256,-302,-119,373,-212
-75,45,-225,-172,-281,-444,-164,371,-945
269,485,119,43,106,-19,150,533,1686
130,343,-273,-282,-596,-825,-249,749,-1003
420,502,-12,56,-236,-136,193,705,1492
-3,29,-102,-58,-137,-129,-18,87,-331
31,49,-48,-40,-39,-94,-3,118,-26
30,7,-91,-40,-102,-100,-13,119,-190
46,55,-40,-23,-67,-111,-1,128,-13
49,163,-47,-43,-138,-196,-20,129,-103
64,125,-3,-64,-44,-43,23,138,196
29,140,52,-39,-49,-185,-74,292,166
46,118,-1,-45,-64,-65,48,161,198
-4,2,-52,-40,-134,-148,-44,116,-304
75,154,-97,-57,-136,-127,97,241,150
-14,9,-75,-63,-131,-172,-66,132,-380
-49,87,-97,-63,-124,-137,-36,168,-251
234,395,-56,0,-211,-261,32,298,431
159,245,-56,-77,-125,-217,75,306,310
83,152,-21,-29,-133,-182,-28,242,84
142,214,-53,-56,-152,-198,-13,255,139
51,74,-96,-82,-223,-261,-86,218,-405
219,185,3,-6,-117,-141,51,354,548
149,273,-41,-50,-104,-258,55,361,385
51,131,-93,-101,-135,-143,19,249,-22
199,420,-139,-24,-266,-342,-18,347,177
137,219,-69,-75,-99,-181,29,223,184
179,281,45,-56,3,-146,47,278,631
78,191,44,-67,-65,-221,-75,272,157
92,111,9,17,28,-38,38,87,344
180,212,27,-48,-57,-68,92,244,582
-59,-21,-72,-49,-116,-120,-63,68,-432
-75,-59,-77,-56,-102,-119,-58,45,-501
-62,-21,-46,-53,-82,-111,-50,70,-355
38,67,-53,-90,-82,-122,-46,128,-160
-21,4,-22,-37,-66,-67,-15,62,-162
-65,-24,-53,-56,-73,-127,-73,46,-425
147,197,24,-44,-92,-75,40,257,454
5,19,-28,-20,-63,-92,-12,34,-157
7,17,-26,-38,-56,-31,-6,36,-97
-4,7,-20,4,-35,-40,-18,26,-80
26,30,-65,-33,-96,-104,-3,83,-162
-46,-12,-99,-68,-135,-97,-50,89,-418
-9,-6,-28,16,-58,-115,-47,59,-188
377,513,-121,-142,-446,-571,16,788,414
-16,117,-6,-84,-28,-137,33,119,-2
11,79,-25,-36,-29,-62,5,76,19
59,90,65,33,25,-11,11,111,383
93,115,28,64,-9,0,61,186,538
18,49,-18,-10,-31,-35,13,99,85
61,44,-13,1,-24,-52,34,58,109
349,337,51,-93,70,-35,191,391,1261
26,149,-26,-101,16,-74,43,168,201
-63,-5,-55,-62,-103,-127,-72,81,-406
-1,27,-22,-23,6,-9,19,22,19
37,73,-82,-66,-141,-199,-11,154,-235
-1,3,-12,-23,-33,-39,13,50,-42
32,61,-23,-21,-16,-72,8,73,42
4,28,-32,-19,-37,-55,-2,61,-52
304,587,51,-5,-115,-200,184,572,1378
3,3,-46,-9,-50,-96,-20,46,-169
166,230,-102,-88,-174,-318,-29,301,-14
7,28,-25,-33,-30,-38,11,72,-8
9,24,-7,-30,-17,-27,-2,74,24
8,30,-27,19,-47,-58,20,84,29
69,52,-4,-19,-3,-92,-23,65,45
43,123,-121,-87,-251,-323,-53,309,-360
10,15,-1,-12,-17,-25,1,31,2
1,9,-25,-20,-9,-18,2,13,-47
12,5,-6,-7,-1,-15,-2,22,8
0,-5,-14,-16,-18,-44,-13,7,-103
26,-1,26,-9,27,-25,-2,32,74
-5,9,-58,-81,-157,-146,-33,182,-289
174,169,-21,-52,-88,-74,14,187,309
18,56,0,10,-13,22,38,46,177
4,13,13,2,6,-13,1,28,54
122,350,-127,-226,-289,-460,-82,642,-70
19,35,-8,-2,-15,-1,16,39,83
4,23,-17,-7,-43,-24,-10,33,-41
20,76,-86,-90,-153,-197,-53,196,-287
5,43,7,-28,0,-27,-7,50,43
94,108,14,6,-17,-95,1,178,289
124,214,-145,-80,-217,-179,46,273,36
27,12,-60,-12,-180,-116,-14,99,-244
-21,22,-19,-18,-139,-65,-31,132,-139
56,150,-14,-20,14,-11,90,140,405
40,157,-100,-41,-116,-150,-1,123,-88
183,165,-87,-57,-245,-183,47,258,81
144,176,-17,38,-76,-99,29,166,361
39,71,21,10,-43,-25,18,106,197
-36,-29,-40,-18,-52,-57,-35,4,-263
121,170,28,15,-9,39,64,146,574
34,38,-58,-25,-94,-107,7,57,-148
-49,-11,-60,-41,-77,-131,-83,70,-382
-53,-28,-69,-44,-99,-116,-59,55,-413
63,60,-51,19,-59,-71,20,40,21
48,87,7,14,-12,-37,24,82,213
102,188,-64,-49,-38,9,69,86,303
69,204,-63,-34,-145,-183,-22,247,73
3,8,-71,-15,-153,-88,0,84,-232
-8,-2,-25,-34,-55,-82,-45,42,-209
27,57,-33,-14,-38,-72,16,81,24
166,278,-148,-5,-219,-205,51,277,195
57,123,-45,-31,-52,-80,35,133,140
127,299,-136,-140,-258,-430,28,481,-29
24,33,-15,-12,-48,-72,-20,39,-71
97,111,-34,-56,-44,-111,1,140,104
-13,127,-171,-86,-346,-433,-105,344,-683
9,63,-57,-81,-106,-109,-32,132,-181
10,5,-20,-11,-55,-43,-8,21,-101
-36,-20,-64,-39,-110,-57,-22,61,-287
18,27,-147,-114,-240,-214,-44,200,-514
39,116,-21,-23,-41,-52,27,119,164
81,30,-110,-98,-189,-191,-5,197,-285
0,-2,-73,-54,-101,-142,-45,99,-318
67,85,-86,-73,-104,-150,-58,201,-118
176,138,-50,0,-257,-322,-59,316,-58
36,29,-47,-30,-108,-129,-27,85,-191
55,82,5,8,-26,-7,10,116,243
2,2,-32,-21,-62,-55,-5,57,-114
12,21,-50,-30,-102,-81,-22,144,-108
10,54,-26,-34,-43,-35,14,40,-20
68,101,-63,-57,-118,-220,3,130,-156
17,17,-12,-13,-54,-32,-4,33,-48
9,22,-42,-23,-74,-21,-2,69,-62
-6,-1,-20,-30,2,-35,-6,0,-96
23,30,-19,-33,-43,-66,-21,63,-66
8,70,-37,-84,-77,-57,-30,149,-58
80,32,-66,60,-154,-138,9,126,-51
12,24,-39,-6,-66,-93,5,61,-102
16,22,-51,-76,-95,-125,15,82,-212
-21,21,-222,-148,-399,-265,-56,299,-791
19,51,31,25,-41,-40,18,108,171
126,135,-205,4,-314,-273,-5,190,-342
49,41,-60,-45,-110,-195,-47,140,-227
810,933,-102,59,-56,-252,439,874,2705
41,79,-55,-35,-68,-110,3,107,-38
14,15,-30,-45,-41,-123,-18,103,-125
106,68,-8,26,-83,-96,27,134,174
-45,5,-48,-26,-91,-111,-69,55,-330
6,6,-25,-5,-56,-67,21,41,-79
17,-9,-172,-137,-243,-332,-107,124,-859
63,33,-26,-27,-65,-87,12,85,-12
-24,0,-42,-60,-43,-92,-33,46,-248
23,-2,-30,-15,-53,-70,-21,35,-133
77,215,-65,-110,-231,-332,-31,273,-204
27,52,-15,-26,-36,-25,-5,55,27
9,71,-12,-25,-11,-1,12,79,122
17,67,-9,-14,-46,-63,21,120,93
82,84,-60,-16,-32,-45,59,98,170
41,41,-29,-31,-61,-115,-13,81,-86
21,47,-93,-25,-151,-114,-20,98,-237
28,-9,-27,-23,-58,-122,-26,71,-166
20,67,-34,-11,-119,-121,11,82,-105
32,40,-44,-11,-76,-90,-3,84,-68
56,158,-48,-114,-108,-249,-32,244,-93
5,11,-6,-9,-6,-46,-15,8,-58
53,78,26,-7,-13,-46,15,71,177
132,202,43,0,-8,-60,64,181,554
190,291,-87,-63,-216,-266,-18,404,235
-35,-46,-33,-17,-25,-73,-48,10,-267
40,71,9,-12,-29,-40,4,63,106
86,90,18,120,-38,-48,71,233,532
25,24,2,-4,-2,-19,14,34,74
-7,0,17,-18,-20,0,1,34,7
37,25,-18,5,-30,-49,17,47,34
-4,4,-9,-8,-16,-53,-23,25,-84
345,449,-110,-107,-284,-265,256,565,849
-103,2,-139,-101,-164,-336,-148,199,-790
214,295,179,126,-38,27,85,384,1272
146,129,123,53,24,31,-3,170,673
25,23,-54,-25,-49,-40,26,50,-44
-72,14,-148,-117,-172,-182,-85,141,-621
-4,20,-17,-11,-19,-49,-10,41,-49
115,182,-68,-8,-63,-85,34,181,288
74,203,38,-90,-20,-108,-12,303,388
-21,-15,-48,-58,-63,-66,-25,47,-249
50,59,-88,-67,-76,-144,22,116,-128
4,-14,-42,-32,-65,-64,-10,83,-140
1,12,-51,-33,-50,-72,-10,53,-150
-1,98,-10,8,-124,-116,11,121,-13
15,-10,-63,-81,-142,-214,-65,117,-443
179,185,-75,-60,-133,-292,-2,270,72
47,86,0,-16,22,-23,50,77,243
-5,11,-92,-43,-146,-123,-11,100,-309
-10,6,-38,-2,-76,-51,-13,28,-156
-4,0,-32,-2,-31,-78,-45,68,-124
26,28,-17,1,-33,-62,24,58,25
6,21,-24,-63,-36,-72,-25,62,-131
7,142,-198,-256,-423,-559,-174,520,-941
0,51,-60,-31,-27,2,27,40,2
43,52,-51,-44,-125,-215,-30,180,-190
-36,13,-43,-17,-76,-88,-49,15,-281
163,190,46,-29,-85,-223,-45,349,366
238,231,18,14,-174,-243,-10,424,498
40,59,-126,-134,-297,-300,-125,329,-554
21,-13,-45,-60,-120,-123,-45,126,-259
-5,-20,-53,-59,-76,-138,-50,113,-288
-14,8,-56,-23,-54,-78,-46,37,-226
61,73,-66,8,-122,-129,-6,95,-86
70,93,-21,-19,-63,-53,43,145,195
-48,93,-20,-34,-43,-164,-78,93,-201
-28,66,-30,-28,-66,-157,-71,98,-216
-40,57,-36,3,-103,-180,-81,136,-244
27,49,-17,-25,-91,-61,39,118,39
18,29,-30,-35,-70,-98,-5,65,-126
19,43,9,-23,24,-37,16,53,104
-31,-7,-37,-20,-37,-56,-38,26,-200
9,-2,-24,4,-30,-38,-10,19,-72
36,68,-22,-21,-29,-31,21,72,94
24,61,-29,-31,-26,-81,-8,91,1
-9,31,-6,-25,-53,-58,-6,57,-69
-14,37,-98,-46,-144,-128,-40,156,-277
37,107,-8,-28,-27,-30,37,126,214
56,198,-150,-131,-280,-374,34,323,-324
581,1025,-264,93,-517,-751,50,625,842
7,3,-44,-22,-34,-28,0,15,-103
-3,-21,-49,-58,-90,-57,0,25,-253
27,35,-117,-52,-363,-298,-62,269,-561
57,180,-134,-83,-151,-120,89,258,96
16,27,3,13,-10,-50,-21,50,28
121,112,-13,-27,-35,-85,15,195,283
-2,71,-47,-70,-57,-77,6,88,-88
53,63,-24,-32,-48,-51,15,110,86
-3,47,20,-10,-29,-1,18,71,113
8,53,-5,-23,28,-9,6,67,125
212,276,42,-84,20,-119,66,320,733
10,21,-22,-10,-48,-50,-13,54,-58
-36,9,-53,-47,-85,-154,-64,118,-312
33,29,-16,8,-36,-3,32,28,75
29,56,-63,-21,-119,-179,-17,82,-232
49,16,-73,-29,-149,-213,-37,124,-312
-69,-26,-59,-75,-76,-104,-59,87,-381
113,111,9,28,-105,-94,-51,196,207
43,86,17,48,-208,-58,1,158,87
77,130,-40,-26,-41,-81,-16,119,122
24,42,16,-29,-38,-46,12,98,79
99,175,-58,-76,-163,-137,71,263,174
36,66,-8,12,-79,-104,-8,129,44
-10,29,-51,-27,-46,-33,-1,39,-100
-22,10,-12,-7,-31,-23,-9,30,-64
140,658,-330,-293,-1067,-874,-102,1115,-753
4,22,-13,-8,6,-15,8,27,31
36,6,-39,-7,-60,-49,-1,38,-76
24,81,-40,5,-67,-97,-17,86,-25
72,52,-13,-8,-25,-49,12,45,86
8,73,-52,-34,-58,-72,-11,117,-29
25,40,-53,-70,-97,-108,-2,114,-151
16,46,-51,-33,-19,-26,27,69,29
25,61,-95,-47,-115,-93,31,111,-122
4,3,-32,-27,-41,-94,-30,46,-171
8,39,12,-19,-23,-48,3,48,20
20,17,5,-17,1,-49,-9,23,-9
40,86,-71,-92,-129,-146,1,187,-124
22,34,-65,-17,-99,-60,11,68,-106
119,69,-125,-59,-172,-158,19,117,-190
50,37,-42,-13,-96,-140,-12,157,-59
63,101,-92,-103,-187,-323,-84,203,-422
20,43,-38,-4,-24,-48,0,77,26
-4,0,-33,-18,-74,-75,-26,52,-178
2,2,-17,-19,-32,-16,-14,32,-62
-16,69,-64,-60,16,-14,22,89,42
91,81,-106,-40,-213,-287,-49,222,-301
181,407,-29,-40,-35,-256,179,455,862
17,56,-154,-86,-172,-181,-41,146,-415
68,242,-150,-69,-219,-215,-15,343,-15
89,113,-13,6,-70,-54,83,189,343
-20,36,-67,-52,-94,-123,-33,171,-182
31,35,-46,-25,-55,-93,0,60,-93
-10,14,-86,-108,-101,-227,-73,183,-408
-27,-24,-45,-8,-53,-39,-29,7,-218
89,122,-39,3,-76,-72,57,159,243
5,66,5,-24,16,-18,27,85,162
23,41,-20,-7,-60,-34,-6,52,-11
190,178,-8,-25,5,6,129,207,682
119,281,-84,-124,-132,-89,113,333,417
35,89,-50,-12,-90,-134,-2,94,-70
19,44,-42,-30,-66,-76,-7,79,-79
57,76,-63,-24,-140,-73,63,127,23
-12,-4,-48,-15,-78,-59,-36,25,-227
31,34,-24,-28,-27,-74,3,27,-58
-33,46,-24,-48,-161,-82,-6,152,-156
273,199,22,-72,11,-121,83,337,732
-11,-1,-55,-51,-92,-75,-20,28,-277
-30,67,-11,-22,-82,-158,-66,142,-160
35,36,10,-12,-60,-63,-19,96,23
25,11,-32,-10,-25,-67,-17,15,-100
-16,20,-41,-20,-72,-56,0,52,-133
12,37,-21,-12,-43,-53,0,56,-24
-44,3,-35,-5,-78,-63,-47,53,-216
-45,-29,-45,-41,-89,-82,-59,20,-370
-31,-5,-38,-31,-48,-97,-36,51,-235
1,2,-60,-24,-112,-63,-29,65,-220
46,55,-8,3,-8,-59,23,86,138
-27,-37,-75,-54,-52,-146,-64,84,-371
20,54,-1,-12,-57,-73,-14,58,-25
12,52,12,-18,14,-45,-19,70,78
-2,15,-1,-2,-8,-26,-31,28,-27
5,11,-10,6,-32,-23,-1,42,-2
32,37,-26,-26,-99,-144,2,116,-108
64,77,-19,1,-41,-52,26,63,119
31,103,9,2,15,-51,1,84,194
2,90,-32,-90,-114,-191,-85,127,-293
-1,20,-9,-14,-12,-30,-3,28,-21
181,277,111,63,36,-5,88,358,1109
29,42,-13,-7,-97,-100,-32,77,-101
-1,56,-34,-10,-46,-92,-33,56,-104
78,97,-72,-75,-79,-158,-10,136,-83
-2,41,-79,15,-145,-153,-41,93,-271
-53,13,-57,-68,-84,-115,-66,73,-357
21,18,-57,-62,-73,-89,-24,73,-193
-1,17,-11,-2,8,-16,-12,17,0
48,25,-48,3,-57,-42,23,21,-27
34,61,-16,-26,7,-38,44,67,133
12,75,-62,-70,-145,-116,-4,162,-148
103,114,22,20,-58,-65,35,200,371
131,96,39,75,-92,-64,67,236,488
29,56,-23,-26,-31,-58,4,69,20
73,77,15,9,13,-74,39,110,262
67,124,24,47,-13,-76,0,166,339
28,55,-65,-8,-161,-146,3,94,-200
-7,119,65,0,-8,99,-41,70,297
25,71,37,-21,-53,-46,-24,105,94
2,-2,-20,7,-18,-24,-8,8,-55
-1,6,-9,4,-10,-34,-16,21,-39
4,12,-69,-81,-100,-122,-16,136,-236
-22,32,-14,-4,-32,-20,-14,63,-11
9,56,3,-33,-21,-78,-22,110,24
-1,30,-20,-17,-62,-38,-12,56,-64
-20,34,-65,-7,-132,-143,-62,92,-303
27,137,-53,-80,-146,-91,-28,214,-20
54,71,-14,-15,-17,-48,44,53,128
43,86,-45,-88,-93,-128,6,150,-69
10,16,4,-17,-27,-13,20,40,33
4,18,-18,-16,-42,-14,5,42,-21
16,39,-13,-12,-5,-22,16,16,35
-41,-17,-13,-44,-9,-114,-47,51,-234
11,14,-25,-13,-19,-55,-10,37,-60
54,82,-96,-19,-134,-110,-8,27,-204
571,641,-94,-21,-278,-373,287,711,1444
23,51,-20,-16,-9,-43,33,47,66
2,37,-21,-27,-35,-61,1,60,-44
22,55,13,-25,-7,-40,-5,67,80
29,-6,-38,-25,-46,-23,11,-8,-106
28,46,-2,-20,21,-21,17,27,96
-31,-23,-35,-25,-21,-45,-30,21,-189
32,30,-21,-1,-6,-38,29,46,71
28,-36,-80,-62,-90,-162,-25,142,-285
39,73,-105,-14,-176,-173,-6,122,-240
2,8,-33,-14,-52,-29,11,44,-63
30,56,-21,-2,-64,-71,-6,124,46
-20,27,-7,-20,-35,-76,-36,95,-72
-15,28,11,0,-56,-68,-39,73,-66
95,148,5,-35,-17,-41,47,181,383
23,38,2,11,-53,-55,-13,62,15
-6,11,-7,-11,-11,-21,6,5,-34
54,80,-47,-21,-92,-99,7,146,28
35,104,-19,-45,-75,-102,31,131,60
15,8,-31,-43,-94,-54,20,73,-106
-11,25,-50,-42,-63,-84,-3,75,-153
4,41,4,7,-23,-89,-7,107,44
134,266,-110,-70,-113,-46,144,333,538
-5,0,-14,-14,-33,-20,-1,20,-67
5,17,7,-3,2,-5,7,10,40
-71,-40,-53,-43,-79,-171,-107,51,-513
1,-1,-30,-14,-24,-40,-6,18,-96
-11,29,-71,-36,-109,-23,11,81,-129
-13,32,-73,-42,-102,-23,7,91,-123
3,39,-38,-15,-104,-47,-15,70,-107
1,13,-55,-23,-138,-37,9,75,-155
34,31,-36,-21,-125,-52,22,118,-29
8,31,-9,-18,-5,-31,4,54,34
-14,25,-27,-59,-16,-64,-2,45,-112
11,42,-41,-36,-126,-69,3,133,-83
-94,-77,-52,-56,-129,-201,-108,106,-611
-27,-14,-35,-42,-53,-81,-49,29,-272
-58,-19,-28,-34,-27,-107,-65,59,-279
5,16,-54,-63,-55,-125,-55,73,-258
-3,19,-4,10,-34,14,1,41,44
31,-9,-104,-91,-153,-169,-57,214,-338
173,266,-148,-151,-234,-454,-7,622,67
17,12,-37,-16,-63,-103,-41,56,-175
48,28,-52,-75,-126,-94,18,151,-102
13,12,-19,-15,-45,-49,5,58,-40
4,13,-39,-53,-44,-50,-23,28,-164
16,-7,-60,-18,-92,-89,-16,77,-189
190,210,-62,-7,-127,-127,75,309,461
74,180,-39,-88,-173,-143,-36,267,42
12,58,-3,-15,-60,-68,-16,91,-1
24,34,-50,16,-106,-63,0,76,-69
6,35,-16,-20,-36,-21,14,30,-8
-1,9,-19,-10,-25,-40,-20,12,-94
29,41,-4,-39,-75,-63,4,113,6
25,49,3,-33,-47,-94,-12,150,41
20,16,-56,-15,-75,-57,-7,82,-92
14,14,-37,-31,-69,-64,-18,75,-116
14,27,-18,-29,-80,-32,-15,117,-16
16,67,-21,-37,-60,-42,-12,95,6
16,49,-3,-15,-54,-39,-19,67,2
74,162,53,-25,1,12,11,195,483
33,104,41,5,-23,-58,-15,131,218
-1,63,5,-34,-34,-24,-27,108,56
19,68,-1,-14,-71,-19,-23,117,76
30,96,-23,-42,-118,-37,-12,169,63
-13,40,-35,-28,-71,-55,-36,90,-108
20,14,-58,-37,-86,-88,-19,56,-198
-53,-31,-61,-44,-62,-104,-70,56,-369
49,17,-20,1,-37,-43,3,71,41
27,25,-21,-23,-15,-53,-15,58,-17
4,-5,-59,-40,-79,-49,-8,75,-161
4,15,-39,-39,-74,-88,-33,64,-190
-5,9,-3,2,-9,-2,-7,6,-9
24,20,-69,-49,-90,-112,-10,107,-179
4,27,-67,-33,-76,-130,-44,75,-244
16,15,-66,-20,-71,-148,-41,85,-230
34,45,-66,-6,-91,-153,-21,105,-153
35,163,-163,-101,-277,-243,6,419,-161
60,138,-209,-175,-349,-282,6,357,-454
31,78,-254,-178,-430,-351,-23,361,-766
-8,18,-14,-14,-29,-28,-4,55,-24
12,13,-17,1,-22,-29,-4,33,-13
14,5,-3,-2,-30,-32,-5,14,-39
6,0,-2,-7,-30,-28,-9,25,-45
17,19,-19,-4,-18,-15,3,14,-3
94,119,12,-66,-14,-49,37,186,319
74,96,-27,-3,-61,-68,38,118,167
91,134,-12,-15,-29,-58,15,161,287
4,3,-24,-32,-54,-27,-9,15,-124
3,7,-25,-29,-54,-20,-6,14,-110
-4,4,-32,-42,-44,-12,0,19,-111
10,39,-17,-38,-29,-16,15,51,15
71,126,-9,-84,-101,-100,-19,139,23
24,173,-32,-55,-157,-129,-46,256,34
-4,3,-33,-18,-45,-35,-15,39,-108
5,57,-14,-31,-50,-102,-19,75,-79
19,17,-15,-30,-42,-29,5,57,-18
7,22,-2,0,-6,-8,-8,19,24
34,35,2,12,-10,-47,8,45,79
-10,21,2,18,-23,-13,-3,20,12
4,33,-3,20,-19,-16,6,37,62
42,83,11,20,34,3,24,75,292
24,63,-13,11,9,-58,12,35,83
13,57,-10,1,-5,-44,-9,49,52
-6,5,-1,-15,-14,-14,-5,25,-25
-17,-6,-23,-29,-22,-28,-16,1,-140
-17,3,-17,-26,-25,-7,-19,-4,-112
-14,26,-5,-25,-12,-18,1,25,-22
1,37,-7,-17,-37,-76,-24,46,-77
8,25,-11,-11,-28,-77,-28,49,-73
11,25,-8,-12,-31,-76,-34,52,-73
14,33,-14,1,-22,-25,4,40,31
179,431,-46,-37,-398,-363,116,706,588
18,20,-18,0,-15,-25,-2,24,2
38,17,-14,-22,-27,-35,-12,37,-18
40,34,0,0,-12,-41,6,44,71
13,21,2,-2,-13,-29,-3,31,20
13,16,-8,4,-7,-30,1,20,9
14,16,-5,0,-6,-36,-12,21,-8
-5,17,-1,4,-16,-27,-6,26,-8
19,30,-11,-15,-11,-39,4,29,6
16,31,3,7,8,-17,8,26,82
5,3,-2,1,-2,0,4,3,12
-9,25,-10,-7,-18,-74,-17,72,-38
0,26,-28,-19,-46,-57,-9,46,-87
15,28,-5,-13,-33,-59,-18,31,-54
0,28,-8,-7,-33,-57,-19,38,-58
5,17,2,-10,-34,-47,-8,44,-31
0,20,-13,-14,-24,-49,-4,37,-47
9,22,-5,-8,-31,-45,-11,44,-25
14,19,-1,-11,-27,-55,-17,33,-45
15,20,-3,-2,-33,-51,-10,38,-26
3,16,-4,-5,-32,-52,-12,45,-41
-4,1,-22,-18,-28,-69,-47,38,-149
18,22,-28,-6,-23,-36,-12,24,-41
30,19,-36,-22,-58,-66,-26,71,-88
26,26,-19,-17,-8,-64,3,62,9
11,27,-18,-9,-57,-64,-8,30,-88
7,57,-14,-23,-14,-18,14,59,68
6,-1,-29,-42,-52,-36,-17,18,-153
14,21,-6,1,-21,-27,-7,38,13
14,21,-6,1,-21,-27,-7,38,13
9,27,-7,9,-26,-24,-2,44,30
7,22,-7,1,-18,-22,2,47,32
7,23,-7,8,-29,-26,0,42,18
11,24,-12,0,-26,-27,-2,44,12
9,19,-8,7,-30,-23,9,46,29
17,28,6,-6,-14,-19,5,36,53
11,29,8,8,-17,-19,4,46,70
1,27,0,4,-24,-30,0,41,19
2,16,-10,6,-31,-25,5,47,10
18,25,7,11,-28,-18,-2,56,69
12,25,6,8,-29,-17,-1,48,52
2,27,7,6,-34,-16,-6,44,30
11,28,14,23,-24,-8,-3,54,95
13,31,-5,26,-41,-7,-2,57,72
14,22,-5,16,-32,-6,-4,51,56
10,24,-4,13,-31,-4,-5,48,51
17,28,-1,17,-34,-9,2,53,73
0,5,-8,-1,-36,-18,-11,36,-33
1,6,-22,8,-37,-14,1,30,-27
3,20,-18,-1,-34,-13,5,39,1
0,6,-25,0,-38,-15,5,41,-26
15,28,2,-1,-32,-10,-4,49,47
10,111,-40,-8,-58,-82,2,117,52
15,48,-14,-24,-20,-57,-2,48,-6
-1,11,-10,-17,-12,-19,1,25,-22
-4,14,-14,1,-23,-39,-12,32,-45
-9,-8,-22,11,-49,-10,6,37,-44
-3,6,-21,4,-33,-12,5,38,-16
0,-1,-10,7,-40,-20,-3,28,-39
0,3,-10,13,-37,-23,-6,31,-29
-3,9,-7,16,-36,-21,3,35,-4
-3,5,0,12,-27,-18,-7,32,-6
-5,4,-6,9,-39,-14,-5,33,-23
0,14,-7,13,-35,-16,5,35,9
-1,10,-10,14,-34,-18,1,32,-6
3,7,-11,8,-35,-23,-1,31,-21
0,14,-5,24,-28,-20,2,34,21
-4,5,-18,-15,-31,-45,-16,19,-105
-13,1,-14,-16,-29,-38,-22,15,-116
-4,21,-4,13,-27,-19,-18,39,1
-3,12,-5,8,-24,-17,-15,45,1
59,104,-54,-40,-192,-85,-1,183,-26
18,23,-13,-5,-29,-27,11,32,10
34,16,-9,-18,-21,-49,-8,32,-23
12,6,-17,-2,-28,-40,2,40,-27
31,65,-33,-52,-74,-54,7,96,-14
34,76,-37,-41,-38,-23,11,98,80
0,2,0,0,1,0,1,0,4
37,73,-19,-52,-29,-5,29,100,134
52,97,-13,-59,-20,-36,24,110,155
39,74,-15,-37,-34,-16,17,100,128
19,72,-39,-53,-79,-73,31,130,8
32,71,-20,-31,-45,-75,10,97,39
19,59,-26,-30,-43,-65,6,88,8
37,80,-35,-31,-43,-62,20,116,82
45,32,-26,-14,-71,-57,0,59,-32
48,22,-24,-5,-59,-55,0,53,-20
-9,6,-51,-47,-34,-51,1,67,-118
0,27,-13,-21,-38,-55,-2,81,-21
-3,30,-22,-28,-51,-51,-11,76,-60
-3,38,-17,-29,-43,-46,1,65,-34
0,34,1,-31,-26,-38,5,66,11
-9,10,-33,-44,-51,-59,-8,42,-152
-3,-3,-32,-12,-41,-51,-21,16,-147
2,7,-23,-7,-27,-44,-9,27,-74
-1,-3,-30,-12,-26,-49,-12,27,-106
7,34,-25,-1,-13,-32,5,14,-11
340,603,686,437,326,536,175,667,3770
318,565,646,430,298,555,172,640,3624
278,587,692,457,266,521,151,752,3704
243,706,918,340,488,615,196,936,4442
14,26,-9,-39,-14,-44,-2,30,-38
6,33,-17,-47,16,-29,14,41,17
54,82,19,49,-141,-70,-30,100,63
27,109,50,84,-206,-46,-37,165,146
103,173,-29,23,-169,-112,36,143,168
396,298,-340,-46,-622,-750,-172,302,-934
23,11,-25,-19,-34,-44,1,-5,-92
32,45,-23,3,-47,-87,-23,20,-80
45,63,-43,6,-116,-86,-1,14,-118
6,18,-21,-1,-19,-25,-9,16,-35
0,20,-11,-4,-5,-21,-2,9,-14
3,18,-7,3,-16,-34,-14,18,-29
17,13,-15,7,-22,-29,6,21,-2
111,178,31,35,-73,-10,-4,288,556
68,56,17,29,-52,-31,18,104,209
18,14,-43,3,-77,-89,-45,60,-159
93,80,22,-1,12,-18,31,101,320
2,12,-24,-16,-26,-16,-1,22,-47
-37,-10,-61,-110,-91,-109,-56,91,-383
1,36,-27,-31,-41,-25,4,44,-39
2,5,2,-1,1,0,-1,3,11
2,5,0,-3,1,0,0,2,7
-59,74,-121,-100,-169,-309,-86,176,-594
-8,22,-22,-8,-40,-26,-8,59,-31
-12,7,-24,-26,-38,-53,-17,59,-104
4,54,22,-11,-4,42,9,106,222
16,40,50,13,9,19,-13,94,228
3,69,68,2,27,15,-13,106,277
22,31,-60,-60,-94,-89,-30,111,-169
0,38,-31,-32,-23,-10,6,70,18
31,93,12,15,-21,-135,-31,96,60
176,379,-38,-265,-332,17,24,720,681
21,-3,-23,-4,-31,-47,-6,33,-60
-6,21,-12,-13,-51,-9,5,75,10
2,7,-24,-10,-34,-54,-13,16,-110
54,51,-21,-39,-42,-69,36,101,71
-4,4,-33,-11,-42,-31,2,28,-87
44,16,-123,-46,-101,-181,-11,46,-356
-5,24,-89,-34,-115,-124,-36,90,-289
46,82,-49,-27,-53,-138,-12,86,-65
13,22,-9,-1,-29,-25,-9,25,-13
2,22,-15,5,-15,-24,-10,26,-9
1,14,-7,-9,-19,-7,10,21,4
59,27,-90,-50,-141,-164,-39,165,-233
52,51,-64,-32,-84,-140,-29,111,-135
53,52,-65,-21,-126,-138,4,131,-110
30,44,10,16,-21,-67,1,96,109
13,8,-23,-2,-30,-66,-29,11,-118
24,-3,-18,-6,-31,-66,-24,28,-96
-5,20,-13,-9,-30,6,-4,-7,-42
2,8,4,2,2,-3,1,18,34
47,90,86,32,44,31,28,91,449
175,277,260,43,100,51,96,294,1296
6,20,22,-5,10,-17,8,31,75
8,13,-13,4,-3,-15,3,18,15
76,78,-14,11,-54,-140,3,128,88
-55,-16,-59,-24,-84,-154,-87,60,-419
-53,-24,-63,-32,-84,-174,-64,69,-425
-18,1,-14,-4,-11,-60,-35,19,-122
-18,-5,-12,6,-25,-60,-37,24,-127
-87,1,-65,-44,-84,-229,-128,103,-533
-88,-51,-125,-62,-148,-277,-138,121,-768
-56,-11,-32,-23,-62,-23,-42,47,-202
0,13,-4,-10,7,-24,-9,20,-7
-5,6,-7,-24,-9,-29,-4,37,-35
-39,36,-43,-73,-117,-48,-23,137,-170
-23,62,-43,-22,-109,-40,-17,134,-58
44,4,-29,-36,-13,-88,5,96,-17
81,123,-15,-27,-49,-178,-19,127,43
11,34,-9,-11,16,2,11,20,74
0,7,-10,-14,-24,-37,-12,26,-64
2,7,-27,-33,-30,-45,-22,18,-130
-48,-25,-55,-32,-88,-76,-25,63,-286
-20,-23,-53,-37,-109,-82,-40,75,-289
-14,-25,-51,-43,-105,-85,-34,80,-277
21,121,-9,-67,-16,12,-6,151,207
77,55,13,-31,-19,-56,18,105,162
-27,56,-111,-58,-258,-172,-37,215,-392
61,-15,-16,-31,-59,-106,12,98,-56
55,98,-40,-61,-90,-113,24,179,52
38,44,-68,-60,-76,-104,3,103,-120
19,-3,-15,5,-33,-14,-16,19,-38
5,21,-40,-44,-83,-133,-20,119,-175
26,19,-27,-37,-5,-90,-37,68,-83
-19,67,-2,-31,-56,-70,-15,87,-39
20,10,-54,-8,-122,-60,12,61,-141
13,11,-20,-5,-18,-16,1,27,-7
40,-8,-60,-19,-96,-83,-10,40,-196
-2,65,-36,-30,-32,-11,25,43,22
12,32,-14,-18,-18,-52,-6,42,-22
298,338,-644,-364,-929,-1263,-274,1038,-1800
-7,16,-15,-6,-35,-5,-8,32,-28
5,15,-13,-10,-13,-42,-15,26,-47
87,158,-20,-11,-120,-106,4,230,222
-3,-2,3,-7,-12,-5,-1,15,-12
-4,18,45,27,-32,18,-10,93,155
7,10,0,10,-26,-62,-5,47,-19
5,18,-8,-41,-38,-116,-28,85,-123
15,12,-49,-32,-91,-101,-23,78,-191
3,2,-36,-29,-66,-32,1,38,-119
74,128,99,-43,76,-25,15,203,527
98,123,-28,14,-52,-70,47,146,278
-55,-24,-74,-74,-89,-108,-64,72,-416
-1,11,-6,7,-27,-18,-10,35,-9
0,29,0,0,-16,-42,-23,57,5
28,91,-19,-24,-48,-111,18,128,63
-5,36,-12,-29,-45,-44,6,63,-30
28,70,22,-8,10,-44,8,75,161
-9,17,-10,-27,-36,-40,-19,15,-109
32,100,54,85,-209,-46,-41,166,141
1,148,120,163,-227,35,-13,273,500
0,15,-11,-11,-5,-27,-10,21,-28
56,448,-73,-280,-394,-186,4,603,178
26,98,6,-11,-35,-109,-15,106,66
101,140,5,17,-12,12,66,194,523
162,265,257,45,102,45,96,279,1251
36,20,2,-10,-89,-73,-2,117,1
24,12,-69,-31,-106,-47,-18,65,-170
27,29,-51,-11,-151,-125,-27,65,-244
6,19,-8,4,-26,-24,0,47,18
9,27,-7,9,-26,-24,-2,44,30
6,18,-6,7,-27,-30,3,43,14
5,19,-1,1,-13,-22,-1,25,13
12,21,-22,-5,-19,-28,-4,32,-13
33,23,-26,-1,-70,-67,-2,48,-62
10,26,-19,-22,-50,-35,8,62,-20
9,20,5,-16,6,21,20,22,87
0,36,2,-35,23,18,24,47,115
33,205,25,-93,-106,-214,-31,255,74
2,48,29,-4,-32,-56,-22,106,71
25,83,-32,-20,-117,-201,-13,198,-77
-17,-5,20,33,-72,-35,-33,83,-26
74,101,-4,-30,19,-61,26,118,243
-8,21,-5,-3,-28,10,-5,-1,-19
-4,20,-6,-1,-29,9,-1,-4,-16
-4,24,-9,-9,-26,9,4,-4,-15
25,-22,19,-6,-53,-31,-20,111,23
30,-21,19,-15,-54,-33,-18,113,21
32,32,-6,-21,-17,-31,28,38,55
-2,27,-32,-71,-76,-117,-17,129,-159
16,30,-19,-23,-23,-50,-8,37,-40
17,27,-12,-28,-33,-58,16,54,-17
-56,-37,-97,-65,-128,-145,-67,106,-489
33,18,-65,-83,-134,-143,-43,125,-292
31,12,-125,-32,-192,-207,-36,144,-405
20,-4,-59,-34,-92,-84,-21,27,-247
16,16,-23,-1,-33,-17,10,36,4
33,182,-132,-114,-171,-286,0,303,-185
11,-3,-25,-16,-29,-31,-8,28,-73
-2,38,-10,-7,-24,-63,-22,47,-43
9,25,-3,-15,-31,-55,-10,38,-42
6,22,-2,-9,-30,-47,-9,43,-26
2,5,-11,-6,-36,-52,-15,43,-70
10,52,-10,1,6,-2,15,50,122
-7,0,-180,-129,-270,-215,-64,172,-693
9,30,-23,-36,-11,-36,3,39,-25
151,185,-8,16,12,-32,106,172,602
29,20,-54,25,-124,-76,-1,77,-104
97,75,-102,-73,-158,-163,10,161,-153
-21,34,-20,-47,-47,-34,2,70,-63
17,2,-18,-15,-27,-53,-6,38,-62
35,10,-55,-3,-136,-67,20,78,-118
7,35,-47,-54,-87,-143,-33,115,-207
40,131,-41,-44,-134,-72,-38,133,-25
5,124,-4,-44,-121,-69,-19,130,2
11,-7,-45,-62,-71,-135,-25,88,-246
7,4,-13,-5,-9,-22,-5,17,-26
9,68,-3,-28,-23,-100,2,108,33
-4,13,-21,-8,-25,-53,-20,22,-96
-11,7,-17,-12,-22,-32,-14,30,-71
48,48,-15,22,-12,10,47,31,179
7,21,-34,9,-83,-101,-9,89,-101
18,10,-51,-34,-67,-107,-2,77,-156
12,56,-4,-92,-15,-105,4,146,2
-13,-42,-75,-10,-95,-57,-14,30,-276
28,46,-46,-18,-67,-109,-18,122,-62
66,77,-56,-55,-56,-141,-34,150,-49
-18,51,-34,-41,-117,-23,-25,97,-110
-9,69,-45,-71,-44,-35,-12,105,-42
3,42,-10,-5,-33,-38,6,59,24
8,23,7,-10,-3,-20,10,54,69
73,53,-17,-52,-106,-200,-13,146,-116
16,33,-86,-91,-238,-137,1,144,-358
14,-25,-60,-51,-167,-69,9,130,-219
7,18,-20,-62,-63,-151,-29,109,-191
-28,16,-47,-93,-46,-136,-27,77,-284
40,15,-58,0,-117,-107,-23,122,-128
50,36,-12,3,-117,-109,8,108,-33
21,12,-50,-49,-102,-58,-2,46,-182
45,39,-23,14,4,20,40,26,165
5,23,-11,-2,-8,-28,-3,35,11
29,24,-23,0,-32,-57,-8,56,-11
18,35,-10,-18,-10,-19,15,48,59
39,113,-40,-52,-64,-92,30,157,91
22,3,-16,19,-47,-20,9,35,5
28,21,-33,13,-43,-17,13,26,8
32,20,-55,-16,-101,-62,2,59,-121
37,33,9,-22,-4,-52,6,39,46
46,78,-1,29,-44,-80,25,103,156
-3,13,-27,-18,-19,-34,-11,1,-98
28,109,-43,-40,-7,-47,43,87,130
7,11,-5,16,-28,-26,4,43,22
14,15,-31,2,-36,-56,-18,21,-89
70,65,-68,-19,-54,-56,19,80,37
-10,3,-23,4,-45,-27,-15,44,-69
-5,6,-36,-35,-58,-52,-4,45,-139
1,13,-57,-26,-79,-119,-36,97,-206
21,-6,-48,-62,-61,-128,-50,136,-198
91,108,27,-11,-25,-85,11,135,251
26,130,-54,-65,-131,-27,-8,165,36
13,54,-68,-89,-37,-86,-8,118,-103
56,44,-42,13,-167,-105,-20,54,-167
58,77,-7,30,-138,-76,-29,106,21
24,12,2,8,-29,2,15,54,88
22,66,-14,-39,16,-45,32,82,120
36,49,-21,-3,-26,-95,-34,13,-81
38,22,-37,7,-44,-43,33,30,6
12,44,-12,1,-110,-34,14,90,5
285,603,761,395,340,563,142,751,3840
-21,6,-24,-27,-42,-13,-16,25,-112
-7,33,-2,-11,-33,-73,-33,87,-39
49,124,-10,1,-58,-58,-4,155,199
13,8,-54,-32,-76,-103,4,46,-194
-7,5,-80,-74,-90,-152,-31,76,-353
25,150,-82,-149,-136,-273,-69,317,-217
27,32,-56,-64,-70,-104,-8,87,-156
15,28,-42,-26,-68,-95,-13,61,-140
17,-1,-42,-42,-62,-105,-50,144,-141
33,8,10,-1,-50,-91,-18,56,-53
23,21,-9,-5,-15,-22,17,20,30
11,30,14,-4,-8,-11,10,44,86
-7,8,-10,-6,-38,-30,-14,33,-64
9,-1,-8,-11,-25,-31,-9,33,-43
3,11,-2,11,-20,-28,-19,41,-3
-5,13,-12,-25,-37,-63,-8,54,-83
85,45,-66,-1,-175,-112,66,185,27
64,139,-89,-105,-124,-223,-47,227,-158
161,191,-37,18,-102,-184,60,261,368
41,40,-4,9,-7,-10,21,26,116
-4,17,-22,-43,-45,-67,-17,52,-129
23,39,-94,-56,-166,-92,1,118,-227
58,97,-2,-29,-90,-94,-18,208,130
11,17,-4,-8,-5,-21,-3,26,13
-1,8,-13,4,-10,-27,-13,12,-40
56,64,-60,2,-91,-125,-37,51,-140
47,91,-10,-52,1,-27,28,103,181
18,-2,-30,-36,-36,-46,-10,39,-103
87,82,-18,-53,-153,-111,-25,243,52
29,45,-21,-31,-33,-72,-11,77,-17
27,6,-66,-20,-124,-87,0,68,-196
30,65,-10,5,-39,-59,-6,66,52
40,19,-95,-87,-202,-227,-59,128,-483
15,2,-82,-38,-102,-119,-15,93,-246
18,35,-42,-28,-62,-44,23,52,-48
76,74,-17,-17,-29,-29,27,92,177
65,53,-33,50,-74,-62,8,6,13
63,82,-77,-62,-215,-196,1,235,-169
46,51,-5,-1,-10,-53,13,61,102
16,35,-46,-26,-87,-73,3,137,-41
7,28,-21,-61,-50,-130,-42,104,-165
4,20,-4,-7,-37,-57,-18,64,-35
14,16,-18,-5,-40,-21,7,31,-16
7,19,-26,-2,-29,-7,20,28,10
17,23,-83,-48,-108,-102,-3,103,-201
10,-26,-30,-35,-57,-112,-41,95,-196
-35,22,-21,-59,-2,-101,-16,82,-130
52,37,-53,-36,-88,-135,19,90,-114
14,9,-11,4,-13,-15,2,1,-9
4,7,-20,-18,-25,-11,0,28,-35
10,26,-38,-17,-109,-49,-8,83,-102
100,98,-67,38,-164,-119,38,111,35
114,262,-162,2,-184,-51,180,210,371
94,122,-28,12,-128,-100,51,157,180
73,77,0,-33,-123,-200,8,148,-50
42,84,3,20,-71,-72,3,132,141
24,28,-67,-5,-120,-60,0,82,-118
26,90,-54,-23,-123,-90,-34,155,-53
58,18,-85,-31,-71,-123,4,83,-147
-21,25,-12,-17,-37,-39,-13,57,-57
63,71,-63,19,-35,24,67,56,202
35,64,18,17,-6,-52,-24,61,113
34,30,2,6,-19,-50,-23,84,64
0,4,-12,-2,-15,-9,-2,19,-17
-8,21,13,-20,1,-31,-3,11,-16
-1,8,8,-27,0,-27,-2,26,-15
9,18,19,-19,-4,-29,-7,33,20
-9,42,-64,-40,-103,-22,3,82,-111
51,155,-60,-61,-134,-215,-11,166,-109
61,108,-54,-36,-143,-208,-26,266,-32
-2,47,-41,3,-101,-42,-11,100,-47
31,19,-53,-45,-84,-71,-21,25,-199
41,50,3,-2,-101,-51,-3,113,50
32,74,1,-33,-61,-46,3,141,111
56,158,-12,-77,26,-199,-85,181,48
9,12,-32,0,-48,-48,-3,42,-68
26,52,-64,-54,-103,-158,-46,109,-238
32,21,4,-14,-85,-75,-7,117,-7
-9,20,-2,-3,-26,11,1,-6,-14
30,22,-5,-9,-2,-40,-10,56,42
161,341,-55,53,66,-53,92,161,766
18,20,-8,13,-68,-4,-22,91,40
8,18,-15,0,-78,-22,-20,99,-10
28,45,1,7,-6,-13,7,59,128
27,-26,-18,-32,-19,-20,4,37,-47
-21,11,-50,-57,-126,-165,-50,98,-360
-49,-24,-50,-69,-123,-98,-50,100,-363
27,46,1,-14,-33,-86,-10,99,30
19,56,-92,-54,-124,-133,-13,78,-263
29,41,-70,-85,-80,-147,-43,92,-263
25,22,-29,36,-63,-28,3,52,18
2,18,-27,-6,-36,-12,-1,31,-31
18,19,-4,-7,-39,-61,-14,45,-43
-2,23,-14,-6,-32,-50,-10,36,-55
4,37,14,-19,-22,-8,-3,75,78
104,118,-247,-150,-261,-235,67,268,-336
10,31,15,35,-30,1,-10,73,125
-19,25,-38,-43,-115,-33,-17,83,-157
23,83,-111,-71,-133,-155,-20,121,-263
54,25,2,-17,-40,-106,15,66,-1
92,81,-6,-12,-48,-30,32,102,211
10,57,-4,-18,-117,-84,-71,116,-111
-5,22,-3,-15,1,-29,-4,18,-15
97,231,12,-45,-292,-169,-88,291,37
22,33,-73,-17,-99,-88,13,62,-147
28,31,-62,-55,-79,-84,10,55,-156
55,128,-28,-112,-133,-230,3,248,-69
62,65,-34,27,-85,-51,14,7,5
46,-21,-70,9,-168,-108,9,126,-177
8,82,-24,-31,-47,-113,-33,67,-91
19,47,-29,-41,-52,-75,4,61,-66
218,153,125,-59,-18,-100,-80,248,487
13,33,4,-14,0,-2,0,55,89
-31,8,-39,-42,-74,-75,-19,76,-196
141,215,15,122,-191,21,69,349,741
70,114,-127,-131,-107,-118,71,202,-26
42,76,-93,-135,-197,-226,-32,307,-258
-56,-48,-77,-39,-116,-107,-39,51,-431
-6,1,-23,-18,-16,-10,-14,10,-76
244,537,644,451,216,531,114,607,3344
43,20,-126,-64,-176,-171,-15,74,-415
7,13,-30,-41,-39,-28,14,10,-94
39,99,-47,-18,-91,-28,19,86,59
240,350,206,70,81,-21,82,416,1424
3,-6,-105,-86,-135,-97,-49,120,-355
2,-35,-114,-58,-149,-122,-26,105,-397
8,84,-9,-31,-20,-16,-22,101,95
-43,-15,-251,-122,-410,-273,-89,292,-911
-8,-7,-51,-33,-98,-126,-43,114,-252
95,136,-29,34,-118,-187,-27,174,78
1,25,2,10,-72,-30,-35,81,-18
-1,22,7,18,-75,-38,-45,66,-46
150,252,20,6,-121,-56,42,357,650
35,1,-64,-66,-102,-159,-54,127,-282
10,40,-96,-48,-191,-100,-21,163,-243
18,83,-107,-77,-131,-151,7,132,-226
35,67,-96,-31,-144,-107,-16,111,-181
7,-13,-79,-60,-79,-160,-19,80,-323
6,4,0,-18,-85,-51,-26,81,-89
6,21,-5,30,-50,-47,-11,80,24
42,25,-43,-8,-29,-100,-37,106,-44
33,22,-27,-55,-20,-101,-20,100,-68
21,25,-30,-14,-27,-61,-6,35,-57
38,31,3,31,-45,-15,9,65,117
15,39,0,-17,-50,-19,18,77,63
-20,21,-66,-32,-133,-49,-12,80,-211
-6,26,-38,-13,-80,-89,-6,92,-114
62,13,-74,-34,-209,-172,-51,139,-326
23,71,-16,-8,-66,-33,13,101,85
4,-5,-11,-9,-27,-21,-6,27,-48
46,152,-38,-11,-188,-221,-12,235,-37
836,555,415,249,-554,199,26,1224,2950
0,8,-32,-9,-111,-62,5,69,-132
3,30,-36,-42,-49,-50,-1,54,-91
42,73,-9,9,-59,-129,-8,106,25
205,624,853,350,394,551,136,855,3968
26,39,-30,-2,-53,-84,12,82,-10
194,140,-132,-128,-161,-214,-44,348,3
33,26,-26,-23,-13,-25,13,45,30
10,121,-109,-160,-233,-249,-79,362,-337
39,87,-49,-16,-162,-116,10,134,-73
44,36,-55,-48,-135,-137,-28,112,-211
22,33,-30,-15,-16,-29,15,22,2
4,161,-21,-72,-80,40,12,254,298
3,15,-36,7,-56,-50,7,45,-65
88,160,-5,-75,48,17,75,56,364
32,60,-40,-40,-72,-63,20,94,-9
5,20,-30,-23,-36,-67,-15,65,-81
34,164,-24,0,-166,-175,-26,290,97
86,131,-5,-46,10,-54,10,146,278
85,84,-42,-11,-133,-153,-15,77,-108
-28,37,-67,-76,-53,-123,-30,78,-262
-10,96,-26,-60,-50,-172,-43,116,-149
32,87,-28,-17,-20,-160,6,125,25
22,11,-9,-4,-11,-58,-16,41,-24
-6,11,-22,-30,-29,-17,10,18,-65
-10,81,-12,-24,-69,-25,-14,101,28
48,53,-10,31,-131,-70,-29,64,-44
82,61,-17,25,-169,-79,-15,98,-14
19,10,-66,-38,-84,-72,-28,31,-228
21,17,-58,-24,-76,-89,-10,47,-172
44,107,29,65,-148,-65,-30,101,103
1,21,-22,-13,-66,-40,17,57,-45
-2,23,-4,-22,-42,-148,-57,136,-116
3,37,25,3,-45,-15,-13,76,71
25,1,-51,-24,-87,-75,20,35,-156
52,78,-29,-39,-47,-99,15,143,74
-30,3,-77,-61,-122,-122,-47,79,-377
-10,8,-31,-21,-65,-110,-31,81,-179
12,13,-99,-63,-129,-122,-28,104,-312
0,24,-26,-63,-66,-47,-19,122,-75
8,108,-224,-255,-484,-496,-151,583,-911
12,45,-3,1,-3,-24,-5,48,71
-33,-18,-67,-9,-90,-52,-37,47,-259
-54,457,-182,-396,-873,-682,-134,1314,-550
11,45,-17,-30,-15,-25,10,95,74
48,24,12,-22,-3,-17,37,87,166
57,78,45,10,18,-1,13,109,329
58,78,30,-19,14,-10,21,97,269
38,70,41,9,-25,8,48,85,274
61,56,-6,30,-37,-31,23,106,202
101,182,23,-2,8,-74,13,190,441
-5,16,24,9,-47,-20,-9,76,44
19,4,-54,-16,-148,-108,-14,47,-270
14,15,-7,-2,-31,-60,-18,35,-54
26,35,-49,-8,-144,-57,17,72,-108
-80,44,-47,-25,-116,-143,-54,131,-290
25,16,-21,-1,-32,-6,23,27,31
-9,48,-41,-52,-80,-129,19,152,-92
20,34,-21,-8,-27,-62,-4,39,-29
1,15,-27,-10,-49,-62,-26,33,-125
8,0,-14,-16,-37,-36,-15,16,-94
31,41,45,-5,41,12,30,58,253
14,20,5,10,-20,-53,-4,62,34
30,19,-32,-24,-8,-109,-23,100,-47
-18,54,-20,-36,-37,-46,-9,52,-60
72,73,-82,-32,-166,-105,26,176,-38
10,15,-9,0,-36,-17,4,30,-3
7,-10,-15,-1,-25,-29,-2,30,-45
10,12,-43,6,-79,-46,-10,58,-92
54,54,-50,-3,14,-12,43,32,132
17,31,3,-1,5,12,16,27,110
8,11,-12,-22,-13,-28,-6,12,-50
-5,-2,-14,-13,-21,-65,-21,29,-112
25,7,-57,-36,-90,-73,-14,52,-186
24,5,-55,-32,-86,-74,-10,31,-197
12,38,-24,-40,-13,-57,-7,32,-59
0,3,-29,-34,-14,-69,-23,14,-152
69,54,-28,43,-83,-61,6,9,9
57,13,-18,23,-76,-38,25,50,36
60,35,-26,28,-67,-17,37,53,103
11,8,-60,-40,-112,-66,-8,32,-235
19,32,9,-33,-47,-61,0,90,9
20,50,-53,-30,-62,-87,-21,67,-116
14,12,-31,-10,-81,-47,-2,45,-100
25,50,-10,-14,-59,-48,-4,67,7
2,17,8,-12,-2,3,0,38,54
24,10,-39,-11,-50,-97,-9,52,-120
109,190,-1,-35,21,-64,35,187,442
34,145,-69,-147,-186,-255,-8,269,-217
-7,16,-69,-38,-176,-22,-1,118,-179
19,25,14,36,-40,-11,15,73,131
30,16,21,16,-32,-23,1,69,98
17,89,79,67,-80,69,17,171,429
21,34,-1,-19,-34,-54,-9,49,-13
7,-10,-24,25,-63,-40,-15,70,-50
12,8,-15,-7,-12,-18,4,13,-15
28,31,-12,2,-5,-34,7,44,61
24,40,2,12,-13,-29,9,31,76
14,22,-22,-6,-33,-32,-17,41,-33
21,45,-35,-30,-35,-64,-13,62,-49
6,12,-44,-34,-74,-101,-11,56,-190
131,-40,-71,-74,-275,-494,-81,379,-525
26,40,-11,-28,-87,-10,-5,156,81
85,160,-137,-28,-169,-133,19,193,-10
123,156,-184,-136,-250,-276,19,272,-276
-13,12,-5,37,-48,-28,-18,30,-33
33,38,-77,-13,-82,-129,4,75,-151
31,25,-60,-16,-93,-136,-18,67,-200
6,-9,-80,-106,-134,-179,-43,106,-439
1,36,-25,23,-41,-79,-19,47,-57
71,25,-34,35,-136,-115,-7,106,-55
17,13,-21,3,-32,-51,17,39,-15
78,110,-13,1,-153,-142,-21,195,55
7,14,-66,-61,-92,-178,-36,72,-340
34,16,-50,-2,-112,-55,16,78,-75
3,6,-27,-39,-23,-67,-6,45,-108
16,83,-2,-28,-15,-95,26,103,88
122,289,-175,-325,-302,-437,-77,600,-305
-11,42,-23,-34,-60,-66,-14,56,-110
124,226,-94,-72,-293,-328,50,482,95
127,222,-103,-74,-299,-325,58,476,82
8,22,-4,-3,-6,-13,-1,30,33
7,23,-20,-3,-37,-9,5,28,-6
15,12,-27,0,-33,-20,7,32,-14
26,18,-15,0,-40,-16,24,48,45
67,142,-55,-13,-67,-84,34,161,185
50,86,-5,-15,-18,-18,27,83,190
18,106,-159,-46,-195,-218,-47,89,-452
23,45,-27,-15,-37,-101,6,52,-54
43,85,-3,-33,-33,-111,-15,65,-2
-2,25,3,-7,-25,-37,-5,56,8
-2,6,-13,-4,-16,-21,-13,20,-43
1,7,-19,19,-91,-53,-5,59,-82
77,49,-40,42,-77,-55,52,84,132
64,117,-54,-13,-48,-79,15,95,97
2,21,-57,-37,-98,-111,-20,35,-265
6,4,-3,3,-5,-5,7,14,21
8,36,4,-18,-6,-37,-3,38,22
-26,38,26,9,-38,33,-13,22,51
8,21,2,-10,-32,-20,7,38,14
7,21,3,-9,-34,-21,4,38,9
-83,-21,-72,-89,-91,-118,-72,52,-494
-70,-46,-89,-62,-117,-133,-71,67,-521
-49,-17,-52,-62,-88,-106,-49,55,-368
-76,-61,-85,-63,-84,-120,-67,35,-521
-57,-38,-82,-42,-92,-132,-76,59,-460
-63,-26,-77,-72,-97,-118,-68,71,-450
-64,-30,-72,-80,-95,-107,-72,61,-459
-90,-68,-83,-67,-112,-110,-55,59,-526
136,213,-41,-11,-27,-67,118,182,503
-25,-14,-59,-39,-64,-81,-68,51,-299
38,83,-1,-11,11,2,36,65,223
102,165,-6,-43,-23,-93,28,160,290
-22,-10,-26,-17,-24,-36,-30,15,-150
28,75,-11,-45,-125,-205,-52,147,-188
-5,-4,-11,-3,-13,-17,-10,9,-54
36,92,-29,-22,-48,-47,49,99,130
-22,40,11,-40,-24,36,-14,13,0
45,94,-44,-17,-78,-123,-1,126,2
56,89,-37,-8,-83,-121,5,123,24
37,92,-38,-14,-46,-55,13,66,55
-1,8,-14,-9,-15,-22,-9,11,-51
2,20,0,-14,-19,-15,-2,21,-7
55,61,2,-2,-16,-46,28,90,172
-5,14,-29,-18,-54,-27,3,25,-91
-20,41,-73,-53,-104,-75,-15,127,-172
10,19,-24,-24,-9,-34,5,41,-16
-49,-42,-64,-53,-76,-135,-79,54,-444
39,103,-4,-9,-67,-108,-3,47,-2
-45,-33,-64,-46,-86,-122,-75,54,-417
-41,-1,-63,-42,-94,-102,-68,66,-345
8,20,-16,-16,-11,-3,16,23,21
135,135,80,59,4,3,21,159,596
6,30,-13,-10,-18,-13,0,39,21
-27,99,-128,-118,-158,-200,-7,178,-361
16,24,-42,-9,-74,-40,17,56,-52
-3,25,3,-5,-12,-14,14,40,48
-54,39,-35,-33,-82,-120,-73,93,-265
-46,25,-37,-24,-93,-122,-58,90,-265
-53,-23,-67,-61,-104,-112,-42,39,-423
-61,-13,-58,-67,-88,-128,-71,58,-428
-1,8,1,4,-2,-17,-10,22,5
132,193,17,-43,-35,-61,77,253,533
86,152,74,9,44,18,63,137,583
-7,41,-22,-7,-53,-61,-10,69,-50
92,142,-43,-26,-158,-168,-5,230,64
-5,2,-32,-27,-24,-36,-2,44,-80
-10,20,-31,-47,-72,-96,-34,85,-185
-16,27,-20,-5,-49,-72,-4,64,-75
82,94,10,-9,20,-33,33,108,305
117,166,9,0,15,-21,89,146,521
160,237,-28,-2,-75,-61,131,256,618
-18,-7,-16,-35,-22,-29,-16,34,-109
87,113,-12,-48,-107,-84,36,209,194
-1,15,-10,-15,-47,-59,-10,20,-107
35,57,21,-21,7,-35,19,54,137
15,58,-27,-6,-37,-58,-18,49,-24
117,171,9,2,19,-19,86,147,532
120,166,8,-5,14,-22,89,143,513
118,170,5,4,26,-19,86,147,537
68,105,14,-39,-15,-51,13,100,195
44,51,7,-26,6,0,58,66,206
-6,29,-28,-36,-47,-111,-31,84,-146
8,14,-19,-5,-7,-64,-31,34,-70
0,60,-9,-51,-28,-40,11,155,98
10,16,1,-2,4,0,8,16,53
12,7,-7,-2,-18,-25,-3,19,-17
12,7,-10,-8,-11,-16,1,17,-8
-12,37,-18,-10,-21,-36,-17,39,-38
-1,23,3,4,-3,-15,-2,38,47
25,40,-16,-21,-20,-43,24,69,58
68,92,-37,-41,-46,-90,18,117,81
18,79,65,23,30,61,-14,119,381
41,63,0,15,-8,-22,18,70,177
1,40,5,-30,-27,-65,-5,82,1
31,114,-25,-61,-86,-216,-11,162,-92
32,5,-37,-19,-36,-97,-6,38,-120
115,268,27,-80,29,-211,18,356,522
12,58,-26,-30,-15,-62,16,68,21
40,49,12,6,4,-20,23,57,171
27,33,0,-4,-6,-8,22,38,102
64,82,-47,-6,-102,-114,-5,199,71
-10,6,-9,-10,-7,-12,-11,14,-39
42,138,-52,-17,-105,-103,10,79,-8
85,109,-23,-24,-36,-56,42,99,196
18,38,23,4,23,-2,18,49,171
8,54,-48,-34,-9,-8,32,87,82
24,33,-28,-14,-78,-70,1,66,-66
68,98,-24,-8,3,-30,52,83,242
66,100,-27,-6,-12,-38,45,79,207
-10,9,-7,-10,-14,-24,-11,22,-45
23,17,-17,0,-17,-28,6,20,4
22,15,-16,-1,-16,-29,4,18,-3
-3,8,-27,-20,-24,-40,-19,20,-105
14,19,-17,3,-28,-15,16,31,23
13,37,-42,-35,-74,-83,-19,88,-115
-1,40,-86,-70,-115,-191,-80,146,-357
56,149,-12,-25,1,-26,67,140,350
-8,-15,-33,-25,-43,-49,-23,31,-165
12,19,-20,-1,-30,-18,17,24,3
-87,-34,-103,-84,-106,-143,-92,88,-561
131,162,215,126,91,39,35,260,1059
-19,2,-25,-19,-20,-19,-20,17,-103
125,196,68,-13,74,-42,23,190,621
-10,29,11,22,-19,0,0,32,65
-5,15,-34,-26,-73,-62,-7,61,-131
201,333,-50,30,-36,-54,146,306,876
-40,52,-48,-40,16,5,21,81,47
13,20,-22,-12,-51,-73,-15,13,-127
12,20,-22,-11,-53,-74,-16,12,-132
9,95,-47,-26,-15,-41,35,144,154
48,62,-30,-6,-77,-78,-1,118,36
124,225,-60,35,-99,-101,60,171,355
12,17,2,2,4,-2,10,3,48
12,17,2,2,4,-2,10,3,48
0,52,11,-5,10,-27,-14,48,75
-2,55,11,-5,9,-25,-11,49,81
99,187,-39,-9,-147,-164,20,213,160
99,177,-47,-21,-149,-178,23,201,105
87,77,-35,108,-132,-65,54,167,261
148,177,11,-20,-16,-161,-5,185,319
59,104,12,-28,13,-21,63,111,313
55,112,5,-35,8,-37,55,117,280
8,28,-31,-24,-43,-36,-19,17,-100
26,82,-106,-78,-133,-108,-56,47,-326
-17,19,-5,-12,-24,-58,-18,53,-62
-5,57,-29,-38,-12,-38,-2,69,2
-3,57,-30,-38,-9,-40,1,71,9
31,75,4,-43,29,-55,24,131,196
-30,25,-44,-39,-56,-119,-54,71,-246
-34,28,-45,-39,-54,-117,-49,71,-239
3,9,1,-4,1,-5,5,8,18
-1,10,1,-2,-2,-9,3,11,11
1,7,3,-2,1,-3,1,10,18
1,8,2,2,-3,-3,2,9,18
0,9,1,-3,0,-6,4,9,14
0,9,0,-7,2,-8,6,3,5
-5,10,2,6,-5,-4,-2,4,6
2,9,0,-4,1,-5,5,7,15
4,7,0,-4,0,-6,2,5,8
-5,6,-1,-2,-3,-3,-2,6,-4
132,238,69,60,18,-59,79,327,864
-5,103,-98,-79,16,-27,50,174,134
122,107,23,63,5,-29,77,124,492
122,107,23,63,5,-29,77,124,492
122,107,26,59,8,-26,76,120,492
122,107,23,63,5,-29,77,124,492
122,107,23,63,5,-29,77,124,492
122,107,23,63,5,-29,77,124,492
118,205,-26,49,-43,-92,64,183,458
-33,8,-74,-38,-104,-145,-42,113,-315
-12,41,-27,-28,-33,-75,4,81,-49
32,40,4,-2,18,16,39,25,172
32,40,4,-2,18,16,39,25,172
32,40,4,-2,18,16,39,25,172
-23,1,-14,-36,-29,-56,-33,31,-159
-18,-4,-22,-34,-31,-37,-14,10,-150
-18,-2,-22,-32,-30,-36,-16,7,-149
30,19,-31,-21,-65,-79,22,70,-55
32,15,-32,-23,-68,-85,22,73,-66
27,18,-32,-22,-67,-81,18,69,-70
30,19,-31,-21,-65,-79,22,70,-55
49,120,0,21,-75,-128,27,179,193
10,-11,-17,-8,-18,-14,15,14,-29
10,-11,-17,-8,-18,-14,15,14,-29
1,9,-1,-3,-1,-11,0,13,7
11,17,-10,0,-7,0,13,27,51
29,41,-33,3,-119,-92,8,81,-82
99,137,-57,-9,-118,-103,37,126,112
23,57,42,13,25,20,23,51,254
4,39,12,3,-8,-17,14,21,68
-11,-6,-14,-11,-14,-24,-21,7,-94
11,-13,-14,-20,-2,-46,-11,27,-68
11,-13,-14,-20,-2,-46,-11,27,-68
13,72,7,-54,-17,43,47,86,197
-5,9,-14,-6,-3,-11,-2,5,-27
-2,10,-1,-12,-6,-23,-4,30,-8
235,285,-180,-34,-280,-345,10,421,112
238,302,-183,-31,-279,-340,21,430,158
135,134,82,59,6,1,20,160,597
139,134,82,59,5,2,21,161,603
1,52,-11,-2,-95,-48,-33,118,-18
-1,54,-12,-1,-95,-47,-33,115,-20
2,54,-11,-4,-96,-42,-30,115,-12
79,118,-30,-53,0,-55,62,131,252
23,28,-18,-45,-31,-41,-8,34,-58
14,-9,-3,11,-17,-27,1,11,-19
16,-9,0,9,-23,-28,-4,13,-26
64,54,-60,-22,-97,-118,-2,68,-113
-5,27,-18,-15,-43,-61,-23,49,-89
62,58,-34,4,-87,-137,-9,60,-83
8,-13,-15,13,-29,-29,19,22,-24
25,28,-1,-20,-13,-17,9,22,33
205,403,5,-24,15,-195,130,429,968
-14,89,-137,-45,-11,-2,47,91,18
-10,-7,-15,-16,-23,-36,-13,12,-108
5,37,-3,-1,0,-16,-6,26,42
-4,20,-10,2,-26,7,2,-1,-10
35,52,-34,-66,-27,-104,-21,63,-102
39,67,18,-25,4,-43,26,91,177
23,32,-2,-11,2,-4,17,35,92
0,4,6,-6,11,-8,3,22,32
60,72,-20,-40,19,-55,13,75,124
17,18,-13,-12,-28,-84,-31,38,-95
16,18,-16,-11,-29,-83,-31,36,-100
16,10,-31,-33,-7,-77,-2,30,-94
16,10,-31,-33,-7,-77,-2,30,-94
3,11,0,-4,1,-5,7,9,22
62,54,-67,-28,-97,-115,0,70,-121
51,38,0,26,-21,-10,15,40,139
2,44,-17,-10,-22,-18,8,29,16
82,57,-16,-7,-47,-22,20,81,148
6,12,-9,5,-4,-34,-10,20,-14
12,67,13,2,13,-12,22,57,174
-79,-25,-73,-65,-100,-132,-83,67,-490
-1,11,-28,-45,-50,-56,-9,55,-123
-17,-7,-16,-16,-21,-18,-23,-1,-119
-66,-30,-65,-48,-101,-131,-73,73,-441
17,34,-13,-9,-37,-23,16,47,32
34,46,-4,-5,-16,-5,20,33,103
34,46,-4,-5,-16,-5,20,33,103
27,45,-7,2,-20,-1,15,35,96
34,46,-4,-5,-16,-5,20,33,103
29,40,-7,-7,-17,-9,23,33,85
29,40,-7,-7,-17,-9,23,33,85
43,13,-100,-48,-197,-107,0,107,-289
43,13,-100,-48,-197,-107,0,107,-289
8,15,4,5,-1,-12,-3,16,32
-1,-3,-19,0,-26,-23,-3,23,-52
-1,-13,-19,6,-31,-23,-1,29,-53
-1,-13,-19,6,-31,-23,-1,29,-53
41,40,-7,-8,26,-1,25,47,163
-4,-1,-54,-46,-61,-96,-49,59,-252
4,9,-12,-4,-20,-5,-8,27,-9
0,5,-12,-5,-18,-2,-5,26,-11
27,39,7,-23,-19,-5,24,74,124
-14,-25,-51,-43,-105,-85,-34,80,-277
-14,-25,-51,-43,-105,-85,-34,80,-277
-9,61,-66,-43,-122,-92,16,100,-155
-74,-29,-77,-62,-83,-134,-79,49,-489
-38,-26,-92,-50,-96,-116,-45,62,-401
-74,-46,-65,-52,-74,-135,-85,53,-478
-14,-6,-13,-11,-15,-15,-17,3,-88
6,45,1,-30,-10,-22,8,43,41
4,36,-2,-29,-16,-24,9,39,17
11,16,-8,14,-20,-10,14,23,40
27,99,-31,-21,-36,-47,29,58,78
31,69,-32,-30,-86,-78,3,130,7
36,93,0,-12,-62,-39,9,158,183
59,78,-34,-49,-94,-60,24,143,67
48,77,-46,-43,-73,-28,4,140,79
21,73,-48,-55,-116,-82,21,165,-21
24,41,-27,-8,-58,-30,23,77,42
23,47,-27,0,-72,-7,19,81,64
18,22,-19,-1,-29,-13,17,31,26
19,22,-20,0,-29,-14,17,30,25
-3,-1,-3,-1,-3,-2,0,-1,-14
4,2,-21,15,-31,-15,2,35,-9
-1,9,-15,9,-35,-18,6,33,-12
0,14,-7,13,-35,-16,5,35,9
-1,7,-14,10,-32,-21,5,27,-19
-1,11,-1,9,-30,-16,-16,44,0
-10,15,-7,13,-36,-16,-17,44,-14
-4,16,-8,10,-28,-11,-14,43,4
6,21,-6,6,-28,-27,-3,44,13
11,3,-14,-16,-34,-41,13,8,-70
11,3,-14,-16,-34,-41,13,8,-70
11,3,-14,-16,-34,-41,13,8,-70
-48,-19,-57,-33,-45,-85,-16,42,-261
-16,13,14,7,-22,-23,-16,28,-15
-8,-8,-13,-4,-31,-32,-27,6,-117
1,8,-10,-9,0,-19,0,21,-8
22,96,-48,-42,-127,-157,12,222,-22
-10,10,-11,-15,-9,-8,-9,14,-38
-10,10,-11,-15,-9,-8,-9,14,-38
35,48,24,16,-11,14,36,63,225
110,154,-69,-75,-118,-123,66,281,226
17,48,3,29,-110,-26,-18,130,73
30,62,-6,-11,-28,-31,24,75,115
143,172,47,-2,-22,-35,30,132,465
34,38,-4,10,15,6,36,31,166
15,23,-5,-10,-9,-21,9,28,30
0,56,-72,-27,-9,-5,44,91,78
93,84,-25,-8,-134,-219,-51,176,-84
13,21,11,-13,-25,-62,4,69,18
94,83,-41,-19,-151,-261,-49,168,-176
47,75,-30,10,-53,-93,19,61,36
4,20,-23,1,-42,-37,-1,27,-51
345,2062,-120,-453,87,-851,410,1257,2737
90,333,-83,-45,-72,-202,68,273,362
-7,19,-16,7,-27,-25,-12,32,-29
40,70,-6,2,-5,-2,46,79,224
38,72,-7,-3,-3,-2,49,80,224
3,13,-1,-1,-11,-23,-5,30,5
5,-6,-46,-34,-93,-85,-11,88,-182
5,-6,-46,-34,-93,-85,-11,88,-182
26,55,-10,2,5,13,30,36,157
13,-9,-50,-8,-103,-44,8,67,-126
22,46,5,-18,-34,-11,37,84,131
-1,1,0,1,-2,-1,0,0,-2
18,24,-25,-11,-26,-15,14,27,6
-4,45,16,2,-30,4,-18,39,54
-3,46,14,-3,-28,11,-15,31,53
18,20,-30,-7,-38,-25,12,28,-22
9,15,-4,-10,1,-6,2,16,23
52,68,21,-2,1,1,41,91,273
-20,12,-42,-42,-47,-38,-7,41,-143
2,11,4,-3,6,4,4,17,45
0,0,0,0,0,0,0,0,0
-58,5,-70,-64,-85,-138,-64,103,-371
24,42,-17,-14,-45,-53,-6,82,13
25,24,-22,-10,-53,-52,3,70,-15
8,26,-4,1,-24,-24,-3,46,26
18,22,1,-21,-19,-56,-8,57,-6
409,468,170,92,-40,-154,143,585,1673
370,480,147,25,-39,-94,122,616,1627
-9,149,-27,-72,-19,-25,61,201,259
35,98,-73,0,-47,-35,51,130,159
16,151,-52,-20,-40,-68,49,176,212
18,86,-14,10,20,5,49,137,311
8,19,-9,-18,-2,-31,-9,4,-38
22,23,-15,7,-29,-25,9,38,30
17,29,-14,-2,-60,-33,-11,45,-29
4,9,-32,-28,-46,-29,0,23,-99
26,48,32,12,13,-32,-3,59,155
17,49,-18,-23,-21,-10,6,58,58
-3,9,-18,-3,-18,-12,-2,22,-25
5,10,-17,-4,-25,-23,-4,25,-33
17,4,-4,-24,-5,-25,-14,45,-6
4,31,-79,-32,-137,-138,-25,61,-315
134,197,177,22,85,69,73,210,967
-9,15,-7,-6,-8,-25,-3,16,-27
99,94,-44,-50,-55,-105,13,174,126
101,146,-37,-41,-55,-100,36,188,238
89,198,-48,-61,-29,-125,49,182,255
41,80,-21,-75,-91,-233,-43,221,-121
0,12,-11,-7,-37,-5,24,35,11
19,21,-121,-129,-177,-178,-10,213,-362
117,178,-34,43,-139,-130,55,271,361
27,99,-5,-38,-31,-58,-4,117,107
16,22,-13,-19,-49,-24,3,46,-18
49,39,-34,-12,-54,-55,5,69,7
30,55,14,-32,-60,-47,-11,128,77
49,87,-14,-51,-57,-98,39,179,134
94,67,-89,63,-54,11,98,66,256
22,10,-30,-1,-27,-61,-15,32,-70
105,90,-19,-48,-4,-55,6,98,173
104,71,-54,-52,-125,-58,49,162,97
26,40,-67,-53,-65,-73,2,84,-106
125,146,-167,-231,-379,-285,72,424,-295
56,53,-40,6,-120,-90,27,83,-25
41,54,16,9,-43,-52,-4,121,142
10,9,-22,-4,-14,-5,3,18,-5
2,49,-11,-54,-36,-93,-12,82,-73
15,12,-12,1,-37,-22,16,32,5
29,25,-7,-7,-61,-135,-43,118,-81
-8,-8,-26,-20,-30,-57,-23,25,-147
-10,8,-32,-94,-73,-105,-39,106,-239
22,49,-17,-65,-56,-153,-14,84,-150
215,284,24,-6,9,51,160,290,1027
28,130,-8,-15,-103,-28,-8,220,216
42,42,-46,-48,-80,-63,9,79,-65
72,169,-28,13,-48,-56,80,120,322
7,-1,-12,14,-14,-30,-23,69,10
43,31,-18,2,-123,-113,12,103,-63
6,15,-13,0,-15,-25,-3,25,-10
52,54,-119,-122,-189,-182,-28,226,-308
9,95,-118,-86,-293,-358,-72,264,-559
7,15,-34,-5,-75,-61,1,51,-101
-2,12,-19,-28,-16,-32,-22,72,-35
-18,23,-12,-4,-40,-33,0,57,-27
5,9,-22,-8,-42,-48,-6,54,-58
24,53,-105,-32,-204,-73,0,93,-244
19,86,-12,-58,-41,-79,-3,113,25
22,102,-42,-41,-93,-58,31,99,20
-8,66,-67,-60,-67,-82,-10,65,-163
41,66,-22,-39,-33,-107,4,85,-5
50,89,-96,-58,-160,-227,-57,183,-276
64,101,-43,-60,-87,-102,16,173,62
55,69,-18,-22,-21,-47,30,81,127
17,-7,-23,-42,-67,-64,-37,55,-168
25,2,-31,-17,-20,-31,13,20,-39
-4,27,-13,-24,-36,-39,-6,54,-41
0,14,-8,3,-22,-23,-7,34,-9
30,53,-118,-71,-142,-98,6,97,-243
246,193,-47,1,-295,-192,-20,225,111
-41,0,-43,-22,-70,-99,-63,54,-284
231,313,-249,-8,-425,-418,-30,299,-287
11,24,-39,-15,-57,-75,8,63,-80
38,45,-4,-39,-17,-122,-3,88,-14
378,483,-159,-100,-228,-179,253,479,927
46,30,-99,-47,-187,-106,6,97,-260
-19,49,-31,-33,-87,-72,-38,128,-103
116,124,69,-13,1,-29,30,160,458
-93,-9,-88,-30,-133,-132,-49,95,-439
-97,-57,-103,-43,-159,-169,-75,98,-605
-83,-14,-107,-59,-145,-128,-64,104,-496
98,171,-122,-74,-124,-119,56,216,102
-9,16,-76,-53,-165,-103,-13,85,-318
22,-8,-54,-27,-99,-42,29,76,-103
2,51,-78,-65,-106,-78,-10,100,-184
27,126,-74,-73,-221,-208,-27,328,-122
36,2,-119,-104,-178,-214,-22,125,-474
40,-20,-82,-89,-204,-228,-33,116,-500
37,47,8,5,-4,-17,0,84,160
-40,10,-61,-32,-77,-110,-27,111,-226
-22,60,-28,-83,-60,-137,-59,119,-210
20,3,-26,-8,-55,-26,10,38,-44
18,15,-25,-7,-49,-22,6,35,-29
-13,21,-21,-39,-43,-74,-39,55,-153
201,258,-39,-30,-114,-193,47,331,461
292,229,-284,-131,-547,-595,-99,199,-936
52,61,-43,-9,-94,-102,-23,128,-30
107,73,9,-34,-9,-81,14,122,201
2,43,-2,-42,-40,-74,-16,61,-68
7,-16,-70,-6,-125,-59,15,52,-202
80,116,-79,-76,-115,-169,14,177,-52
89,141,-171,-71,17,-70,76,66,77
193,204,-224,-152,-198,-228,47,331,-27
15,2,-47,-58,-95,-104,-8,79,-216
24,47,-9,-3,-31,-41,2,29,18
3,48,-19,-43,-73,-75,-30,97,-92
-4,27,-12,-28,-65,-59,-46,87,-100
40,92,-13,-34,-44,-83,-16,96,38
43,106,-27,1,-67,-69,18,110,115
14,54,2,0,-12,-30,10,92,130
10,14,-42,-39,-70,-83,-38,35,-213
44,16,-140,-111,-265,-260,10,214,-492
12,28,-38,-56,-42,-105,-20,107,-114
-41,-2,-68,-66,-103,-114,-38,68,-364
399,609,-424,-225,-753,-979,-105,630,-848
11,77,-117,-96,-248,-148,-1,199,-323
-14,46,-71,-52,-111,-125,-37,123,-241
81,52,-12,-56,-103,-196,-16,157,-93
-2,9,-14,2,-21,-27,-9,16,-46
-10,17,-33,-16,-53,-44,-7,50,-96
-36,33,-62,-92,-71,-128,-41,98,-299
143,299,-173,-175,-381,-215,-39,543,2
-31,0,-97,-33,-126,-24,7,74,-230
29,52,-27,-58,-95,-56,23,80,-52
1,20,-19,-47,-35,-77,-8,52,-113
83,133,-9,53,-142,-5,46,200,359
-24,21,-37,-10,-52,-36,-13,91,-60
-2,10,8,-24,-3,-39,-1,10,-41
8,-22,-46,-60,-135,-74,-15,66,-278
10,30,16,4,-27,-35,-18,66,46
38,11,-65,-21,-114,-88,3,82,-154
107,63,-51,-6,-119,-121,79,125,77
34,27,-27,-2,-72,-59,-3,66,-36
6,17,4,-3,-2,-18,5,32,41
37,59,-18,4,5,-16,20,120,211
21,118,118,170,-228,19,-9,224,433
286,289,-270,88,-179,-52,315,47,524
-3,24,1,-7,0,-17,4,36,38
25,61,-49,-32,-107,-95,-1,54,-144
17,4,-22,-6,-22,-24,-8,17,-44
332,626,635,300,301,452,185,757,3588
116,195,111,1,-49,59,3,344,780
77,199,137,-6,-10,57,1,354,809
209,379,-123,-215,-580,-379,17,879,187
0,-36,-62,-11,-89,-51,-6,37,-218
-5,-31,-66,-13,-87,-44,-8,39,-215
241,330,-104,-169,-186,-429,-4,606,285
8,28,-60,-22,-161,-85,1,94,-197
432,691,-170,8,-443,-324,64,556,814
4,21,-39,-37,-50,-82,0,50,-133
23,51,-7,-17,-13,-9,17,60,105
5,-8,-30,-27,-37,-48,-18,18,-145
38,42,-11,-38,-46,-100,-9,83,-41
-20,49,-28,-24,-53,-77,-13,93,-73
33,49,-23,-18,-56,-46,-3,101,37
4,14,-23,-19,-38,-51,-10,78,-45
10,28,-50,-40,-76,-87,-16,28,-203
70,83,-2,-16,-16,-27,37,99,228
37,47,-30,-26,-30,-70,10,71,9
31,59,-27,-45,-63,-89,3,55,-76
-3,14,2,-29,-35,-21,-34,72,-34
30,49,-8,-32,-36,-90,7,120,40
23,56,-1,-27,-38,-77,12,124,72
31,96,-22,-15,-43,-54,20,144,157
42,13,-51,7,-101,-81,17,93,-61
-3,-6,3,-33,-14,-32,-12,47,-50
104,163,-88,8,-136,-133,59,150,127
59,193,-31,-15,-70,-117,23,157,199
82,35,-112,-74,-195,-249,-58,82,-489
122,2,-77,-86,-194,-421,-67,216,-505
31,31,-39,-12,-11,-43,28,43,28
91,79,-94,-145,-110,-179,-16,201,-173
-8,15,-7,-8,-20,-7,-2,32,-5
14,24,-12,5,-13,-18,13,26,39
198,253,-286,-24,-497,-383,21,227,-491
262,297,-233,11,-443,-454,-4,248,-316
40,54,-47,2,-85,-98,24,92,-18
5,38,-49,3,-129,-76,-9,90,-127
45,100,-86,-66,-65,-142,3,127,-84
56,83,22,-13,13,-17,46,86,276
40,37,-99,-64,-112,-149,-15,172,-190
41,41,-13,-23,-22,-43,23,84,88
21,42,-46,-55,-138,-130,-21,140,-187
19,13,-18,-10,-29,-24,16,23,-10
-20,-5,-23,-22,-35,-42,-35,31,-151
70,81,-45,-29,-115,-108,35,146,35
23,45,-29,2,-35,-95,-22,30,-81
5,26,-18,-9,-18,-53,-16,39,-44
3,8,-10,-1,-17,-27,-10,20,-34
0,28,-15,-1,-27,-79,-22,46,-70
46,47,-13,-25,-38,-35,7,70,59
70,38,18,27,4,-40,39,84,240
-1,27,13,-11,5,-20,1,38,52
30,31,-45,-17,-98,-72,-42,114,-99
18,107,14,5,-120,-151,-59,108,-78
51,145,-43,-69,-49,-53,-10,244,216
-11,7,-33,-6,-42,-32,-3,33,-87
11,1,-25,-10,-23,-17,8,20,-35
5,-10,-29,-3,-27,-18,2,21,-59
139,122,-25,-13,-58,-127,46,142,226
277,295,-237,27,-447,-428,-8,264,-257
219,289,-265,-3,-474,-407,9,260,-372
-101,81,-207,-168,-364,-380,-159,352,-946
-6,29,-27,-62,-48,-154,-29,89,-208
61,82,-129,-84,-207,-71,30,211,-107
-15,39,-23,-48,-52,-66,-25,78,-112
308,582,-380,-445,-519,-421,172,870,167
-5,103,-67,-81,-223,-140,-37,293,-157
27,89,-5,-26,-28,-58,17,114,130
-4,6,-168,-151,-246,-211,-71,160,-685
11,62,-117,-81,-191,-144,-2,127,-335
-7,18,-13,-4,-31,7,0,-5,-35
7,141,132,192,-228,25,-31,249,487
18,59,31,53,-162,-73,-40,92,-22
30,104,87,106,-181,-21,-36,180,269
67,50,-126,-70,-80,-104,37,128,-98
36,148,-6,-36,-64,-66,-6,209,215
46,12,-53,-45,-87,-126,-26,74,-205
-18,90,-81,-37,-65,-20,52,155,76
16,11,-17,-5,-58,-76,-8,71,-66
61,81,-43,-33,-91,-69,-22,161,45
-2,10,-33,-19,-31,-20,-12,24,-83
19,17,-49,-31,-94,-92,0,34,-196
31,72,7,-11,9,-44,-4,53,113
0,7,-56,-45,-77,-42,-1,61,-153
-11,26,18,6,-24,-15,11,68,79
30,38,-26,-17,-50,-58,-1,80,-4
-1,34,-13,-24,-41,-39,9,55,-20
-1,35,-9,-23,-38,-34,11,60,1
-4,29,-18,-20,-47,-45,1,61,-43
-7,21,-18,-31,-66,-60,-6,56,-111
60,24,-55,-35,-125,-164,-22,103,-214
54,17,-64,-38,-127,-175,-26,110,-249
9,81,-5,-50,-120,-121,16,172,-18
13,4,-84,-18,-121,-73,-2,59,-222
34,91,-27,-17,3,-20,62,41,167
53,36,-52,-65,-109,-194,-30,143,-218
32,55,-59,-65,-94,-63,11,75,-108
-150,-43,-140,-80,-207,-169,-132,119,-802
9,24,-54,-24,-85,-82,-16,44,-184
20,4,-62,-19,-143,-94,-2,65,-231
295,703,680,348,369,466,188,776,3825
0,16,-63,-35,-98,-171,-23,84,-290
21,29,-43,-2,-46,-25,15,44,-7
85,74,25,-9,4,-2,61,78,316
-3,4,-9,-3,-16,-40,-22,14,-75
66,62,-38,-28,-22,-48,31,75,98
24,27,-53,-24,-117,-45,10,86,-92
-10,15,-34,-32,-74,-89,-43,81,-186
-6,32,-29,-29,-88,-96,8,53,-155
16,70,17,13,-64,-38,-24,135,125
85,55,-51,12,-121,-119,7,33,-99
16,51,-10,-8,-21,-10,23,70,111
1,11,-16,-13,-49,-24,-23,74,-39
-2,7,-13,-3,-36,-35,-1,21,-62
12,16,-5,22,2,-55,-19,33,6
48,42,4,19,-14,-15,12,73,169
6,47,35,-64,-29,-10,-28,151,108
48,66,5,-27,-67,-119,-5,145,46
50,131,-37,-9,-17,-99,3,88,110
64,95,-22,-26,-27,-28,56,106,218
76,119,-43,-12,-30,-19,86,109,286
20,-1,-57,-29,-108,-117,-38,47,-283
0,58,-25,-18,-74,-86,-10,92,-63
27,19,-11,-45,-45,-99,-44,101,-97
3,7,-16,3,-19,-15,-5,22,-20
92,-107,-93,-187,-255,-368,-86,319,-685
13,-11,-12,-19,-47,-34,-17,61,-66
-19,-22,-70,-113,-101,-131,-39,94,-401
60,149,4,-64,-169,-58,26,280,228
27,-10,-42,-39,-70,-95,3,38,-188
2,14,-5,-2,-25,-11,-5,26,-6
43,54,-41,-51,-15,-47,31,84,58
10,157,-56,-122,-200,-302,-51,262,-302
15,4,-109,-56,-184,-85,7,84,-324
16,28,-12,-3,-22,8,9,34,58
67,86,-134,-96,-151,-183,-22,121,-312
45,38,-83,-36,-85,-106,24,98,-105
29,33,-37,-14,-28,-38,20,27,-8
89,95,96,95,6,17,10,197,605
75,89,6,-8,3,-68,48,126,271
82,62,25,33,11,-6,16,100,323
-86,20,-82,-29,-148,-153,-83,130,-431
7,58,37,-11,-9,5,36,60,183
43,52,33,-13,-23,-123,-32,130,67
25,28,-118,-78,-145,-282,-61,158,-473
-1,25,1,11,-27,-73,-31,17,-78
-14,2,-101,-98,-113,-79,-26,117,-312
77,107,20,-19,-6,-104,-39,132,168
47,78,-2,-48,-28,-132,-3,146,58
14,4,-5,-8,-6,-13,14,8,8
174,176,-134,34,-223,-188,20,286,145
86,73,58,27,-59,-19,-5,185,346
3,26,-93,-61,-73,-117,-23,83,-255
40,36,-54,-54,-98,-99,4,96,-129
5,7,-44,-19,-69,-115,-8,82,-161
-7,17,-7,-41,-45,-72,-44,67,-132
54,54,-39,-24,-42,-118,-7,63,-59
66,41,-74,-16,-231,-225,-58,134,-363
11,6,-17,-8,-13,-24,-2,4,-43
15,20,-5,-8,-24,-53,-31,50,-36
62,91,-9,-5,-31,-110,3,131,132
71,106,-35,-53,-112,-128,37,212,98
6,10,-46,-44,-89,-96,-18,76,-201
9,-19,-49,-11,-107,-80,-30,47,-240
13,-16,-56,-62,-60,-85,-4,49,-221
1,10,-32,-20,-29,-12,-1,15,-68
37,29,3,5,-32,-45,17,74,88
-4,14,-43,-48,-58,-83,-12,66,-168
96,2,-83,-70,-187,-275,-83,213,-387
12,55,-10,-3,-89,-58,6,125,38
5,8,-27,-31,-39,-37,-6,23,-104
39,38,16,-6,-39,-83,-28,119,56
10,49,-43,-57,-63,-55,12,103,-44
94,60,-8,-5,-19,-64,19,80,157
19,46,0,-22,-23,-48,5,51,28
7,27,-15,-2,-10,-29,-12,31,-3
13,3,-25,-14,-46,-48,11,35,-71
25,85,-40,-55,-94,-39,21,157,60
36,47,-2,6,-45,-132,-20,108,-2
32,41,41,-18,-42,-69,-16,113,82
1,72,-9,-28,-5,-125,-17,64,-47
63,77,-75,-36,-84,-124,31,52,-96
13,7,-50,-72,-113,-91,2,94,-210
5,-9,-15,13,-28,-40,-4,37,-41
126,140,-28,-35,-63,-44,69,176,341
2,1,-27,-35,-30,-57,3,43,-100
-8,7,-15,-7,-31,-37,-5,28,-68
55,142,44,7,15,-74,-6,158,341
35,101,9,-10,-10,-9,26,84,226
37,100,0,-25,-50,15,42,127,246
-19,4,-28,-10,-48,-22,-19,16,-126
15,8,-44,-8,-91,-64,-17,49,-152
47,72,-57,-88,-109,-190,-33,132,-226
46,173,156,251,-266,188,155,334,1037
9,39,-13,-38,-45,-85,-11,120,-24
35,65,-22,-8,-36,-2,26,86,144
-7,3,-6,-14,6,-16,-3,17,-20
-4,7,-15,-9,5,-15,-4,16,-19
-2,34,-61,-79,-19,-31,-10,77,-91
1,15,-27,-25,-17,-10,-7,27,-43
15,30,-26,-37,-88,-176,0,110,-172
6,6,-46,8,-51,-62,7,47,-85
40,43,-18,-41,-42,-126,-33,134,-43
-16,111,-56,-34,29,24,70,138,266
-1,116,-46,-49,-22,-12,63,157,206
5,40,-7,-20,5,9,23,67,122
-11,30,-27,-59,-71,-111,-21,60,-210
-4,35,-17,-6,-38,-87,-35,122,-30
-3,55,-8,-2,-36,-75,-19,90,2
21,59,19,13,-8,-20,15,94,193
540,849,-13,-62,-216,-277,262,1035,2118
27,53,-4,-43,-19,-132,-41,115,-44
104,105,45,50,-66,-8,47,167,444
-10,42,-17,-7,-74,17,15,80,46
6,9,-48,-53,-63,-110,-27,39,-247
191,237,132,106,-3,-21,6,281,929
14,24,-31,-35,-32,-72,-26,87,-71
72,103,-108,-97,-137,-204,58,210,-103
133,205,63,121,-51,-37,12,248,694
274,532,-305,-167,-691,-542,-32,400,-531
34,25,-8,-3,-70,-36,4,100,46
625,363,321,-57,348,65,26,574,2265
-4,3,-2,-6,-2,-16,-10,20,-17
50,88,22,25,-52,-50,8,121,212
9,11,-35,-27,-40,-23,11,33,-61
8,57,-31,-49,-83,-185,-39,92,-230
17,106,-80,-90,-222,-308,-80,206,-451
124,111,-20,-25,-63,-80,-3,230,274
5,17,-28,-13,-50,-50,6,38,-75
19,17,-30,9,-41,-15,14,35,8
34,104,-1,39,-95,-79,-41,208,169
280,670,-39,-92,-455,-106,309,1005,1572
-7,12,-43,-62,-101,-110,7,92,-212
115,306,-19,-149,-186,-248,-8,431,242
63,151,-15,-3,-56,-3,16,158,311
2,25,-33,-31,-62,-36,28,53,-54
193,221,-137,-136,-400,-466,-5,441,-289
23,10,-70,28,-126,-91,6,64,-156
55,62,-47,4,-135,-25,52,99,65
14,3,7,-25,-59,-61,-20,142,1
17,97,-130,-143,-233,-212,-36,200,-440
-29,-24,-57,-14,-78,-78,-22,58,-244
24,34,0,-48,-47,-167,-43,119,-128
48,77,-124,-91,-177,-87,18,206,-130
27,10,-30,-68,-82,-129,-22,108,-186
60,42,-20,-13,-29,-53,15,97,99
95,179,-60,-74,-126,-134,30,211,121
-28,-5,-76,-72,-113,-117,-23,102,-332
96,60,-92,65,-58,7,92,47,217
70,66,-87,49,-46,8,88,66,214
74,64,-84,49,-56,4,93,65,209
-14,7,-33,-27,-41,-52,-10,43,-127
-20,86,-57,-35,34,17,50,117,192
17,27,-63,-19,-85,-53,-5,53,-128
37,3,-92,-52,-124,-167,-42,110,-327
-6,28,-12,-42,-47,-92,-14,69,-116
20,21,-9,-13,-95,-118,-47,81,-160
15,69,-59,-42,-159,-147,-18,148,-193
-2,25,-21,4,-49,-20,13,46,-4
43,69,-28,-41,-9,-113,-35,134,20
-34,29,-96,-80,-124,-228,-102,141,-494
34,5,-114,-96,-124,-215,-53,127,-436
65,45,-26,23,-94,-119,-35,114,-27
16,39,-14,4,-107,-58,-14,78,-56
24,25,5,10,-35,-34,-25,45,15
23,107,-9,38,-97,-2,-7,169,222
51,121,-96,-48,-171,-175,-12,159,-171
-6,30,-158,-110,-303,-209,-30,208,-578
7,9,-15,-6,-27,-25,-4,20,-41
-1,2,-72,-72,-100,-137,-27,92,-315
-7,2,-86,-60,-117,-89,-21,107,-271
7,51,3,-9,0,-13,13,50,102
47,37,-35,-24,-79,-90,-17,108,-53
-4,90,-44,-58,-65,-108,-31,114,-106
60,77,-115,-173,-161,-257,-40,214,-395
6,23,-2,-16,-37,-66,-28,108,-12
31,48,-20,22,-10,-21,30,19,99
128,71,16,7,-32,15,97,124,426
84,108,-105,-131,-103,-93,70,188,18
-24,57,-82,-65,-39,-30,25,146,-12
-31,82,-98,-45,37,21,92,149,207
-25,76,-123,-42,-5,39,33,70,23
26,159,-32,-35,-9,15,82,204,410
-43,111,-44,-72,27,-18,25,164,150
35,145,-30,-13,-32,-68,43,144,224
0,51,-40,-27,-10,-27,58,106,111
-16,82,-80,-49,0,23,55,104,119
-4,113,-105,-56,-29,-24,44,129,68
7,91,-22,-2,18,23,36,71,222
-5,117,-57,-14,-16,25,86,186,322
12,90,-8,-44,-18,-42,33,105,128
50,142,-31,-24,-11,-42,59,147,290
-12,64,-91,-22,9,-12,19,76,31
-3,94,-45,-14,-25,-7,37,137,174
-37,68,-72,-59,-3,-17,-1,153,32
-13,121,-98,-82,25,-27,39,162,127
18,97,-30,-25,-15,-21,43,124,191
-34,92,-167,-70,15,-3,59,86,-22
-23,107,-92,-36,3,30,83,142,214
87,222,-47,-36,-68,-111,95,238,380
-15,45,-11,-26,-12,-4,33,72,82
22,0,13,-17,-53,-121,-47,60,-143
36,34,-100,-51,-176,-103,-13,98,-275
-4,2,-32,-18,-42,-39,-6,20,-119
22,74,4,4,26,37,41,59,267
-13,112,-66,-39,-33,1,54,187,203
33,155,-5,-39,13,-16,68,151,360
-12,-7,-37,-22,-59,-56,-21,26,-188
12,-23,-53,-20,-81,-107,9,78,-185
2,2,-100,-75,-136,-120,-11,132,-306
43,59,-62,-36,-73,-111,16,150,-14
34,44,-49,-87,-26,-93,-6,115,-68
31,79,72,74,-36,0,0,124,344
42,69,-118,-19,-338,-209,-70,330,-313
22,40,-40,-28,-61,-63,-24,92,-62
4,40,-32,-1,-117,-99,-1,115,-91
18,36,9,-60,-66,-167,-32,145,-117
153,213,-81,-3,-18,-101,75,125,363
35,33,1,16,-27,-16,15,47,104
46,57,5,-1,4,-19,33,84,209
53,71,33,-14,13,-10,23,98,267
31,43,31,27,11,-12,6,59,196
16,11,-21,-30,-37,-91,-18,58,-112
75,75,-9,46,-76,-102,25,92,126
-5,20,-20,6,-77,-30,-4,65,-45
29,46,-32,-66,-54,-81,0,56,-102
63,69,9,35,-46,-42,29,92,209
88,145,15,-56,-24,-34,57,177,368
19,26,-12,-21,-2,-21,12,3,4
180,192,90,31,3,-13,78,290,851
16,-6,-43,-34,-51,-66,6,71,-107
43,35,17,-30,-40,-117,-25,116,-1
15,0,-76,-60,-106,-144,-56,85,-342
-28,36,4,-51,-66,-73,-14,142,-50
72,52,-51,-1,-136,-119,0,70,-113
116,81,-25,25,-18,-71,25,94,227
111,59,-56,31,-56,-12,73,50,200
34,18,-28,-11,-63,-73,7,43,-73
19,29,-11,-47,-62,-69,-5,74,-72
21,16,-37,-42,-32,-57,-4,77,-58
4,30,-41,-40,-110,-90,7,106,-134
32,41,-46,-50,-26,-111,-26,88,-98
-19,39,-62,-101,-94,-140,-40,106,-311
-3,66,-43,-91,-78,-71,-5,126,-99
8,92,-62,-53,-145,-161,-26,195,-152
53,66,-30,-38,-133,-80,12,110,-40
0,21,-73,-23,-225,-130,-43,167,-306
62,64,-30,2,-75,-60,19,57,39
-6,51,-4,-23,-20,-29,2,60,31
71,396,146,-144,-14,-25,-38,626,1018
46,27,53,28,9,18,16,106,303
32,77,-7,-23,-21,-10,38,70,156
36,63,10,-5,18,-52,13,75,158
56,161,-142,-135,-233,-250,-21,249,-315
51,47,-55,-31,-112,-102,-1,63,-140
27,8,-102,-51,-215,-137,-42,107,-405
15,57,-16,-44,-35,-74,12,98,13
27,47,-47,-50,-87,-195,-34,90,-249
12,82,11,-6,-18,-23,28,69,155
-11,29,-89,-99,-183,-223,-73,96,-553
26,16,-30,-31,-66,-105,-14,107,-97
7,8,-14,-14,-15,-2,7,30,7
9,98,-16,-61,-110,-116,-54,173,-77
-10,13,-24,-32,-46,-46,-28,24,-149
-50,8,-69,-57,-115,-88,-25,132,-264
-5,12,-44,-29,-56,-41,15,57,-91
150,158,18,9,14,-46,52,209,564
163,61,-197,-60,-354,-299,29,138,-519
-19,-15,-37,-11,-53,-80,-28,39,-204
15,44,-41,-42,-71,-155,-31,156,-125
39,52,-100,-98,-159,-105,-28,157,-242
-19,10,-16,-43,-40,-74,-33,53,-162
22,11,-53,-69,-95,-116,-25,79,-246
-24,-21,-72,-90,-99,-109,-49,74,-390
30,18,-2,16,-33,-20,6,50,65
2,18,-19,-10,-15,-33,-3,44,-16
6,19,-5,-2,3,7,9,32,69
11,136,-11,-25,-124,-83,-63,179,20
-66,-18,-75,-38,-127,-170,-77,102,-469
550,785,-146,-144,-238,-272,426,763,1724
119,136,-19,-29,16,-19,50,60,314
21,17,-16,-4,-16,-9,30,38,61
40,154,37,6,-20,-86,23,189,343
25,12,-23,-17,-48,-56,6,32,-69
23,81,1,3,-72,-1,28,138,201
0,15,-60,-34,-137,-87,6,122,-175
64,71,-20,12,-26,-43,15,82,155
40,67,-29,2,-79,-11,20,90,100
11,42,-27,-1,-36,-26,23,47,33
58,108,-18,-17,1,-81,11,85,147
117,163,-50,-57,-98,-121,16,223,193
96,179,-116,-80,-112,-157,85,198,93
9,12,-14,-6,-12,-17,6,33,11
126,151,-11,-24,-26,-46,85,202,457
17,58,11,61,-160,-82,-32,76,-51
20,98,54,73,-169,-38,-30,153,161
37,145,-43,-92,-92,-97,48,298,204
103,45,-85,-131,-152,-172,-13,209,-196
-46,-13,-53,-17,-83,-65,-63,45,-295
4,2,-60,-42,-111,-81,-21,43,-266
22,10,-49,-36,-80,-79,-28,48,-192
5,20,-38,-35,-81,-181,-15,102,-223
30,8,-25,-18,-16,-45,5,9,-52
33,83,-57,-39,-87,-154,21,110,-90
111,89,-78,-126,-149,-258,21,248,-142
-1,-6,-65,-62,-86,-148,-53,96,-325
48,92,-32,-33,-62,-136,-34,149,-8
20,44,-21,-7,-26,-29,24,22,27
-9,25,-37,-40,-50,-55,-20,54,-132
5,119,-92,-69,-168,-82,8,205,-74
143,175,-95,54,-118,-37,82,215,419
-17,53,-113,-123,-199,-167,-20,146,-440
29,12,-29,-59,-49,-66,-6,52,-116
10,14,-37,-42,-35,-40,1,27,-102
-41,0,-28,-26,-54,-64,-66,54,-225
19,14,-26,-24,-46,-42,-1,52,-54
65,104,-4,-7,-30,-41,36,164,287
46,49,-28,-7,-42,-31,30,22,39
28,96,12,-34,-14,-87,-33,102,70
9,12,-84,-31,-175,-130,-8,112,-295
60,61,-122,-95,-133,-142,34,125,-212
11,68,-15,-24,-63,-78,8,92,-1
120,146,29,-16,-14,-109,33,153,342
58,113,-49,-18,-57,-91,-17,117,56
-11,20,-12,-23,-43,-94,-23,67,-119
116,201,-30,-15,-90,-126,55,195,306
73,124,61,44,31,-13,25,176,521
55,79,53,69,-34,12,23,117,374
5,29,-20,-19,-52,-52,-13,60,-62
-96,34,-163,-144,-157,-228,-85,217,-622
2,9,-17,-9,-20,-53,-15,20,-83
16,-11,-46,-53,-52,-91,-21,46,-212
44,91,-4,-23,-41,-79,-9,135,114
27,18,-2,-52,-33,-173,-13,172,-56
80,89,-82,-129,-156,-147,10,272,-63
74,82,-72,-80,-166,-186,-34,248,-134
127,42,55,31,-66,-53,4,186,326
66,122,-49,-19,-191,-187,-36,180,-114
8,24,-18,6,-32,-21,8,27,2
7,16,-11,-1,-34,-20,-2,34,-11
38,63,-51,-30,-49,-75,16,117,29
37,75,-5,-9,-43,1,7,71,134
4,24,-24,-18,-18,13,13,27,21
36,-21,21,-10,-48,-33,-14,114,45
22,91,-41,-5,-155,-135,0,71,-152
-8,101,-219,-158,-273,-216,-41,250,-564
19,182,9,-68,-107,15,8,284,342
-12,-10,-32,-35,-24,-73,-19,49,-156
-7,25,-2,-33,-30,-41,3,60,-25
41,83,-60,-23,-15,-31,21,82,98
18,37,-44,-8,-127,-104,-37,121,-144
-4,53,-39,-25,-64,-143,-40,77,-185
61,38,29,11,-88,-44,23,116,146
-2,5,-54,-3,-110,-71,7,78,-150
16,52,-11,-34,-27,-33,-3,120,80
8,40,-26,36,-99,-63,-14,102,-16
-20,30,-8,5,-39,-29,-21,45,-37
-5,5,-4,-7,-3,-8,-2,27,3
8,48,18,6,-40,-33,-11,81,77
58,64,-76,-33,-53,-49,50,117,78
9,17,15,-14,-43,-19,7,68,40
51,67,-49,-37,-73,-107,12,98,-38
88,88,63,103,-65,-30,49,222,518
69,113,35,26,-36,-38,26,204,399
50,127,-8,-60,-92,-90,27,240,194
46,41,-10,-1,-35,-23,19,64,101
-23,-15,-41,-24,-49,-55,-31,32,-206
11,12,-96,-41,-143,-139,-57,154,-299
98,143,2,-3,-49,8,34,160,393
26,-7,-40,-22,-57,-43,-4,33,-114
24,-8,-42,-21,-63,-49,-9,28,-140
16,14,-27,1,-60,-43,2,42,-55
31,-1,-30,-1,-52,-36,4,56,-29
10,13,-21,-27,-52,-27,-1,29,-76
21,9,-17,-9,-9,-29,-3,32,-5
26,33,-15,-5,-7,-30,7,47,56
132,142,52,8,-22,-102,-19,222,413
17,84,-2,4,-12,-24,34,64,165
20,20,-22,-4,-5,-23,1,9,-4
93,118,-173,-87,-259,-236,-35,245,-334
16,68,-104,-89,-160,-129,-27,99,-326
37,63,-89,-88,-167,-131,-4,135,-244
13,62,-79,-89,-207,-299,-79,179,-499
3,-3,-24,-1,-63,-46,-11,34,-111
-6,24,-13,-25,-45,-46,-18,61,-68
-30,-32,-174,-110,-290,-239,-57,157,-775
15,16,-23,0,-32,-17,10,35,4
5,1,-21,-22,-45,-37,-2,13,-108
88,121,-36,-2,-159,-120,5,93,-10
16,189,-72,-61,-180,-206,-13,344,17
35,127,-69,-15,-242,-204,-38,323,-83
22,-6,-70,-21,-105,-138,-18,74,-262
1,42,-26,-4,-30,-8,4,69,48
64,60,28,38,-31,-3,26,114,296
55,146,-182,-138,-353,-266,19,457,-262
74,98,3,-47,-53,-135,9,139,88
25,37,-24,-29,-18,-83,-13,53,-52
26,53,-16,-34,-40,-30,4,58,21
82,139,-46,-13,-33,-88,31,196,268
9,32,-6,-20,-20,-23,16,34,22
55,41,-81,-74,-74,-141,-3,150,-127
27,53,-1,-11,-22,-85,-49,39,-49
195,264,-140,-19,-31,-59,122,128,460
-22,18,-57,-64,-22,-145,-70,85,-277
-26,46,-49,-74,-53,-131,-39,76,-250
117,163,10,2,-99,-102,44,234,369
4,7,-13,-19,-9,-53,-4,50,-37
2,37,-57,-29,-155,-69,13,112,-146
13,15,-79,-52,-70,-126,-33,66,-266
127,360,347,57,175,238,97,432,1833
18,23,3,-1,-15,-35,-12,50,31
7,30,-51,-60,-43,-120,-28,109,-156
377,634,697,316,375,427,132,744,3702
-8,61,-35,-55,-116,-108,5,162,-94
1151,236,-989,-483,-1298,-1384,200,653,-1914
1445,2024,1205,1039,-197,777,833,2556,9682
20,8,-29,-11,-80,-42,-2,71,-65
19,60,-90,-48,-195,-233,-37,248,-276
-1,31,-37,-19,-29,-38,1,55,-37
33,49,-7,25,-1,-4,36,36,167
24,23,-4,10,-15,-33,-2,21,24
2,-25,-52,-61,-126,-71,-13,64,-282
93,264,-90,-67,-53,-89,122,157,337
19,6,-32,-13,-63,-86,-31,77,-123
-36,-38,-54,-26,-64,-65,-39,22,-300
37,-6,-11,-46,-3,-121,-20,64,-106
19,38,-27,24,-10,21,41,28,134
-2,-9,-27,-28,-17,-65,-23,9,-162
20,25,-55,-56,-119,-87,17,92,-163
44,28,-64,-18,-97,-122,-35,62,-202
-4,31,-12,12,-39,20,17,35,60
172,352,-103,-84,-555,272,308,835,1197
67,189,-292,-244,-561,-865,-230,644,-1292
-21,-22,-68,-42,-117,-62,-3,86,-249
34,20,-104,-80,-201,-194,1,182,-342
-33,-45,-275,-92,-434,-273,-80,295,-937
-56,-49,-97,-42,-132,-146,-51,57,-516
-53,-13,-88,-67,-120,-117,-91,86,-463
-82,-46,-87,-74,-118,-105,-64,70,-506
-30,91,-68,-56,-28,-53,-14,126,-32
-17,39,-17,-15,-79,-100,-10,81,-118
-58,-10,-96,-90,-124,-153,-56,94,-493
21,40,-95,-43,-48,-76,11,74,-116
66,116,-7,-52,-43,-98,4,184,170
33,50,-21,-28,-45,-75,-8,74,-20
13,30,-60,-70,-124,-95,-32,133,-205
-12,0,-16,-7,-17,-37,-9,27,-71
246,370,-146,-155,-167,-312,85,410,331
-23,1,-61,-38,-104,-57,3,63,-216
43,143,-16,-75,-75,-178,-11,231,62
-28,-22,-92,-80,-148,-114,-64,102,-446
-50,-30,-83,-76,-104,-136,-80,53,-506
-36,21,-42,-23,-94,-121,-39,79,-255
24,32,-9,29,5,17,24,34,156
24,39,-18,-54,-42,-97,-30,109,-69
16,73,32,6,-42,-38,-16,149,180
4,-23,-30,-15,-37,-28,-10,35,-104
17,20,-37,12,-49,-66,-20,63,-60
65,66,-83,-93,-144,-168,-10,149,-218
11,21,4,-30,-17,-101,-6,81,-37
43,75,1,14,-23,-11,19,120,238
170,481,-407,-318,-794,-1198,-162,959,-1269
28,72,-24,-8,-73,-79,-15,79,-20
65,252,46,-47,-101,-146,-8,363,424
19,21,-42,-26,-50,-47,2,22,-101
42,36,-16,-28,-89,-126,-5,104,-82
-16,-33,-59,-45,-153,-132,-20,107,-351
-39,-20,-69,-24,-67,-57,-42,33,-285
25,56,-77,-1,-163,-67,4,136,-87
-5,-14,-49,-38,-108,-66,8,83,-189
-9,22,-39,-37,-70,-82,-44,52,-207
16,62,-40,-45,-125,-116,-21,141,-128
-5,49,-41,-44,-88,-80,-20,150,-79
53,14,-22,-38,-63,-99,-33,117,-71
79,78,-15,-27,-38,-105,-3,147,116
47,37,-91,-39,-192,-164,27,114,-261
50,85,-40,-1,-159,-107,6,152,-14
17,33,-22,1,-56,-32,3,34,-22
84,80,-8,-63,-38,-173,-14,146,14
61,31,33,-7,-53,-102,13,142,118
-19,28,13,12,-83,32,35,117,135
-9,15,-30,-57,-53,1,13,53,-67
4,96,-143,-41,-266,-180,-17,207,-340
2,5,-2,0,0,-1,0,0,4
315,1075,105,-220,-98,73,286,1204,2740
63,81,-66,-121,-120,-158,-22,195,-148
14,29,-54,-28,-113,-69,2,68,-151
13,27,-4,-7,-13,-46,-17,44,-3
37,28,16,-4,-84,-130,-24,145,-16
62,52,-6,-60,-13,-145,-29,103,-36
14,30,-77,9,-158,-77,39,103,-117
18,31,-55,-45,-80,-164,-25,114,-206
9,-13,-69,-52,-103,-165,-44,84,-353
109,86,-108,-81,-189,-240,-26,234,-215
-1,11,-5,-11,-6,-12,3,12,-9
7,22,-25,-33,-15,-11,2,31,-22
53,105,-26,-80,-44,-143,-48,198,15
50,59,-21,7,-71,-18,26,89,121
81,157,6,-63,-100,-191,-14,199,75
-17,47,-52,-57,-137,-125,-7,162,-186
13,69,-22,-55,-66,-90,-8,160,1
25,27,-4,19,-10,-33,-4,31,51
55,60,-40,18,-42,-1,56,74,180
18,48,3,-17,32,29,35,45,193
18,40,11,-23,20,5,27,21,119
18,37,10,-22,20,7,27,22,119
3,49,-58,-27,-127,-132,6,128,-158
22,92,-26,-40,-77,-71,24,108,32
54,110,-46,-44,-129,-163,6,206,-6
7,0,-26,-19,-50,-66,4,81,-69
5,70,76,63,-70,54,19,121,338
145,188,-40,29,-217,-99,64,331,401
27,51,-28,-36,-27,-100,14,84,-15
38,46,-31,11,-24,-78,-5,24,-19
-19,-20,-57,-48,-71,-171,-69,64,-391
148,198,-1,-56,-4,-153,32,261,425
21,59,11,-23,-5,-16,23,61,131
11,-8,-51,-38,-52,-76,2,59,-153
46,4,-71,14,-165,-118,6,122,-162
-81,-2,-68,-31,-150,-164,-62,102,-456
61,101,17,-18,-122,-62,9,228,214
91,144,3,-9,-41,-110,-10,178,246
24,36,-25,-7,-34,-68,11,87,24
0,26,-16,-10,-22,-35,2,16,-39
18,17,-25,-22,-64,-120,-45,93,-148
17,73,-5,12,-64,-231,-89,143,-144
23,51,-29,-18,-45,-44,-3,69,4
11,32,-36,-35,-77,-90,9,71,-115
-35,29,-90,-72,-125,-195,-82,169,-401
-16,54,3,-22,-38,-43,-15,101,24
41,2,1,-11,-24,-102,-30,115,-8
99,52,-70,-6,-152,-194,-89,302,-58
-1,-7,-15,-18,-18,-6,10,17,-38
36,53,-46,-10,-41,-30,27,23,12
3,-11,-18,15,-28,-9,-2,23,-27
45,17,-91,-72,-97,-198,-3,133,-266
25,31,-40,-10,-85,-124,-12,110,-105
2,112,13,-32,-115,3,-10,159,132
50,46,-32,-10,-58,-54,7,41,-10
-16,60,-4,-59,-21,-154,-50,115,-129
66,108,-56,-92,-217,-159,-16,252,-114
123,200,204,81,36,69,108,259,1080
26,43,-22,-68,-99,-106,-24,115,-135
35,74,-29,-26,-99,-209,-20,174,-100
27,9,-1,-29,-39,-66,-17,85,-31
8,12,-27,-14,-26,-13,9,39,-12
5,5,-15,-3,-21,-33,-11,21,-52
89,285,25,-56,78,-42,50,268,697
54,104,-62,-61,-78,-72,53,211,149
-18,3,-73,-57,-132,-134,-26,94,-343
48,72,-36,-55,-213,-198,17,209,-156
40,16,-51,-42,-67,-89,0,79,-114
-16,31,-42,-27,-59,-23,18,49,-69
31,67,-6,-25,-24,-47,5,61,62
15,-15,-62,-55,-74,-114,-38,89,-254
22,0,-63,-71,-59,-109,-27,82,-225
4,29,-6,3,-41,-41,0,52,0
8,15,-27,-9,-50,-23,-13,58,-41
41,79,-33,-42,-8,-73,43,118,125
47,96,-110,-128,-113,-218,-10,181,-255
137,176,-140,-242,-390,-271,-31,591,-170
124,126,-179,-273,-323,-233,78,445,-235
-3,40,-57,-101,-126,-124,-36,118,-289
116,130,-74,-111,-183,-155,35,414,172
300,368,-152,-175,-390,-425,-57,762,231
-90,91,159,198,-123,141,17,211,604
184,224,-43,-39,24,-59,123,270,684
123,210,-61,24,-225,-191,-7,173,46
2,15,-15,-18,-30,-40,-21,51,-56
29,41,-28,14,-132,67,68,128,187
39,52,-29,-41,-65,-149,-70,142,-121
5,-12,-59,-40,-138,-85,-5,56,-278
6,19,-26,-5,-30,-9,18,24,-3
5,18,-45,-5,-40,-24,-1,15,-77
16,34,-21,-18,-40,-32,-3,48,-16
27,51,8,19,-9,-11,10,45,140
230,207,61,3,47,-35,59,122,694
65,72,-32,25,-91,-131,8,82,-2
-8,101,-193,-174,-287,-210,-74,253,-592
55,112,-15,-41,-49,-64,31,95,124
5,95,-44,-82,-85,-145,-17,108,-165
96,108,34,-13,-38,-30,48,171,376
77,120,25,-30,-35,-23,31,169,334
19,4,-13,-3,-36,-22,-9,30,-30
109,92,34,61,-18,-39,30,151,420
110,125,62,17,17,-33,19,173,490
71,52,-49,-36,-84,-153,-12,129,-82
19,24,-21,0,-32,-57,-11,28,-50
19,-6,-95,-45,-188,-169,-39,134,-389
5,11,-23,-17,-60,-78,-37,76,-123
-52,-11,-75,-92,-176,-212,-84,178,-524
-2,39,-13,-15,-34,-43,-17,74,-11
-104,-44,-125,-64,-143,-210,-112,92,-710
19,45,-19,-2,-23,-53,-11,36,-8
147,364,-58,-131,-446,-256,-120,628,128
3,10,-36,-71,-46,-122,-18,84,-196
3,19,-26,-25,-44,-62,-15,76,-74
4,16,11,-14,-47,-36,-21,89,2
30,64,-19,-44,-45,-65,13,140,74
29,28,-30,-28,-118,-123,5,91,-146
-3,0,-1,-10,-18,-18,1,24,-25
2,-1,-10,-2,-22,-14,6,18,-23
57,25,-26,-36,-5,-123,3,88,-17
3,21,-41,-20,-69,-108,-5,48,-171
23,46,-34,-52,-133,-115,-14,158,-121
-11,24,-18,-46,-39,-58,-9,75,-82
-40,-32,-58,-45,-46,-90,-63,23,-351
53,169,-9,-55,-37,-119,5,233,240
-28,26,-79,-87,-63,-119,-24,77,-297
32,46,10,-12,-51,-59,0,119,85
12,18,-8,-8,-39,-53,-25,32,-71
-53,10,-92,-51,-101,-133,-69,70,-419
50,33,-28,-12,-52,-56,0,34,-31
6,14,-54,-10,-65,-52,-5,53,-113
3,30,-56,-49,-71,-165,-21,76,-253
90,115,-39,-7,-91,-35,58,128,219
33,72,20,11,-1,7,37,65,244
15,62,-20,-14,-9,-12,44,60,126
16,9,-3,-12,-29,-21,-4,29,-15
-17,42,-51,-84,-80,-112,-6,142,-166
20,20,-63,-5,-164,-41,16,106,-111
115,312,-96,-104,-444,-199,-1,499,82
32,13,-20,-16,-11,-39,17,21,-3
34,-1,-44,-19,-61,-85,-26,53,-149
-4,10,-51,-29,-46,-88,-31,38,-201
45,40,-32,-52,-64,-122,-20,54,-151
1,51,-20,-59,-34,-151,-51,117,-146
273,434,-112,-298,-316,-285,37,553,286
-6,3,-42,-35,-43,-82,-13,37,-181
-38,-18,-77,-73,-132,-118,-60,78,-438
-49,-18,-48,-58,-82,-149,-78,75,-407
-54,15,-54,-51,-95,-153,-93,76,-409
738,913,-49,-16,-329,-247,266,1060,2336
10,21,-9,9,-12,-25,-22,31,3
102,289,338,155,162,195,30,346,1617
-64,-44,-74,-79,-99,-121,-45,75,-451
-70,-52,-84,-71,-99,-132,-55,68,-495
0,83,-109,-138,-181,-271,-102,186,-532
32,87,-63,-54,-70,-158,-4,88,-142
1,58,-53,-3,-146,-91,-11,152,-93
-40,-20,-66,-58,-95,-139,-84,90,-412
-46,-46,-95,-83,-126,-127,-50,69,-504
-50,-51,-74,-82,-98,-112,-60,62,-465
-75,-39,-88,-91,-126,-128,-77,73,-551
-47,-2,-84,-33,-135,-137,-53,103,-388
-1,27,-48,-30,-62,-39,-5,55,-103
99,108,-97,-76,-196,-130,-9,153,-148
7,6,-32,-11,-69,-33,2,34,-96
32,22,-12,-18,-46,-46,4,51,-13
18,25,-13,-4,-52,-52,12,50,-16
188,491,-9,-42,-501,-303,-129,767,462
11,12,-25,-3,-39,-18,-8,4,-66
150,249,-89,-8,-40,-99,90,249,502
9,58,-29,-43,-36,-40,-19,75,-25
25,81,-2,-20,-22,14,42,140,258
7,37,-5,-18,-7,-12,32,76,110
66,71,25,35,-25,-13,38,102,299
25,48,-73,-37,-202,-84,-2,123,-202
0,11,-5,-4,-26,6,4,-10,-24
31,37,-16,27,-59,-33,-12,58,33
24,30,-21,-13,-51,-71,-5,43,-64
-1,2,-42,-3,-68,-43,1,42,-112
14,8,-28,9,-95,-53,3,30,-112
6,10,-34,19,-63,-55,-13,31,-99
-2,16,-12,-26,-21,-22,-9,16,-60
10,16,-12,-6,-16,-34,-13,20,-35
8,14,-19,-6,-16,-29,-9,15,-42
-28,5,-67,-21,-99,-56,-20,56,-230
-23,-30,-61,-76,-81,-151,-69,78,-413
302,653,644,307,383,440,146,760,3635
-10,60,-26,-37,-33,-29,6,63,-6
6,50,-10,-28,-47,-95,-12,66,-70
33,111,-33,-74,-158,-224,-67,276,-136
-4,174,13,-25,-109,-109,-33,173,80
2,70,-43,-69,-139,-80,-7,185,-81
8,24,-41,-12,-116,-74,-19,65,-165
98,92,-82,-5,-94,-111,55,53,6
61,93,-46,-92,-116,-176,-21,232,-65
7,43,-36,-61,-99,-81,-24,102,-149
114,53,-180,-72,-318,-245,9,131,-508
154,274,-159,-116,-153,-197,118,312,233
90,107,33,-4,-50,5,38,146,365
69,94,-31,-63,-25,-28,63,124,203
-12,76,24,31,-84,73,-9,27,126
40,27,-29,-22,-39,-3,49,66,89
28,54,-45,-58,-109,-118,-23,145,-126
43,47,8,0,-51,-37,2,114,126
42,99,26,31,-14,-2,23,138,343
3,10,-36,-31,-76,-98,-47,80,-195
7,17,-39,-7,-123,-83,-19,74,-173
7,10,-14,-17,-37,-65,-22,41,-97
14,13,-5,-2,5,-28,1,14,12
26,18,-47,-47,-65,-113,-9,74,-163
57,71,-39,1,26,4,54,46,220
75,32,-69,-7,-124,-142,3,151,-81
19,38,-69,-57,-106,-109,3,101,-180
80,98,-79,-104,-208,-306,3,195,-321
34,12,-84,-28,-64,-108,25,72,-141
61,118,35,-8,18,-32,13,141,346
-6,-2,-9,-8,-12,-13,-11,15,-46
18,18,-25,-10,-49,-51,0,71,-28
10,34,-21,-7,-39,-43,4,74,12
-1,7,-24,-23,-25,-39,-15,44,-76
12,60,-2,-32,0,-39,7,43,49
-5,29,-2,-16,0,-8,1,40,39
39,96,67,-23,-4,-32,27,139,309
11,3,-9,-29,-57,-93,-14,90,-98
24,13,-30,-33,-41,-90,-9,99,-67
28,34,-13,-5,-17,-22,28,50,83
18,18,-73,-55,-91,-109,-18,89,-221
17,-11,-51,-34,-105,-71,-3,51,-207
2,18,-6,-40,-49,-50,4,39,-82
0,24,-22,-28,-55,-99,-19,87,-112
33,24,-45,-15,-85,-72,-9,26,-143
-17,-16,-38,-52,-91,-94,-5,82,-231
27,13,-32,-3,-64,-73,-15,17,-130
37,24,-53,-18,-108,-99,-15,128,-104
5,20,-31,-40,-85,-86,-3,62,-158
124,141,-27,-55,-109,-79,28,218,241
-27,-1,-57,2,-74,-39,-29,29,-196
18,20,-26,6,-22,-36,5,13,-22
14,4,-19,-25,-23,-46,15,2,-78
17,-31,-68,-76,-167,-149,-35,154,-355
45,45,-21,-19,-72,-105,33,92,-2
155,175,-4,-24,-52,-29,37,268,526
-8,-7,-34,9,-66,-138,-46,48,-242
3,4,-22,-35,-25,-27,30,33,-39
95,293,360,103,197,208,88,336,1680
68,58,-64,-48,-134,-83,30,154,-19
47,61,-16,-1,-25,-63,3,49,55
-27,10,-44,-6,-72,-54,-53,57,-189
5,10,-27,-9,-34,-66,-23,44,-100
50,192,-174,-203,-465,-463,59,532,-472
80,69,-33,-34,35,-60,22,62,141
143,153,0,-24,-116,-221,38,247,220
332,347,-153,-37,-173,-101,188,318,721
90,78,-66,-85,22,-100,16,83,38
14,112,103,28,53,81,32,138,561
-27,15,-35,-57,-60,-88,-20,70,-202
80,73,-48,-60,-122,-156,-40,152,-121
137,265,36,1,-27,-23,113,298,800
41,52,-28,-27,-56,-141,-46,133,-72
13,23,18,34,-59,-33,1,67,64
-7,-4,-25,12,-65,-46,-4,41,-98
4,16,-38,3,-64,-45,1,52,-71
-8,2,-22,-37,-20,-77,-14,62,-114
-11,17,-8,-12,-41,-67,-33,60,-95
24,20,-24,2,-43,-68,2,65,-22
-2,17,-11,-10,-66,-39,-3,57,-57
-2,-5,-37,22,-76,-40,20,36,-82
18,1,2,38,-85,-42,-15,50,-33
9,6,-30,-29,-16,-80,-21,14,-147
-49,-50,-70,-67,-133,-133,-74,62,-514
-35,-26,-88,-88,-143,-120,-45,80,-465
-2,34,-67,-52,-124,-143,-53,125,-282
-22,41,-93,-81,-121,-147,-58,118,-363
61,66,-20,-5,-41,-94,3,72,42
215,374,-20,-9,-184,-179,119,456,772
90,19,31,3,-43,-63,-3,92,126
79,115,-28,-40,-33,-88,9,161,175
8,-1,-14,-5,-18,-25,-11,28,-38
-17,12,-35,-24,-35,-74,-39,75,-137
50,108,-22,-30,-125,-124,26,136,19
-4,27,-43,-1,-107,-47,18,93,-64
35,22,-87,-84,-198,-157,16,137,-316
-27,33,-72,-36,-123,-38,-16,100,-179
-41,-21,-85,-87,-129,-117,-21,130,-371
-43,5,-61,-56,-125,-122,-48,96,-354
36,152,-69,-136,-183,-251,-14,200,-265
55,36,-30,-31,-51,-48,17,116,64
71,100,37,77,-56,7,55,135,426
57,84,4,2,-24,-24,36,104,239
78,76,-47,29,-41,-86,60,82,151
83,75,-133,-118,-162,-217,14,141,-317
-1,-20,-48,-67,-78,-124,-44,84,-298
-2,8,-48,-60,-59,-121,-18,102,-198
2,1,-40,-49,-70,-106,-27,65,-224
21,29,-45,-9,-112,-92,-8,83,-133
-55,-25,-60,-84,-101,-133,-75,59,-474
7,-3,-4,1,-52,-46,-13,38,-72
26,191,61,-35,67,-1,112,220,641
70,119,48,-16,-38,-56,35,155,317
199,261,-76,-43,-144,-212,86,338,409
71,96,-105,-129,-157,-235,5,251,-203
23,155,50,19,-5,23,18,80,363
62,66,-88,-160,-258,-196,-29,306,-297
43,17,-80,-2,-125,-120,-5,112,-160
-21,-12,-59,-17,-84,-91,-39,51,-272
47,134,-25,11,-71,-31,-11,113,167
18,13,-29,-60,-45,-50,-4,45,-112
94,173,-8,-36,-19,-48,37,177,370
-15,30,-12,-2,-61,-61,-5,79,-47
-28,21,-11,-29,-47,-91,-42,98,-129
-48,-17,-54,-47,-67,-46,-28,37,-270
-2,26,-7,1,-3,-26,-5,15,-1
107,97,-57,-98,-91,-151,-15,250,42
76,36,-61,-41,-87,-86,17,78,-68
57,82,-21,-3,-39,-33,24,80,147
93,94,-27,18,-123,-132,-3,172,92
49,120,-1,12,-152,-96,6,214,152
30,81,-117,-80,-310,-219,-36,266,-385
-6,12,-38,-7,-101,-29,13,46,-110
-52,-19,-68,-32,-121,-117,-44,103,-350
-41,-37,-74,-41,-104,-130,-60,55,-432
7,65,-25,-32,-8,-1,21,67,94
37,48,-99,-84,-160,-159,31,185,-201
46,75,-127,-125,-183,-143,-18,195,-280
60,85,-87,-50,-208,-174,28,207,-139
73,67,-102,-84,-210,-145,32,225,-144
43,73,-25,-26,-100,-48,-3,146,60
94,123,39,-26,-12,-74,35,173,352
-31,-46,-107,-61,-137,-121,-58,109,-452
41,72,-13,-9,-44,-31,34,75,125
-4,7,-21,-27,-28,-18,8,19,-64
157,342,-136,-107,-155,-151,113,339,402
114,290,-140,-77,-224,-329,79,304,17
-10,156,35,59,-137,-124,7,246,232
13,11,-9,0,-1,-17,2,9,8
312,733,979,260,510,474,174,1000,4442
20,-26,-114,-17,-184,-116,-1,128,-310
10,24,-16,-20,-24,-78,-22,46,-80
12,45,-49,-34,-49,-58,-1,77,-57
28,56,-53,-41,-85,-57,19,84,-49
78,145,6,-92,-104,-239,-6,297,85
78,108,-63,-98,-168,-222,-11,322,-54
22,16,-53,-34,-63,-92,-17,84,-137
130,178,-70,-28,-17,-82,79,108,298
75,60,-36,7,-66,-56,29,106,119
145,187,-71,-39,-166,-189,21,189,77
6,126,-47,-109,-93,-259,23,255,-98
-5,10,-56,-36,-38,-138,-43,114,-192
56,44,-34,-3,-58,-46,15,69,43
11,74,-65,-70,-107,-163,-57,145,-232
4,1,-20,-18,-24,-27,-4,16,-72
4,13,-25,-4,-119,-55,-2,79,-109
-11,26,-35,3,-64,-38,-1,74,-46
159,68,-110,102,-133,-21,132,99,296
-20,-5,-37,-12,-97,-79,-26,71,-205
-10,64,-108,-75,-146,-141,-54,113,-357
0,-1,-43,-36,-95,-100,-26,30,-271
24,32,-54,-15,-138,-98,-3,95,-157
15,19,-46,-15,-52,-83,-16,49,-129
30,37,-30,7,-34,-58,1,45,-2
4,5,-35,-32,-38,-62,9,15,-134
3,21,-36,-38,-66,-42,-10,35,-133
11,16,-35,13,-74,-37,11,47,-48
3,9,-25,-7,-30,-31,-1,34,-48
-3,7,2,-9,-4,-18,-2,15,-12
21,17,-40,-18,-67,-62,-5,71,-83
28,-4,-28,16,-70,-42,-2,47,-55
-1,9,-33,-22,-53,-18,5,34,-79
22,12,-42,8,-77,-54,2,38,-91
12,14,-22,-24,-44,-29,-9,19,-83
13,28,-5,-8,-4,-30,-5,37,26
57,24,-88,-29,-97,-92,7,80,-138
-4,0,-89,-74,-182,-206,-78,84,-549
14,-6,-73,-51,-203,-198,-76,87,-506
104,154,32,-12,-53,-94,-6,226,351
88,113,-70,-25,-140,-179,-15,206,-22
-10,9,-13,-4,-24,-31,-19,15,-77
31,16,-25,-34,-59,-95,-15,36,-145
21,34,-29,-18,-69,-86,-23,40,-130
81,146,8,-20,-30,-84,41,223,365
-34,-8,-32,3,-75,-93,-43,65,-217
65,130,-18,-40,3,-77,17,157,237
80,135,-17,-65,-33,-102,25,153,176
41,103,1,-31,-17,-82,8,108,131
12,45,3,5,-19,-14,-8,64,88
-43,3,-26,-3,-63,-56,-52,37,-203
-57,-7,-66,-76,-103,-120,-69,76,-422
405,641,-22,-53,-69,59,231,621,1813
37,27,-34,-40,-25,-102,21,106,-10
32,16,-27,-12,-68,-60,-8,60,-67
-2,-1,-33,-38,-100,-115,-29,86,-232
32,-3,-51,13,-60,-90,9,45,-105
17,30,-44,-30,-126,-45,16,106,-76
58,127,-38,-70,-94,-161,4,221,47
-68,-44,-113,-67,-170,-164,-71,114,-583
-21,9,-70,-77,-114,-110,-60,84,-359
40,90,-29,-7,-23,-86,13,76,74
-24,-13,-13,-2,-36,-54,-21,14,-149
-48,-35,-79,-66,-111,-113,-33,68,-417
-40,-7,-52,-65,-117,-130,-68,100,-379
-64,-41,-93,-87,-100,-135,-89,59,-550
-6,3,-93,-48,-150,-128,-26,92,-356
12,35,-56,-41,-120,-123,-10,72,-231
13,26,-89,-60,-216,-77,22,132,-249
279,415,-197,31,-301,-251,25,270,271
19,0,8,9,-41,-27,-4,28,-8
6,16,-51,-35,-84,-81,-9,37,-201
13,18,-28,-17,-48,-84,-16,20,-142
14,14,-48,-13,-68,-111,-16,85,-143
25,46,-23,-23,-27,-27,22,64,57
-63,1,-122,-34,-200,-191,-90,120,-579
38,17,-43,-29,-124,-72,19,75,-119
2,17,-55,-37,-130,-77,-8,91,-197
-30,-1,-66,-43,-137,-114,-46,111,-326
-58,-14,-83,-76,-104,-104,-50,76,-413
14,70,-119,-156,-239,-201,-20,200,-451
17,11,-68,-85,-98,-139,-46,119,-289
-59,-1,-69,-84,-113,-109,-46,67,-414
-51,-7,-48,-38,-77,-143,-82,47,-399
-72,-26,-75,-77,-92,-109,-49,54,-446
-45,-22,-52,-29,-59,-131,-51,71,-318
-39,-62,-68,-66,-70,-146,-50,76,-425
-21,-42,-65,-43,-124,-134,-37,113,-353
9,17,-19,-12,-32,-53,-13,32,-71
-4,28,-25,-13,-38,-30,0,42,-40
5,57,-26,-26,-125,-82,8,125,-64
9,71,-37,-68,-77,-47,24,84,-41
14,6,-57,-77,-88,-82,-25,53,-256
18,17,-14,-5,-8,-20,-3,12,-3
66,69,-42,-46,-74,-156,-14,72,-125
17,28,-49,-27,-108,-61,-11,65,-146
-39,-15,-34,-21,-48,-82,-33,58,-214
119,102,47,64,-4,-13,37,175,527
75,101,83,77,-39,-20,30,157,464
37,40,11,10,-21,-24,-8,59,104
37,15,-5,24,-48,-29,3,56,53
60,21,-1,6,0,-57,9,62,100
72,47,-7,18,-58,-42,35,70,135
115,4,-40,79,-108,-67,87,97,167
51,64,33,32,10,-5,15,96,296
63,41,21,10,15,-33,21,53,191
33,85,77,33,10,-16,13,109,344
49,90,51,17,-4,-5,36,123,357
65,51,36,79,-29,-1,49,112,362
20,42,39,61,-58,-13,12,101,204
13,44,-40,-68,-84,-41,14,89,-73
38,28,-51,-13,-103,-61,0,71,-91
44,41,-175,-124,-397,-257,10,332,-526
-9,-8,-65,-37,-57,-92,11,56,-201
-5,6,-8,1,-7,-20,-18,27,-24
0,35,1,-24,-11,-33,-2,44,10
-23,-5,-79,-44,-124,-146,-47,92,-376
41,18,-66,-50,-57,-133,-9,83,-173
12,37,-11,-27,-19,-27,14,59,38
53,34,-6,16,-55,-9,35,95,163
-16,29,-61,-64,-78,-120,-28,95,-243
0,31,-44,-63,-72,-88,-10,113,-133
468,784,28,-101,10,-134,343,898,2296
-84,12,-93,-41,-188,-197,-85,151,-525
-129,-38,-99,-66,-158,-153,-94,109,-628
6,17,-64,-53,-87,-97,-15,100,-193
-115,-41,-123,-76,-191,-166,-79,83,-708
2,56,2,-42,-37,2,27,62,72
4,34,-61,-68,-32,-101,6,47,-171
3,10,-54,-76,-50,-111,0,35,-243
-4,59,9,-24,9,-106,-42,103,4
35,16,-54,-16,-165,-101,-11,85,-211
20,22,-24,38,-111,-53,-13,84,-37
47,11,-101,-32,-193,-152,-8,117,-311
4,-3,2,-17,-24,-51,-16,34,-71
12,35,102,84,-29,55,-9,104,354
31,37,54,55,-53,-1,4,126,253
19,21,-31,-30,-34,-48,-3,33,-73
33,15,-34,7,-57,-67,-10,36,-77
21,19,-28,0,-66,-60,9,27,-78
82,28,-102,-17,-92,-158,9,20,-230
17,15,-17,0,-11,-30,0,16,-10
15,42,-28,-15,-27,-45,-12,91,21
24,43,-32,-24,-43,-49,-10,95,4
37,32,-12,-12,-63,-54,-25,109,12
64,128,-72,-88,-188,-124,61,318,99
43,95,-12,-76,-132,-221,-43,189,-157
8,13,-35,-31,-37,-42,-7,23,-108
58,57,-33,-81,-7,-79,-24,99,-10
-22,25,-83,-13,-170,-114,-6,109,-274
-28,22,-32,-55,-96,-116,-47,114,-238
-25,59,-20,-58,-98,-108,-51,151,-150
-72,4,-61,-51,-108,-122,-48,107,-351
97,108,-6,70,-53,-33,49,161,393
65,81,13,17,-42,-31,11,98,212
-69,-28,-70,-71,-128,-115,-86,73,-494
-78,-21,-94,-88,-102,-148,-82,59,-554
-39,11,-75,-64,-116,-108,-51,102,-340
-62,-32,-85,-70,-125,-136,-72,69,-513
-37,-30,-84,-76,-105,-107,-54,65,-428
-17,-8,-77,-69,-113,-141,-61,84,-402
23,52,-29,-68,-52,-89,17,98,-48
-55,-15,-61,-52,-108,-151,-84,76,-450
81,85,-20,13,-72,-57,18,124,172
0,6,-27,-10,-37,-19,18,11,-58
19,6,-21,-5,-39,-31,4,34,-33
4,43,-73,-8,-120,-74,22,78,-128
-99,-37,-217,-158,-289,-180,-85,187,-878
37,99,-95,-26,-95,-133,7,106,-100
32,97,-90,-22,-99,-125,9,101,-97
119,153,-68,-49,-145,-41,67,213,249
-23,37,-61,-71,-101,-86,-4,119,-190
1,13,-52,-51,-65,-71,-9,77,-157
87,44,-62,-23,-107,-112,-2,119,-56
-5,12,-56,-60,-83,-55,-13,46,-214
6,21,-16,-12,-29,-56,-10,44,-52
45,136,-68,-46,-243,-115,-23,270,-44
127,233,72,-43,5,-77,36,300,653
-9,1,-50,-23,-81,-87,-4,91,-162
9,85,-45,-49,-112,-96,27,144,-37
-8,7,-23,-26,-41,-20,-3,61,-53
-14,36,-9,-19,-43,-45,-23,45,-72
2,12,-29,-27,-53,-75,-31,72,-129
-54,-36,-68,-40,-106,-120,-68,75,-417
132,252,-59,-10,-135,-303,-6,279,150
-8,37,-85,-74,-137,-131,-34,120,-312
72,37,-82,-107,-144,-153,-7,169,-215
141,136,-146,-58,-241,-144,5,142,-165
116,114,66,52,-40,7,89,159,563
65,112,-23,5,-43,-30,51,103,240
-16,20,-30,-92,-80,-130,-55,94,-289
-37,23,-55,-107,-79,-127,-49,89,-342
29,37,-12,8,-62,-33,33,54,54
20,68,-94,-88,-122,-149,37,157,-171
-62,18,-239,-155,-419,-412,-186,340,-1115
2,12,-8,-14,5,-18,3,18,0
-13,12,-34,-46,-41,-64,-6,75,-117
1,15,-8,0,2,-32,-8,16,-14
-6,0,-16,-16,-20,-35,-13,-4,-110
4,21,-24,-3,-29,-6,18,29,10
0,54,-104,-57,-221,-184,-18,133,-397
-12,25,-42,14,-118,-193,-37,96,-267
-49,-27,-59,-46,-46,-84,-64,27,-348
124,146,-87,-38,-118,-145,13,207,102
66,95,-91,-104,-166,-149,12,196,-141
46,91,-95,-91,-170,-104,31,148,-144
59,75,-71,-66,-180,-141,2,133,-189
28,-6,-18,-4,-57,-134,-31,100,-122
-8,11,0,-16,-3,-13,-6,38,3
15,46,0,-4,-37,-35,3,49,37
27,31,-33,-11,-35,-46,-2,48,-21
31,92,-8,4,-43,-44,-30,138,140
55,61,-4,-31,-39,-110,-7,98,23
31,47,-42,-21,-115,-101,-5,88,-118
41,42,-69,-27,-136,-137,-6,75,-217
0,-12,-100,-88,-109,-118,-47,82,-392
100,120,-25,-53,-28,-79,-6,163,192
26,30,-62,-48,-76,-151,-18,70,-229
18,50,-64,-65,-122,-170,-25,134,-244
34,10,-113,-68,-190,-114,-10,84,-367
114,137,-144,-53,-166,-134,51,161,-34
39,96,-36,-64,-45,-112,18,117,13
27,42,-57,-36,-72,-115,-3,105,-109
-34,5,-63,-78,-100,-137,-58,86,-379
-39,16,-61,-34,-82,-138,-60,70,-328
-40,-31,-84,-68,-139,-128,-77,75,-492
-67,-15,-67,-55,-90,-122,-70,52,-434
5,56,-35,-3,-135,-131,-23,108,-158
-61,-67,-55,-61,-118,-108,-61,118,-413
10,31,-13,-7,-71,-16,-4,77,7
66,84,-17,-26,-117,-124,2,104,-28
-38,21,-33,-35,-32,-19,-10,31,-115
-11,-2,-26,-5,-49,-8,-5,18,-88
181,248,0,-73,-55,-194,24,351,482
3,51,-26,-45,-43,-77,-40,70,-107
23,6,-23,6,-37,-68,-10,69,-34
-8,30,-24,-45,-21,-50,6,58,-54
141,78,-137,-30,-309,-237,9,116,-369
78,59,-53,-23,-222,-218,-46,144,-281
-10,17,-8,-1,-18,-50,-17,37,-50
41,46,-10,-50,-32,-38,7,74,38
36,55,-29,-26,-28,-53,-11,60,4
27,107,-69,-97,-137,-253,-15,249,-188
0,2,-49,-38,-93,-72,-14,50,-214
-1,41,-21,-46,-48,-43,24,80,-14
2,12,-49,-12,-58,-98,-12,65,-150
65,72,-92,-28,-78,-152,9,69,-135
70,67,-81,-7,-81,-116,52,71,-25
19,16,-29,-17,-22,-51,-1,18,-67
-7,1,-26,-27,-18,-24,-9,18,-92
82,119,69,71,2,57,31,139,570
25,41,-64,-32,-102,-79,5,64,-142
23,-8,-48,-27,-109,-87,-4,58,-202
249,268,-154,-26,-175,-108,113,294,461
12,16,-11,3,-15,-1,7,38,49
120,156,-59,6,-19,-14,108,148,446
29,57,-19,2,-58,-93,-15,47,-50
26,42,0,-2,-19,-14,22,55,110
27,49,6,-16,34,30,35,46,211
18,35,8,-23,21,6,25,21,111
20,37,8,-22,20,5,25,20,113
-7,0,-83,-34,-114,-118,-24,87,-293
-56,27,-69,-74,-111,-92,-48,123,-300
25,34,-49,-61,-51,-132,-20,125,-129
-15,8,-71,-68,-77,-134,-48,101,-304
-15,69,-72,-57,-85,-129,-50,134,-205
-35,-38,-79,-80,-113,-117,-61,79,-444
47,65,-71,-47,-85,-79,-7,124,-53
-15,49,-42,-67,-133,-121,-33,132,-230
-66,7,-68,-57,-108,-138,-61,87,-404
-38,-14,-51,-44,-95,-105,-36,70,-313
177,166,97,-57,-31,-60,-46,256,502
193,169,64,-43,-78,-120,-97,245,333
70,54,-19,29,-25,-57,22,64,138
97,40,-21,63,-77,-29,67,110,250
-41,13,-48,-52,-111,-106,-30,87,-288
81,63,4,-42,-74,-178,-23,165,-4
-47,0,-313,-296,-368,-484,-189,462,-1235
-103,-71,-294,-207,-360,-534,-270,332,-1507
2,-19,-68,-46,-97,-174,-59,98,-363
1,-15,-63,-51,-101,-171,-56,99,-357
-9,61,-66,-43,-122,-92,16,100,-155
-1,121,-83,-69,-134,-234,-36,221,-215
-28,161,173,224,-203,77,-20,276,660
5,11,-4,6,-24,-24,2,19,-9
2,6,-8,6,-25,-16,0,13,-22
53,63,-14,-2,-28,-45,45,86,158
2,534,305,-15,-205,263,-122,596,1358
15,597,393,97,-171,282,-139,697,1771
19,67,-50,-35,-96,-74,26,84,-59
17,36,-55,-15,-91,-113,27,122,-72
280,371,122,121,-36,-2,110,497,1463
13,0,-137,-150,-285,-348,-57,238,-726
-43,0,-65,-25,-84,-123,-77,74,-343
284,365,-276,27,-427,-427,38,266,-150
284,334,-268,23,-427,-444,11,307,-180
38,167,18,-34,-135,-161,5,271,169
18,15,-95,-56,-211,-198,-36,159,-404
89,19,-115,-67,-246,-244,-60,95,-529
-60,-55,-80,-85,-94,-196,-85,88,-567
109,113,-63,-36,-80,-126,45,175,137
85,143,-76,-40,-115,-122,71,151,97
32,51,-38,-30,-74,-67,-6,110,-22
-13,7,-24,-16,-28,-36,-17,30,-97
20,63,-60,-49,-56,-153,0,107,-128
70,164,202,215,-30,206,29,266,1122
33,61,-12,8,-27,-28,29,52,116
502,571,-76,263,-306,-180,151,873,1798
70,148,-54,5,-9,-20,65,129,334
186,260,-104,11,46,-7,115,142,649
47,134,-234,-117,-479,-260,19,359,-531
119,152,4,7,-81,-103,31,225,354
159,175,-64,-27,-98,-116,82,207,318
171,223,-58,-16,-66,-73,76,229,486
116,84,-2,3,-10,-98,30,93,216
112,118,-3,42,-41,-56,30,159,361
327,350,-298,59,-444,-435,21,305,-115
-10,6,-11,-10,-27,-5,-1,25,-33
-6,91,-124,-56,-14,31,58,105,85
28,74,-12,-10,-29,-119,-18,99,13
15,49,-19,-46,-82,-66,-4,79,-74
36,111,8,19,-54,-240,-97,174,-43
98,125,-31,-74,-45,-181,-23,233,102
51,77,-16,13,-112,-88,-21,97,1
-1,137,102,142,-213,38,-11,262,456
29,36,-108,-108,-128,-210,-45,120,-414
14,20,-42,-1,-110,-49,30,76,-62
75,145,-106,-124,-261,-274,-4,294,-255
21,161,-147,-135,-276,-209,-5,310,-280
37,33,-72,-71,-104,-70,-2,33,-216
-24,67,-32,-11,-64,-125,-17,140,-66
8,20,-19,-3,-51,-80,-38,77,-86
4,5,-84,-37,-172,-149,-19,98,-354
17,50,-23,-21,-123,-108,-9,164,-53
0,22,-22,-35,-47,-45,2,98,-27
17,20,-50,-43,-63,-72,1,80,-110
70,100,34,23,-22,-45,47,108,315
-1,32,-19,-15,-37,-47,-25,31,-81
7,13,-27,-17,-46,-43,-15,40,-88
-34,45,-86,-80,-143,-117,-46,96,-365
12,50,-23,-39,-54,-55,9,98,-2
18,83,-39,-30,-104,-49,37,155,71
-9,-13,-59,-62,-95,-154,-24,86,-330
30,17,-65,-17,-101,-58,-9,57,-146
30,39,-33,-6,-56,-50,-1,28,-49
-10,30,-38,-61,-79,-119,-29,110,-196
15,56,7,4,-55,-57,36,80,86
3,66,-46,-51,-88,-71,-11,92,-106
71,43,-39,10,-75,-36,64,105,143
6,38,14,-26,4,-22,4,53,71
26,109,-108,-49,-245,-200,2,166,-299
34,8,-73,-33,-148,-99,-24,103,-232
8,19,-16,-36,-46,-72,-28,38,-133
22,62,-79,-90,-166,-212,-21,230,-254
-4,33,-50,-67,-131,-93,-21,93,-240
-13,15,-55,-52,-114,-111,-31,88,-273
11,10,-61,-65,-132,-102,-23,96,-266
28,133,-29,-56,-77,-74,32,164,121
27,87,22,5,-10,-22,8,133,250
25,26,-60,-35,-53,-87,3,95,-86
8,-3,-11,-17,-21,-19,0,14,-49
29,65,-41,-44,-41,-111,-11,95,-59
182,270,-21,-7,-168,-321,-47,327,215
55,40,-70,-57,-110,-56,55,113,-30
4,18,-28,-21,-96,-32,-3,79,-79
0,25,-4,-24,-25,-12,-7,74,27
-7,62,-38,-68,-81,-89,-36,119,-138
-37,-12,-63,-32,-106,-105,-64,49,-370
-14,8,-58,-22,-90,-112,-23,49,-262
40,83,11,-20,-56,-126,-40,177,69
34,11,-44,5,-32,-19,19,30,4
20,66,-49,-83,-87,-131,-18,99,-183
92,104,-34,95,-137,-76,-37,165,172
28,60,-67,-62,-68,-119,-19,109,-138
13,19,-22,-21,-17,-42,1,22,-47
5,-2,-47,-53,-79,-114,-23,55,-258
251,351,-55,-30,-91,-83,107,376,826
-41,0,-57,-76,-137,-117,-47,103,-372
-17,-9,-49,-51,-109,-79,-10,81,-243
27,17,-19,5,-32,-29,4,32,5
28,7,-70,-7,-93,-82,-12,39,-190
19,20,-35,13,-41,11,13,27,27
1,26,-43,-34,-64,-43,6,23,-128
138,164,118,25,23,25,15,126,634
310,492,-74,-56,-207,-230,160,643,1038
10,-15,-37,-47,-81,-81,-20,37,-234
87,160,-15,-2,-87,-42,37,194,332
-7,75,-47,-71,-58,-264,-58,176,-254
13,10,-35,-22,-71,-90,-16,86,-125
-13,-11,-53,-70,-97,-122,-53,91,-328
18,136,-106,-54,-245,-261,-39,328,-223
12,-5,-31,-26,-47,-101,-45,88,-155
20,48,-64,-54,-156,-79,11,104,-170
62,44,-131,-18,-209,-115,50,97,-220
2,10,-39,-75,-122,-78,-15,57,-260
95,183,-77,-36,-214,-189,31,245,38
24,52,15,-9,5,-12,21,38,134
18,16,-6,7,-27,-16,15,29,36
3,58,-49,-76,-46,5,31,92,18
194,355,236,83,-14,2,88,544,1488
341,549,438,131,183,29,79,691,2441
7,11,-137,-94,-201,-237,-87,151,-587
-14,-6,-10,-11,-43,-41,-23,29,-119
25,22,-37,-55,-80,-108,-18,112,-139
51,88,13,6,13,-65,0,80,186
18,49,-76,-23,-66,-75,37,78,-58
-19,-10,5,22,-15,-5,-23,7,-38
386,441,-59,51,-205,-187,154,481,1062
30,-2,-15,-18,-30,-121,-16,83,-89
42,31,-16,-15,-18,-54,-2,46,14
35,11,-41,-17,-85,-77,20,72,-82
68,60,-35,-42,-87,-52,-2,137,47
22,35,19,-42,-17,-137,-46,102,-64
-56,62,-88,-77,-266,-336,-141,302,-600
70,62,-90,-104,-122,-145,-9,213,-125
32,119,18,-4,-37,-180,-78,180,50
6,41,-33,2,-70,-51,-5,65,-45
35,38,-14,-7,-77,-46,-6,109,32
44,80,-44,-80,-67,-77,-31,163,-12
8,19,9,6,-22,-8,9,27,48
117,188,-40,1,-59,-40,75,116,358
21,114,22,-23,1,-100,-51,117,101
5,27,-81,-68,-181,-122,-21,69,-372
25,109,15,-33,-55,-132,7,181,117
16,35,-27,-4,-33,-37,8,51,9
8,40,-50,-29,-54,-88,-22,25,-170
-11,-4,-52,12,-81,-27,-7,41,-129
3,30,-26,-10,-81,-52,-10,59,-87
-16,38,-2,11,-95,-28,-13,93,-12
23,61,13,-8,-11,-26,15,60,127
-17,47,-69,-48,-108,-14,-1,91,-119
54,44,-6,35,-108,-48,27,123,121
34,72,43,49,-84,-27,28,138,253
76,47,-5,33,-84,-56,11,127,149
-8,30,-30,-14,-8,-26,-4,31,-29
-19,5,-32,-16,-58,-30,-11,21,-140
-5,29,-28,-26,-41,-27,-13,39,-72
30,85,-91,-57,-161,-165,-12,173,-198
34,59,-83,-74,-161,-187,-20,156,-276
162,228,-106,-42,-114,-127,89,203,293
68,60,-34,20,-29,-77,4,68,80
-57,-4,-161,-141,-217,-212,-72,169,-695
24,21,-31,-19,-80,-54,-2,67,-74
15,21,-63,-23,-104,-46,15,69,-116
-17,16,-19,-16,-48,-47,-23,54,-100
5,26,-53,-42,-73,-93,-22,49,-203
2,35,-50,-33,-96,-94,-10,29,-217
1,87,-132,-65,-202,-124,15,150,-270
26,101,-38,-40,-129,-52,20,213,101
17,99,-49,-52,-148,-189,-47,183,-186
-14,52,-78,-50,-122,-50,-12,98,-176
13,22,-25,1,-58,-29,1,39,-36
-33,-15,-87,-58,-116,-113,-43,77,-388
-37,-26,-81,-99,-108,-102,-49,75,-427
-56,-19,-79,-81,-124,-123,-53,80,-455
-6,20,-11,-23,-39,-58,-28,32,-113
120,128,46,-20,69,-25,40,136,494
79,119,27,-37,27,-15,76,178,454
-40,24,-157,-107,-237,-223,-87,290,-537
-31,-15,-44,-3,-93,-98,-32,60,-256
67,112,-29,-66,-22,-109,32,211,196
21,45,-33,-15,-20,-33,13,20,-2
64,89,20,-67,20,-76,19,120,189
40,110,-62,-55,-73,-119,11,163,15
-13,26,-43,-45,-63,-60,-11,77,-132
78,78,-46,-19,-65,-25,47,100,148
71,102,-49,-13,-127,-110,-2,61,-67
22,29,-34,10,-13,-31,17,54,54
8,32,-23,-3,-93,-44,-1,75,-49
20,26,-8,12,-25,-46,-5,41,15
-2,17,-25,-24,-13,-16,2,10,-51
126,58,-9,73,-76,-82,68,120,278
38,96,-88,-60,-187,-324,-25,217,-333
28,21,-17,-8,-44,-59,3,55,-21
116,260,-128,-115,-228,-369,26,240,-198
-29,-5,-56,-48,-84,-122,-35,66,-313
51,66,-23,-35,-81,-103,-8,97,-36
47,53,-21,-3,-29,-32,19,55,89
-19,-17,-20,-44,-23,-64,-14,37,-164
37,21,-56,-33,-80,-107,19,63,-136
-2,12,-41,-17,-56,-73,-24,56,-145
40,53,-102,-53,-127,-146,8,130,-197
-9,56,-143,-182,-250,-307,-47,210,-672
22,46,3,-6,-18,-11,13,63,112
23,49,-46,13,-70,-97,1,59,-68
24,60,-41,-43,-67,-127,5,86,-103
16,23,-24,13,-20,-30,5,46,29
-18,17,-100,-50,-148,-207,-50,126,-430
14,10,-15,-9,-23,-16,-13,20,-32
-41,-8,-51,-49,-88,-127,-50,97,-317
-58,23,-56,-53,-89,-128,-67,99,-329
35,139,-135,-91,-279,-181,4,288,-220
-34,-1,-95,-70,-132,-142,-43,105,-412
-84,-13,-59,-78,-89,-93,-80,93,-403
-30,-19,-41,-15,-62,-57,-48,37,-235
23,64,11,-68,-37,-87,3,149,58
-70,-44,-68,-74,-114,-117,-67,72,-482
59,101,-39,-14,-47,-118,8,138,88
-4,10,-36,-38,-74,-72,8,52,-154
6,61,-36,-51,-50,-63,-6,88,-51
18,14,-37,5,-100,-87,-9,66,-130
23,38,-10,-12,-7,-19,-1,42,54
116,173,-38,-15,-115,-110,41,204,256
76,116,-31,-32,-54,-38,58,127,222
46,95,-70,-63,-86,-191,-42,172,-139
49,163,-45,-51,-68,-190,15,228,101
80,77,-93,-58,-162,-205,-23,167,-217
-16,14,-112,-56,-213,-152,-54,162,-427
-8,23,-108,-87,-207,-163,-68,183,-435
17,4,-98,-47,-209,-171,-47,199,-352
27,87,-168,-117,-235,-204,-14,157,-467
16,13,-22,-28,-58,-84,-10,54,-119
120,119,-42,-36,-57,-112,31,139,162
-12,53,-94,-119,-138,-284,-89,143,-540
15,48,-140,-134,-174,-305,-55,162,-583
68,109,-354,-258,-614,-817,-203,365,-1704
33,107,-256,-211,-432,-597,-123,365,-1114
-6,13,-96,-65,-177,-152,-18,115,-386
203,180,-39,0,-94,-202,-11,245,282
144,233,-42,-46,16,-43,73,208,543
29,30,-25,-26,-54,-54,-17,62,-55
38,87,-33,-32,-48,-124,-20,86,-46
27,31,-61,-93,-166,-115,-3,175,-205
-7,22,-9,-10,-4,3,14,19,28
18,72,-42,-43,-76,-95,24,100,-42
45,47,-57,-58,-75,-84,6,111,-65
-1,27,-61,-48,-101,-107,-4,110,-185
151,208,-50,-18,-142,-146,86,321,410
21,39,-45,-45,-80,-114,-25,78,-171
267,369,-16,-141,-116,-371,41,548,581
29,196,-184,-152,-344,-369,-34,405,-453
56,108,-47,-15,-54,-4,64,142,250
25,112,-5,18,-70,-103,1,164,142
55,96,-102,-162,-206,-174,16,275,-202
93,95,-196,-99,-369,-456,-121,235,-818
24,19,-57,2,-135,-56,25,82,-96
13,33,-19,-2,1,-6,11,30,61
106,134,105,-6,9,-66,31,176,489
25,3,-27,-3,-52,-50,9,22,-73
11,18,-14,0,-37,-39,6,11,-44
22,4,-5,10,-55,-63,-17,32,-72
12,9,-36,-21,-88,-140,-55,115,-204
0,26,-16,2,-30,-21,0,31,-8
16,17,-34,-18,-32,-37,6,35,-47
161,452,-332,-283,-695,-929,-181,830,-977
79,27,-58,-44,-148,-195,-36,143,-232
19,40,-41,-61,-80,-130,-31,124,-160
-48,-32,-126,-76,-176,-125,-59,95,-547
-49,23,-134,-71,-188,-157,-69,93,-552
-59,-13,-145,-68,-184,-140,-65,85,-589
-27,29,-129,-29,-186,-160,-54,134,-422
67,91,-5,-28,1,-64,20,138,220
18,48,-51,-43,-78,-32,12,81,-45
23,15,-14,-22,-37,-48,-4,23,-64
-53,5,-61,-28,-108,-116,-67,88,-340
-34,1,-43,-7,-102,-113,-48,92,-254
-36,22,-27,-47,-106,-111,-47,69,-283
-12,28,-56,-12,-90,-107,-25,97,-177
36,150,-30,-36,-88,-75,49,194,200
159,258,-35,-145,-175,-149,19,473,405
44,40,-73,-42,-108,-144,-4,135,-152
15,31,-4,-28,-8,-27,0,78,57
-53,3,-44,-30,-105,-138,-72,81,-358
18,-11,-1,20,-66,-70,-1,74,-37
13,17,-25,25,-69,-48,-5,79,-13
172,239,24,17,-15,-102,25,230,590
66,77,-129,-37,-252,-214,-21,191,-319
-4,78,-33,-64,-19,-96,8,89,-41
-14,-36,-45,-63,-70,-147,-29,105,-299
85,100,28,-1,29,-41,29,140,369
33,24,-81,-66,-204,-146,-24,99,-365
37,40,-12,-40,-22,-70,0,87,20
9,23,-16,2,-33,-44,-16,42,-33
16,39,1,-5,-15,12,22,53,123
77,102,-29,-11,-75,-47,44,97,158
15,31,-16,-16,-96,-104,4,110,-72
92,105,13,-33,-24,-98,9,191,255
15,45,-39,-20,-43,-74,-10,67,-59
15,54,-22,-32,-50,-72,-10,64,-53
21,56,-20,-8,-44,-71,-13,70,-9
21,38,-31,-4,-72,-58,9,89,-8
19,39,-6,7,-5,-4,18,50,118
14,48,-24,-10,-41,-68,-1,70,-12
20,52,-34,-23,-56,-69,-3,72,-41
27,57,-25,2,-45,-60,2,88,46
59,83,-38,-26,-64,-89,12,103,40
40,87,-20,-22,-53,-81,18,97,66
11,47,-24,-24,-53,-70,-13,78,-48
62,51,-54,-21,-40,-70,17,73,18
8,30,-49,-69,-84,-123,-18,116,-189
49,50,-65,-37,-107,-155,-1,48,-218
53,37,-46,-15,-92,-107,0,119,-51
30,29,-30,-10,-13,-41,16,34,15
37,80,38,-23,9,10,1,86,238
15,33,-60,-49,-89,-87,-8,89,-156
30,67,5,-26,-36,-40,-16,121,105
22,66,-4,-9,-35,-37,-21,119,101
15,73,4,-17,-20,-38,-27,115,105
32,71,29,-18,-24,-30,-14,165,211
24,91,19,-32,-35,-43,-8,152,168
23,62,8,0,-18,-22,-17,107,143
29,58,15,-13,-14,-24,-15,114,150
3,11,-86,-91,-64,-151,-41,84,-335
-63,-37,-77,-79,-98,-102,-58,77,-437
28,66,-59,-95,-75,-159,-40,154,-180
28,48,-49,-56,-103,-85,-1,82,-136
112,106,25,101,-75,-38,52,155,438
73,66,56,97,-70,-34,41,136,365
12,76,-13,4,-55,-42,5,90,77
45,78,-46,7,-44,-23,39,29,85
39,78,-43,-12,-54,-46,35,50,47
-16,-13,-41,-57,-64,-69,-35,27,-268
35,9,-10,-53,-13,-109,-40,74,-107
-25,29,-90,-52,-133,-177,-67,137,-378
-17,12,-20,-17,-35,-2,-17,45,-51
12,31,-32,24,-59,-34,-15,63,-10
1,20,-57,-15,-102,-79,-6,86,-152
44,45,-28,-5,-20,-17,23,33,75
64,91,-42,-88,-88,-130,21,174,2
24,48,-42,-43,-91,-95,-15,66,-148
19,32,-45,-54,-108,-105,-6,63,-204
26,55,-12,-28,-61,-64,19,88,23
606,997,-359,-282,-133,-171,559,931,2148
24,123,-103,-94,-241,-289,-102,262,-420
18,123,-124,-85,-248,-297,-97,253,-457
-61,-38,-152,-88,-197,-160,-36,166,-566
63,87,-86,9,-135,-171,-9,153,-89
33,41,-86,-32,-155,-129,-6,123,-211
179,228,-76,-6,-67,-72,103,225,514
-53,-13,-72,-16,-134,-135,-69,52,-440
-73,-44,-70,-61,-83,-158,-87,82,-494
21,52,-50,-17,-106,-117,-14,98,-133
-17,-27,-41,-28,-88,-131,-42,71,-303
-79,-20,-68,-61,-84,-147,-75,83,-451
-30,-9,-77,-9,-157,-159,-69,87,-423
-35,17,-50,-87,-86,-147,-73,91,-370
484,699,-164,-135,-290,-233,213,711,1285
46,52,29,-32,-37,-28,21,91,142
59,30,-1,-26,-12,-35,19,80,114
43,101,-111,-71,-179,-123,-3,131,-212
192,261,96,13,-60,-124,45,413,836
-2,-3,-30,-32,-23,-74,-36,6,-194
42,83,-94,-56,-181,-140,13,153,-180
72,66,-1,0,3,-7,30,56,219
295,525,294,167,-204,-46,-172,625,1484
0,26,-43,-15,-74,-102,-16,59,-165
-42,-27,-75,-62,-95,-147,-65,87,-426
33,42,-5,-25,-7,-33,22,58,85
-109,23,-104,-55,-184,-133,-92,129,-525
25,32,-41,-58,-55,-64,-5,51,-115
-1,22,-27,-33,-74,-43,-9,76,-89
-1,17,2,0,-9,11,-1,62,81
33,3,-51,-8,-67,-30,31,44,-45
0,26,-30,-28,-14,17,24,43,38
12,11,-25,-20,-29,-6,7,49,-1
0,39,-14,-25,-29,-28,3,46,-8
16,-11,-42,-28,-68,-40,4,39,-130
20,19,-14,-12,-1,-18,26,28,48
521,687,-299,-110,-280,-248,344,657,1272
-8,-19,-42,-21,-60,-62,-5,54,-163
185,247,9,-86,-113,-198,-14,378,408
150,135,32,8,-14,-65,43,153,442
389,538,-366,-222,-729,-948,-151,540,-949
190,89,-253,-84,-432,-461,-56,261,-746
11,54,-15,-23,-40,-53,-1,51,-16
13,7,-26,-45,-46,-106,-41,57,-187
-83,-75,-103,-96,-194,-220,-76,115,-732
-27,2,-83,-46,-68,-105,-46,93,-280
6,20,-1,-9,0,-23,0,39,32
42,23,10,1,-19,-53,13,41,58
50,37,-77,-90,-67,-205,-17,176,-193
74,116,-24,-35,-62,-78,37,189,217
15,-7,-31,-33,-71,-49,-1,51,-126
36,38,-13,-22,-50,-58,-25,46,-48
-47,-34,-73,-48,-131,-144,-75,64,-488
-31,-1,-44,-8,-79,-106,-49,50,-268
28,23,-7,-12,-17,-19,2,29,27
21,-6,-79,-48,-102,-125,-35,75,-299
19,-40,-68,-86,-112,-153,-23,73,-390
-34,20,-31,-21,-59,-151,-64,108,-232
-56,7,-43,-51,-88,-139,-74,116,-328
16,22,-11,-11,-22,-34,-7,25,-22
-38,-18,-52,-41,-98,-112,-40,75,-324
-39,28,-23,-15,-100,-121,-52,79,-243
-66,-15,-55,-38,-80,-131,-70,58,-397
-53,-14,-47,-46,-83,-147,-85,45,-430
-29,-4,-36,-7,-101,-116,-43,77,-259
-66,-6,-54,-40,-83,-121,-65,65,-370
-25,2,-37,-24,-87,-124,-48,68,-275
19,31,-92,-41,-136,-81,18,71,-211
30,28,-105,-96,-118,-186,-30,85,-392
-31,3,-70,-45,-112,-131,-52,77,-361
-43,-29,-92,-47,-114,-121,-55,67,-434
-25,34,-33,-44,-92,-140,-53,76,-277
69,55,34,16,6,-17,38,89,290
53,34,-28,11,-25,-6,51,49,139
43,27,-2,3,-25,-47,11,45,55
7,22,0,-12,-14,-13,6,55,51
-13,7,-1,-7,-19,6,-7,-7,-41
21,59,-40,-22,-79,-100,-3,92,-72
126,138,33,63,-9,-99,-5,186,433
22,34,-37,-7,-64,-43,14,58,-23
7,89,-128,-91,-241,-210,2,282,-290
0,13,-20,-19,-36,-20,-11,27,-66
35,59,1,-30,3,-69,-5,105,99
-111,-66,-119,-28,-190,-163,-113,76,-714
-46,-46,-84,-66,-134,-135,-71,80,-502
8,40,-42,-5,-55,-31,20,59,-6
-41,-15,-76,-82,-87,-100,-40,74,-367
0,24,-48,-21,-73,-80,-5,103,-100
-1,19,-65,-65,-80,-92,-10,101,-193
14,23,-20,-23,-69,-91,-3,86,-83
-1,13,-129,-95,-192,-163,-69,191,-445
1,8,-43,-25,-15,-31,-4,31,-78
8,-12,-6,-38,-46,-43,-46,61,-122
4,6,-12,-8,-19,-30,-9,25,-43
-110,-35,-113,-69,-133,-168,-99,95,-632
-97,-73,-126,-41,-206,-156,-77,100,-676
-56,-33,-83,-21,-177,-204,-90,138,-526
-28,-9,-91,-54,-131,-151,-52,57,-459
-33,3,-52,-64,-91,-127,-40,80,-324
5,14,-62,-57,-115,-140,-37,100,-292
22,10,-57,-52,-132,-126,-30,107,-258
-16,80,-51,-36,-62,-49,15,109,-10
-1,10,-73,-58,-101,-106,-16,89,-256
46,45,-72,-46,-108,-83,24,152,-42
-20,71,-113,-84,-192,-201,2,249,-288
-13,3,-27,10,-58,-20,-10,46,-69
-53,-14,-15,4,-34,-36,-57,36,-169
20,21,-9,22,-17,-31,4,44,54
11,-7,0,9,-16,-27,-4,42,8
-7,119,-131,-177,-162,-257,-63,270,-408
114,116,-33,-14,-140,-155,-1,196,83
63,98,-35,-18,-185,-140,18,182,-17
98,151,-11,23,-81,-37,94,198,435
43,22,-43,-39,-38,-84,-9,105,-43
69,73,35,60,-29,-10,41,121,360
149,136,38,3,33,-12,57,174,578
49,90,-22,-13,-85,-84,-1,118,52
37,52,-69,-71,-114,-67,27,98,-107
-9,27,-6,-6,-66,-62,-18,104,-36
-1,-7,-28,-41,-147,-217,-25,58,-408
10,2,-30,-68,-79,-97,-27,98,-191
33,42,-40,-92,-96,-124,-30,127,-180
25,50,-39,-13,-74,-78,-4,68,-65
-46,-8,-51,-27,-81,-54,-52,34,-285
22,15,-6,2,-9,6,19,17,66
-8,1,-66,-50,-63,-100,0,75,-211
-52,18,-35,-36,-113,-142,-57,84,-333
-17,-21,-36,-42,-54,-131,-36,110,-227
0,58,-41,-55,-57,-86,10,124,-47
28,97,-21,-73,-38,-129,-36,158,-14
292,346,-6,29,-106,-196,43,395,797
67,193,-109,-114,-229,-310,-38,329,-211
17,21,-48,2,-66,-77,-2,54,-99
24,12,-64,-27,-62,-107,-22,76,-170
15,15,-49,-9,-77,-111,-30,78,-168
689,886,442,22,461,92,346,861,3799
32,43,-86,-19,-150,-128,-6,78,-236
5,32,-99,-78,-140,-126,-8,58,-356
14,36,-17,1,-1,-37,0,46,42
-77,-62,-80,-96,-100,-143,-74,64,-568
-53,16,-114,-70,-177,-156,-64,117,-501
29,105,52,82,-215,-50,-38,166,131
313,571,13,65,-159,-189,168,449,1231
12,32,-65,-40,-117,-103,-7,105,-183
14,66,-34,-29,-92,-65,9,104,-27
24,21,-38,-31,-49,-75,-11,52,-107
33,55,5,-41,-46,-60,3,92,41
26,-6,-66,-54,-95,-63,2,57,-199
29,72,-134,-153,-176,-262,-36,183,-477
9,7,-43,-38,-36,-38,3,23,-113
-5,70,-41,-65,-37,-89,-21,154,-34
21,6,-57,-30,-100,-59,0,58,-161
94,89,42,2,5,-37,-6,132,321
-3,101,-15,-33,-2,13,8,89,158
34,243,-100,-158,-81,-293,-33,327,-61
-45,51,-148,-117,-186,-230,-79,212,-542
1,46,-26,-43,-44,-93,-33,94,-98
31,44,-13,-1,-13,-21,29,21,77
-33,89,-23,-42,-145,-157,-99,209,-201
-18,32,-107,-90,-151,-249,-124,148,-559
21,38,-11,-47,-63,-111,-18,118,-73
63,62,-17,38,-25,26,59,74,280
-55,-25,-56,-89,-74,-129,-64,92,-400
86,126,-14,-3,-4,-43,0,148,296
12,56,-29,-12,-45,-52,9,63,2
36,57,-82,-53,-176,-114,-8,123,-217
29,30,-31,-44,-47,-80,1,75,-67
-37,-14,-68,-61,-109,-112,-58,89,-370
13,32,-26,-31,-63,-101,-26,70,-132
-3,-8,-56,-25,-154,-53,-1,73,-227
-34,-4,-68,-75,-130,-111,-52,114,-360
9,20,-13,-8,-22,5,12,43,46
32,73,-53,-54,-118,-98,-21,170,-69
-5,8,7,11,0,-20,-12,14,3
-67,-41,-64,-51,-91,-141,-61,80,-436
16,27,3,-10,-82,-17,9,87,33
23,51,-27,-27,-73,-52,-6,150,39
-60,6,-96,-46,-147,-200,-92,93,-542
-70,-2,-111,-40,-179,-159,-90,144,-507
-60,-55,-70,-48,-118,-123,-58,90,-442
131,176,-96,49,-196,-91,110,182,265
-12,-1,-62,-74,-79,-85,-11,112,-212
108,296,-196,-65,-528,-642,-26,559,-494
53,86,3,3,-7,-56,12,126,220
52,59,-16,-41,-16,-82,-11,73,18
64,-3,-39,-41,-76,-107,-29,57,-174
-25,10,-29,-14,-83,-105,-33,81,-198
18,22,-56,-17,-78,-89,-11,67,-144
5,24,-69,-86,-187,-99,14,78,-320
21,46,-28,-35,-25,-28,28,49,28
26,64,-52,-68,-29,-92,-13,90,-74
4,56,-40,-57,-95,-72,-5,76,-133
172,138,-58,-30,-74,-130,58,168,244
-9,1,-52,-10,-187,-47,5,123,-176
22,24,2,-23,-2,-41,3,47,32
5,24,-54,-16,-107,-78,-18,91,-153
-34,-16,-51,-7,-56,-106,-61,44,-287
24,28,-34,-23,-121,-52,19,129,-30
7,40,4,-1,0,-18,15,50,97
482,1013,-209,127,-469,-742,-45,677,834
7,6,-10,-9,-16,-23,1,3,-41
26,13,-2,-14,-8,-22,8,49,50
42,40,-27,-42,-49,-37,49,89,65
79,33,-120,-79,-258,-238,-48,114,-517
66,92,-61,-38,-99,-163,-1,108,-96
6,44,-55,-43,-99,-92,-7,64,-182
28,34,-66,-66,-109,-99,18,87,-173
53,55,-40,-17,-83,-109,12,106,-23
39,100,-46,-70,-57,-113,11,169,33
3,15,-46,-32,-65,-76,-3,48,-156
47,72,22,36,-28,-7,21,118,281
83,84,16,45,-32,-56,47,127,314
68,115,9,-78,-121,-329,-41,247,-130
33,27,-38,-61,-42,-89,-11,63,-118
27,88,-40,-43,-40,-100,-7,104,-11
35,47,-50,-36,-64,-96,-11,67,-108
48,48,-9,-36,-56,-76,22,87,28
25,57,-18,-9,-58,-55,17,44,3
-24,13,-50,-43,-100,-164,-72,86,-354
-55,-13,-65,-71,-118,-145,-72,83,-456
-51,-24,-78,-72,-98,-119,-63,60,-445
16,23,-27,-10,-53,-42,-1,41,-53
89,156,-65,-71,-5,-10,99,216,409
103,99,39,33,-3,-35,33,113,382
82,66,-10,1,2,-29,30,87,229
3,4,-39,-16,-42,-43,0,17,-116
13,0,-38,-14,-58,-65,-15,23,-154
97,100,-95,-96,-197,-169,24,195,-141
149,142,87,4,-9,-97,-103,240,413
176,123,82,-1,-3,-53,-25,161,460
37,79,-101,3,-183,-122,2,131,-154
693,794,309,-179,320,-109,309,580,2717
-10,60,-18,-21,-80,-88,-7,119,-45
13,82,-96,-108,-137,-199,-39,155,-329
-10,9,-36,-25,-28,-60,-25,31,-144
158,305,-104,-113,-92,-26,133,55,316
147,102,-58,-14,-64,-44,71,164,304
45,36,-54,-59,-86,-66,18,68,-98
27,77,-24,-92,-11,-81,-4,104,-4
31,68,-28,-86,-36,-76,1,114,-12
13,108,-11,-44,-23,-77,26,161,153
19,62,7,-14,1,-20,45,75,175
47,64,-4,-2,-22,-11,32,69,173
41,66,-34,-4,-47,-29,17,79,89
-48,-10,-93,-68,-139,-155,-66,98,-481
0,12,-50,-50,-89,-93,-15,78,-207
-2,58,2,-28,0,-86,-24,68,-12
-2,0,-16,-27,-18,-22,1,29,-55
9,32,-21,-35,-33,-64,11,68,-33
12,18,-12,-22,-6,-25,5,40,10
314,517,-41,121,-164,27,173,655,1602
472,547,-295,-55,-420,-379,139,898,907
32,46,-11,-8,-22,-42,15,51,61
164,332,6,-48,-11,-171,44,326,642
19,38,-22,2,-37,-34,9,38,13
62,39,-32,-60,-47,-105,0,69,-74
-55,8,-72,-53,-82,-133,-52,85,-354
114,274,-152,-161,-370,-446,-49,449,-341
-4,23,-43,-33,-91,-15,-7,100,-70
-18,64,2,-9,-106,-60,-12,139,0
29,29,-51,-57,-87,-94,9,97,-125
15,60,-7,-61,-50,-46,1,78,-10
92,150,-70,-56,-89,-118,14,186,109
17,53,11,-6,-25,-31,-9,72,82
-11,28,-23,-12,-52,-7,-16,73,-20
-3,-4,-44,-46,-12,-62,-9,38,-142
21,51,18,-7,12,27,20,35,177
42,53,-24,-46,-46,-144,-43,92,-116
-6,3,-53,-22,-108,-88,-13,48,-239
12,98,-30,-33,-42,-38,40,137,144
27,30,-12,-33,4,-27,-16,27,0
15,30,1,-21,-27,-19,12,57,48
-19,54,-102,-118,-149,-96,-3,139,-294
96,145,-134,-82,-144,-156,38,199,-38
34,43,-131,-99,-144,-178,-30,147,-358
106,93,-36,-2,-42,-67,63,117,232
79,87,-35,-81,-96,-124,5,197,32
-7,12,-77,-51,-100,-120,-30,80,-293
-60,-52,-78,-52,-101,-123,-54,59,-461
-1,28,-35,-29,-78,-54,-10,69,-110
16,4,-21,-20,-19,-16,-5,6,-55
6,15,-18,-29,-49,-75,-34,54,-130
9,-2,-43,-47,-89,-110,-21,25,-278
12,2,-16,-2,-18,-12,15,4,-15
15,13,-8,15,-21,-17,12,20,29
9,3,-30,-22,-114,-45,13,62,-124
99,68,23,93,-58,-56,46,137,352
52,57,26,9,4,-16,23,93,248
48,90,-4,4,-31,-36,17,121,209
10,13,-33,-31,-17,-79,-4,35,-106
11,11,-37,-25,-21,-81,5,39,-98
-10,10,-9,2,-6,1,12,7,7
43,9,-4,-22,-20,-93,12,131,56
-11,72,-43,-16,-108,-124,-16,124,-122
-58,5,-70,-64,-85,-138,-64,103,-371
-8,7,-69,-81,-86,-73,-34,55,-289
58,57,-6,-14,-18,-48,-5,74,98
0,46,-29,-25,-55,-159,-56,116,-162
-7,15,-71,-82,-124,-180,-31,137,-343
7,-20,-27,-76,-81,-70,-10,60,-217
-74,43,-122,-66,-206,-185,-93,198,-505
2,4,-63,-21,-49,-112,-21,66,-194
-2,14,-44,-11,-82,-107,-6,72,-166
46,53,-74,0,-57,-121,-14,74,-93
71,53,-36,-4,-66,-96,18,95,35
-13,30,3,1,-31,12,9,33,44
46,92,16,-7,6,-35,17,86,221
64,53,-22,8,-78,-58,42,57,66
23,82,4,-15,-35,-37,18,65,105
98,65,-52,27,-162,-217,-4,86,-159
121,163,71,-15,38,-20,56,210,624
105,86,25,-45,41,-51,46,107,314
105,95,36,11,-22,-23,67,123,392
87,56,-22,12,-42,-50,56,86,183
75,112,-43,-116,-109,-139,24,193,-3
52,52,-36,-36,-76,-39,24,76,17
1,9,-16,-8,-31,-38,-12,22,-73
5,19,-35,-24,-50,-56,-25,60,-106
110,107,-49,-2,-99,-38,60,163,252
12,39,-15,-27,-29,-102,-17,70,-69
68,72,-3,5,-13,-39,29,131,250
-5,107,-36,-76,-118,-145,-26,187,-112
-23,162,-293,-180,-533,-761,-287,411,-1504
24,71,5,-35,-21,-32,-6,77,83
22,19,-16,-48,-44,-105,-37,57,-152
197,261,-267,-228,-656,-675,-145,698,-815
-28,25,-51,-42,-36,-56,-15,21,-182
41,133,11,9,-80,-94,34,195,249
17,12,-25,-10,-52,-69,-24,79,-72
70,9,-66,11,-73,-20,66,32,29
8,3,-107,-45,-187,-137,-16,107,-374
-2,25,-100,-65,-226,-121,-27,94,-422
7,32,-177,-121,-261,-193,-22,168,-567
89,77,64,-8,-55,-52,11,133,259
91,118,-86,-69,-131,-145,-3,188,-37
84,91,-33,-49,-112,-56,27,173,125
104,150,38,-19,-46,-20,47,227,481
5,45,-11,-18,-57,-49,1,69,-15
36,2,-36,5,-69,-45,9,46,-52
26,-3,-30,-15,-55,-44,-4,39,-86
27,7,-13,-28,-30,-54,-13,35,-69
5,9,-43,-18,-54,-38,-11,23,-127
3,16,-18,-18,-53,-38,-3,46,-65
17,16,-19,-13,-51,-46,-3,27,-72
12,23,-125,-101,-141,-189,-29,104,-446
8,11,-10,-10,-23,-2,7,33,14
17,9,-26,-22,-15,-66,-4,44,-63
20,0,-56,-47,-114,-143,-58,126,-272
19,16,-51,-45,-105,-133,-25,142,-182
43,192,60,18,-33,-108,-30,251,393
59,60,-40,-37,-107,-164,-22,163,-88
25,22,-13,-16,-1,5,23,34,79
21,32,-43,-20,-55,-102,-18,80,-105
20,99,-39,-28,-62,-93,-4,123,16
31,27,-61,-54,-62,-104,2,48,-173
21,13,-7,4,-42,-40,-3,46,-8
-4,15,-4,-16,-10,-46,-1,19,-47
-14,33,-24,-17,6,21,24,54,83
-8,114,-55,-62,-2,-37,42,163,155
84,72,86,-24,5,-108,8,160,283
41,-11,5,-86,2,-101,-14,145,-19
64,52,-108,17,-198,-78,12,129,-110
-20,38,-86,-59,12,-5,39,137,56
9,165,-64,-19,39,-5,49,190,364
31,115,-97,-112,-197,-235,-37,246,-286
215,354,-102,-96,-173,-258,126,428,494
204,359,-40,-30,-122,-198,125,435,733
8,-7,-27,-25,-121,-62,-13,106,-141
25,59,-25,-9,-110,-80,18,83,-39
4,2,-20,-3,-45,-37,-4,49,-54
21,20,-49,0,-82,-73,-15,44,-134
-24,-1,-47,-56,-63,-66,4,84,-169
5,25,-18,-31,-15,-43,-10,40,-47
-49,7,-39,-68,-80,-144,-61,72,-362
490,607,-337,-207,-562,-602,88,982,459
-3,19,-51,-51,-39,-147,-40,98,-214
11,22,-36,-26,-73,-108,8,35,-167
92,199,-39,-32,10,33,121,191,575
260,325,-291,-88,-608,-163,108,675,218
123,147,-12,-25,-82,-149,34,203,239
-8,9,-30,-25,-30,-55,-24,27,-136
-28,7,-53,-48,-97,-100,-44,90,-273
14,12,-92,-6,-199,-92,27,85,-251
-1,32,-53,-58,-91,-145,-54,142,-228
4,17,-92,-40,-207,-105,-30,149,-304
23,37,-46,-42,-52,-73,0,65,-88
17,16,2,-22,4,-24,-12,27,8
9,15,-20,3,-13,-11,11,14,8
-50,-39,-68,-32,-85,-86,-46,16,-390
-87,-40,-73,-78,-86,-151,-84,70,-529
-66,-22,-77,-69,-88,-154,-91,50,-517
-77,-44,-80,-62,-113,-118,-76,66,-504
-44,-23,-82,-56,-112,-117,-67,84,-417
-62,-18,-62,-64,-99,-127,-91,62,-461
-51,-47,-92,-58,-118,-133,-56,62,-493
57,55,-28,-54,-89,-95,24,125,-5
38,31,12,-52,-34,-145,-33,102,-81
0,45,37,10,-85,-89,-16,172,74
-30,27,11,-40,-85,-127,-60,130,-174
82,55,-83,-43,-165,-193,-9,157,-199
63,185,-15,-40,-61,-104,56,144,228
77,96,-36,-74,-82,-193,-2,209,-5
-20,65,-57,-41,-9,8,42,114,102
-18,58,-66,-86,-125,-95,-14,184,-162
-36,62,-134,-66,-219,-215,-13,179,-442
-72,-8,-144,-96,-230,-215,-79,140,-704
-74,-21,-140,-107,-188,-218,-79,123,-704
-100,-42,-129,-103,-190,-224,-107,112,-783
-52,70,-80,-78,-145,-219,-55,211,-348
-24,28,-101,-75,-182,-203,-79,199,-437
-62,-18,-115,-43,-176,-209,-65,163,-525
-62,-12,-110,-42,-163,-207,-54,156,-494
55,211,-121,-196,-342,-343,-74,458,-352
-4,-15,-19,-9,-38,-27,-24,25,-111
-15,-14,-40,-36,-71,-70,-28,43,-231
-37,11,-55,-35,-106,-120,-43,91,-294
-78,-2,-77,-73,-97,-151,-77,85,-470
27,32,-78,-60,-103,-167,8,114,-227
87,103,-48,-47,-73,-107,44,158,117
3,125,-84,-82,-9,-8,46,206,197
12,95,-41,-35,-8,-68,37,120,112
284,320,-97,-67,-80,-190,74,414,658
10,8,-34,-52,-19,-104,-7,55,-143
391,512,20,3,62,-15,161,470,1604
361,352,-33,19,-80,-128,132,431,1054
-43,63,-143,-105,-208,-295,-107,205,-633
-9,80,-88,-116,-208,-270,-39,236,-414
33,74,0,-15,-46,-80,9,105,80
3,-23,-89,-52,-180,-105,1,101,-344
11,4,-38,-41,-58,-69,-6,57,-140
50,84,-21,12,6,-5,64,67,257
4,20,23,-34,14,-97,-57,33,-94
-2,33,5,-19,1,-23,2,34,31
22,52,-70,-49,-81,-88,-15,75,-154
29,46,-2,-2,-22,-121,-30,103,1
45,61,51,-58,18,-121,-26,141,111
39,29,-30,5,-41,-48,5,83,42
21,38,-39,-39,-44,-99,-6,47,-121
13,50,-16,-22,-27,-73,-19,55,-39
29,83,-28,-16,-55,-102,-9,67,-31
46,60,-40,-45,-63,-113,8,121,-26
80,184,-59,-64,-131,-104,34,231,171
-3,45,-24,-27,-52,-86,-14,56,-105
31,40,1,-12,-28,-23,-4,45,50
9,28,-23,-26,11,-35,-1,15,-22
-2,93,87,64,-59,91,27,145,446
35,5,-1,-24,-30,-113,-16,54,-90
196,204,-215,-114,-360,-159,111,393,56
31,34,-18,-23,-50,-25,5,52,6
-2,16,-60,-1,-121,-82,-46,74,-222
50,109,83,87,-96,10,94,162,499
20,10,-91,-57,-182,-145,-20,113,-352
26,32,-74,-39,-157,-133,-8,134,-219
12,8,-8,7,-23,-16,9,2,-9
58,51,-89,13,-168,-201,-57,122,-271
15,147,-79,-110,-173,-310,-28,240,-298
-15,67,-23,-50,-64,-94,-31,87,-123
11,12,-12,-17,-10,-34,-16,14,-52
1,-1,-24,-12,-9,-27,-10,15,-67
18,41,-56,-46,-52,-64,13,63,-83
25,33,-23,-11,-40,-28,5,45,6
19,38,-12,-23,-7,-29,-7,30,9
-69,-16,-132,-17,-210,-227,-76,129,-618
168,108,-14,104,-97,-23,60,226,532
11,56,6,15,-77,-34,17,87,81
46,172,-39,-54,-48,-249,-60,200,-32
84,82,-66,-8,-82,-53,49,124,130
10,-5,-13,-6,-40,-42,-10,26,-80
86,174,-121,-108,-220,-223,33,283,-96
94,189,-105,-62,-205,-235,-46,259,-111
47,95,-50,-81,-95,-175,-16,121,-154
13,185,37,-54,23,20,79,234,537
-29,47,-83,-51,18,19,62,108,91
-25,40,-64,-57,-34,-51,13,88,-90
53,76,-78,-44,-92,-117,44,150,-8
-7,138,-47,-34,2,-30,48,205,275
-8,82,-32,-29,1,16,38,99,167
-32,155,-53,-41,-2,-9,62,173,253
-5,1,-28,-26,-18,-12,0,51,-37
-6,46,-35,-17,3,3,15,64,73
107,348,5,-99,122,-203,133,460,873
28,67,-51,-23,-149,-12,28,175,63
183,170,-63,10,-128,-83,43,149,281
14,19,-61,-67,-76,-90,-30,80,-211
8,-9,-41,-6,-60,-37,5,27,-113
6,29,-43,-33,-95,-78,-34,35,-213
-15,69,-80,-130,-201,-152,37,138,-334
1,127,-67,-54,-291,-202,-21,169,-338
3,10,13,29,-9,-22,1,90,115
-14,36,14,-10,-7,-31,-12,65,41
20,41,-40,-37,-53,-27,-24,75,-45
18,18,-5,-26,-7,-48,-9,54,-5
24,13,-34,-4,-73,-52,5,42,-79
20,17,-25,-20,-66,-51,-15,71,-69
13,167,-43,-63,-167,-109,40,282,120
25,1,-87,-99,-89,-266,-90,164,-441
24,76,-10,-97,-37,-243,-66,183,-170
36,47,-84,-24,-112,-194,-1,68,-264
19,7,-33,-28,-53,-89,-3,63,-117
38,-8,-31,-39,-56,-52,-1,52,-97
48,55,-3,10,12,28,51,52,253
-4,40,2,21,-8,34,13,29,127
62,54,10,-7,5,-48,39,84,199
191,402,50,151,-248,-332,-106,561,669
80,93,8,9,-14,-56,40,132,292
78,54,-32,26,-54,-60,29,69,110
60,61,-5,14,-37,-44,17,64,130
34,39,-11,6,-44,-83,-6,83,18
5,67,-29,3,-43,-59,-6,86,24
-14,3,-44,-21,-54,-45,-10,54,-131
48,20,-41,-27,-77,-91,-34,68,-134
14,85,-60,-65,-78,-141,-7,126,-126
62,154,-112,-150,-288,-372,-44,327,-423
21,58,-12,16,-52,-63,-25,76,19
55,36,-44,-11,-71,-84,-5,92,-32
9,44,-21,-10,-64,-60,5,51,-46
0,21,-13,-35,-61,-36,20,86,-18
15,53,-156,-85,-239,-159,4,195,-372
281,660,883,352,503,479,123,915,4196
81,112,22,5,-17,-20,40,128,351
33,35,-4,5,-36,-6,12,51,90
19,24,-28,-31,-70,-36,6,61,-55
-28,23,-24,2,-101,-5,14,113,-6
25,15,-44,-21,-115,-104,0,80,-164
17,39,-6,-1,-48,-73,-27,78,-21
-21,10,-17,-14,-61,-87,-44,30,-204
23,56,-152,-102,-267,-300,-91,162,-671
12,28,-105,-141,-221,-282,-33,189,-553
-8,2,-27,20,-79,-71,-33,95,-101
4,121,14,-104,-37,-71,-17,112,22
0,69,-63,-62,-66,-114,-6,126,-116
22,35,23,10,-18,-11,12,52,125
10,6,-2,11,-19,-6,7,41,48
38,25,-8,2,-30,-6,25,78,124
34,-17,-249,-96,-441,-517,-134,258,-1162
6,32,-57,-69,-70,-68,11,102,-113
-2,-18,-24,-25,-21,-52,-28,29,-141
39,8,-27,-26,-32,-36,25,30,-19
41,36,-101,-65,-247,-193,-17,239,-307
23,15,-50,-33,-57,-104,-4,41,-169
30,43,-55,-55,-101,-109,-15,79,-183
-80,-32,-143,-63,-212,-207,-104,117,-724
-1,26,-36,-17,-49,-29,6,15,-85
-1,-1,-5,-15,3,2,3,5,-9
177,306,-270,-150,-340,-350,19,429,-179
27,30,-38,-19,-21,-66,32,52,-3
229,251,-69,2,-149,-101,127,259,549
5,-3,-22,-12,-49,-28,-3,26,-86
-48,16,-95,-16,-130,-92,-46,104,-307
62,56,13,-9,-62,-62,-1,88,85
163,200,45,11,-98,-136,26,315,526
36,47,-13,-6,-3,9,32,42,144
109,176,-60,-51,-173,-232,44,237,50
40,33,-9,-21,-22,-60,1,45,7
9,4,-11,-28,-36,-39,-29,46,-84
49,3,-1,19,-45,-42,-25,54,12
207,283,-107,-108,-208,-274,4,384,181
8,22,-88,-75,-156,-148,-39,69,-407
80,177,-84,-54,-218,-188,23,228,-36
-48,11,-76,-9,-129,-181,-47,111,-368
28,60,-36,-12,-60,-99,-2,78,-43
178,199,-35,-20,-104,-100,124,314,556
106,175,-36,24,-124,-145,39,165,204
439,484,211,50,99,-82,125,484,1810
58,77,-35,-22,-62,-77,25,117,81
97,159,-88,-69,-173,-194,-16,224,-60
106,165,-54,-62,-124,-108,39,268,230
94,120,-7,-49,-82,-76,25,146,171
94,46,-104,-102,-204,-221,-62,236,-317
113,129,-168,-165,-276,-157,40,292,-192
5,22,-45,-41,-61,-98,-20,107,-131
7,57,-7,-42,-57,-73,-7,130,8
23,33,25,-11,-9,-24,-4,72,105
25,93,-81,-24,-92,-104,12,82,-89
50,73,-74,-5,-89,-96,26,79,-36
-16,7,-66,-49,-94,-102,-18,72,-266
26,53,-69,-70,-78,-136,11,120,-143
33,14,-98,-58,-199,-83,-2,88,-305
-4,36,-33,-30,-61,-67,-8,87,-80
-41,8,-209,-142,-318,-215,-95,188,-824
-4,8,-37,-19,-34,-56,-7,37,-112
-3,8,1,-4,-10,-8,-11,14,-13
70,58,-38,-23,-51,-51,23,100,88
94,57,-74,5,-126,-50,32,111,49
16,-6,-91,-40,-144,-154,-52,85,-386
92,102,-89,-73,-187,-189,14,205,-125
32,93,-118,-97,-220,-148,34,202,-222
63,96,-40,-44,-172,-144,27,224,10
76,28,-110,-96,-211,-164,4,180,-293
68,38,-125,-92,-243,-138,1,179,-312
121,133,43,-29,-53,-95,41,223,384
-5,69,0,-45,-47,-103,-33,115,-49
44,-16,-42,27,-203,-236,-38,135,-329
8,-32,-60,-37,-135,-140,-66,153,-309
3,19,-36,-32,-55,-54,-2,25,-132
70,39,-13,8,-47,-52,12,74,91
30,55,46,69,-46,-41,-20,87,180
23,79,4,-69,-52,-139,-28,142,-40
22,19,-43,-96,-98,-160,-29,126,-259
48,53,8,6,-33,-36,21,65,132
-43,-24,-44,-17,-66,-54,-63,27,-284
-32,-31,-47,-27,-60,-50,-35,21,-261
-46,-13,-24,-13,-43,-72,-59,27,-243
-16,6,-83,-52,-108,-146,-51,87,-363
41,60,-29,-9,-77,-114,-15,95,-48
21,88,-55,-79,-223,-155,-34,187,-250
32,-16,-54,26,-94,-95,-10,32,-179
15,4,-13,40,-77,-80,-12,51,-72
-1,14,-24,-7,-34,-19,-2,12,-61
17,27,2,-15,-3,-29,6,39,44
17,41,-12,0,1,-34,11,11,35
41,65,-64,-59,-61,-85,-1,81,-83
-2,18,-241,-49,-349,-283,-57,261,-702
-93,-35,-162,-113,-260,-236,-107,209,-797
53,52,-39,0,-92,-92,24,82,-12
-11,43,-77,-31,-105,-67,-25,73,-200
26,49,-29,-34,-70,-35,8,77,-8
40,65,-17,-16,-72,-19,10,95,86
51,99,7,-20,-34,-44,49,107,215
4,27,3,-8,1,-36,-15,22,-2
19,51,-47,-25,-91,-149,-19,102,-159
10,-42,-159,-76,-205,-334,-112,198,-720
-26,-8,-50,-12,-51,-104,-53,43,-261
-27,-19,-52,12,-96,-81,-40,54,-249
45,66,-76,-95,-196,-148,14,137,-253
10,34,-25,-11,-24,-24,13,76,49
94,112,-75,-40,-54,-42,85,85,165
22,14,-35,-43,-95,-86,-41,87,-177
20,7,4,44,-31,-58,-23,58,21
47,8,-74,-5,-125,-127,9,77,-190
-64,-19,-92,-61,-137,-112,-49,106,-428
-51,-28,-57,-31,-116,-48,-33,60,-304
14,29,0,12,-21,-19,6,44,65
-15,37,10,-3,-85,-82,-22,81,-79
96,61,-28,-36,-38,-105,32,134,116
-4,13,-31,-19,-48,-29,-8,11,-115
38,79,-139,-67,-244,-187,-19,204,-335
-21,37,-137,-120,-252,-369,-122,224,-760
294,411,-99,-119,-185,-294,67,375,450
218,341,-13,66,-164,-66,63,435,880
218,394,27,122,-111,-110,87,432,1059
144,180,-21,-34,-47,-76,42,163,351
172,247,-31,-80,-61,-143,87,339,530
51,49,-41,-38,-22,-63,22,66,24
38,29,-34,-25,-29,-51,-18,54,-36
15,73,-1,-46,-51,-62,-8,102,22
17,11,-27,-39,-36,-55,-8,49,-88
15,38,-5,-12,-93,-85,-32,128,-46
22,0,-64,-9,-91,-82,3,47,-174
131,187,-56,-30,-125,-161,59,313,318
186,299,103,28,-234,-220,-46,327,443
17,31,-11,-12,-44,-45,-8,23,-49
110,54,-76,-106,-194,-156,-7,229,-146
108,41,-91,-122,-145,-145,-28,158,-224
57,38,-71,-120,-165,-173,-44,186,-292
84,32,-72,-135,-139,-138,-16,168,-216
64,36,-100,-147,-143,-150,-38,167,-311
64,40,-81,-114,-134,-144,-34,171,-232
110,115,-28,-90,-121,-224,-20,179,-79
102,141,40,-8,10,-52,25,192,450
93,66,28,89,-61,-33,23,166,371
56,75,39,20,-5,-21,10,136,310
43,42,-38,2,-39,-41,8,46,23
-45,-42,-42,-4,-55,-61,-33,29,-253
7,22,-21,-27,-64,-85,-23,75,-116
49,79,-36,-20,-77,-44,6,155,112
22,0,-20,1,-91,-33,-1,65,-57
16,13,-9,-1,-36,-19,-5,29,-12
60,42,11,4,-66,-22,36,112,177
6,19,-9,-12,-13,-22,3,27,-1
-4,14,-18,-10,-13,-16,-5,19,-33
53,41,-131,-80,-202,-238,-49,144,-462
38,28,-14,-25,-2,-45,29,13,22
32,49,65,60,-43,-4,4,127,290
50,26,45,-11,-1,-9,-12,62,150
16,38,-48,-18,-151,-57,9,121,-90
31,34,-8,6,-16,-34,23,57,93
-6,-13,-64,0,-109,-66,15,67,-176
17,29,1,-3,-7,-9,19,26,73
106,62,-92,-84,-107,-114,53,149,-27
26,47,-12,-51,-65,-60,-17,172,40
10,53,-10,22,-43,-94,-17,94,15
-1,-3,-57,-40,-103,-62,9,57,-200
25,28,-3,-19,-26,-60,-16,39,-32
-10,8,-16,-5,-9,-16,2,19,-27
35,56,-18,-29,-66,-92,-16,123,-7
50,63,29,43,-22,-1,17,99,278
80,54,5,39,-21,-22,13,111,259
38,33,-2,6,-11,-22,9,59,110
-45,-21,-118,-133,-137,-176,-61,105,-586
32,43,-7,8,8,-10,10,41,125
57,96,-33,-19,-65,-74,43,98,103
27,71,-89,-62,-153,-247,-40,154,-339
36,112,-115,-109,-289,-146,-39,330,-220
11,24,-22,1,-47,-69,28,69,-5
35,33,-9,7,1,-13,29,27,110
99,51,-87,48,-118,-84,91,140,140
6,17,-4,3,-11,3,7,13,34
8,20,2,-9,-14,-28,-2,17,-6
-1,20,-1,-21,-18,-37,-17,1,-74
21,28,-6,-59,-52,-113,-19,129,-71
-9,0,-64,-62,-94,-48,-19,73,-223
-8,17,-18,-11,-27,-45,-17,29,-80
3,-6,-12,-6,-13,1,-1,10,-24
7,-7,-16,1,-21,-4,12,10,-18
0,6,-14,0,-16,-15,0,3,-36
18,5,45,-34,-7,-1,-6,113,133
189,289,-59,-5,-137,-194,55,313,451
0,4,-21,-40,-87,-53,-29,63,-163
-23,-14,-29,-29,-37,-33,-19,21,-163
18,-9,-41,-48,-122,-85,-3,94,-196
12,34,-3,-22,-6,-28,-8,23,2
0,-3,-35,-28,-19,-20,8,14,-83
-23,-25,-35,-8,-43,-57,-29,18,-202
-1,18,-31,-19,-47,-32,-9,32,-89
-7,44,-47,-38,-85,-115,-41,84,-205
-5,1,-39,-28,-49,-67,-4,22,-169
183,294,-20,-69,-107,-132,72,372,593
105,114,58,40,-15,-19,43,154,480
33,72,-27,-78,-119,-113,-21,187,-66
-14,30,-8,-20,-53,-44,-30,43,-96
6,12,-9,-13,-67,-38,3,49,-57
12,46,-6,-9,-68,-39,25,95,56
-3,8,-28,-1,-87,-28,-16,63,-92
360,427,-72,-119,-296,-269,53,717,801
19,140,74,-21,-94,-9,45,208,362
-18,-3,-40,2,-74,-68,-41,37,-205
-32,10,-48,-6,-76,-67,-44,31,-232
-25,-26,-42,-24,-91,-55,-30,34,-259
-20,-5,-37,-21,-65,-95,-46,44,-245
-47,-16,-27,-15,-70,-68,-36,36,-243
-6,21,-37,-40,-96,-83,-16,108,-149
2,6,-22,-11,-17,-39,-9,20,-70
-27,-8,-47,18,-98,-52,-37,45,-206
-12,15,-36,0,-62,-61,-23,47,-132
46,54,8,21,-27,-18,27,75,186
0,17,-33,-14,-73,-108,-41,85,-167
222,176,16,-70,-31,-127,33,232,451
19,47,-44,2,-85,-57,-7,56,-69
111,157,-64,-35,-97,-55,49,223,289
67,63,-1,3,-13,-41,26,85,189
10,25,-20,-4,-24,-4,26,29,38
-18,-7,-40,-25,-45,-52,-17,35,-169
29,62,31,14,10,18,41,73,278
-66,16,-76,-15,-138,-142,-88,127,-382
77,148,-7,-48,-33,-130,30,181,218
62,178,-23,-47,-79,-160,-8,211,134
16,25,-10,-19,-39,-56,-10,90,-3
142,290,-99,-111,-84,-156,155,405,542
118,112,52,57,6,-23,22,122,466
30,57,-68,-47,-101,-184,-9,108,-214
19,38,-35,-23,-53,-61,10,41,-64
24,62,-15,-5,-26,-58,-3,58,37
39,124,-63,-58,-172,-235,0,201,-164
17,75,-38,-23,-83,-95,5,99,-43
109,99,9,-13,-42,-118,43,160,247
44,30,-33,3,-31,-36,36,46,59
19,41,-33,-16,-62,-37,4,76,-8
-18,-17,-27,-14,-60,-111,-57,63,-241
-107,-50,-193,-116,-266,-197,-76,159,-846
13,6,-1,7,-33,-15,-2,35,10
-25,108,-122,-94,-232,-377,-92,161,-673
122,227,-82,18,-212,-269,-5,201,0
60,122,13,-41,29,1,83,132,399
0,49,-42,-39,-80,-12,14,119,9
21,63,-52,-27,-95,-41,21,138,28
-18,33,-24,-17,-108,-82,-12,92,-136
2,4,-35,-20,-49,-48,-3,34,-115
3,14,-2,-13,-19,-14,-6,19,-18
12,-1,-53,-12,-77,-57,-18,45,-161
102,194,-37,-78,-95,-198,11,228,127
1,10,6,11,-20,-34,-10,23,-13
-27,29,-47,-10,-63,-59,-30,49,-158
49,78,-89,-90,-198,-273,-51,178,-396
13,106,-26,-11,-78,-119,-9,138,14
61,64,-19,-19,-42,-75,-3,92,59
32,32,-9,2,-11,-38,5,50,63
9,83,-53,-59,-82,-90,23,143,-26
14,68,-12,-77,-55,-99,-34,148,-47
5,36,-2,-28,-79,-90,-17,93,-82
-11,36,-98,-48,-142,-88,-39,123,-267
55,81,28,-13,9,-25,11,53,199
36,55,-30,-27,-48,-140,-46,86,-114
30,2,-19,-54,-85,-164,-37,94,-233
86,44,30,53,-24,-55,38,114,286
-12,13,-7,-16,-23,-13,-8,12,-54
509,729,-518,-243,-1491,-1327,164,600,-1577
3,72,-3,-38,-30,-81,-11,90,2
-67,-17,-53,-38,-76,-128,-72,53,-398
-55,-4,-49,-60,-88,-132,-74,64,-398
-51,-12,-31,-67,-64,-115,-57,56,-341
-57,-18,-63,-45,-66,-114,-60,63,-360
-86,-32,-65,-67,-75,-130,-97,53,-499
13,88,11,-6,-147,-43,42,168,126
-11,8,2,-24,-6,-9,-5,18,-27
72,85,-19,10,-34,-54,43,73,176
-25,22,-62,-30,-10,-10,20,79,-16
-8,76,-52,-54,-100,-53,-7,121,-77
53,67,5,-12,2,-30,33,99,217
105,345,17,-89,-45,-2,79,409,819
17,56,-32,3,-129,-27,-8,148,28
103,113,27,-50,-37,-102,-3,210,261
18,32,-22,-38,-44,-47,-7,62,-46
-46,-20,-61,-18,-44,-72,-34,39,-256
12,15,-26,-4,-56,-33,5,57,-30
61,122,9,-19,19,-80,27,98,237
13,13,-9,11,1,-6,3,10,36
31,53,16,-3,-1,-26,13,61,144
-5,14,10,-8,6,-9,1,19,28
12,9,-17,-5,-17,-33,-13,6,-58
-3,9,-8,-5,-20,-11,-6,15,-29
0,8,-18,-4,-11,-26,-10,31,-30
1,12,-3,-38,-13,-45,-22,30,-78
-2,81,-24,-31,-74,-75,-15,120,-20
-54,1,-158,-67,-207,-208,-52,156,-589
33,63,-2,-6,-14,-47,-2,71,96
-26,-4,-49,-28,-95,-137,-48,84,-303
5,20,-25,-5,-28,-7,20,27,7
16,28,27,-3,-6,-5,17,41,115
-8,14,-2,-11,-16,-17,1,20,-19
-10,8,-15,-26,-17,-59,-3,50,-72
-2,21,6,-2,0,-11,2,21,35
4,16,-12,-7,1,-10,6,12,10
37,181,-85,-45,-155,-238,-4,128,-181
-27,59,-87,-103,-166,-355,-115,224,-570
1,133,-27,-60,-110,-326,-103,182,-310
18,161,-81,-62,-206,-344,-36,242,-308
32,69,14,-17,22,6,40,47,213
6,27,24,13,-15,-6,3,44,96
46,46,-26,4,-32,-39,17,49,65
7,12,4,-3,4,-14,3,11,24
18,43,26,-9,18,-9,11,35,133
13,17,-19,-28,-35,-21,0,64,-9
16,37,-12,-3,-11,-26,2,27,30
8,30,-37,-10,-56,-31,0,29,-67
24,28,-41,-6,-35,-5,10,31,6
63,320,46,-72,-144,-95,-11,470,577
-56,-27,-46,-42,-92,-135,-74,87,-385
-69,-40,-69,-40,-96,-129,-73,77,-439
-48,-29,-63,-49,-90,-123,-69,72,-399
-55,-34,-49,-40,-45,-131,-80,77,-357
-55,-42,-70,-58,-84,-125,-73,80,-427
-59,-21,-64,-56,-106,-114,-69,77,-412
-53,-39,-72,-56,-99,-114,-72,84,-421
-66,-51,-75,-53,-103,-125,-80,89,-464
-69,-33,-62,-66,-97,-126,-75,88,-440
-64,-26,-69,-48,-105,-127,-84,78,-445
-72,-43,-84,-56,-108,-122,-92,84,-493
-66,-45,-64,-47,-89,-139,-98,77,-471
-51,-27,-62,-53,-67,-122,-43,54,-371
-2,9,-16,5,-13,-28,-11,18,-38
7,-5,-26,-8,-37,-21,-7,21,-76
6,-5,-23,-10,-34,-21,-11,20,-78
22,-5,-19,9,-19,-17,8,13,-8
17,34,-12,-18,-14,-60,-11,54,-10
0,-3,-25,-25,-52,-61,-22,49,-139
77,133,-48,-53,-1,-39,46,178,293
-34,79,-42,-31,-105,-181,-56,144,-226
-21,72,3,-31,-155,-152,-97,156,-225
-8,-2,-8,-12,-6,-16,-10,7,-55
30,105,6,5,-46,-75,-7,153,171
-7,18,-17,-47,-6,-35,7,56,-31
-65,-3,-56,-66,-77,-118,-82,53,-414
57,214,-43,-29,-8,-102,97,262,448
8,31,7,5,4,-25,6,37,73
-14,31,-5,-3,-32,30,10,21,38
-12,57,-10,-10,-52,50,21,37,81
-2,5,-31,-26,-43,-36,-8,48,-93
11,18,-17,-17,-3,-7,9,16,10
41,40,-1,-17,3,-40,4,30,60
10,46,-34,-19,-29,-3,35,56,62
-9,105,-12,-18,-69,66,-15,60,108
-12,8,-1,4,-14,-15,-14,11,-33
-33,-15,-67,-27,-83,-86,-57,38,-330
-16,-13,-21,-21,-16,-9,-2,12,-86
-5,14,-28,-34,-7,-35,-1,37,-59
13,9,-48,-16,-96,-20,-6,57,-107
-61,-36,-59,-11,-89,-69,-48,45,-328
13,-14,-54,-54,-87,-150,-59,58,-347
10,32,14,-2,-4,2,2,41,95
9,56,4,-7,-2,-11,11,44,104
-25,20,-3,-21,-34,16,-3,15,-35
-20,32,4,-15,-27,17,-3,16,4
0,118,-5,-13,-74,71,-3,64,158
-5,116,-1,-5,-68,84,5,72,198
-6,93,-6,-14,-53,53,-7,52,112
-9,114,-5,-17,-70,80,-11,56,138
1,160,15,-15,-91,99,-2,87,254
-3,184,17,-23,-95,133,1,95,309
-2,169,19,-14,-92,117,-2,82,277
-4,100,-1,-2,-56,62,-15,66,150
0,124,0,-7,-67,92,-2,74,214
-3,120,-10,-17,-79,85,-8,74,162
-2,111,22,-23,-37,68,-4,61,196
-6,8,0,-1,-33,-2,3,39,8
44,0,-38,-63,-8,-76,-9,63,-87
11,36,4,-46,-77,-155,-59,154,-132
3,59,-10,-19,-74,-118,-55,144,-70
6,5,0,-56,-54,-103,-44,125,-121
0,12,-12,-35,-68,-57,-26,42,-144
0,11,-27,-28,-23,-15,11,11,-60
-13,6,-18,-7,-22,-55,-40,37,-112
-13,15,-12,17,-15,-3,7,11,7
17,15,-10,-5,-12,-29,-1,34,9
-5,17,-1,-16,-12,-30,-10,13,-44
49,75,-10,7,-71,-133,-32,160,45
6,5,-19,-25,-31,-32,2,19,-75
-1,19,-4,-16,-46,-19,-9,21,-55
-5,16,-58,-41,-95,-61,-5,57,-192
4,6,-29,-38,-38,-31,-5,8,-123
23,34,0,-4,-23,-45,8,58,51
10,22,-38,-60,-121,-78,-16,69,-212
30,97,23,-43,-48,-121,-56,183,65
0,10,-23,-29,-22,0,9,28,-27
51,35,-14,1,-61,-33,14,23,16
11,-18,-47,-60,-132,-65,-12,67,-256
-42,-39,-45,-42,-72,-125,-56,83,-338
29,17,5,-1,13,-21,5,14,61
2,-14,-52,-27,-71,-22,10,27,-147
1,9,-18,-12,-1,-24,-10,5,-50
4,10,-32,-30,-31,-37,-1,27,-90
-18,9,-40,-15,-34,-12,4,8,-98
3,17,-15,-15,-13,-24,-7,14,-40
9,4,-18,0,-16,-38,-5,19,-45
3,-8,-43,-29,-47,-39,-3,28,-138
4,0,-21,-28,-31,-60,-23,40,-119
44,26,-65,-11,-129,-90,-15,96,-144
9,15,-23,-1,-52,-39,2,45,-44
-5,5,-41,-6,-73,-34,-11,30,-135
31,10,-29,4,-63,-47,3,44,-47
5,17,-2,-15,5,-13,6,22,25
-5,4,-30,-22,-46,-30,-9,29,-109
-62,-40,-81,-56,-124,-100,-58,82,-439
14,10,19,-22,4,-21,-14,28,18
15,26,-3,-16,-10,-28,1,44,29
23,1,-26,-13,-35,-43,5,37,-51
18,1,-18,-16,-30,-38,4,24,-55
19,11,-27,-3,-66,-41,-4,40,-71
256,356,89,-20,70,-27,86,448,1258
-6,33,-69,-89,-91,-58,-1,64,-217
-15,36,-54,-61,-79,-80,-38,58,-233
-17,12,-34,-50,-75,-58,4,55,-163
-17,-12,-24,-9,-25,-37,-21,5,-140
41,34,-51,-31,-76,-133,-49,73,-192
1,1,-34,-26,-46,-45,-26,26,-149
14,4,-9,-24,-27,-32,2,24,-48
-10,23,-79,-91,-131,-101,-5,109,-285
19,19,-27,-14,-46,-31,11,27,-42
7,2,-29,-24,-49,-27,6,21,-93
2,0,-8,-13,-26,-18,-5,19,-49
59,41,-8,-5,-25,-28,11,34,79
20,30,-38,-26,-46,-33,24,30,-39
6,28,-14,-21,-16,21,25,41,70
24,33,-42,-36,-82,-50,-11,38,-126
24,18,-9,15,-28,-35,1,29,15
17,29,-20,-42,-48,-63,-12,38,-101
36,27,-4,12,-34,-31,22,49,77
7,19,-5,-36,-21,-2,22,61,45
-3,4,-29,-34,-18,-29,-13,21,-101
20,57,-13,-20,-19,-1,26,76,126
24,12,-39,-16,-16,-13,17,24,-7
12,39,-7,-24,-17,-25,5,40,23
46,57,-21,-34,-59,-47,18,69,29
0,-36,-57,-39,-81,-122,-39,36,-338
11,-3,-9,-6,-7,-24,1,20,-17
-5,13,-24,4,-29,15,8,18,0
-21,83,-24,-33,-115,-157,-59,139,-187
42,64,-65,-99,-107,-131,10,162,-124
6,62,-60,-102,-95,-120,-14,132,-191
14,62,-53,-103,-90,-112,1,132,-149
-18,0,-15,-21,-11,-38,-21,34,-90
27,60,-62,-86,-103,-127,8,151,-132
25,27,-14,3,-11,-17,19,30,62
26,30,-14,5,-12,-19,21,29,66
26,30,-14,5,-12,-19,21,29,66
26,30,-13,4,-11,-19,20,27,64
24,28,-14,7,-11,-23,17,29,57
22,28,-11,2,-11,-24,17,23,46
31,32,-5,6,-12,-18,22,34,90
26,30,-14,5,-12,-19,21,29,66
16,26,6,-10,14,10,13,15,90
17,26,6,-10,14,10,12,12,87
16,23,6,-7,15,10,9,11,83
15,26,6,-9,14,8,10,12,82
18,9,-30,-32,-36,-25,15,8,-73
42,30,-22,-23,-50,-35,9,59,10
-6,-3,-35,-27,-35,-55,3,8,-150
10,22,-21,-20,-21,-35,5,18,-42
-1,17,-23,-20,-20,0,1,13,-33
-81,-7,-107,-51,-159,-118,-79,87,-515
8,-10,-14,8,-44,-31,-8,23,-68
29,48,-51,-14,-60,-75,-12,75,-60
28,21,-33,-7,-36,-55,3,27,-52
29,49,-87,-69,-132,-150,-34,81,-313
3,8,-7,-13,-16,-29,-2,26,-30
-23,-13,-19,-6,-28,-47,-25,29,-132
24,24,-40,-65,-66,-111,-14,74,-174
21,29,-18,-7,-7,5,6,59,88
0,5,-21,-20,-42,-66,-25,33,-136
17,12,-9,5,-27,-12,9,18,13
10,22,-11,-5,-5,2,22,34,69
3,28,-11,-6,3,-4,18,8,39
17,23,0,-7,-7,-12,18,22,54
1,-3,-20,-5,-20,-21,7,20,-41
13,-6,-13,-32,-57,-91,-15,47,-154
35,39,-54,-26,-90,-47,-7,71,-79
-2,27,-7,-12,-20,-42,-22,25,-53
-1,14,6,4,-32,-23,-15,34,-13
4,-2,-15,-12,-19,-28,-13,23,-62
51,68,42,-16,-61,-15,8,119,196
17,7,-33,-9,-79,-75,-12,17,-167
7,19,-36,-36,-63,-97,-24,75,-155
12,9,-38,-36,-44,-16,7,9,-97
13,20,0,9,-7,-16,11,4,34
-27,-36,-58,-25,-79,-69,-56,30,-320
9,36,-31,-24,-33,-20,19,67,23
11,24,-8,-40,-46,-74,-28,50,-111
8,14,-13,-46,-48,-68,-17,41,-129
19,8,-34,-18,-21,-41,1,16,-70
25,88,-65,-47,-84,-67,6,83,-61
18,78,-40,-43,-94,-77,9,73,-76
7,30,-22,-11,-24,3,15,41,39
0,16,-15,-23,-20,-16,-7,28,-37
-1,7,-16,-20,-35,-7,12,31,-29
16,14,-12,-28,-16,-30,8,27,-21
11,11,-19,-16,-11,-31,-6,39,-22
35,-1,-24,-3,-77,-81,-11,19,-143
8,19,-18,-25,-33,-7,32,30,6
15,19,-23,0,-23,4,12,45,49
4,9,-26,-27,-30,-24,-3,25,-72
-8,5,2,-9,-2,2,2,13,5
11,20,-25,-18,-32,-23,4,27,-36
-5,16,-26,-24,-21,8,23,32,3
-3,14,-6,-10,-25,-7,-4,33,-8
3,20,-11,-5,-12,-15,-3,13,-10
-1,7,-2,2,-8,-12,3,23,12
9,7,-5,-20,-21,-24,-11,16,-49
4,9,-7,-7,-17,-10,-7,23,-12
-1,31,16,-16,-13,-6,12,51,74
12,26,-13,-9,-5,-11,2,40,42
4,11,-8,-7,-31,-1,10,36,14
-4,5,-23,-14,-25,-31,-1,42,-51
17,22,0,8,5,3,11,-1,65
-6,4,-30,-30,-45,-22,-18,8,-139
24,52,-26,-55,-78,-93,-13,36,-153
-20,-17,-45,-36,-54,-38,-15,33,-192
27,6,-50,-31,-37,-37,20,39,-63
-20,2,-25,-41,-28,-22,-23,43,-114
20,-3,-31,-23,-64,-46,-10,32,-125
-3,29,-56,-37,-100,-81,-23,90,-181
-5,21,-11,5,-31,-50,-7,43,-35
57,99,-23,-9,-57,-93,-9,112,77
-11,45,18,13,-18,18,19,27,111
94,121,-20,-31,-64,-24,64,167,307
92,124,-28,-33,-68,-24,68,165,296
90,118,-24,-46,-62,-21,65,152,272
3,8,-9,-20,-23,-20,-3,21,-43
-7,7,-27,-53,-37,-14,8,40,-83
0,17,9,-34,-32,-63,-38,46,-95
-5,10,-43,-32,-97,-58,-6,63,-168
12,9,-35,-39,-52,-33,4,3,-131
28,19,-43,-14,-25,-31,23,41,-2
17,64,-22,-21,-32,-5,36,60,97
16,10,-29,-20,-18,-43,3,12,-69
-3,10,-13,-16,-34,-7,5,22,-36
7,21,-25,-3,-28,-8,21,28,13
8,6,-34,-10,-65,-31,-5,30,-101
7,-6,-35,-29,-38,-29,10,43,-77
8,9,-29,-7,-45,-2,9,41,-16
10,20,-23,-16,-46,-29,8,18,-58
10,7,13,-23,0,-21,-16,26,-4
13,26,-14,-23,-12,-12,6,41,25
-3,4,-17,-17,-4,-3,11,31,2
24,27,-24,-1,-16,-17,5,17,15
19,6,-27,-27,-24,-9,22,25,-15
2,17,0,-13,-11,1,4,15,15
14,12,-13,0,-2,11,25,22,69
37,16,-2,-8,-102,-68,-18,66,-79
0,0,-4,-4,-17,-23,-14,8,-54
12,-11,-21,-7,-30,-24,-1,23,-59
25,29,13,-8,-103,-63,-1,63,-45
8,10,-17,-4,-33,-13,1,15,-33
6,6,-3,-13,6,6,10,15,33
10,5,-24,-22,-25,-11,14,22,-31
15,38,-35,-22,-25,-51,-10,51,-39
15,3,-14,-11,-22,-11,20,54,34
-11,18,-14,-22,-38,-7,12,31,-31
6,25,-25,-23,-55,19,43,79,69
-3,11,-7,-3,-20,-2,-4,35,7
2,14,-8,-10,-10,-7,3,19,3
9,19,4,0,12,12,18,11,85
-23,2,-11,-16,-13,-43,-15,16,-103
-22,1,-29,-33,-55,-77,-24,57,-182
6,18,-26,-13,-17,-11,4,15,-24
7,12,-16,-15,-19,-18,-2,13,-38
33,9,-18,-28,-9,-38,-2,42,-11
69,101,56,-6,-10,35,37,108,390
1,4,-30,-32,-35,-33,-7,15,-117
39,64,-119,-117,-213,-276,-43,203,-462
20,3,-22,-10,-40,-29,-9,21,-66
29,-12,-26,-41,-81,-76,-9,52,-164
21,-1,-69,-35,-95,-80,-29,20,-268
22,16,-20,-28,-23,-29,13,25,-24
30,9,-37,12,-71,-75,-7,19,-120
-2,13,-9,-15,-37,-5,21,37,3
-2,13,-14,-12,-40,-14,18,33,-18
2,18,-12,-11,-38,-6,22,35,10
-4,10,-12,-11,-35,-6,26,38,6
-4,11,-18,-14,-38,-11,17,35,-22
4,17,-13,-10,-38,-6,25,40,19
5,14,-12,-13,-37,-7,24,38,12
84,124,-26,-43,-72,-19,63,170,281
1,12,-13,-11,-35,-7,26,37,10
82,162,-49,-84,-128,-74,101,291,301
1,15,-11,-12,-36,-9,25,38,11
89,121,-31,-39,-73,-25,66,165,273
0,14,-9,-9,-38,-6,23,36,11
39,20,-137,-117,-192,-182,-20,181,-408
32,22,-144,-109,-203,-179,-20,180,-421
19,69,-179,-212,-261,-275,-28,309,-558
34,10,-145,-103,-199,-188,-15,178,-428
90,124,-26,-31,-73,-20,67,167,298
25,17,5,-11,-8,-23,6,53,64
26,15,-31,-60,-72,-85,7,97,-103
16,68,24,-18,-10,16,35,56,187
3,28,-7,2,-12,-5,7,17,33
3,-8,-20,-8,-19,-16,-5,9,-64
-3,-3,-22,-7,-34,-20,-6,24,-71
12,20,-11,-4,2,-9,5,19,34
21,-3,-25,-27,-13,-38,-12,25,-72
0,21,-10,-5,-3,-8,9,0,4
10,2,-14,-3,-13,-11,3,7,-19
16,17,-6,8,-14,-14,8,26,41
8,-1,-18,-12,-27,-7,10,17,-30
2,25,-25,-9,-23,-18,6,23,-19
6,33,-36,-17,-87,-64,-8,60,-113
-2,8,-56,-63,-93,-92,-13,91,-220
-6,17,-55,-36,-95,-59,-4,58,-180
-8,12,-46,-35,-97,-59,-6,60,-179
9,10,-6,-8,-28,-7,7,22,-1
17,12,-12,-12,13,-11,2,36,45
12,14,-4,5,3,3,10,1,44
25,15,-20,-20,-26,-42,-8,6,-70
-4,25,15,-32,-32,-59,-30,52,-65
103,77,44,14,13,40,85,119,495
-21,-1,-24,-44,-22,-26,-21,40,-119
1,17,-11,-22,-16,-56,-8,35,-60
45,59,-24,30,-72,-58,3,8,-9
-7,8,-46,-39,-98,-59,-11,60,-192
25,8,-14,-17,8,-8,15,19,36
30,41,-81,-58,-110,-23,40,100,-61
1,14,-6,-6,-12,-6,7,33,25
-8,8,-45,-38,-97,-55,-9,58,-186
1,5,-40,-36,-86,-75,-12,87,-156
8,0,-41,-40,-85,-81,-11,84,-166
39,19,6,-10,-84,-74,-2,119,13
18,-8,-38,-59,-55,-90,-21,64,-189
9,7,-16,-2,-36,-47,-10,45,-50
9,21,-28,-15,-34,-11,9,23,-26
35,47,-12,-16,-46,-41,9,81,57
-1,5,-30,-14,-25,-51,-10,28,-98
-3,1,-1,-3,-3,-3,-1,3,-10
-5,154,-141,-127,-254,-168,-23,326,-238
-11,6,-28,-15,-26,-38,-11,28,-95
-10,8,-27,-15,-25,-38,-9,27,-89
13,-4,-34,-5,-29,-60,-16,24,-111
34,56,-57,-37,-78,-54,0,102,-34
293,358,-24,-45,-16,-186,74,402,856
125,141,-3,-51,64,-68,38,185,431
101,183,-121,-30,-108,-200,28,142,-5
15,34,-12,-41,-31,-10,7,53,15
41,48,-24,-8,-72,-89,5,58,-41
66,75,-53,-31,-109,-71,31,149,57
68,131,22,-15,-80,-50,21,243,340
-8,7,-52,-84,-50,-150,-38,71,-304
5,6,-37,-28,-64,-36,1,41,-112
227,302,85,-53,88,-41,119,184,911
10,44,-41,-48,-121,-143,-35,118,-216
-13,23,-44,-66,-68,-98,-40,124,-182
83,91,56,42,-3,-18,19,130,400
81,150,-44,-15,-65,-208,-16,200,83
24,64,-46,-29,-53,-57,10,59,-28
-5,12,-64,-44,-64,-59,-10,57,-177
93,130,-114,-119,-122,-62,126,247,179
-1,17,-44,-42,-73,-115,-21,89,-190
33,46,-64,-76,-177,-117,-14,157,-212
47,30,-38,-33,-49,-86,-9,99,-39
69,38,99,-39,-79,-234,-70,355,139
15,51,35,57,-17,-7,1,48,183
78,130,-53,-70,-74,-129,24,175,81
-69,105,-174,-233,-378,-591,-174,494,-1020
257,285,-52,71,-183,-95,146,428,857
72,53,-31,36,-88,-52,37,75,102
12,51,-29,-48,-23,-61,16,68,-14
-23,3,-54,-12,-82,-41,-22,34,-197
18,12,-108,-35,-195,-151,-24,74,-409
24,39,-10,18,-35,-77,-19,62,2
-20,14,-69,-2,-130,-133,-63,124,-279
-53,-4,-86,-22,-122,-112,-65,54,-410
-55,-10,-72,-35,-76,-103,-63,55,-359
13,78,-27,-1,-181,-59,-23,81,-119
35,94,-29,3,-208,-61,-11,109,-68
-3,82,-28,-37,-80,-180,-33,94,-185
-4,33,-51,-44,-88,-151,-19,69,-255
35,24,-12,-5,-58,-36,6,66,20
9,41,-52,5,-98,-68,-5,83,-85
136,97,67,82,19,-31,19,158,547
81,88,-21,4,-61,-75,55,108,179
118,83,-36,73,-115,-108,32,116,163
145,94,-11,48,-46,-94,32,136,304
127,98,-13,40,-51,-119,40,145,267
1,25,-18,-14,-32,-57,-1,35,-61
55,99,-31,-7,-59,-26,42,114,187
191,193,-32,31,-76,-119,50,296,534
112,99,-7,38,-44,-68,47,143,320
82,180,108,4,-68,58,-93,264,535
-39,25,-63,-62,-83,-106,-27,72,-283
64,248,61,-144,-494,-435,-124,906,82
188,362,23,-67,-15,-163,97,384,809
169,369,-442,-336,-714,-1229,-250,721,-1712
113,115,-39,-102,-70,-116,-19,184,66
10,14,-20,-1,-48,-38,1,26,-56
-4,74,-17,-23,-59,-61,-1,91,0
3,36,-11,-26,-70,-59,-22,93,-56
-13,24,-15,-9,-29,-33,-2,50,-27
68,79,6,4,-28,-60,-1,80,148
24,28,-9,-18,-71,-46,27,72,7
-3,51,-21,-58,-34,-79,-26,109,-61
-3,3,-12,-5,-20,-25,-21,21,-62
681,918,-85,-93,-1,-297,360,698,2181
9,35,-7,-11,-31,-56,-15,48,-28
31,9,-87,-62,-126,-179,-28,129,-313
117,114,6,-22,-83,-110,31,261,314
-1,44,-1,-25,-36,-40,4,69,14
40,78,56,-1,68,15,15,63,334
6,7,-18,-11,-11,-14,5,15,-21
3,11,-20,-3,-8,-14,6,15,-10
-10,83,-32,-28,-139,-183,-63,226,-146
-1,40,-18,-2,-23,-25,8,31,10
7,3,-20,-22,-20,-38,-5,51,-44
139,256,-31,-68,-24,-171,62,332,495
4,59,-17,-40,-38,-49,23,79,21
-4,21,-10,-1,-27,8,0,-2,-15
-8,23,-6,-7,-30,9,1,-4,-22
36,90,-58,-33,-5,-128,-18,36,-80
6,43,-39,-37,-78,-132,-7,84,-160
9,92,27,-17,-8,-15,-35,76,129
13,34,-12,-25,-58,-90,4,123,-11
1,-2,-18,-11,-8,-23,-14,27,-48
130,67,-70,65,-56,-6,106,40,276
5,11,-11,-1,-25,-5,-4,42,12
88,120,-17,-35,-89,-116,-22,200,129
-1,20,0,4,-8,-7,6,24,38
95,110,-39,-15,-131,-182,-47,130,-79
9,23,0,3,0,-17,4,25,47
60,186,39,-78,-21,-108,-6,227,299
-9,13,4,-6,0,1,-5,15,13
23,22,-14,9,-18,-24,4,33,35
86,74,111,69,22,9,17,149,537
189,350,-101,5,-251,-180,46,252,310
-120,-46,-146,-82,-169,-138,-67,88,-680
33,210,78,2,-169,-89,-163,374,276
9,30,-36,-38,-50,-75,13,55,-92
-4,17,-28,-21,-11,-8,16,35,-4
-3,18,-26,-14,-41,-51,11,47,-59
61,72,-35,-22,-38,-70,36,73,77
22,66,-37,-33,-55,-46,20,116,53
10,30,-3,-8,-13,-8,22,31,61
5,-1,-29,-1,-65,-5,28,50,-18
25,25,-31,-33,-33,-57,21,39,-44
-1,-3,-17,-17,-16,-6,4,12,-44
28,26,-20,-32,-24,-53,27,20,-28
7,8,-20,-4,-26,-27,-3,12,-53
0,46,-37,-34,-61,-72,26,58,-74
69,129,-54,9,3,27,97,59,339
33,65,-25,-2,-33,-20,44,54,116
7,6,-12,-22,-12,-34,-3,21,-49
91,292,1,-68,-153,-77,71,413,570
7,68,1,-35,-95,-55,-25,122,-12
28,70,-23,-37,-91,-60,12,128,27
36,76,-64,6,-83,-84,12,122,21
80,104,23,-15,-16,-22,25,116,295
62,63,-129,-46,-184,-276,-67,123,-454
28,28,-35,-2,-43,-8,44,43,55
-2,32,-7,3,-9,-21,4,19,19
-7,-12,-22,-29,-25,-41,-4,19,-121
8,22,-11,-10,0,14,20,25,68
31,56,-17,-6,-9,-21,25,23,82
34,58,14,-41,-10,-74,4,109,94
16,19,-21,-14,-20,-45,-1,16,-50
-1,1,-34,-29,-43,-44,-20,31,-139
-10,14,-32,-29,-38,-42,-21,28,-130
7,5,-15,-19,-18,-29,-7,16,-60
3,0,-37,-31,-56,-43,4,14,-146
30,45,-27,-13,-35,-15,29,47,61
31,29,-2,9,2,11,23,17,120
39,64,15,-27,8,1,28,54,182
59,67,-27,21,9,-28,31,56,188
12,19,-27,-11,-34,-6,11,24,-12
2,-4,-3,-2,-3,-8,-1,2,-17
181,215,105,102,-45,-59,64,293,856
175,264,56,-44,84,-49,133,245,864
121,121,-63,21,-157,-74,82,275,326
8,76,-43,-67,-25,-133,-30,101,-113
47,88,14,-15,-48,-68,7,113,138
-21,3,-27,-25,-32,-39,-8,42,-107
22,32,10,12,2,0,2,41,121
58,84,-84,-87,-185,-236,-8,250,-208
42,74,20,-14,24,23,41,74,284
42,74,20,-14,24,23,41,74,284
42,74,20,-14,24,23,41,74,284
42,74,20,-14,24,23,41,74,284
42,74,20,-14,24,23,41,74,284
15,16,-58,-39,-64,-124,-18,85,-187
15,16,-58,-39,-64,-124,-18,85,-187
90,124,-29,-26,-73,-34,61,168,281
3,2,-28,4,-44,-36,-38,52,-85
59,69,-25,-43,-190,-181,-95,294,-112
71,95,-8,6,-77,-117,33,139,142
236,222,13,22,-4,-53,72,263,771
564,1595,-453,-317,-314,31,-528,1550,2128
66,221,-10,-12,-168,-85,51,261,324
42,68,26,-25,-8,-86,-14,130,133
77,129,-35,-80,-142,-66,-39,162,6
238,841,202,-121,-630,-166,155,1394,1913
279,528,-206,-76,-1075,-958,-80,1279,-309
332,288,-31,-439,-487,-398,-319,855,-199
112,199,29,67,-1,-110,42,263,601
107,205,28,64,-2,-99,36,272,611
42,4,-53,-44,-81,-85,-1,77,-141
134,225,-59,-47,-148,-188,26,253,196
6,31,-32,-22,-62,-43,-1,81,-42
7,11,-27,-16,-42,-37,0,63,-41
128,253,30,-67,-2,-129,40,312,565
192,207,4,52,-119,-98,85,233,556
104,141,-3,-9,-7,-72,37,187,378
16,24,40,25,-30,23,5,55,158
44,120,-24,-39,7,-53,39,113,207
-11,14,-54,-85,-58,-148,-37,71,-308
-24,71,-159,-104,-278,-165,-13,206,-466
-66,-10,-165,-175,-239,-291,-142,201,-887
-21,11,-173,-111,-274,-332,-99,225,-774
9,13,-19,-3,-7,7,7,20,27
27,6,-37,-76,-65,-89,-1,99,-136
32,44,-58,-26,-74,-62,19,107,-18
67,76,34,7,-4,-17,36,122,321
14,57,-36,-17,-40,-33,24,31,0
3,7,-33,-27,-27,-46,-9,17,-115
6,30,-33,-46,-112,-58,-16,69,-160
-1,17,-62,-18,-69,-77,-15,65,-160
32,130,-206,-198,-307,-144,68,252,-373
34,8,-38,-30,-84,-60,18,47,-105
56,24,5,13,-20,-19,26,51,136
-5,29,-25,-34,-33,-79,-7,52,-102
-24,26,-32,-51,-34,-84,-28,58,-169
8,36,-37,-60,-46,-89,-18,56,-150
23,21,-16,-30,-8,-95,-17,32,-90
16,77,-22,-52,-55,-111,-4,104,-47
33,118,10,-33,-24,-94,17,152,179
28,50,0,29,-64,-12,31,107,169
97,115,48,70,39,-24,29,148,522
-26,32,-53,-33,-132,-193,-67,80,-392
-2,37,-3,-17,-8,-16,-2,38,27
94,-36,-242,-124,-410,-497,-96,262,-1049
103,144,-12,-35,-36,-147,8,159,184
80,187,-6,-12,-126,-166,-12,215,160
30,41,-45,-10,-24,-14,12,52,42
101,173,-139,-62,-157,-242,66,217,-43
-6,-3,-41,-14,-33,-53,-24,20,-154
-11,15,-32,-35,-72,-45,5,86,-89
118,156,7,75,-80,15,91,248,630
82,83,-200,-170,-210,-129,72,210,-262
-8,14,-34,-62,-73,-69,-38,91,-179
7,18,-33,-39,-78,-67,-21,95,-118
-11,32,-26,-36,-83,-62,-40,91,-135
-21,59,-90,-83,-159,-242,-76,150,-462
40,80,-13,-42,-93,-129,-8,131,-34
64,211,-229,-218,-368,-466,-76,558,-524
56,82,6,-12,-12,-45,40,115,230
62,129,-22,-34,-72,-47,29,151,196
20,22,11,-3,4,-11,2,32,77
50,82,-50,-35,-108,-107,8,95,-65
16,20,2,0,-4,-13,1,15,37
41,39,-71,-62,-115,-154,-20,111,-231
27,39,7,-23,-19,-5,24,74,124
320,298,-317,-161,-578,-634,-70,264,-878
31,28,-1,3,-52,-5,34,81,119
59,114,-16,-19,-30,-99,-2,126,133
103,82,-4,28,-41,-70,79,139,316
43,69,-19,-26,6,-45,28,69,125
-14,85,-4,-18,-48,-105,-9,133,20
-192,-86,-311,-272,-341,-504,-235,304,-1637
65,112,37,-20,2,24,53,89,362
9,38,-7,-14,4,-39,-4,47,34
87,120,-41,-11,-133,-19,87,241,331
101,76,41,-13,-40,-55,23,169,302
69,132,37,-34,-33,-55,23,163,302
-15,-1,-54,-65,-95,-92,-47,93,-276
-30,21,-38,-26,-62,-52,-22,67,-142
-1,45,-46,-23,-128,-111,-4,93,-175
74,44,-24,-76,-47,-205,-11,131,-114
77,113,-76,-74,-87,-232,19,162,-98
25,12,-25,-9,-32,-36,15,25,-25
-33,-11,-20,-11,-49,-56,-51,46,-185
45,-7,-34,-14,-67,-73,-5,61,-94
-1,19,-26,-15,-26,-17,-8,-2,-76
536,972,-394,-314,-559,-572,350,1040,1059
66,80,-53,-39,-102,-56,13,115,24
3,10,-5,8,-37,-11,-2,29,-5
12,6,-14,4,-34,-23,-12,20,-41
34,21,-32,-22,-63,-79,21,70,-50
248,339,13,41,-70,-78,110,409,1012
99,54,24,-16,-34,-81,-6,123,163
47,152,71,166,-195,8,-12,226,463
58,38,-50,-13,-125,-126,-38,95,-161
-12,-17,-26,-26,-36,-41,-29,38,-149
-12,-15,-25,-19,-36,-37,-27,39,-132
14,-3,-86,-68,-129,-109,-42,120,-303
-89,-30,-112,-53,-154,-185,-61,113,-571
41,28,-29,4,-63,-50,12,51,-6
40,98,-39,-62,-49,-45,26,89,58
41,102,-236,-293,-351,-486,-157,533,-847
-67,-53,-63,-79,-92,-100,-77,65,-466
-60,-31,-65,-39,-121,-142,-76,68,-466
-14,-13,-50,-65,-89,-119,-26,121,-255
126,97,-94,-63,-101,-192,59,169,1
238,268,38,-45,-42,-64,138,350,881
18,29,-71,-7,-237,-115,-22,157,-248
14,103,-216,-155,-302,-189,-30,228,-547
129,149,-55,-54,-86,-175,44,237,189
132,216,-100,-56,-113,-85,124,242,360
162,193,209,197,19,149,34,247,1210
73,120,-47,-6,-69,-109,-2,94,54
58,51,-16,65,-107,-75,34,143,153
14,72,17,17,-29,-30,9,113,183
59,39,-12,1,-17,-68,9,63,74
130,208,-16,-102,-81,-134,59,333,397
246,648,811,310,434,531,124,901,4005
-90,-33,-118,-44,-182,-195,-103,110,-655
42,102,-63,-103,-93,-198,3,210,-100
151,239,-88,-64,-159,-246,23,274,130
90,140,-8,-49,-67,-108,0,297,295
102,102,0,-27,-88,-132,11,239,207
17,39,-23,3,-31,-24,11,28,20
115,252,-52,-40,-30,-23,89,156,467
37,20,-25,7,-32,-44,11,18,-8
130,170,53,-7,-7,-37,19,208,529
84,112,57,-7,39,-24,16,127,404
10,14,-33,-42,-84,-89,-27,80,-171
117,111,-69,-25,-124,-23,74,251,312
-65,-27,-92,-17,-118,-124,-63,87,-419
4,74,-88,-78,-91,-132,-1,152,-160
8,51,-23,-19,-92,-81,-12,82,-86
-27,46,-66,-103,-94,-128,-66,136,-302
35,90,-52,-91,-66,-119,5,121,-77
-66,-8,-78,-25,-125,-156,-86,99,-445
78,43,-87,-118,-166,-232,-22,218,-286
2,18,6,0,4,-24,-10,27,23
-5,21,-25,-15,-40,-41,-18,32,-91
321,691,-326,-87,-535,-562,-94,473,-119
117,188,-57,-75,-125,-79,73,251,293
94,64,-32,-59,-190,-130,47,276,70
38,30,-71,-16,-140,-78,-1,126,-112
129,199,-8,-22,-66,-8,73,248,545
32,31,-48,-20,-78,-151,-3,104,-133
6,20,-10,3,-7,-14,0,22,20
-8,27,-37,-38,-74,-69,2,56,-141
16,31,-4,-13,-14,-33,-9,46,20
100,197,22,25,-22,41,94,239,696
0,144,-15,-3,0,14,95,178,413
426,1009,825,230,209,576,281,1224,4780
134,120,-70,-49,-170,-109,54,209,119
47,133,-25,-89,-223,-74,-31,329,67
144,219,-83,34,-219,10,95,342,542
119,166,-26,41,-232,-18,63,321,434
36,114,-55,-94,-190,-97,-37,222,-101
448,973,-682,-617,-478,-453,-448,981,-276
8,84,-20,-43,-49,-96,10,101,-5
1,15,4,-14,-10,-27,-4,31,-4
82,74,-79,45,-51,12,83,73,239
13,7,-12,-26,-11,-9,24,37,23
56,88,28,-19,-58,12,30,127,264
31,70,-20,-36,-53,-23,38,88,95
5,24,10,3,-9,-12,-12,35,44
14,21,-23,-12,-34,-29,-9,30,-42
116,116,-8,-24,-45,-89,32,170,268
-48,-12,-58,-60,-86,-138,-45,96,-351
-7,11,-55,-38,-79,-99,-34,88,-213
7,14,-19,2,-10,-18,14,37,27
11,51,-40,-24,-55,-70,1,102,-24
38,89,-93,-136,-197,-185,-3,234,-253
143,230,7,-44,-26,-147,55,261,479
45,52,-62,2,-83,-85,23,98,-10
14,32,-51,-63,-86,-179,-70,152,-251
-956,569,-1142,-1004,-375,-270,-820,354,-3644
49,98,-46,-38,-42,-140,26,45,-48
79,102,-30,8,-60,-67,35,89,156
53,141,-81,-82,-243,-290,-26,216,-312
10,73,-62,-37,-16,1,41,66,76
254,213,-244,-123,-223,-239,38,366,42
-26,35,-32,-55,-50,-159,-47,115,-219
116,165,50,-18,48,-42,47,203,569
357,526,-232,25,-344,-86,333,506,1085
72,70,30,-27,-78,-1,25,124,215
-20,-2,-66,-14,-82,-77,-19,57,-223
-8,18,-7,-28,-45,10,-6,73,7
908,1356,-871,-423,-1533,-1883,-280,1432,-1294
-5,-4,-28,-34,-24,-74,-20,13,-176
49,57,11,-8,16,-42,25,79,187
44,59,60,116,-44,-43,4,149,345
21,59,-36,-1,-124,-23,50,109,55
177,219,-21,-27,26,-40,75,207,616
220,262,-15,-53,4,-164,133,388,775
32,25,-60,-64,-59,-81,-2,57,-152
-19,-27,-45,-40,-56,-49,-9,17,-228
33,16,-42,-46,-65,-93,8,60,-129
883,1349,-52,-170,-184,-203,459,1522,3604
22,82,-74,-84,-91,-157,29,252,-21
67,66,-103,-5,-173,-199,-15,79,-283
8,50,-53,-4,-82,-92,-11,91,-93
187,265,-47,-78,-72,-61,96,306,596
89,168,-22,8,-139,-119,46,109,140
11,2,-17,-18,-27,-28,-6,33,-50
-10,58,-24,4,-54,-120,-52,72,-126
8,26,14,-1,15,-5,4,35,96
-8,76,30,-2,-13,-35,-36,71,83
-3,50,-6,-8,-111,-105,-15,105,-93
-11,20,-84,-49,-135,-147,-48,123,-331
162,275,-123,-59,-212,-180,102,368,333
-19,107,-56,-25,-191,-211,-47,213,-229
2,110,-52,-28,-156,-218,-58,157,-243
-2,30,-9,-32,-18,-10,-4,81,36
114,246,314,131,141,222,75,354,1597
159,151,-130,-77,-128,-240,-21,248,-38
-22,35,-44,-17,-96,-124,-30,134,-164
94,50,-10,118,-150,-90,86,167,265
-19,76,-117,-53,-4,13,53,89,38
-22,51,-82,-32,6,5,28,77,31
92,111,-51,-45,-91,-119,3,165,65
4,58,-122,-44,-20,2,13,65,-44
-13,98,-104,-59,-30,-3,52,81,22
79,131,-29,0,-3,-63,87,147,349
116,209,186,30,71,83,71,219,985
103,107,-10,-78,-18,-65,47,174,260
49,95,-33,-6,-57,-33,46,42,103
20,-21,-20,-33,-101,-178,-37,127,-243
50,4,-28,-61,-99,-147,-41,156,-166
263,382,-17,-67,-147,-181,127,416,776
-7,106,-290,-216,-497,-247,-60,379,-832
-82,31,-126,-98,-232,-283,-106,178,-718
50,59,-16,17,-137,-102,-34,55,-108
266,473,237,12,-255,-72,-75,567,1153
133,126,-5,-37,-73,-102,50,216,308
98,181,-30,-29,-115,-116,36,223,248
141,135,-27,-33,-95,-98,51,207,281
145,149,-10,-29,-85,-73,69,230,396
22,23,-9,6,-25,-43,30,81,85
45,15,-10,-14,1,-49,18,91,97
22,92,24,7,-64,-70,-15,145,141
22,35,-68,-89,-25,-126,-4,115,-140
15,24,-19,-6,-10,-39,1,17,-17
4,43,-29,-56,-63,-94,-28,115,-108
20,5,-33,-27,-53,-80,-3,66,-105
6,2,-10,-29,-23,-20,-4,39,-39
-31,15,-61,-65,-110,-144,-58,106,-348
116,111,18,-38,-50,-72,28,207,320
23,36,-27,-23,-29,-10,-17,50,3
71,251,14,-113,-153,-252,-5,390,203
25,10,-28,3,-67,-80,-17,31,-123
-30,-16,-40,-35,-44,-50,-31,23,-223
22,17,-35,-47,-110,-75,-13,83,-158
46,48,-6,-11,-15,-34,21,35,84
65,102,-60,-5,-59,-98,9,86,40
54,44,-102,-74,-143,-225,-49,148,-347
79,111,-44,-92,-111,-137,7,190,3
29,66,-16,-11,-44,-42,9,49,40
144,150,-37,-104,-49,-86,26,184,228
140,159,10,-11,7,-92,82,184,479
8,16,-7,-16,-23,-23,6,36,-3
8,-10,-73,-12,-128,-154,-9,75,-303
96,124,-62,-90,-168,-219,-3,202,-120
141,228,-77,2,-170,-230,46,302,242
-47,203,-262,-68,-7,15,101,141,76
17,64,-37,-88,-50,-115,-20,104,-125
37,124,-48,-16,-83,-106,23,153,84
47,203,-51,-41,-20,-11,114,156,397
58,61,-88,-65,-199,-175,-17,202,-223
11,39,-62,-54,-113,-4,50,114,-19
6,31,-91,-73,-71,-108,-33,122,-217
138,267,-146,1,-108,32,200,98,482
99,262,-23,-143,-248,-88,43,525,427
44,95,-91,-65,-109,-173,-29,119,-209
-28,23,-69,-85,-82,-112,-52,87,-318
15,38,-26,-29,-80,-75,-2,62,-97
98,71,-2,46,-39,-52,56,124,302
15,100,-26,-36,-94,-132,-16,162,-27
-48,6,-90,-8,-159,-145,-50,108,-386
28,68,15,-4,14,11,16,64,212
46,92,-37,-74,-102,-135,11,200,1
61,72,-53,-32,-74,-83,31,155,77
5,14,1,2,-9,2,13,22,50
-24,89,-184,-229,-455,-254,-38,375,-720
1,53,-64,-84,-44,-123,-17,132,-146
50,54,-16,-51,-50,-95,-15,137,14
84,139,-32,-6,-72,-150,-10,112,65
53,152,-76,-60,-124,-297,-62,250,-164
72,33,-121,-117,-170,-170,-23,212,-284
-19,20,-20,3,-45,-34,-17,47,-65
38,61,-55,-60,-89,-63,1,110,-57
-9,7,-48,-21,-105,-65,-12,82,-171
2,41,4,12,-25,-28,8,57,71
34,53,-75,-58,-82,-93,34,132,-55
122,186,-59,-95,-150,-247,-1,292,48
-9,43,-82,-61,-131,-72,10,110,-192
9,26,-87,-97,-165,-129,-56,130,-369
16,30,13,-7,-4,-1,16,35,98
12,60,-42,-50,-85,-60,22,83,-60
-32,72,-135,-108,-276,-198,-23,286,-414
9,32,-33,-18,-19,-38,3,34,-30
39,63,-28,-27,-75,-50,18,119,59
96,155,63,1,-18,-50,-3,179,423
17,83,28,19,-29,-40,10,109,197
67,130,-53,-24,-151,-153,34,214,64
-29,-7,-32,-28,-34,-59,-27,48,-168
128,115,6,-49,-47,-111,9,132,183
46,63,-100,-91,-105,-154,16,148,-177
-52,61,-98,-85,-165,-203,-52,162,-432
6,17,-23,-16,-8,-72,6,47,-43
15,28,-53,-35,-118,-90,-16,77,-192
40,38,-57,-17,-135,-58,21,106,-62
13,88,68,31,-30,5,4,112,291
25,5,-65,-18,-117,-76,18,34,-194
-2,38,-5,15,-39,-48,-11,50,-2
77,92,17,-15,-58,-56,18,153,228
19,110,-94,-45,10,-44,30,204,190
12,110,-98,-48,27,-30,14,178,165
77,91,-16,-24,-84,-44,33,191,224
55,29,52,-22,-11,-120,-52,110,41
10,12,-26,-31,-29,-29,6,27,-60
60,74,21,-22,30,-45,26,118,262
114,102,27,105,-91,-18,49,204,492
1,31,-45,-68,-72,-140,-32,116,-209
34,83,-2,-34,1,-111,-12,136,95
9,67,7,-1,1,7,-10,69,149
19,42,-13,-41,-16,-6,25,48,58
23,57,-8,-16,-24,-44,-13,75,50
126,179,-27,31,-139,-113,22,140,219
58,41,-96,-91,-172,-243,-72,210,-365
229,651,640,217,308,479,199,809,3532
11,16,-22,-15,-34,-21,-5,54,-16
404,434,-30,-152,-63,-175,171,535,1124
559,1295,-313,-47,-270,218,402,157,2001
1,40,-18,-6,-15,9,12,32,55
-58,-11,-43,-37,-51,-90,-58,28,-320
113,119,-28,-50,-87,-203,-15,189,38
54,81,24,-3,21,-65,-10,108,210
9,28,-29,-18,-52,-46,0,73,-35
8,-7,8,6,-21,-18,-28,19,-33
-13,-16,-26,-22,-21,-19,-18,10,-125
111,116,-124,13,-179,-167,32,142,-56
-24,69,36,6,-54,43,-22,31,85
-2,9,1,1,-16,-18,0,15,-10
82,116,16,-8,-7,-15,35,127,346
68,81,43,72,-28,2,21,145,404
-15,-5,-37,-25,-88,-40,-24,33,-201
-5,2,-22,-9,-44,-54,-22,-3,-157
21,4,-20,1,-63,-59,-12,51,-77
24,50,-32,-25,-68,-57,-1,87,-22
54,44,-38,-81,-71,-171,-81,141,-203
95,131,-267,-247,-439,-540,-25,443,-849
76,72,-59,6,-105,-128,-12,78,-72
24,52,-51,-23,-88,-93,-14,103,-90
132,208,-65,-199,-97,-266,10,358,81
98,166,-24,-205,-63,-313,-35,340,-36
168,236,64,-89,51,-170,21,285,566
342,473,43,-314,-447,-335,-245,843,360
29,48,28,-5,-23,26,25,65,193
34,35,-54,-51,-26,-146,-42,83,-167
33,45,-40,-34,-63,-131,-2,96,-96
93,54,-118,-46,-229,-240,-42,110,-418
121,216,-8,-60,13,-105,111,266,554
32,29,-26,2,-30,-45,2,36,0
25,48,-15,6,-36,-65,-5,45,3
164,294,40,-1,-27,92,138,259,959
141,177,-93,-97,-202,-174,39,301,92
58,48,-26,-19,-148,-97,18,208,42
39,21,-33,-49,-89,-125,-32,96,-172
44,80,-39,-69,-234,-163,-25,312,-94
-14,21,-44,-16,-111,-34,-8,73,-133
173,140,-44,-45,-81,-99,65,208,317
8,7,-47,-37,-43,-88,-28,74,-154
99,122,31,-53,-81,-172,-11,204,139
-55,24,-116,-35,-212,-143,-66,161,-442
341,496,-108,92,-232,-304,90,360,735
155,263,-80,15,-196,-222,53,196,184
51,43,-47,-13,-97,-182,-37,115,-167
138,66,80,18,-48,-36,46,165,429
7,70,-70,-43,-170,-132,10,166,-162
17,15,-2,-5,-71,-84,-18,111,-37
-76,-27,-159,-129,-279,-296,-141,205,-902
-13,11,-53,-70,-40,-155,-42,65,-297
92,128,-7,-23,-82,-209,-3,185,81
73,150,-9,-37,0,-42,49,137,321
140,159,-19,-63,-64,-203,33,253,236
28,112,-54,-77,-142,-119,-23,215,-60
12,28,-35,-15,-30,-70,-4,44,-70
65,65,-7,-10,-29,-65,-10,79,88
-7,9,4,-11,-7,-26,5,33,0
26,55,16,-16,-15,-19,6,74,127
-57,-8,-90,-55,-104,-77,-57,69,-379
32,28,-43,-21,-61,-44,15,81,-13
-64,75,-134,-106,-271,-299,-82,264,-617
26,3,-20,-5,-46,-53,-26,68,-53
29,43,-75,-68,-93,-130,-2,102,-194
67,133,-79,-66,-65,-72,65,185,168
80,139,-94,-129,-161,-169,46,293,5
234,372,-138,-102,-131,-249,113,375,474
75,188,-65,-57,-104,-113,70,198,192
9,67,-93,-84,-162,-208,-31,207,-295
79,150,7,40,3,-45,37,108,379
31,107,-37,-64,4,-61,73,144,197
14,-3,-14,13,-38,-22,-2,21,-31
-9,52,-55,-76,-72,-68,20,105,-103
7,67,-72,-44,-129,-102,-10,117,-166
-83,-39,-86,-69,-124,-122,-90,99,-514
9,64,-42,-42,-84,-139,-25,98,-161
9,82,-70,-67,-139,-262,-127,163,-411
-29,100,-74,-101,-7,7,71,206,173
10,27,5,-22,0,-14,14,16,36
-15,63,-76,-46,-37,-33,22,127,5
4,79,2,-18,-34,-71,-7,94,49
59,121,-59,-72,-46,-127,56,177,109
30,74,-22,-40,-113,-167,-39,132,-145
60,151,61,37,-43,-35,33,213,477
51,38,-31,-38,-60,-92,-2,114,-20
35,62,-115,-119,-98,-264,-78,135,-442
21,37,10,-64,30,-113,-6,93,8
3,46,-85,-71,-96,-154,-34,143,-248
-106,27,-251,-180,-416,-503,-208,346,-1291
-26,-20,-82,-73,-110,-112,-33,113,-343
580,639,248,26,70,-111,268,885,2605
1131,2037,-305,-757,239,824,1444,1370,5983
-8,109,-63,-75,-15,-6,45,170,157
120,172,-75,-95,-135,-198,-3,332,118
82,147,5,39,0,-47,43,108,377
90,108,-9,-3,-92,-114,12,100,92
19,43,-28,-9,-10,7,41,80,143
-53,7,-78,-59,-116,-136,-62,118,-379
68,48,-40,-13,-112,-163,-13,115,-110
26,23,-16,12,-21,-43,14,43,38
4,54,20,-4,-5,18,-4,46,129
-74,2,-80,-56,-78,-116,-56,80,-378
22,79,-140,-86,-200,-293,-96,218,-496
17,80,21,5,-16,1,26,66,200
141,149,-116,-39,-171,-144,29,221,70
-6,13,0,-5,-15,-22,-8,31,-12
6,26,-11,5,-48,-37,-10,45,-24
0,16,-5,-13,13,-33,-6,13,-15
30,31,-15,-13,-31,-39,17,38,18
15,55,-11,-26,-41,-82,-6,115,19
109,153,51,-23,39,-67,27,183,472
28,47,-26,4,-70,-116,-8,99,-42
159,228,-20,-77,-38,-193,53,205,317
-81,-9,-68,-91,-78,-171,-85,173,-410
-1,22,-30,-29,-52,-85,-36,50,-161
24,37,-26,-30,-92,-138,-22,117,-130
3,20,-18,-33,-41,-67,-4,74,-66
11,10,-9,17,-35,-37,0,24,-19
125,162,-28,-43,3,-126,54,152,299
28,26,-59,-54,-83,-144,-39,69,-256
-13,6,-24,-13,-28,-29,-13,26,-88
194,317,-60,145,-249,-44,219,220,742
44,60,10,-7,-5,-45,30,64,151
10,8,-5,0,-8,-8,6,5,8
151,230,59,22,13,-8,72,231,770
22,257,-427,-413,-712,-866,-237,738,-1638
-9,5,-5,-1,-1,-26,-15,8,-44
17,34,-79,-24,-145,-120,-20,121,-216
29,18,-67,-51,-67,-107,-9,57,-197
-33,1,-29,-46,-38,-62,-29,48,-188
230,372,-50,20,-16,-111,174,294,913
280,421,-61,6,-176,-222,55,278,581
9,57,17,14,-16,2,19,77,179
47,111,-93,-36,-109,-66,17,23,-106
43,136,-27,-81,-164,-204,-14,233,-78
2,16,-12,-9,-18,-25,-12,21,-37
81,124,46,39,6,-30,37,141,444
-11,128,-74,-74,9,-22,38,150,144
1,20,-8,-9,-18,-18,-8,32,-8
62,88,-40,-11,-84,-118,10,125,32
2,6,-29,-17,-22,-18,2,26,-50
55,202,-129,-56,-110,-65,122,70,89
-6,26,-31,-57,-58,-45,-14,82,-103
21,-1,-24,-40,-59,-115,-25,90,-153
44,61,2,-12,-86,-85,15,119,58
2,24,-7,-74,-58,-67,-11,121,-70
48,89,-134,-77,-240,-287,-75,197,-479
34,123,-137,-139,-267,-300,-10,301,-395
401,458,271,228,64,32,151,630,2235
74,78,14,12,-27,-45,36,114,256
54,64,-34,-10,-27,-46,49,71,121
46,36,-23,-17,-43,-68,-9,74,-4
18,17,-37,-7,-66,-51,-29,21,-134
11,36,-25,-41,-101,-131,-16,112,-155
44,68,23,-3,25,-10,14,55,216
-27,-20,-51,-32,-80,-76,-19,56,-249
42,-8,2,-31,-30,-121,-17,69,-94
27,21,-11,-33,-30,-95,-15,74,-62
-7,10,-28,-44,-48,-62,-34,62,-151
-15,-6,-47,-24,-65,-93,-42,75,-217
-4,24,-30,-40,-55,-74,-16,77,-118
127,189,-151,-187,-314,-352,25,338,-325
12,15,-61,-34,-67,-78,-15,73,-155
163,363,-90,-128,-222,-176,108,516,534
-13,259,-52,-129,-172,-382,-102,360,-231
36,6,-177,-158,-288,-362,-111,153,-901
8,71,-151,-123,-335,-453,-127,272,-838
-29,189,-24,-144,-143,-275,-103,325,-204
118,207,-69,-14,-240,-243,13,312,84
366,512,59,-64,-36,-160,202,571,1450
215,182,47,68,-32,-74,58,272,736
53,63,-97,-48,-220,-230,-37,142,-374
188,382,-82,-218,-249,-360,76,534,271
44,77,-98,-98,-261,-297,-111,358,-386
14,26,-48,-43,-60,-70,0,64,-117
37,-2,5,-3,-66,-108,-14,71,-80
86,103,5,4,10,-47,38,113,312
100,146,-70,-27,-68,-98,52,178,213
26,34,-32,-22,-24,-40,19,14,-25
108,128,-8,8,-5,-23,68,102,378
26,55,-29,-66,-51,-100,-10,121,-54
473,808,-145,-106,-381,-332,181,844,1342
18,41,6,-5,-97,-31,-1,115,46
75,149,-16,-112,-155,-239,-26,340,16
100,285,55,-70,52,-35,99,301,787
97,301,140,385,-397,-142,5,574,963
39,38,-41,-49,-56,-89,13,81,-64
8,35,-17,-28,-58,-70,-3,57,-76
516,859,-255,-215,-382,-142,276,954,1611
82,68,-14,28,-84,-56,36,156,216
45,94,-11,-47,-76,-85,-25,154,49
63,96,10,41,-56,-63,23,159,273
142,170,-90,-15,-212,-169,-16,201,11
33,29,-30,-19,-65,-33,-1,41,-45
21,44,-46,-42,-84,-60,-11,65,-113
50,44,-63,-38,-93,-105,36,111,-58
2,147,-23,-104,-68,-199,-12,178,-79
83,233,65,-22,-31,-94,9,269,512
102,145,11,-35,11,-28,30,185,421
47,-14,-101,-101,-212,-151,-4,210,-326
32,71,-113,-119,-149,-133,-27,218,-220
54,131,-61,-98,-177,-187,-13,292,-59
22,44,3,12,-48,-3,9,50,89
220,245,-93,9,-123,-136,128,251,501
220,316,-147,-115,-120,-227,141,439,507
55,51,-22,-16,-42,-124,-17,54,-61
142,175,-89,-132,-227,-291,-4,393,-33
-4,52,-169,-76,-267,-174,14,190,-434
-17,-56,-107,-81,-199,-144,-37,123,-518
-26,35,-34,-14,-87,-121,-31,101,-177
327,602,-7,-93,-187,-167,202,649,1326
36,92,-48,-48,-71,-85,-22,162,16
1,-16,-28,-34,-77,-115,-13,85,-197
-26,33,-47,-35,-91,-133,-41,83,-257
39,82,-40,1,-114,-117,1,115,-33
13,143,-79,-65,-50,-91,19,73,-37
1,93,-12,-60,25,-10,43,137,217
28,68,-44,-20,-68,-25,46,71,56
6,38,-23,-38,-75,-79,9,112,-50
148,185,73,96,-141,0,59,275,695
1,41,4,-31,-10,-58,-25,84,6
-75,-11,-88,-45,-121,-77,-29,61,-385
71,136,-26,-10,-89,-99,0,161,144
89,122,-128,-131,-338,-114,-8,361,-147
3,47,0,-29,-58,-55,-19,51,-60
273,554,-141,-217,-342,-397,-10,719,439
33,16,-15,-8,-74,-46,-11,91,-14
174,126,-41,-56,-114,-119,52,211,233
52,62,-93,-44,-173,-189,-25,115,-295
22,68,-67,-34,-81,-83,16,81,-78
78,136,-89,-32,-154,-92,32,107,-14
51,72,51,62,-31,-21,31,167,382
84,104,30,58,-28,-36,31,195,438
137,121,39,89,-64,-45,38,227,542
76,97,15,-12,-16,-48,37,151,300
73,75,68,6,17,-56,2,143,328
69,47,-3,19,3,-50,14,111,210
701,964,-445,-297,-641,-541,289,1170,1200
82,124,-53,-109,-185,-86,30,236,39
41,35,-29,25,-77,-27,29,56,53
110,128,-73,-72,-160,-153,16,265,61
140,171,-97,-56,-160,-196,14,267,83
180,333,89,-64,-41,-85,55,428,895
41,60,-5,-17,4,-39,20,112,176
1,-3,-23,-30,-26,-36,-9,17,-109
45,115,-98,-83,-122,-205,-35,176,-207
37,62,-47,-54,-104,-193,-26,128,-197
15,38,-44,-4,-55,-59,-21,49,-81
16,52,-26,-41,-35,-56,1,79,-10
37,70,-1,-5,-7,-37,6,86,149
81,315,8,-123,2,51,89,294,717
6,21,-19,-26,-22,-36,3,21,-52
41,-3,-103,-81,-180,-127,34,63,-356
-41,-16,-45,-21,-68,-67,-47,36,-269
7,26,-148,-84,-179,-231,-82,165,-526
5,-8,-136,-101,-207,-248,-72,148,-619
3,12,-23,-3,-51,-63,-17,47,-95
233,319,-117,-51,-249,-302,44,408,285
40,19,-36,-17,-118,-74,1,77,-108
5,8,-7,-5,-6,-22,0,18,-9
148,123,-132,-207,-182,-323,-57,271,-359
10,24,-105,-71,-109,-279,-83,298,-315
-44,-45,-52,-25,-44,-77,-42,20,-309
430,639,-102,-59,-342,-414,16,679,847
374,485,-129,-90,-86,-199,222,589,1166
94,95,-35,-22,-140,-143,5,198,52
29,5,-90,-19,-110,-208,-33,93,-333
20,49,-58,-67,-68,-58,13,78,-91
99,135,-93,-55,-182,-360,-5,277,-184
9,32,-13,-45,-69,-68,-34,100,-88
26,98,-40,-55,-147,-105,-5,133,-95
-2,65,-43,-63,-113,-143,-48,135,-212
64,239,-220,-28,-61,40,186,108,328
56,79,20,23,-63,-37,59,127,264
30,38,6,-4,18,18,38,26,170
33,44,3,-3,19,19,41,28,184
32,38,3,-4,15,20,36,23,163
32,39,1,-5,15,23,38,22,165
5,5,-6,6,-6,-15,4,10,3
22,96,-142,-98,-241,-409,-79,284,-567
27,85,-23,-6,-48,-102,4,101,38
3,23,-24,-26,-5,-45,10,34,-30
67,71,-197,-281,-538,-523,-60,467,-994
44,20,-73,-30,-73,-160,3,74,-195
-2,-5,-47,-44,-59,-112,-41,67,-243
179,160,46,-58,108,-78,45,184,586
57,19,-40,-23,-128,-177,-24,91,-225
99,18,-131,-27,-259,-222,-20,137,-405
36,19,-8,-3,-40,-33,8,59,38
54,130,-115,-28,-122,-91,80,180,88
-16,104,-20,-28,-14,10,35,141,212
120,150,-42,-42,-112,-195,-32,230,77
204,313,-33,-20,-26,-28,110,245,765
82,102,-61,-45,-67,-94,23,148,88
-3,7,-9,8,-22,-28,1,39,-7
22,121,-43,-48,-100,-86,-9,109,-34
13,62,-14,-35,-79,-77,-13,92,-51
139,-35,60,26,-41,48,59,171,427
112,99,-5,-37,-25,-21,87,165,375
108,125,-87,-52,-26,-76,58,38,88
-11,8,-42,-36,-69,-37,-7,67,-127
226,296,-56,-28,-67,-28,229,345,917
141,380,-131,-139,-129,-308,-17,526,323
32,75,-63,-89,-57,-115,-11,98,-130
23,68,-22,-29,-48,-80,23,114,49
199,328,-46,-16,-189,-273,-3,275,275
42,105,-36,-23,-39,-86,5,87,55
57,74,-33,-55,-142,-142,-13,203,-51
-3,45,-9,-35,-43,-59,-34,58,-80
52,67,27,61,-55,-5,21,163,331
-2,50,48,84,-98,62,15,132,291
69,87,-71,-74,-70,-88,13,119,-15
18,17,-9,-3,-60,-79,-24,88,-52
7,21,-39,-35,-80,-29,20,54,-81
35,45,-9,-7,-39,-62,-18,55,0
-8,27,-36,-44,-27,-68,-18,20,-154
6,31,-37,-36,-86,-77,-5,93,-111
155,187,37,-50,-73,-118,42,231,411
-4,-2,-2,-5,-9,-31,-7,23,-37
31,80,-70,-64,-79,-78,25,93,-62
-70,-8,-116,-35,-166,-230,-93,128,-590
47,47,-24,-3,-14,-22,23,24,78
51,54,-42,-57,-59,-77,12,85,-33
46,66,-34,-36,-94,-80,-26,113,-45
168,221,27,-140,22,-181,11,272,400
36,99,-111,-24,-214,-296,-44,162,-392
102,195,-52,-51,-240,-215,-68,345,16
130,156,35,2,-22,-88,45,185,443
60,87,-67,-47,-72,-58,54,120,77
121,172,-129,-67,-140,-174,48,150,-19
151,102,-53,40,-81,-156,113,149,265
87,91,-12,-15,-104,-141,29,179,114
30,59,-2,-39,-80,-37,-5,103,29
55,32,-70,-7,-118,-129,-2,64,-175
134,193,-11,-89,-170,-202,-20,390,225
105,155,-131,-112,-255,-187,2,419,-4
63,118,15,58,-1,-20,38,94,365
-1,73,-16,-37,-46,-78,-11,95,-21
58,35,-22,18,-58,-87,3,94,41
-3,14,-36,-34,-42,-39,-18,21,-137
209,344,-69,-31,-273,-247,73,465,471
40,77,-105,-96,-111,-155,-26,125,-251
9,43,-20,-41,-20,-58,14,75,2
-1,20,-14,1,-17,-38,-25,45,-29
9,29,13,-12,-9,-9,12,24,57
65,103,18,-25,-27,13,49,113,309
94,162,33,-9,-1,43,61,154,537
3,47,7,-14,-19,-35,15,45,49
21,136,-93,-140,-184,-217,-28,296,-209
-3,11,-35,-37,-53,-48,-12,32,-145
-45,12,-42,-39,-67,-131,-29,60,-281
54,75,-21,-19,-47,-43,12,101,112
122,195,-58,13,-129,-87,62,222,340
-9,18,-35,-31,-109,-57,-4,74,-153
89,62,-20,-48,-86,-122,-15,173,33
3,24,-41,-40,-75,-59,-23,56,-155
-6,13,-8,-17,-23,-31,-11,35,-48
61,99,12,-46,-2,-6,73,185,376
48,74,11,-17,-21,-112,-41,78,20
-31,29,-43,-9,-104,-162,-63,119,-264
27,50,-45,-35,-62,-30,15,59,-21
10,48,-31,-32,-56,-59,-29,80,-69
8,2,-6,-4,-22,-36,-21,21,-58
-11,27,-34,-28,-96,-79,-4,46,-179
-51,-4,-61,-47,-98,-129,-43,83,-350
83,151,-79,-63,-147,-181,42,261,67
15,100,7,-29,-20,-127,-17,122,51
89,75,-73,26,-127,-126,76,136,76
14,258,-363,-324,-641,-895,-321,556,-1716
210,268,72,40,-15,2,57,251,885
47,77,0,7,-38,-52,14,89,144
64,98,-17,-41,-32,-124,8,158,114
3,31,6,-16,-4,-64,-26,30,-40
-61,-64,-74,-70,-101,-130,-71,71,-500
10,7,-65,-6,-92,-148,-35,83,-246
-15,52,-23,-30,-53,-55,-21,63,-82
101,94,-33,-38,-107,-124,21,157,71
130,186,-157,-243,-323,-256,82,474,-107
-41,1,-49,-6,-85,-126,-45,53,-298
105,187,-15,-20,-50,-69,110,244,492
21,1,-10,-12,-54,-26,3,64,-13
31,141,-95,-39,-255,-231,-21,317,-152
64,69,21,33,11,-33,14,96,275
18,63,-16,1,-13,-31,12,51,85
49,28,-53,-47,-41,-69,5,98,-30
-3,98,-56,-25,-24,-6,18,124,126
11,19,-16,-31,-26,-51,-2,27,-69
15,13,-97,-77,-85,-173,-33,90,-347
20,1,-45,-54,-133,-121,-13,75,-270
131,180,-120,-54,-217,-225,16,286,-3
54,97,-69,-69,-79,-140,9,109,-88
91,212,4,-9,-87,-263,-68,323,203
19,61,-52,-26,-52,-52,-1,54,-49
146,248,40,-7,22,-66,51,303,737
16,30,-115,-141,-165,-219,-27,222,-399
31,38,-20,-24,-65,-73,-6,85,-34
-15,137,-194,-118,-406,-484,-154,335,-899
-13,132,-15,-42,-15,11,55,182,295
17,32,-28,-16,-26,-26,13,40,6
65,183,-301,-252,-357,-510,-101,386,-887
10,20,-6,-11,-16,-7,5,38,33
21,25,7,-33,9,-35,-1,28,21
83,82,-49,-17,-103,-78,52,155,125
17,75,-65,-64,-70,-102,20,114,-75
68,103,-99,-93,-155,-167,43,201,-99
66,123,-36,-29,-70,-133,-38,188,71
36,7,-24,-62,-66,-118,-8,66,-169
41,123,-37,-51,-78,-204,-12,98,-120
46,120,16,-18,-48,-61,33,150,238
-13,34,-189,7,-358,-242,-66,241,-586
50,96,-28,-10,-88,-107,14,119,46
63,66,-52,-30,-119,-127,4,111,-84
48,62,-32,-12,-49,-76,9,74,24
162,351,-50,-53,59,96,197,263,1025
546,544,-218,185,-328,53,454,572,1808
26,27,-3,-33,-4,-24,8,68,65
13,72,-127,-41,-64,-198,-65,242,-168
41,64,-8,34,-48,-11,22,140,234
148,278,-43,-66,40,-76,143,211,635
60,173,-46,-28,-40,-100,43,111,173
322,699,-256,86,-376,-471,41,417,462
34,62,-41,-3,-31,-8,45,21,79
36,103,-7,-34,-120,-50,-27,222,123
84,247,95,-21,-8,-135,-36,260,486
4,28,-22,-20,-44,-58,-6,53,-65
13,56,-19,-22,-84,-36,15,97,20
39,50,-66,-4,-82,-55,39,61,-18
4,11,-27,-18,-48,-77,-21,98,-78
193,381,-240,-163,-327,-407,69,482,-12
99,42,-6,-3,6,-61,33,98,208
204,230,-104,-42,-207,-304,-18,210,-31
-29,41,-48,-44,-94,-116,-23,105,-208
162,214,41,-55,-25,-69,93,325,686
45,149,22,-27,-27,-107,36,176,267
67,121,-58,-96,-112,-147,11,206,-8
113,146,-86,-41,-158,-245,11,229,-31
58,122,3,-30,-19,-78,9,136,201
-44,47,-83,-97,-99,-131,-55,123,-339
215,191,27,-69,39,-77,41,239,606
76,62,12,-12,-67,-65,7,151,164
53,92,-42,-5,-36,-66,40,79,115
-27,30,-104,-49,-184,-294,-81,156,-553
47,41,-49,-54,-100,-132,-25,144,-128
48,59,-52,-51,-100,-121,9,127,-81
-59,-16,-67,-21,-90,-57,-31,40,-301
111,90,-62,-14,-113,-130,-10,182,54
213,278,-4,-12,-5,-126,111,333,788
20,16,-51,-95,-102,-142,-17,97,-274
61,99,16,10,-18,-37,33,119,283
36,8,-17,13,-49,-51,-5,32,-33
24,99,-17,-14,-22,-87,20,128,131
64,109,-52,-12,-86,-122,4,105,10
1,31,-116,-103,-181,-239,-70,159,-518
29,31,-38,-14,-48,-71,-19,97,-33
36,24,0,-12,-87,-83,-4,127,1
-14,-11,-44,-49,-50,-109,-57,54,-280
53,67,-41,29,-117,-100,-17,81,-45
66,81,8,44,-74,-54,35,125,231
8,53,6,-1,1,-44,19,52,94
-29,-7,-44,12,-107,-77,-13,74,-191
24,64,-11,-20,-2,-17,30,37,105
209,333,-58,-89,-25,-42,140,303,771
12,37,4,5,-6,-4,18,56,122
-52,-11,-86,-64,-124,-142,-77,105,-451
4,171,-333,-249,-555,-809,-300,476,-1595
16,42,13,-1,5,-48,-26,49,50
27,39,9,-8,4,4,12,38,125
32,26,5,-4,-6,-14,-2,50,87
83,98,-32,-19,-87,-118,10,167,102
33,22,-20,-12,-59,-50,19,85,18
48,69,-53,-48,-103,-133,6,145,-69
25,36,-75,-49,-93,-118,5,109,-160
11,8,-59,-44,-81,-107,1,71,-200
54,59,-56,-29,-98,-116,-20,54,-152
66,100,2,-10,4,-66,6,117,219
34,95,-89,-95,-178,-217,-51,216,-285
12,1,-80,-63,-141,-118,-35,108,-316
47,100,16,-41,22,-88,13,106,175
56,89,-25,5,-15,-22,50,130,268
-31,4,-26,-27,-46,-90,-51,58,-209
13,34,-49,-31,-109,-83,-9,97,-137
108,92,-34,-32,-50,-33,100,70,221
103,185,-13,-87,-88,-129,54,321,346
156,81,-203,-110,-425,-420,-93,275,-739
29,8,-105,-93,-146,-129,-27,158,-305
80,130,-55,-42,-97,-170,-6,182,22
15,7,-20,-21,-30,-33,1,51,-30
37,107,60,13,-110,-77,-26,261,265
47,98,47,-11,-9,41,46,108,367
69,92,-80,-15,-108,-118,-9,140,-29
35,64,-52,-31,-40,-46,30,61,21
-59,-37,-68,-72,-85,-134,-87,51,-491
-51,-20,-80,-49,-111,-121,-48,64,-416
36,228,-46,-50,-180,-279,3,263,-25
15,22,-34,-37,-53,-47,-3,80,-57
62,71,-22,-49,-85,-107,-2,113,-19
39,18,-70,-63,-153,-122,3,131,-217
22,38,-52,-66,-119,-146,-3,131,-195
156,233,-20,-66,-142,-212,3,332,284
49,64,-112,-29,-154,-200,-60,122,-320
52,37,-123,-62,-173,-205,-34,101,-407
35,62,-72,-100,-144,-171,-13,113,-290
46,60,-109,-87,-134,-196,-65,83,-402
125,145,-158,-65,-192,-212,-71,167,-261
-62,-52,-204,-64,-337,-259,-100,242,-836
291,305,-23,-46,-69,-144,100,358,772
104,152,-12,-4,-43,-74,14,234,371
14,-9,-22,-32,-63,-59,-13,70,-114
38,48,-76,-146,-171,-146,-39,179,-313
66,75,-105,-108,-218,-365,-96,296,-455
-7,7,-31,-24,-49,-30,-5,36,-103
15,12,-28,-9,-49,-49,-5,48,-65
-48,-36,-69,-88,-107,-107,-66,59,-462
35,69,-9,-13,-77,-169,-36,97,-103
1,21,-45,-51,-14,-5,12,46,-35
-11,46,3,10,-20,2,-15,57,72
38,135,-15,-20,-23,-118,-22,188,163
34,57,16,6,-7,-18,7,75,170
83,254,20,26,-73,-172,63,237,438
61,168,-63,-60,-189,-238,-3,272,-52
21,72,-42,-10,-84,-68,-7,83,-35
63,54,-18,-17,-29,-82,37,100,108
-99,3,-263,-227,-423,-524,-187,365,-1355
-1,45,-44,3,-99,-115,-30,56,-185
-1,36,-30,-48,-63,-125,-19,108,-142
65,117,19,-12,-41,-196,-27,194,119
-50,28,-185,-134,-261,-229,-82,178,-735
29,52,-67,-63,-130,-93,1,135,-136
130,237,6,3,-189,-144,19,195,257
192,273,55,38,-195,-171,-18,220,394
80,59,26,4,-16,-34,40,159,318
47,38,-37,7,-72,-40,44,64,51
31,123,-91,-59,-100,-163,-18,97,-180
91,165,-49,-15,-50,-115,-17,140,150
18,48,-16,9,-78,-101,-28,78,-70
10,10,-4,2,-2,-9,6,22,35
-2,11,-29,-12,-49,-43,-14,28,-110
364,500,6,-9,-30,-175,134,455,1245
18,71,-67,-78,-209,-143,-15,278,-145
508,248,-364,-15,-656,-761,-52,232,-860
47,68,-25,-109,-54,-136,-44,150,-103
89,128,-101,-81,-117,-64,84,188,126
15,23,-59,8,-122,-64,-7,69,-137
3,44,-30,-40,-65,-76,-23,47,-140
110,140,23,19,-126,-121,-6,204,243
14,14,-58,-65,-86,-95,0,88,-188
30,5,-56,-49,-52,-108,-4,70,-164
4,43,-12,-34,-61,-23,-3,72,-14
173,180,-38,-69,-161,-168,12,290,219
52,101,18,-11,41,37,59,73,370
21,28,-20,-29,-74,-120,-2,74,-122
38,58,-63,-8,-104,-82,-8,129,-40
36,31,9,-11,-76,-74,-4,122,33
33,59,-15,-24,19,-19,24,66,143
104,94,-29,-49,29,-95,38,117,209
-25,47,-28,-56,-47,-61,0,90,-80
11,15,-19,-24,-47,-81,-20,68,-97
28,34,-70,-39,-110,-118,6,74,-195
26,13,-21,1,-34,-30,6,28,-11
174,236,-37,-86,-64,-219,9,292,305
10,7,-31,-8,-35,-74,-25,41,-115
-33,72,-289,-241,-481,-543,-202,531,-1186
59,65,-15,-22,-45,-66,13,57,46
20,0,-41,-40,-113,-102,-49,146,-179
27,43,-3,-30,-73,-149,-20,126,-79
94,105,-92,0,-173,-194,-31,105,-186
178,123,5,-46,-16,-70,37,222,433
24,22,-20,-19,-22,-32,30,2,-15
69,111,-41,-27,-101,-1,65,148,223
7,20,-7,-6,6,1,7,29,57
106,131,-132,-125,-229,-323,-42,302,-312
25,59,-83,-83,-98,-139,-26,102,-243
15,3,-23,-21,-67,-53,-29,68,-107
55,60,38,-8,-54,-123,1,216,185
331,454,22,50,-103,-154,133,497,1230
206,402,-41,-17,-139,-149,92,451,805
149,295,-348,-130,-442,-432,2,382,-524
25,39,38,34,-26,22,9,71,212
8,28,-62,-34,-80,-77,0,41,-176
11,2,-32,-12,-43,-18,3,16,-73
136,247,-100,-104,-89,-255,88,312,235
149,674,849,304,393,502,135,942,3948
0,22,-8,-25,-71,-102,-10,106,-88
127,330,369,180,168,257,54,332,1817
115,298,367,170,186,304,78,371,1889
6,19,-6,0,1,-1,10,5,34
10,21,-30,-16,-59,-28,5,51,-46
129,133,-87,26,-1,32,95,44,371
20,61,-14,-24,-56,-115,-13,90,-51
46,52,18,53,-70,31,39,102,271
37,64,8,34,-24,-26,12,128,233
-19,-35,-58,-83,-102,-115,-40,62,-390
167,166,59,-33,-135,-148,-6,296,366
104,176,-39,-62,-77,-137,11,160,136
22,15,-30,-30,-10,-34,-22,45,-44
32,-10,-69,-57,-130,-77,4,90,-217
119,181,-62,-146,-54,-77,47,254,262
67,126,-95,-62,-63,-38,58,188,181
99,98,-106,-52,-123,-145,-3,141,-91
95,113,-124,-107,-259,-157,12,324,-103
25,37,-28,-1,-56,-74,-3,19,-81
80,128,-32,-14,-70,-82,29,146,185
72,83,8,-11,-26,-47,29,98,206
83,155,-7,-97,-47,-126,44,189,194
36,29,-120,-112,-175,-374,-108,212,-612
69,101,-31,-34,-4,-85,-13,84,87
19,67,-44,-26,-76,-85,6,64,-75
16,71,-36,-34,-88,-122,-17,61,-149
-1,24,-30,0,-149,-86,-24,126,-140
-26,166,-192,-90,-370,-529,-181,334,-888
109,206,-95,-83,-177,-259,16,244,-39
116,166,-73,-80,-136,-152,11,221,73
174,331,31,-9,-72,2,122,201,780
275,382,-77,-165,10,-192,86,5,324
92,166,62,9,12,-17,38,143,505
74,98,17,39,-60,-107,-4,152,209
79,180,-54,-48,-82,-171,-44,222,82
-2,36,-119,-117,-179,-210,-54,140,-505
356,360,88,97,-79,-68,61,462,1277
39,209,-67,-94,-149,-136,22,237,61
233,406,30,-32,-176,-295,103,457,726
152,130,-17,-39,-110,-169,2,220,169
80,282,79,76,4,93,111,262,987
39,82,-79,-60,-163,-198,-47,151,-275
-13,29,-51,-35,-40,-47,4,62,-91
21,17,-31,-100,-47,-180,21,86,-213
43,74,-52,-55,-125,-127,-9,111,-140
7,115,-45,-59,-118,-92,-16,185,-23
28,48,-7,-22,-63,-87,-14,92,-25
62,67,-22,-40,-17,-76,3,83,60
92,172,-269,-266,-281,-429,-78,345,-714
50,63,-42,-17,-100,-42,16,134,62
40,75,-49,-39,-103,-62,12,149,23
77,103,-46,-22,-81,-152,-7,173,45
102,232,-114,-121,-266,-286,-4,313,-144
-9,23,-30,-33,5,-14,0,30,-28
47,17,-64,-64,-135,-77,7,129,-140
44,13,-48,-51,-128,-69,6,130,-103
18,12,-21,-26,-32,-30,14,46,-19
33,24,-5,-28,-4,-30,17,54,61
128,317,-1,-114,-7,-154,47,337,553
182,261,-157,-6,-256,-259,20,230,15
246,280,-579,-529,-1064,-1254,-144,740,-2304
3,23,-20,-24,-15,-37,14,48,-8
331,402,-80,-23,-214,-154,98,563,923
75,113,-29,-43,-4,-90,11,111,144
12,30,-8,5,-29,-34,-12,44,8
17,28,-19,-23,-17,-51,14,54,3
2,10,-72,-28,-89,-79,-22,44,-234
12,18,4,-21,0,-18,8,33,36
3,9,-45,-64,-121,-81,-19,58,-260
187,255,-52,-7,-5,-44,136,227,697
98,56,-70,10,-117,-110,11,66,-56
176,264,-38,-23,-100,-24,157,173,585
-39,95,-48,-29,-160,-114,-106,221,-180
107,101,-42,27,-81,-14,86,121,305
38,23,-20,-6,-54,-52,8,52,-11
28,7,-105,-12,-172,-100,15,18,-321
50,21,-22,-29,-23,-115,-15,29,-104
40,87,-87,-49,-73,-122,-8,129,-83
20,47,-45,-23,-74,-101,-61,114,-123
45,147,-98,-111,-116,-212,-10,175,-180
-5,144,10,-60,-23,-134,7,128,67
43,49,1,-8,-40,-80,-22,100,43
132,325,-141,-182,-541,167,293,823,876
49,71,-39,-4,-73,-100,6,111,21
33,76,-64,-31,-42,-49,50,33,6
50,100,-199,-146,-199,-92,66,214,-206
-71,-38,-81,-70,-84,-122,-59,52,-473
18,36,-39,-19,-21,-15,11,44,15
-72,9,-50,-52,-84,-119,-25,83,-310
16,26,-25,-55,-38,-68,-7,59,-92
-4,-14,-38,-27,-44,-53,6,32,-142
4,-8,-23,-2,-88,-74,-27,43,-175
25,-1,-34,-30,-35,-38,6,53,-54
22,152,48,9,-74,-254,-87,197,13
34,83,-15,-35,-128,-126,-27,118,-96
-13,45,-83,-46,-165,-134,-23,129,-290
14,26,-12,-9,-33,-86,-32,42,-90
-25,21,-81,-13,-166,-114,-9,104,-283
-30,9,-76,-20,-158,-126,-13,94,-320
8,11,-108,-57,-234,-196,-35,151,-460
144,201,-74,-27,-169,-274,-20,308,89
26,15,-61,-72,-93,-120,-23,131,-197
-13,21,-88,-67,-147,-125,-15,144,-290
-18,20,-33,-20,-52,-50,-26,33,-146
197,190,19,68,-73,-60,88,245,674
31,38,-46,-27,-52,-99,15,124,-16
24,88,-13,-56,-46,-119,-9,131,0
46,53,-11,2,-56,-95,-3,101,37
67,64,13,6,-33,-19,26,76,200
63,64,-8,-34,3,-24,40,70,174
168,222,-26,-3,-108,-208,12,196,253
70,122,-76,-14,-87,-47,73,139,180
2,4,-43,-50,-77,-86,-7,85,-172
-20,-18,-26,-14,-25,-31,-21,25,-130
7,33,-1,4,-14,-15,3,27,44
138,136,-29,-31,-73,-95,15,185,246
20,46,-30,-13,-28,-25,18,53,41
138,166,-28,7,-15,-83,36,172,393
348,400,-507,-575,-1008,-769,-39,1192,-958
34,90,14,-13,-28,-24,-29,123,167
-33,86,-246,-225,-358,-540,-184,447,-1053
53,86,-2,-10,-110,-97,-42,65,-57
120,128,35,66,-41,-139,18,182,369
81,94,-80,-75,-129,-170,5,192,-82
46,79,-31,-32,-126,-106,-34,69,-135
5,82,-8,22,-192,-57,-28,98,-78
-17,32,-91,-47,-105,-148,-36,135,-277
39,44,-24,-38,-73,-80,-13,83,-62
-49,25,-74,-18,-69,-196,-87,106,-362
60,81,10,16,-39,-40,47,129,264
27,26,-69,-33,-26,-94,-3,69,-103
-5,-24,-79,-55,-128,-77,-6,55,-319
105,161,-169,-201,-173,-219,57,207,-232
55,32,-15,-84,-50,-119,-36,153,-64
5,9,-46,-21,-80,-65,-7,61,-144
23,96,-78,-105,-212,-154,-8,197,-241
12,49,-57,-19,-49,-68,-3,48,-87
37,102,-299,-313,-514,-692,-227,516,-1390
74,191,-320,-279,-534,-734,-243,525,-1320
43,66,-59,-78,-197,-150,-32,222,-185
16,34,-12,28,-96,-61,-20,83,-28
23,67,-2,3,-36,-46,10,55,74
-16,108,-66,-13,-11,5,44,128,179
-38,71,-64,9,-2,28,85,128,217
11,146,-104,-65,-24,-25,19,174,132
-47,199,-99,-65,-38,11,41,266,268
-46,110,-69,-79,-6,7,66,173,156
6,165,-9,-43,-23,19,85,235,435
0,47,-78,-44,-25,-44,35,148,39
-7,82,-93,-45,2,3,31,106,79
80,211,-47,-69,-131,-165,58,301,238
5,11,4,-3,2,-7,2,11,25
10,48,-42,-35,-70,-102,1,105,-85
77,77,-87,-84,-176,-202,33,236,-126
47,92,18,-45,-28,-67,12,113,142
-30,19,-52,-63,-44,-102,-40,37,-275
-6,51,-12,-7,-3,-20,3,33,39
24,-1,-43,-46,-45,-100,-26,57,-180
85,244,-266,-284,-558,-687,-185,578,-1073
49,66,-102,-95,-114,-147,1,149,-193
43,39,-56,-47,-156,-170,-50,148,-249
47,65,5,-30,-1,-75,-12,111,110
-31,1,-63,-72,-103,-93,-13,100,-274
-50,-34,-35,-16,-61,-108,-39,36,-307
16,21,18,-3,-30,-19,3,36,42
58,328,-129,-190,-274,-593,-94,589,-305
274,381,-120,-82,-318,-397,68,523,329
238,245,-15,116,-232,-158,23,373,590
138,376,-176,-70,-435,-636,-76,466,-413
545,714,-86,-225,-47,-52,336,720,1905
138,129,-5,56,-66,-72,31,185,396
149,279,-95,-30,-288,-177,63,348,249
157,266,-56,-60,-137,-187,66,380,429
44,67,-63,-74,-73,-156,-26,109,-172
10,52,17,14,-42,-15,-15,77,98
138,202,-214,-41,-269,-193,32,167,-178
114,210,-35,-14,-24,-56,87,220,502
744,774,252,94,134,11,347,1038,3394
237,396,-55,-62,-60,-180,153,335,764
67,215,-146,-153,-346,-339,2,358,-342
37,349,-265,-165,-309,-351,58,462,-184
13,11,-15,-15,-22,-55,-14,20,-77
160,227,-112,-61,-113,-168,85,294,312
125,178,-37,-64,-102,-179,42,248,211
77,169,-7,-39,-109,-94,45,235,277
1,36,-1,-10,-11,1,4,43,63
50,58,-16,-9,2,-21,24,61,149
41,64,-18,-86,-93,-218,4,195,-111
67,132,-29,4,-54,-35,51,175,311
91,125,-6,-66,-112,-161,-26,285,130
-31,28,-44,-24,-50,-65,-21,36,-171
47,130,-82,-60,-134,-192,-3,198,-96
0,38,-28,-15,-119,-68,11,73,-108
-48,30,-50,0,-106,-168,-78,112,-308
27,74,-85,-73,-48,-135,-1,121,-120
-52,34,-91,-83,-95,-170,-30,127,-360
35,113,-71,-57,-140,-178,-23,158,-163
12,12,-16,-20,-49,-70,-17,46,-102
22,46,3,20,-52,-55,-5,54,33
84,83,-121,-92,-210,-187,39,174,-230
32,90,-75,-82,-148,-179,-14,191,-185
120,372,60,-63,-125,86,85,474,1009
179,439,169,34,-85,32,37,494,1299
-3,44,-35,-18,-48,-61,-2,84,-39
106,131,-18,46,-45,-45,52,169,396
146,172,-12,38,-24,-21,78,202,579
426,953,-333,89,-700,-775,-49,691,302
25,75,-37,-51,-81,-97,-34,100,-100
-9,70,-68,-15,-28,-58,36,94,22
10,19,-39,-17,-55,-64,-14,35,-125
66,47,-30,-3,-72,-72,30,88,54
-7,10,-11,-2,-14,-23,-8,15,-40
71,167,-46,-3,-122,-121,39,141,126
142,182,13,-7,29,-49,31,204,545
-3,11,-140,-108,-182,-166,-44,162,-470
-13,3,-102,-98,-216,-196,-82,150,-554
-31,33,-80,-122,-175,-161,-42,192,-386
183,307,-191,-152,-158,-289,123,456,279
44,25,-9,-10,-26,3,29,52,108
-6,24,-70,-52,-100,-120,-34,113,-245
49,49,-47,-18,-64,-39,33,104,67
176,289,-59,-46,-59,-174,96,347,570
126,182,0,-36,-48,-86,43,297,478
2,11,-71,-27,-107,-72,-2,71,-195
113,165,-150,-130,-208,-125,78,307,50
-14,9,-57,-31,-81,-58,-14,44,-202
-90,3,-90,-72,-146,-119,-69,98,-485
65,65,6,6,5,-17,16,67,213
-31,182,1,-58,28,-21,64,205,370
188,265,158,13,26,-57,105,337,1035
83,113,1,-36,-15,-39,22,152,281
-8,86,-156,-81,-186,-248,-47,239,-401
11,57,42,-12,-9,-13,-9,145,212
18,50,11,-7,-16,-22,-9,105,130
22,64,16,-15,-18,-32,-7,109,139
25,56,4,-17,-23,-29,-18,109,107
44,41,-8,-51,-68,-109,-33,161,-23
86,164,-29,-24,-225,-236,24,338,98
-8,10,-24,-33,-33,-32,2,32,-86
340,502,-144,-104,-236,-211,289,643,1079
-74,-7,-78,-61,-81,-106,-66,63,-410
54,6,-146,-33,-269,-280,-78,133,-613
333,296,-139,48,-86,5,197,275,929
531,563,-265,168,-474,-415,146,374,628
1,14,-37,-36,-92,-24,1,81,-92
13,55,11,-54,-55,-23,-1,45,-9
142,371,445,128,174,284,98,508,2150
-12,47,-30,-27,-34,-92,-11,64,-95
93,122,1,12,-52,-70,25,195,326
-51,179,-199,-246,-281,-566,-199,288,-1075
76,244,-119,-129,-323,-463,-67,398,-383
-10,199,-139,-146,-324,-449,-111,282,-698
30,204,-162,-225,-258,-342,-25,348,-430
102,185,-104,-2,-158,-195,-9,130,-51
230,268,-118,-136,-275,-362,-14,350,-57
74,150,-65,-120,-173,-148,38,294,50
23,68,-30,-17,-37,-107,8,130,38
166,260,-57,-52,-163,-224,64,366,360
63,60,-103,-120,-179,-177,-41,245,-252
64,92,-25,22,-159,-103,-19,124,-4
27,65,0,-19,-42,-56,4,93,72
79,97,3,-9,-15,-49,19,116,241
-35,39,-65,-32,-82,-244,-128,132,-415
22,116,-98,-72,-165,-309,-70,131,-445
55,47,-20,-6,-34,-38,27,84,115
-34,70,-59,-59,-85,-220,-67,147,-307
41,122,-4,-58,-29,-46,1,119,146
29,55,-127,-98,-163,-186,-50,170,-370
-17,78,-11,10,-63,-7,1,169,160
76,141,-92,-121,-193,-175,11,290,-63
155,127,-45,-48,-49,-165,23,167,165
32,29,-17,2,-17,4,31,41,105
5,9,-31,-14,-35,-31,-16,34,-79
40,-19,-42,-3,-86,-87,-11,37,-171
103,140,-21,19,-64,-44,27,130,290
10,-2,-41,-31,-102,-124,-51,23,-318
70,41,7,-16,-16,-87,9,120,128
-40,-23,-51,-39,-60,-87,-48,36,-312
16,37,-32,-11,-38,-70,-3,60,-41
55,49,-14,12,-21,-31,24,80,154
83,85,-17,-28,-51,-74,8,130,136
0,38,-21,-46,-69,-59,15,72,-70
90,81,-146,-25,-239,-204,54,150,-239
67,184,-212,-117,-293,-419,-52,252,-590
99,141,-24,-13,-66,-95,30,235,307
-13,37,-29,-32,-83,-55,-5,59,-121
122,198,-44,-13,-34,-95,57,131,322
67,119,-45,-9,-145,-163,-13,139,-50
15,79,-115,-191,-173,-194,-49,143,-485
26,32,-66,-57,-179,-203,22,163,-262
241,330,101,-19,6,-16,87,426,1156
-27,59,-83,-31,-206,-258,-76,249,-373
-35,-18,-79,-48,-68,-121,-53,64,-358
18,88,-24,-37,-91,-108,0,117,-37
36,28,23,4,-22,-20,8,48,105
21,20,-12,-6,-30,-48,-4,37,-22
-13,2,-36,-12,-50,-66,-18,38,-155
43,139,-104,-83,-112,-221,-2,199,-141
-24,46,-71,-9,-106,-148,-80,129,-263
4,20,-63,-75,-100,-126,-10,97,-253
219,268,-46,-77,-107,-133,46,328,498
22,85,-15,-25,-72,-184,-47,95,-141
-1,3,-86,-28,-113,-114,-32,76,-295
73,105,6,1,-10,-10,69,94,328
7,84,-73,-19,-131,-160,-25,118,-199
40,143,-91,-40,-145,-147,-15,183,-72
-18,17,-16,-6,5,-11,-2,14,-17
99,100,-55,-2,-59,-26,75,165,297
50,58,50,13,5,-3,17,59,249
114,133,-63,-25,-153,-154,22,148,22
156,282,-201,-78,-349,-300,4,421,-65
188,190,-117,-11,-86,-60,127,172,403
57,126,-65,-46,-99,-123,27,183,60
-29,61,-130,-112,-208,-97,-46,179,-382
-3,27,-59,-58,-129,-144,-18,139,-245
-3,36,-63,-40,-94,-119,16,80,-187
-24,51,-54,-11,-2,20,32,87,99
251,450,-153,89,-269,-270,6,310,414
-26,-40,-71,-40,-103,-125,-28,34,-399
28,58,-27,-14,-47,-78,-9,95,6
25,20,-44,-50,-75,-92,12,50,-154
32,31,-21,-12,-94,-81,3,87,-55
11,27,2,-10,-28,-41,-1,63,23
-7,86,-7,-3,-59,-8,38,151,191
68,94,-102,-54,-226,-205,26,228,-171
26,90,-6,-1,3,-28,8,149,241
17,47,-16,-40,-8,-44,13,92,61
31,31,-35,-37,-78,-103,-2,119,-74
14,20,-15,-46,-53,-109,-13,82,-120
31,12,-27,-48,-33,-115,-10,77,-113
11,24,-20,-14,-16,-31,-11,22,-35
-16,13,-45,-67,-123,-72,-19,85,-244
-28,-4,-34,-35,-43,-92,-51,26,-261
11,23,-11,-24,-40,-31,9,32,-31
0,54,-30,-43,-43,-83,5,83,-57
50,124,-58,-114,-148,-166,46,246,-20
99,99,-150,-90,-188,-238,25,202,-241
630,819,-616,-37,-1216,-943,289,535,-539
481,506,-77,-32,-290,-343,139,605,989
-3,153,-140,-126,-252,-164,-23,324,-231
7,21,-23,-38,-61,-102,-44,91,-149
9,20,-46,-46,-55,-89,-31,81,-157
27,77,12,-13,19,0,27,57,206
8,32,-95,-53,-97,-135,-31,106,-265
16,61,-54,-66,-72,-143,-30,125,-163
31,-6,-49,-42,-39,-43,8,35,-105
44,26,5,-20,16,-40,-10,31,52
3,21,-12,3,-9,-15,-3,24,12
13,49,-56,-54,-65,-40,14,87,-52
26,43,-42,-71,-74,-108,4,62,-160
51,60,-22,-28,-85,-40,23,106,65
62,109,-16,-28,-17,-43,62,104,233
-10,20,-27,-43,-61,-54,-32,76,-131
4,64,-62,-74,-148,-124,4,188,-148
25,6,-45,-41,-44,-92,4,54,-133
80,28,-64,-172,-286,-233,-1,289,-359
-2,76,-83,-60,-184,-213,-44,208,-302
93,77,13,76,-45,-18,46,138,380
18,15,-48,20,-100,-92,2,58,-127
141,221,-92,14,-209,-213,-2,123,-17
53,94,-112,-86,-163,-162,-14,184,-206
17,5,-35,-20,-59,-19,-13,38,-86
119,163,17,-21,40,24,74,137,553
45,97,-63,-51,-92,-61,20,139,34
60,30,-22,-38,-6,-90,-1,16,-51
42,114,-16,-95,-146,-182,-52,236,-99
35,43,25,-13,0,-69,11,85,117
68,170,-100,-46,-60,-101,65,107,103
59,61,-18,1,-51,-69,37,105,125
51,92,-4,-28,-102,-96,-55,75,-67
29,76,-61,-56,-51,-52,53,113,51
18,24,-39,-7,-63,-81,-1,39,-110
70,92,12,-14,-48,-60,12,122,186
83,132,-97,-68,-181,-231,4,258,-100
94,180,-41,-3,-142,-226,-12,212,62
25,73,-80,-83,-79,-160,-5,116,-193
119,187,-131,-5,-108,-52,125,251,386
-14,-18,-49,-21,-55,-53,-15,33,-192
7,39,-35,-3,-125,-12,14,116,1
5,54,-28,-9,-100,-5,9,120,46
4,0,-22,-6,-23,-18,1,21,-43
14,21,-16,-14,-12,-26,-3,13,-23
31,48,-115,-114,-232,-168,-1,180,-371
-2,15,-36,-26,-58,-21,-10,33,-105
-5,83,-78,-93,-196,-322,-71,229,-453
5,23,-31,-10,-32,-41,0,34,-52
39,62,-12,8,-63,-103,-50,103,-16
72,91,-28,-22,-45,-66,28,90,120
-55,-35,-90,-59,-107,-105,-69,67,-453
-54,10,-72,-63,-73,-133,-28,101,-312
3,79,-150,-147,-252,-270,-17,294,-460
21,74,-128,-51,-137,-129,-26,101,-275
117,191,-92,-76,-97,-94,88,203,240
-18,62,-70,-110,-115,-239,-85,229,-346
36,65,2,-8,-8,-90,-27,85,55
26,47,-1,-6,-39,-85,-15,120,47
59,380,-469,-385,-818,-1181,-257,915,-1756
146,132,82,67,5,1,17,159,609
51,41,-28,3,-56,-32,6,72,57
23,77,-74,-62,-75,-165,-4,126,-154
247,320,41,2,-66,-6,114,232,884
92,103,105,13,9,-52,19,158,447
100,142,147,-33,82,-26,98,178,688
135,270,-121,12,-130,-198,2,171,141
81,81,-7,18,-45,-46,29,137,248
30,77,-4,-11,-54,-102,-31,103,8
14,42,-42,-51,-88,-144,-14,167,-116
19,48,-52,-32,-88,-169,-22,141,-155
34,8,-48,-58,-66,-103,-11,41,-203
163,183,-50,-139,-2,-65,115,186,391
91,111,10,21,-58,-46,65,120,314
17,41,-46,6,-97,-104,-10,98,-95
-11,37,-11,-22,-41,-68,-19,66,-69
176,285,-11,-41,-82,-222,60,458,623
45,68,4,-3,-14,-67,19,90,142
75,198,-95,-118,-177,-344,-32,229,-264
35,36,25,24,-24,-32,-17,85,132
16,21,1,4,-16,-40,-2,31,15
30,20,-48,-37,-69,-45,6,36,-107
16,24,-11,2,-5,-21,23,35,63
-10,-15,-7,-10,-9,-20,-18,17,-72
130,258,136,127,-44,94,35,321,1057
24,29,-24,-19,-57,-26,20,76,23
35,82,-29,-33,24,-24,25,45,125
31,42,-15,2,-50,-50,-16,46,-10
157,138,183,116,90,97,29,204,1014
92,104,-25,30,-122,-136,-10,213,146
1,11,-5,-7,-12,-10,5,22,5
29,43,-30,-21,-47,-34,33,50,23
52,93,-23,-21,-41,-51,25,81,115
-41,-65,-69,-41,-61,-89,-42,23,-385
110,124,-38,17,-76,-35,67,149,318
75,56,-28,-17,-38,-47,30,95,126
50,43,-16,-33,-48,-41,17,39,11
57,36,-31,-20,-75,-73,18,118,30
49,85,4,-9,-40,-60,18,126,173
81,170,53,-40,24,-107,38,212,431
92,247,23,-52,-10,-203,1,193,291
10,-20,-79,-15,-75,-128,-38,62,-283
14,39,-82,-52,-181,-156,-36,187,-267
74,104,16,-17,-12,-52,12,135,260
349,387,136,68,-26,-140,135,583,1492
63,89,-6,-27,-37,-16,34,72,172
112,164,-62,-33,-113,-145,14,178,115
-74,-44,-84,-84,-103,-112,-71,49,-523
-68,-34,-44,-73,-88,-122,-69,50,-448
-62,-5,-62,-42,-87,-115,-62,69,-366
-63,-5,-54,-45,-78,-136,-80,60,-401
-62,-34,-65,-42,-86,-119,-65,73,-400
-58,-21,-61,-42,-89,-129,-79,71,-408
58,71,-26,6,-73,-92,6,65,15
-49,-38,-74,-35,-87,-121,-61,97,-368
-9,18,-34,-30,-49,-66,-18,32,-156
31,79,-22,2,-75,-64,19,118,88
131,157,118,-44,60,-46,68,257,701
112,158,-33,-30,-36,-118,40,122,215
268,551,-137,40,-411,-482,-97,436,168
12,28,-45,-53,-120,-134,-35,109,-238
1,60,-65,-69,-85,-110,-14,91,-191
380,510,49,10,-32,-88,95,644,1568
9,22,-19,-15,-9,-28,6,29,-5
46,122,-48,-38,-56,-75,3,121,75
37,47,-16,7,4,20,37,36,172
403,579,-225,-191,-329,-405,151,714,697
34,75,-39,-11,-47,-107,-14,69,-40
59,113,74,16,-11,38,33,133,455
9,17,15,-14,-43,-19,7,68,40
10,-4,-17,-11,-53,-28,2,43,-58
27,55,30,47,-40,22,29,84,254
136,185,-17,-114,-135,-181,54,311,239
53,25,-33,-8,-43,-47,13,57,17
89,166,0,5,22,-13,73,129,471
100,182,6,-15,24,-11,90,137,513
49,139,-16,-14,26,-14,54,126,350
53,59,6,19,-36,-47,16,97,167
78,78,-73,78,0,5,78,78,322
46,107,-43,-92,-153,-86,-5,232,6
287,377,-10,92,-239,-13,191,519,1204
33,16,2,-3,-77,-40,15,85,31
-31,25,-73,-16,-109,-121,-32,104,-253
62,115,-95,-53,-177,-31,66,177,64
31,58,5,3,3,-19,14,68,163
223,327,50,2,5,-126,46,410,937
-1,-23,-37,-56,-80,-85,-15,74,-223
58,147,36,0,-15,-50,28,172,376
-40,-20,-49,-38,-90,-115,-53,70,-335
54,58,9,10,-35,-21,13,70,158
221,412,-167,-129,-250,-139,203,514,665
92,82,-24,11,-98,-102,-7,147,101
354,900,-200,-144,-1031,-968,-40,1317,188
-25,25,-125,-21,-210,-185,-78,119,-500
12,32,-35,-20,-86,-99,-18,70,-144
-35,-15,-88,-67,-103,-123,-48,90,-389
-51,16,-47,-80,-78,-156,-82,123,-355
18,16,-30,-55,-69,-62,-9,85,-106
21,75,27,21,2,-27,1,85,205
-9,-2,-22,-27,-61,-42,-21,41,-143
565,925,-78,-186,-269,-336,368,999,1988
35,39,30,8,10,1,35,83,241
14,121,-23,-34,-45,-37,46,150,192
7,20,25,-34,-6,-51,-15,68,14
12,21,-35,-10,-65,-63,-45,85,-100
62,91,41,47,-24,-53,8,117,289
64,30,-32,12,-95,-72,22,67,-4
345,378,84,27,-97,-177,64,523,1147
34,72,3,-46,-35,-79,5,115,69
75,88,25,-31,14,-55,31,142,289
-41,-43,-41,-39,-25,-107,-50,32,-314
261,373,-189,-67,-223,-217,106,383,427
14,107,-19,-18,-78,-96,-22,109,-3
53,67,-34,-27,-73,-73,25,62,0
10,34,-36,0,-91,-70,-7,97,-63
18,24,-3,-12,-10,-11,6,41,53
-41,34,-54,-92,-96,-162,-61,100,-372
-36,-11,-88,-103,-79,-141,-71,87,-442
20,14,-18,0,-36,-32,6,23,-23
18,46,-25,-47,-38,-59,7,85,-13
22,47,-92,-55,-137,-157,-43,74,-341
32,64,6,16,-30,-30,3,25,86
52,84,-58,-24,-42,-108,8,102,14
9,1,-28,-8,-44,-18,-12,18,-82
-26,8,-66,-73,-111,-68,-8,118,-226
-5,15,-7,-11,-17,-6,1,9,-21
1,41,-66,-57,-47,-114,-28,83,-187
17,12,-21,13,-29,-11,6,16,3
5,44,33,7,3,7,-17,85,167
-101,-19,-119,-57,-213,-283,-82,156,-718
66,27,-32,14,-84,-22,37,79,85
-54,14,-313,-261,-359,-495,-182,480,-1170
22,197,-233,-239,-364,-517,-93,580,-647
31,75,-28,-65,-51,-108,-11,110,-47
33,22,-48,-3,-91,-153,-5,117,-128
53,105,-6,-39,-19,2,48,113,257
29,-6,-35,-19,-72,-46,-15,29,-135
80,114,-77,-91,-40,-83,29,154,86
761,1003,-148,-12,-132,-640,297,1256,2385
68,83,-7,48,-29,-42,39,152,312
25,91,-19,-32,-49,-71,-12,113,46
9,76,-84,-48,14,2,49,80,98
-12,7,-32,-26,-9,-6,0,17,-61
-20,67,-48,-35,-25,18,47,126,130
28,121,-33,25,-24,-4,63,146,322
-16,35,-35,-16,2,3,19,17,9
161,166,50,-44,86,-23,71,199,666
5,58,-48,-8,-11,16,36,92,140
11,24,2,3,1,-15,8,25,59
20,23,-14,-19,-19,-44,17,38,2
-18,12,-104,-88,-230,-240,-71,181,-558
-12,36,-36,-43,-81,-107,-5,112,-136
13,20,-26,19,-28,-6,18,34,44
52,71,-43,-40,-68,-49,38,89,50
84,104,-17,31,-54,-66,19,126,227
103,152,0,31,-51,-66,22,168,359
15,98,-30,-50,-95,-127,-6,89,-106
48,25,-56,-24,-110,-95,-9,108,-113
137,171,-20,-38,-50,-135,21,188,274
91,124,-9,-17,-46,-74,4,136,209
23,91,12,9,-38,39,27,80,243
7,6,-92,-93,-163,-165,-77,75,-502
29,52,-99,-66,-158,-170,-59,131,-340
-16,34,-41,-122,-145,-177,-57,210,-314
-30,25,-64,-88,-70,-84,-32,124,-219
2,53,-29,-34,-17,-54,10,46,-23
-49,-14,-126,-88,-165,-209,-84,154,-581
84,102,-67,32,-176,-125,-2,86,-66
165,217,-115,-72,-370,-308,-26,461,-48
63,65,47,-9,39,-14,8,66,265
39,23,-10,-13,7,-4,21,31,94
31,25,-21,-9,3,-7,28,35,85
38,25,-55,-98,-83,-199,-10,138,-244
5,26,-70,-46,-143,-145,-29,106,-296
-7,14,-64,-52,-104,-101,-10,105,-219
39,85,1,-29,-1,-72,16,88,127
-6,61,-97,-84,-226,-219,-43,202,-412
97,183,-47,-54,-116,-219,-39,209,14
90,148,-86,-128,-98,-218,-11,235,-68
16,24,-13,-11,-30,-27,0,43,2
-16,34,-41,-55,-84,-132,-33,96,-231
1,-9,-14,-1,-19,-15,-1,26,-32
-20,-14,-58,-83,-81,-116,-21,95,-298
34,42,-7,-16,-25,-24,10,41,55
32,28,-13,-22,-94,-115,-20,103,-101
-6,28,1,13,-31,24,10,26,65
-23,96,-136,-158,-273,-249,-83,266,-560
55,53,-40,-28,-30,-70,19,85,44
80,73,12,-15,31,-58,39,83,245
-11,40,-74,-67,-62,-121,-21,95,-221
-12,72,-24,1,-85,-104,-5,164,7
20,-5,-36,-37,-68,-124,-25,51,-224
15,11,-8,-25,-14,-33,22,29,-3
28,63,-62,-58,-69,-74,32,27,-113
-5,7,-26,-15,-47,-23,-9,23,-95
46,77,11,2,-123,-141,-18,162,16
7,9,-2,-26,-6,-32,-13,51,-12
-9,22,-3,14,-23,-26,-26,48,-3
44,35,-63,-67,-156,-64,10,127,-134
7,61,-23,-36,-65,-66,-32,110,-44
-15,3,-19,-5,-51,-37,-18,27,-115
6,16,0,-5,3,-21,1,31,31
32,55,-21,-56,-10,-18,22,11,15
-21,-9,-32,-27,-75,-62,-24,65,-185
27,21,-79,-37,-127,-100,10,78,-207
12,29,-5,1,-14,-20,-5,20,18
-38,30,-26,-4,-78,-154,-70,82,-258
-8,-3,-94,-44,-172,-190,-35,101,-445
43,35,-26,-39,-69,-99,-12,107,-60
-25,6,-49,-82,-58,-145,-56,135,-274
141,197,30,-21,-29,-105,79,228,520
13,38,-23,-31,-75,-18,12,116,32
12,52,-3,-52,-18,-105,-12,82,-44
15,150,-21,-44,-11,-33,98,158,312
-9,61,-13,-32,-60,-104,-47,79,-125
66,54,-32,-31,-44,-44,2,68,39
32,37,-6,2,-35,-49,-16,48,13
-8,140,-2,-51,-5,13,45,142,274
-50,-35,-55,-50,-111,-144,-86,86,-445
5,19,5,-3,-6,-9,-15,29,25
81,120,56,-12,16,-93,19,143,330
-15,17,-35,-18,-54,-57,-8,46,-124
10,15,-5,-6,0,-12,7,19,28
-27,14,-12,-26,-25,-62,-1,39,-100
-31,-2,-6,-7,-29,-49,-25,38,-111
37,42,-34,4,-56,-72,3,50,-26
30,28,-59,-86,-134,-168,-62,199,-252
92,93,-3,-23,-28,-77,3,88,145
6,33,-43,-48,-93,-45,-7,37,-160
41,33,-37,-16,-71,-74,-26,103,-47
32,41,3,8,-26,-15,29,58,130
-6,0,-16,-18,-18,-1,-5,11,-53
48,112,31,-30,-6,29,56,105,345
142,164,108,-30,28,-42,35,175,580
69,70,-2,-12,-17,-36,17,75,164
-9,15,-21,-31,-20,-68,-15,63,-86
73,81,20,-15,-11,-29,0,128,247
154,140,-37,-26,-84,-106,70,159,270
30,34,-24,-24,-41,-74,11,61,-27
33,54,-37,-32,-56,-182,-47,80,-187
117,145,-40,-16,-68,-34,52,166,322
162,93,39,21,-37,-80,25,206,429
-2,61,-18,12,-71,-41,-12,109,38
-18,15,-8,-36,-38,-64,-23,48,-124
37,25,-27,-49,-64,-98,-12,105,-83
6,25,-8,-9,-15,-13,5,27,18
74,21,-98,1,-169,-114,53,121,-111
65,25,-74,-2,-109,-70,7,80,-78
68,110,-24,-63,-60,-180,-42,156,-35
1,25,-9,6,-27,-33,-4,32,-9
4,15,-14,3,-27,-25,5,29,-10
134,181,-32,-74,-83,-157,-15,212,166
99,156,-73,-78,-21,-47,28,211,275
-8,11,-11,-18,-40,-46,-7,46,-73
-19,130,-42,-31,-2,-45,31,119,141
43,119,15,-37,-42,-142,-41,119,34
-3,6,-4,-5,-23,-15,-4,19,-29
119,58,9,79,-93,-72,61,174,335
40,37,-41,-45,-90,-154,-17,116,-154
16,20,-40,-28,-94,-79,5,76,-124
5,23,-30,-20,-29,-16,4,29,-34
13,26,-33,-49,-20,-113,-18,106,-88
-4,7,-61,-24,-94,-43,-10,84,-145
40,79,-69,-120,-161,-240,-52,256,-267
3,12,-25,-1,-29,-34,4,10,-60
-10,11,-60,-39,-89,-119,-17,86,-237
12,123,-211,-147,-287,-216,-26,238,-514
-31,-32,-67,-44,-96,-110,-32,57,-355
-2,26,-38,-12,-84,-46,6,69,-81
110,222,-69,-59,-185,-214,43,318,166
14,26,-12,-6,-37,-45,15,67,22
17,29,-9,7,-29,-42,9,34,16
37,41,12,-22,-36,-125,-41,90,-44
27,30,-29,-12,-31,-52,-3,34,-36
18,16,-23,-45,-50,-88,-3,88,-87
13,15,-15,2,-50,-45,3,47,-30
3,20,-40,-37,-49,-51,3,57,-94
20,12,-21,4,-38,-18,12,32,3
6,20,-25,-3,-29,-7,19,28,9
191,454,6,-126,-474,-344,-43,814,478
48,95,14,-3,-14,-122,24,143,185
-1,-5,-47,-55,-72,-69,2,84,-163
1,6,-87,-60,-129,-135,-13,84,-333
94,160,-57,-42,-92,-116,52,221,220
-3,8,-33,-72,-66,-88,-12,54,-212
35,26,-32,-44,-112,-101,-43,182,-89
52,31,-10,-43,-110,-111,-49,195,-45
150,234,-70,-97,-146,-140,74,299,304
32,61,-21,-26,-60,-85,25,132,58
164,198,-1,-87,-124,-210,34,288,262
33,33,-129,-169,-211,-230,-40,317,-396
38,53,-19,-23,-48,-114,-17,98,-32
31,79,-21,15,-71,-93,-11,127,56
1,0,-34,-11,-94,-55,-9,64,-138
70,37,-18,-86,-110,-158,-41,196,-110
14,3,-73,-25,-92,-71,-18,59,-203
8,-4,2,-3,-22,-56,-21,90,-6
120,224,-45,-26,-129,-166,34,260,272
-2,21,-57,-54,-85,-140,-16,77,-256
30,57,-55,-63,-78,-102,-32,132,-111
35,16,25,-23,-88,-172,-41,215,-33
15,18,-34,-14,-42,-81,-1,65,-74
1,-6,-27,-20,-36,-34,-18,14,-126
1,-2,-28,9,-38,-63,-27,31,-117
39,44,-47,-56,-112,-102,13,93,-128
16,12,-41,-64,-112,-109,-4,73,-229
18,10,-7,-14,-28,-48,-12,52,-29
-19,8,-71,-44,-76,-142,-63,125,-282
28,42,-25,18,-28,-30,19,68,92
66,92,-164,4,-240,-198,21,105,-314
9,37,-19,-31,-57,-60,16,66,-39
3,42,-16,-28,-46,-105,-28,61,-117
127,103,-76,-72,-92,-185,24,191,20
184,203,-15,17,-77,-139,44,249,466
175,325,-41,-25,-55,-173,105,379,690
-16,7,-10,-2,-25,-12,2,18,-38
17,14,-9,-25,-3,-31,1,8,-28
49,126,-52,-48,-111,-200,3,167,-66
92,92,-136,-45,-201,-212,3,102,-305
103,173,-3,-30,-78,-88,44,227,348
20,-5,30,-35,33,-7,7,49,92
47,100,-54,-62,-98,-218,-17,207,-95
158,215,-3,8,-53,-16,6,215,530
29,175,13,24,-104,-218,-48,173,44
32,103,-7,-10,-60,-90,3,66,37
42,21,-80,-66,-148,-128,3,80,-276
16,69,-26,-53,-104,-156,-34,129,-159
-24,-17,-38,-35,-78,-91,-35,119,-199
80,216,-50,-45,-65,-159,-1,263,239
110,546,561,190,185,365,86,772,2815
121,124,23,9,-50,-78,37,261,447
-10,17,-25,-4,-8,-32,-3,25,-40
52,149,27,10,-51,-73,19,169,302
6,35,-8,-4,-42,-43,-7,37,-26
14,59,-5,-1,-24,-15,-13,85,100
24,44,1,-9,-5,-32,-2,42,63
12,18,-23,0,-18,-42,-12,20,-45
22,27,-40,-58,-41,-65,17,86,-52
86,133,-60,8,4,1,103,112,387
-112,-32,-119,-53,-164,-140,-96,142,-574
-22,6,-41,-16,-78,-125,-45,59,-262
-24,-11,-46,-4,-104,-135,-63,65,-322
127,146,4,-7,-61,-66,62,158,363
93,151,-44,-49,-89,-202,7,159,26
-15,28,5,4,-5,-6,-2,24,33
206,278,-64,-88,-110,-212,116,225,351
33,94,-51,-33,-175,-171,1,118,-184
15,32,-28,-35,-43,-107,-2,95,-73
15,87,-5,-11,16,-15,23,72,182
1,10,-8,4,-23,-8,3,4,-17
2,50,0,-32,3,-46,2,82,61
-7,-12,-17,-19,6,-13,2,12,-48
92,73,-1,-8,-47,5,52,111,277
115,212,-30,-31,-77,-204,-33,223,175
189,142,-125,14,-132,-158,111,287,328
4,5,-5,-3,-36,-56,-9,52,-48
22,74,15,-32,20,-30,4,84,157
92,196,-34,-68,-131,-176,52,292,223
-53,-11,-61,-15,-67,-118,-78,66,-337
266,333,1,-61,-170,-292,25,364,466
-2,39,-12,-30,-39,-44,3,61,-24
36,52,-8,-17,-49,-53,15,94,70
16,57,-11,-23,-46,-78,-2,77,-10
114,136,-193,-138,-290,-371,-45,225,-562
24,44,-18,-9,-34,-79,-33,66,-39
46,63,-1,-4,-72,-134,-16,93,-25
3,66,16,-7,20,21,17,70,206
142,206,-108,-58,-147,-186,70,227,146
12,43,-27,-19,-34,-31,12,52,8
342,404,3,5,-167,-103,140,556,1180
391,514,-127,-12,-263,-236,91,606,964
70,133,-85,-106,-172,-293,-69,271,-251
8,41,-19,21,-25,-82,-14,78,8
395,600,-28,94,-261,-203,167,784,1548
33,100,11,28,-73,-77,-1,154,175
556,831,-312,-356,-661,-782,15,1458,749
97,268,-115,-61,-27,-169,43,321,357
174,363,-104,-24,-300,-270,87,281,207
29,51,-15,-19,-13,-31,27,61,90
240,490,-11,-34,-41,-117,174,497,1198
-26,95,-71,-82,-26,-5,34,140,59
-9,-13,-27,-2,-42,-56,-17,28,-138
70,213,-23,4,-71,-113,59,181,320
33,74,-31,-61,-56,-45,30,87,31
12,28,-20,-13,-48,-26,16,38,-13
-5,38,-6,-25,-24,-55,-18,72,-23
-2,14,-3,-17,3,-25,9,26,5
219,36,-227,-259,-400,-572,-275,560,-918
86,117,6,-23,-33,-80,32,125,230
50,91,66,129,-168,-23,-6,159,298
209,245,-80,-42,-75,-155,107,320,529
3,19,-4,-16,0,-14,-4,33,17
113,178,-36,-18,-85,-94,37,204,299
84,160,-56,35,-85,-80,48,103,209
56,67,-13,-4,-145,-125,4,203,43
-12,-11,-181,-150,-264,-370,-126,184,-930
24,60,17,11,-20,-15,10,64,151
42,67,-42,-47,-115,-121,-9,157,-68
270,397,-41,-44,-311,-291,70,543,593
37,92,-44,-47,-102,-140,-4,75,-133
-10,32,-223,-107,-402,-300,-72,252,-830
214,233,24,23,-59,-133,46,244,592
-109,12,-113,-48,-202,-180,-83,141,-582
-42,-19,-95,-54,-119,-102,-31,59,-403
15,-13,-26,-27,-120,-101,-24,107,-189
120,166,-20,-21,1,-92,77,204,435
-3,99,-65,-43,-39,-39,41,152,103
-17,92,-83,-48,-32,-12,48,108,56
19,-2,-28,-6,-34,-42,-1,21,-73
61,71,-3,6,-34,-71,16,119,165
12,76,-6,-1,-11,28,33,70,201
24,57,-54,-68,-122,-134,-18,157,-158
9,289,1,-78,-106,-308,-18,369,158
150,184,-44,-67,-186,-293,-37,288,-5
155,201,-101,-83,-209,-272,-26,310,-25
29,40,3,-16,6,3,22,55,142
10,62,-38,-77,-81,-115,-27,168,-98
176,164,-30,9,-12,-105,65,163,430
70,122,-73,-74,-59,-166,61,180,61
54,34,-6,-4,-58,-54,0,21,-13
75,194,-197,-198,-363,-456,-105,465,-585
-109,-38,-134,-122,-152,-225,-91,111,-760
74,164,-12,-30,-134,-114,-6,256,198
19,14,7,-14,-40,-41,19,58,22
131,236,22,38,-24,-77,70,309,705
-5,-11,-34,-9,-56,-74,-21,33,-177
14,102,-47,1,-130,-90,10,142,2
26,52,-50,-30,-113,-144,-4,113,-150
66,90,7,-21,1,-20,23,79,225
-1,15,-14,-8,-59,-84,-20,51,-120
-51,5,-47,-44,-106,-94,-52,109,-280
33,105,-63,-34,-71,-174,-4,72,-136
197,248,-125,19,-210,-204,49,151,125
149,234,-58,-64,-202,-154,17,235,157
100,197,-12,-33,-72,-76,61,216,381
104,91,15,-15,-80,-65,33,138,221
19,58,-18,-19,-25,-8,35,39,81
91,137,-139,-57,-164,-125,57,227,27
31,55,19,28,-31,-7,22,51,168
-5,19,-18,-4,-46,-23,-11,29,-59
0,48,-59,-56,-106,-83,-14,107,-163
133,421,10,-114,-156,-492,-28,546,320
75,174,-98,-84,-68,-42,68,191,216
-1,62,-56,-70,-123,-216,-60,141,-323
-16,77,-103,-100,-212,-190,-7,117,-434
37,24,-95,-43,-137,-160,-37,94,-317
23,68,-8,19,-21,-58,3,60,86
139,210,-115,-46,-77,-98,115,157,285
36,17,-47,16,-96,-89,-16,72,-107
22,103,45,-2,-44,-30,16,158,268
114,335,279,79,98,216,97,460,1678
245,254,-51,-109,-203,-307,-7,372,194
164,275,-153,-16,-217,-202,31,296,178
-17,55,-70,-53,-119,-58,-13,98,-177
15,98,24,-47,-18,-12,-19,182,223
32,169,-76,-9,-149,-371,-85,160,-329
19,94,-40,-15,-66,-96,-10,63,-51
51,75,-23,-22,-84,-90,-1,116,22
187,231,53,45,-50,-140,40,336,702
79,108,-116,-105,-239,-205,21,328,-129
-6,112,-16,-45,36,-11,50,136,256
38,99,-54,-44,-47,-123,-2,90,-43
9,53,-51,-17,-97,-71,-10,107,-77
10,35,-26,-46,-113,-137,-35,115,-197
-26,23,4,-41,-25,-56,-24,71,-74
142,192,-235,-233,-196,-298,24,431,-173
103,175,52,22,8,-23,44,243,624
-80,104,-132,-141,-157,-253,-62,232,-489
108,158,-42,-55,-58,-133,46,124,148
-12,29,-5,-28,-35,-38,1,62,-26
6,30,-5,-27,-38,-51,1,58,-26
-1,39,-8,-33,-44,-46,7,60,-26
0,50,-24,-29,-33,-66,-20,83,-39
-4,16,-39,-8,-46,-65,1,58,-87
-15,-2,0,-11,-7,-22,-7,21,-43
-15,-5,-7,-14,-10,-19,-20,12,-78
-13,-12,-16,-16,-2,-15,-12,2,-84
8,20,-9,-7,-22,-16,1,28,3
-13,13,-12,-12,-8,-9,2,11,-28
-10,4,-3,-17,-4,-14,-11,3,-52
-7,-3,-14,-9,-23,-2,-2,-1,-61
-4,24,-18,-11,-5,-7,-7,15,-13
-13,1,-1,-10,-7,-4,-8,6,-36
-10,13,5,-9,-4,-25,-16,22,-24
-39,-7,-145,-131,-180,-236,-58,142,-654
-8,109,-90,-43,-14,-14,87,122,149
-28,2,-86,-49,-77,-163,-25,99,-327
34,57,-26,-13,-124,-190,16,175,-71
4,20,2,-34,0,-44,-11,44,-19
129,252,-59,-90,-109,-153,44,335,349
96,153,-31,-51,-64,-98,57,219,281
193,198,25,7,42,-78,71,242,700
175,213,-80,-6,-111,-74,110,187,414
4,62,-42,-62,-115,-152,-8,129,-184
39,67,-18,-13,3,-25,12,80,145
53,39,-82,-24,-130,-193,4,106,-227
21,43,-55,-56,-68,-121,9,116,-111
52,185,48,5,-117,-61,1,308,421
24,78,35,27,-49,45,24,132,316
22,65,20,-8,27,-33,17,63,173
-11,-27,-68,-41,-81,-89,-38,62,-293
19,27,-31,-16,-52,-88,-8,68,-81
100,104,8,-45,-94,-130,-20,203,126
90,183,-174,-175,-353,-517,-46,448,-544
39,54,-50,0,-49,-32,25,106,93
8,2,-11,-10,-6,-20,-9,12,-34
-6,24,-12,-19,-115,-91,-27,90,-156
5,7,-9,-7,-8,-25,-11,30,-18
155,181,-118,-4,-271,-298,-46,317,-84
30,76,7,-37,11,-24,-3,109,169
77,153,-79,-38,-52,-102,91,141,191
34,30,20,-21,2,-4,25,150,236
104,141,-1,-21,13,-90,33,185,364
144,337,-116,-36,-137,-251,43,290,274
103,281,-62,-36,-87,-148,57,218,326
22,10,-26,-8,-96,-23,-45,118,-48
35,58,10,-11,8,-41,14,74,147
31,55,5,-25,21,-46,22,65,128
67,161,16,1,-5,-76,60,201,425
6,10,-33,-21,-24,-50,-8,42,-78
17,49,-72,-94,-106,-218,-74,150,-348
-15,51,-47,-36,-10,-39,38,94,36
4,26,-2,-10,-12,-44,10,57,29
-2,36,-19,-2,-27,-46,-3,35,-28
4,27,-19,-36,-29,-51,-23,40,-87
10,53,-2,-21,-7,-54,13,67,59
-63,16,-54,-43,-93,-88,-37,100,-262
26,56,-15,-25,8,-6,29,54,127
-34,56,-103,-43,1,29,90,101,97
114,131,-10,-44,-68,-148,16,172,163
132,244,5,-27,9,-39,76,221,621
10,36,-20,-9,-58,-53,-9,80,-23
295,362,-19,3,-3,10,237,263,1148
-1,120,-17,-63,-6,-19,44,199,257
38,59,-54,-32,-90,-105,20,71,-93
-17,-9,-53,8,-92,-87,-34,32,-252
58,203,-21,-89,-34,-165,49,178,179
94,112,-35,-84,-56,-161,1,169,40
8,4,-19,-9,-19,-35,-10,34,-46
22,46,4,-22,-14,-56,1,71,52
1,26,-26,-13,-31,-75,-23,68,-73
502,578,-122,-154,-306,-417,92,811,984
-8,27,-22,-28,-67,-84,-24,54,-152
-8,3,11,-7,-11,-12,-5,38,9
-15,3,5,13,-18,6,-15,4,-17
-13,11,9,11,-16,10,-4,2,10
-21,14,16,28,-27,13,-12,11,22
-12,23,30,39,-44,23,-7,13,65
-16,23,22,42,-40,23,-5,8,57
-11,4,8,9,-24,-1,-14,-1,-30
-25,14,18,27,-30,14,-24,7,1
-13,3,-6,-7,-21,-7,-5,8,-48
-18,7,6,13,-37,10,-16,2,-33
-21,18,27,34,-32,14,-17,16,39
-18,14,25,28,-33,13,-22,9,16
-32,20,46,56,-36,28,-34,21,69
0,9,6,9,-15,-7,-11,7,-2
-19,17,19,15,-23,9,-8,11,21
-14,15,28,32,-33,11,-15,18,42
-23,15,28,27,-22,13,-23,21,36
2,17,8,-4,-39,-7,-31,40,-14
-12,39,26,10,-33,7,-22,43,58
31,81,10,-8,-21,-1,13,82,187
15,77,6,-12,-23,-21,-42,91,91
29,2,-16,-21,-29,-83,-25,82,-61
60,44,-100,43,-226,-148,-3,126,-204
16,29,-27,-11,-52,-17,15,57,10
89,114,-7,-42,-72,-205,1,140,18
119,178,20,-58,-59,-151,22,238,309
-5,100,-44,-50,-80,-164,-41,102,-182
20,-5,-13,-16,-41,-87,-34,75,-101
-10,129,-55,-60,-14,-25,47,152,164
3,41,-70,-70,-82,-124,-8,133,-177
-10,5,7,15,-20,-3,-4,3,-7
80,140,-67,-50,-49,-45,7,145,161
17,29,-62,-64,-157,-206,-30,70,-403
19,172,-81,-120,-173,-244,-33,275,-185
16,116,-54,-107,-12,-205,-10,201,-55
131,194,3,-11,-36,-133,21,190,359
-2,76,-33,-36,-29,-44,28,96,56
-20,0,-14,-16,-12,-35,-18,11,-104
58,71,30,-26,19,7,27,95,281
14,40,-24,-20,-86,-96,-7,123,-56
-14,-31,-72,-34,-120,-83,-49,57,-346
10,13,2,-20,-4,-47,-25,57,-14
19,60,20,12,-2,-15,15,65,174
54,118,-42,-49,-113,-173,-52,175,-82
40,105,-47,-46,-42,-54,18,91,65
-3,57,-70,-50,-14,-11,28,97,34
19,22,-37,-57,-41,-83,-9,77,-109
134,190,17,2,-20,-28,99,196,590
9,20,2,-12,2,-18,21,22,46
-26,3,-43,-31,-47,-94,-42,52,-228
-8,32,40,4,-18,-4,-25,52,73
3,93,-16,-29,-25,11,37,147,221
56,95,26,12,24,-36,28,121,326
16,31,-133,-77,-216,-126,14,168,-323
-27,23,-57,-56,-38,-163,-32,107,-243
52,80,-8,42,-174,-74,-26,131,23
158,136,1,14,-32,-19,98,152,508
123,173,19,7,-41,-51,55,144,429
68,95,22,-32,15,-60,33,138,279
-36,-15,-30,-44,-40,-94,-28,77,-210
-18,14,23,23,-27,10,-15,10,20
41,125,-66,-81,-139,-226,-55,238,-163
380,628,-134,-142,-115,-296,254,667,1242
70,108,-79,-119,-153,-265,-21,266,-193
28,33,-41,-53,-60,-188,2,142,-137
359,612,-121,54,-293,-436,-33,484,626
0,30,10,-9,2,-12,9,45,75
-26,8,-45,-9,-72,-69,-29,67,-175
42,88,-33,-5,-56,-50,19,105,110
212,212,-4,-12,26,-56,115,213,706
-9,-10,-17,1,-24,-33,-6,25,-73
37,9,3,-7,-88,-88,0,120,-14
-100,113,-127,-326,-327,-233,-162,391,-771
7,56,13,-17,12,-29,8,50,100
24,31,-2,6,-11,-35,-3,59,69
26,51,-34,-30,-41,-79,-8,85,-30
-26,86,-74,-23,-3,26,56,108,150
30,4,-18,-34,-124,-143,-45,158,-172
26,34,-19,-26,-28,-38,5,64,18
52,86,32,22,10,-9,27,117,337
-5,9,-11,-32,-23,-22,-10,49,-45
-21,97,-86,-54,-51,-24,84,137,82
171,271,-34,-13,-43,-58,139,276,709
9,15,-4,-10,1,-6,2,16,23
62,109,-35,-21,-50,-145,22,126,68
0,28,-37,-30,-79,-141,-45,124,-180
51,26,-72,-46,-174,-94,-17,183,-143
82,184,-235,-153,-389,-327,-39,394,-483
13,32,10,-2,0,-7,13,22,81
61,61,-37,-1,-51,-47,21,14,21
103,197,44,-16,-13,-78,20,211,468
102,149,-69,-24,-64,-109,30,135,150
-22,10,-42,-57,-72,-93,-32,87,-221
-31,51,-67,-48,22,-39,45,104,37
2,25,-25,-22,-63,-36,-20,60,-79
48,17,-23,-9,-149,-171,-30,93,-224
-5,53,-27,-40,-41,-46,-11,73,-44
10,21,-3,-24,-18,-28,-3,21,-24
-87,-2,-104,-73,-149,-179,-113,96,-611
58,104,3,-7,-58,-130,2,91,63
-76,3,-98,-59,-150,-181,-104,101,-564
43,37,-46,-64,-157,-177,-26,160,-230
63,28,4,-41,-42,-117,2,111,8
3,63,-44,-43,-69,-109,-30,102,-127
1,18,-8,-15,-13,-44,-6,49,-18
32,75,4,-46,34,-55,28,130,202
56,71,29,27,22,10,35,82,332
47,82,7,-22,30,-42,17,86,205
-7,22,-4,-26,-28,-30,-29,45,-57
9,16,-11,1,-32,-46,-9,40,-32
-42,-8,-117,-73,-158,-184,-71,126,-527
14,66,34,-11,19,-70,-6,82,128
84,114,-58,-44,-108,-174,20,130,-36
31,31,-4,5,-39,-43,-8,53,26
42,104,-15,-26,-53,-75,18,96,91
18,109,-19,-16,8,-22,59,114,251
30,23,-26,-56,-31,-105,3,100,-62
60,89,-81,-25,-110,-64,25,128,22
-6,22,-32,-11,-2,-13,21,29,8
161,278,-62,-34,-173,-155,25,271,311
118,174,6,-6,-17,-79,53,189,438
10,55,-71,-54,-28,-50,55,116,33
21,62,-82,-82,-179,-189,-43,168,-324
-6,4,-41,-12,-48,-53,-9,6,-159
79,231,-77,-114,-194,-293,-42,435,25
0,26,-56,-44,-74,-106,-35,81,-208
64,173,-26,-7,-5,-91,29,153,290
51,36,-47,-29,-96,-141,13,105,-108
43,43,-50,-45,-79,-121,-8,101,-116
8,23,1,-12,-17,-31,-11,27,-12
10,29,-2,0,6,-17,7,18,51
143,200,-97,1,-91,-102,59,167,280
14,62,-31,-50,-77,-114,30,131,-35
-53,-21,-66,-48,-69,-117,-63,74,-363
234,502,-106,-202,-278,-411,82,720,541
-1,34,-42,-58,-89,-165,-41,92,-270
59,157,-89,-66,-254,-334,-29,369,-187
9,29,-50,-55,-29,-123,-45,72,-192
177,265,2,-8,-68,-62,53,288,647
71,155,-32,-61,-86,-162,-34,180,31
-11,18,-64,-60,-60,-51,1,74,-153
5,28,1,-8,1,-11,-2,18,32
9,2,-10,-1,-32,-36,-16,23,-61
21,18,-4,-9,-17,-18,7,37,35
36,125,-105,-31,-60,-10,83,131,169
66,87,-11,-6,-44,-74,34,110,162
-1,11,-9,-11,-11,-13,-5,20,-19
11,64,-9,-6,-87,-57,8,100,24
3,24,0,-7,-7,5,27,28,73
-163,-48,-245,-210,-279,-356,-206,218,-1289
-31,492,-595,-702,-774,-836,48,1335,-1063
-5,9,-24,-63,-71,-101,-14,66,-203
21,73,-35,-6,-42,-25,5,51,42
23,166,29,57,-221,-109,44,227,216
28,80,-96,-106,-96,-181,43,203,-125
20,21,-30,12,-41,-45,28,43,8
6,15,-32,-34,-46,-88,-22,58,-143
141,245,-142,-36,-259,-237,46,194,-48
-1,23,-86,-63,-173,-187,-66,156,-397
112,128,44,-1,-6,-62,33,232,480
-1,-12,-8,-14,-51,-93,-38,67,-150
82,206,-46,-21,-89,-100,19,220,271
-27,43,-76,-75,-120,-95,14,108,-228
1,46,-13,-17,-38,-52,-13,78,-8
31,55,-59,-86,-54,-189,-49,110,-241
33,40,-30,-53,-57,-72,-10,101,-48
98,172,-23,-65,-236,-69,18,396,291
-16,17,-15,-22,-30,-49,-25,54,-86
139,233,-53,9,-72,-37,94,237,550
171,207,3,-19,-28,-81,130,293,676
-44,-43,-152,-169,-183,-231,-107,110,-819
-15,17,-9,-11,-26,-57,-25,55,-71
75,142,5,-23,12,-30,45,109,335
-32,-18,-34,-16,-57,-78,-51,40,-246
206,331,-86,-148,-176,-244,31,486,400
161,343,-134,-39,-160,-183,25,207,220
-56,122,-133,-111,-230,-221,-89,288,-430
64,579,16,-123,-381,-75,2,868,950
20,17,-22,4,-37,-51,-4,43,-30
-8,17,-8,-12,-7,-28,-13,18,-41
247,384,-160,-101,-144,-120,160,393,659
35,8,-17,-2,-41,-44,3,17,-41
-12,-1,-4,-2,-7,-21,-10,5,-52
-3,6,-13,-16,-4,-25,-7,28,-34
-33,10,-70,-11,-123,-182,-49,104,-354
82,158,-110,-34,-177,-160,24,151,-66
33,37,6,-1,17,19,39,22,172
28,34,1,-5,15,11,35,22,141
185,269,-72,69,-174,-204,24,121,218
18,65,-46,-48,-84,-90,-29,87,-127
-6,51,-92,-31,-14,-17,49,199,139
43,64,-11,12,-42,-32,24,90,148
93,84,-19,6,-23,9,50,78,278
18,72,-2,-73,-26,-82,-13,111,5
15,6,-25,-13,-32,-34,-6,25,-64
-9,-6,-24,-2,-16,-19,9,27,-40
51,211,11,-47,-16,-75,52,140,327
276,246,-154,16,-183,-171,141,310,481
-90,38,-140,-144,-267,-259,-88,272,-678
-101,38,-169,-173,-316,-287,-108,257,-859
-10,25,15,-4,4,-42,-3,49,34
43,143,-27,-18,-48,-92,28,156,185
-19,34,4,-26,-27,-39,-11,82,-2
14,43,-16,-21,-29,-22,38,28,35
71,98,-2,-21,-73,-89,38,159,181
-14,6,-24,-33,-29,-82,-40,59,-157
59,76,-70,-18,-95,-76,10,123,9
10,17,-15,-19,-28,-10,11,53,19
-7,16,-16,-9,-17,-26,-9,28,-40
137,305,-90,-88,-288,-422,-16,541,79
466,490,26,-128,15,-107,181,622,1565
27,25,-52,-25,-57,-178,-11,179,-92
-66,12,-101,-59,-144,-164,-56,117,-461
128,181,-167,-98,-269,-249,49,249,-176
78,110,-66,-16,-72,-127,6,101,14
2,0,6,-7,2,-2,-2,26,25
42,94,-90,-75,-144,-308,-36,280,-237
110,150,4,18,-45,-48,56,157,402
27,38,2,10,-19,-26,-1,37,68
-7,111,-60,-40,-110,-195,-81,190,-192
49,86,19,-27,-46,-95,-22,130,94
36,65,-44,-26,-28,-52,5,71,27
49,104,-23,27,-80,-155,-13,124,33
18,26,-12,7,-5,-36,6,6,10
-1,9,-8,3,-52,-50,-25,51,-73
42,81,-39,-40,-68,-71,4,138,47
-3,57,31,7,-39,14,-16,51,102
-36,108,64,75,-97,4,4,123,245
124,168,-48,-62,-117,-123,44,261,247
162,284,-107,-35,-144,-264,-5,335,226
10,41,-10,-3,-2,6,22,45,109
17,25,1,-6,3,-10,15,27,72
-49,129,-112,-97,-43,37,73,190,128
16,58,12,-2,-12,-8,7,47,118
27,86,-14,-48,-24,-48,16,102,97
23,24,-6,-10,-1,-12,0,29,47
-6,11,-4,-8,-20,-15,-4,19,-27
42,82,-6,-25,-87,-68,-8,116,46
88,165,31,-77,-50,-71,-19,319,386
55,179,-5,-70,-123,-92,43,358,345
106,146,14,-19,-45,-119,40,130,253
213,268,128,24,32,-104,26,305,892
-39,38,-63,-38,-105,-70,-25,90,-212
30,77,10,-10,-11,-108,-15,64,37
32,121,-81,-20,-100,-114,-18,66,-114
142,197,-27,-53,-70,-55,92,195,421
-2,34,-16,-33,-48,-103,-27,82,-113
4,35,-39,18,-74,-87,-18,66,-95
101,137,2,17,4,-2,57,167,483
65,71,-23,-27,-6,-32,29,134,211
-16,16,-37,-21,-34,-49,-16,37,-120
9,5,-16,-2,-39,-34,6,60,-11
-21,-1,-17,-24,-28,-62,-23,41,-135
32,38,-45,-61,-78,-76,-3,122,-71
-7,19,-26,-66,-108,-106,-54,86,-262
-7,39,-40,-36,-158,-96,-21,116,-203
25,28,-16,-11,-19,-22,24,29,38
-84,-7,-123,-103,-177,-193,-138,124,-701
28,61,-16,-22,-28,-29,22,107,123
33,153,-23,-23,10,-54,51,144,291
82,118,-32,-15,-40,-63,18,98,166
52,239,-27,-19,-170,-226,21,251,121
-29,10,-65,-19,-96,-67,-20,63,-223
83,154,-92,-24,-100,-124,16,138,51
34,48,-65,-74,-62,-121,9,129,-102
38,50,11,7,-122,-144,-80,154,-86
-2,38,-51,-43,-63,-85,-4,89,-121
56,61,-29,-92,-46,-108,6,151,-1
17,51,-27,-46,-89,-92,28,86,-72
6,27,-15,-10,-18,-15,3,11,-11
-27,19,-40,-34,-95,-98,-51,117,-209
23,46,-30,4,-26,-43,12,37,23
-15,3,-27,-40,-67,-47,-24,57,-160
6,22,-42,-1,-104,-69,16,75,-97
37,104,-22,1,-29,-77,31,67,112
28,52,-15,14,-153,-134,-29,128,-109
66,26,-33,-45,-81,-95,-23,97,-88
-39,-47,-46,-43,-50,-118,-65,38,-370
22,41,-28,-31,-66,-23,13,91,19
0,49,-5,-1,-18,-61,4,77,45
75,122,-13,3,-40,-59,48,169,305
19,18,2,-14,7,-17,23,16,54
101,121,-22,-13,-77,-78,50,127,209
28,86,-52,-45,-53,-92,-12,143,3
-19,10,-17,-11,-33,-62,-48,65,-115
1,71,-88,-101,-149,-281,-101,169,-479
26,104,45,22,-37,2,26,145,333
18,23,-5,6,-37,-55,-11,23,-38
25,47,-35,-7,-57,-69,10,106,20
-12,36,-10,-12,-49,-84,-38,67,-102
20,23,-26,-39,-61,-43,-8,36,-98
-7,7,-25,-5,-21,-13,14,14,-36
9,7,-24,-9,-61,-82,-22,69,-113
14,35,-6,-15,-12,-30,10,47,43
285,322,-76,-82,-101,-136,142,364,718
102,175,74,-16,65,-48,20,192,564
67,106,-49,-26,-36,-81,36,121,138
36,49,-64,-41,-59,-144,-34,109,-148
-37,-8,-45,-27,-63,-97,-46,67,-256
200,272,10,-53,-19,-174,58,348,642
63,92,-45,-61,-54,-109,25,182,93
87,366,12,-101,-235,-379,33,528,311
263,351,-69,-53,-105,-179,77,394,679
0,9,-42,-33,-102,-63,-6,48,-189
68,88,-99,-47,-121,-121,31,84,-117
-7,-1,-11,-6,-35,-63,-10,27,-106
24,42,-2,20,-41,-2,28,56,125
63,90,18,-35,22,-19,13,91,243
109,130,-38,4,-32,-35,61,191,390
127,275,-43,-53,-93,-131,33,165,280
-1,14,-51,-67,-34,-44,1,24,-158
70,153,-68,-46,-54,-59,43,188,227
48,45,-15,-15,-33,-43,17,82,86
9,17,-5,3,-12,-22,-2,25,13
127,264,-75,-85,-108,-180,92,430,465
4,16,-25,-8,-31,-9,-1,32,-22
6,32,-11,5,-10,-23,14,48,61
12,35,-40,43,-69,-81,-13,31,-82
52,98,-157,-139,-231,-310,-47,215,-519
18,26,-26,-15,-53,-21,31,48,8
8,39,40,6,14,5,15,53,180
134,109,-27,13,-131,-145,1,249,203
73,101,-53,-45,-140,-164,-55,215,-68
201,221,-121,-205,-381,-281,22,635,91
148,229,-35,-21,-190,-337,-1,281,74
203,237,-128,-52,-114,-164,99,255,336
40,39,-76,-56,-73,-65,15,46,-130
-3,65,-84,-52,-81,-95,6,81,-163
26,78,-98,-63,-103,-135,10,117,-168
6,70,-67,-41,-75,-68,14,31,-130
2,57,-62,-31,-37,-32,19,37,-47
33,41,-64,-42,-79,-102,-16,86,-143
12,31,-12,-12,-33,-30,9,65,30
-58,0,-35,-35,-20,-75,-32,64,-191
146,174,-34,-72,-115,-113,45,234,265
19,75,-28,-8,-83,-84,-6,95,-20
8,9,-8,-7,4,6,10,13,35
-1,82,-46,-59,-183,-193,-60,195,-265
14,23,0,50,-47,-4,8,43,87
-31,-22,-65,-35,-86,-83,-34,50,-306
69,123,-162,-58,-186,-178,-60,123,-329
-28,-24,-34,-23,-11,-67,-23,13,-197
117,211,-85,-4,-157,-160,15,98,35
-27,-5,-39,-23,-42,-57,-28,29,-192
7,2,-51,-5,-71,-109,-20,40,-207
-100,-70,-93,-68,-71,-190,-99,83,-608
13,33,9,0,-3,-15,14,35,86
37,89,5,-36,-6,-77,1,75,88
-6,60,-67,-29,-174,-172,-39,191,-236
57,102,-33,-52,-54,-35,39,97,121
11,31,-16,-30,-30,-106,-31,77,-94
-3,20,10,-3,1,-27,-9,25,14
45,140,-35,31,4,35,69,74,363
67,143,37,28,-50,48,63,209,545
10,16,-8,-1,-15,-40,1,8,-29
24,9,-5,-5,-17,-19,14,35,36
8,28,-21,-21,-28,-75,-18,59,-68
69,159,-72,-20,-132,-145,28,204,91
81,162,-108,-56,-184,-135,29,138,-73
-28,77,-51,-42,4,-20,52,167,159
585,1166,-862,-724,-1451,-1431,-261,1831,-1147
15,78,-38,-25,-117,-185,-41,121,-192
93,146,67,-20,32,-49,25,184,478
355,1192,1056,966,96,813,195,1594,6267
30,172,-74,-98,-247,-205,-65,381,-106
29,40,-7,-7,-17,-9,23,33,85
-3,1,-16,-12,5,-12,-4,8,-33
14,68,-4,-23,-100,-43,-11,167,68
-22,23,-9,-67,-26,-99,-45,64,-181
157,335,5,34,-8,-93,105,384,919
56,125,-32,-41,-56,-84,13,67,48
12,-10,-13,-36,-12,-32,8,25,-58
28,75,-37,-50,-76,-104,13,69,-82
4,21,-12,-15,-11,-18,-2,35,2
-15,31,-24,-28,-18,-43,-5,37,-65
10,18,-11,3,-3,-8,4,32,45
-2,31,-25,-23,-42,-40,-3,33,-71
124,116,-73,-17,-41,-74,42,107,184
84,135,-45,-48,-15,-70,29,158,228
-5,11,-98,-22,-152,-134,-37,132,-305
205,287,15,9,-11,-176,83,325,737
56,112,-124,-113,-200,-198,20,203,-244
110,249,-83,-59,-111,-65,104,251,396
-15,61,-10,-49,0,-30,22,90,69
18,16,-3,-15,-23,-31,-5,44,1
-20,7,12,-26,-74,-121,-56,103,-175
20,38,-28,-2,-68,-71,-14,141,16
17,23,42,14,-59,-76,9,124,94
1,9,-7,-17,-27,-37,-28,32,-74
-14,-4,-22,-46,-18,-23,-16,27,-116
14,37,-12,-13,-17,-51,-8,42,-8
17,106,-37,-40,-185,-128,-6,191,-82
-86,-47,-77,-69,-94,-151,-86,48,-562
-1,53,-69,-36,-128,-137,-33,122,-229
-34,28,-21,-24,-110,-131,-44,129,-207
-13,-9,-66,-21,-154,-127,-39,152,-277
-68,-23,-75,-71,-108,-137,-95,97,-480
38,36,-38,-20,-59,-74,-17,63,-71
-24,64,-60,-73,-186,-235,-105,233,-386
7,2,-2,-19,1,-43,0,35,-19
-68,84,-128,-103,-214,-305,-118,245,-607
79,211,-150,-291,-265,-381,-58,565,-290
-2,70,-31,-39,-47,-49,-3,57,-44
10,15,-8,-8,-24,-33,-13,49,-12
79,123,3,-14,7,-42,54,142,352
-15,18,-18,-17,-48,-76,-23,73,-106
368,567,2,-95,-32,-138,189,619,1480
53,70,-22,-6,-90,-47,30,150,138
16,15,6,-5,4,-5,8,26,65
9,45,-38,-30,-64,-161,-59,77,-221
88,161,-59,-40,-12,-43,86,138,319
56,90,4,9,26,19,67,36,307
81,122,-50,-26,-59,-69,54,115,168
101,107,-61,-25,-97,-123,10,165,77
460,318,-104,467,-733,35,310,739,1492
96,166,-70,-76,-147,-214,-53,216,-82
-8,47,-50,-53,-108,-96,-15,137,-146
184,222,-128,43,-154,-141,218,263,507
4,134,-255,-183,-279,-500,-172,336,-915
78,515,68,-150,262,-128,103,334,1082
133,174,17,-6,-123,-119,5,250,331
-2,52,-45,-59,-16,-23,44,112,63
-54,-29,-125,-86,-246,-252,-84,237,-639
277,530,-227,-154,-347,-202,127,677,681
25,35,-23,-19,-41,-99,-21,80,-63
11,17,-6,-17,-40,-38,-13,76,-10
-40,-23,-42,-52,-44,-91,-40,71,-261
44,117,-74,-6,-18,-23,33,77,150
-1,32,-39,-27,-76,-80,19,62,-110
152,220,-13,-85,-4,-35,103,277,615
17,134,-63,-48,8,-5,63,193,299
-34,20,-16,3,-45,-35,-20,48,-79
159,197,-1,-33,-40,-93,49,229,467
34,42,-6,-6,-17,-4,23,35,101
29,51,1,-7,-15,-48,3,75,89
267,388,-12,-52,-43,-134,144,461,1019
93,137,22,-44,2,-106,46,184,334
-25,-18,-84,-73,-140,-124,-48,91,-421
19,27,-18,5,-22,-23,21,39,48
26,-3,-17,-3,-26,-41,1,24,-39
-102,-74,-99,-68,-82,-190,-101,87,-629
56,272,92,85,-103,-132,-42,264,492
-6,17,-10,-4,-8,-16,-4,9,-22
-8,8,-3,3,-31,-37,-9,34,-43
-50,-30,-36,-33,-59,-33,-35,38,-238
10,133,-54,-51,1,-28,79,181,271
12,9,-22,-27,-28,-12,24,28,-16
340,522,103,-49,87,-33,213,573,1756
-23,157,-143,-147,-262,-196,-37,331,-320
308,465,-229,-111,-365,-244,86,341,251
33,71,-19,-33,-93,-139,-4,101,-83
5,27,-37,-36,-38,-70,-7,71,-85
-14,26,-36,-8,-77,-60,-13,68,-114
68,54,-30,39,-79,-50,45,84,131
142,166,-94,32,-155,-134,14,203,174
-3,4,-12,-11,-10,-28,-11,13,-58
4,9,4,-16,9,1,7,17,35
15,3,-24,-16,-42,-27,4,33,-54
-56,-11,-51,-51,-92,-124,-55,52,-388
23,48,-16,-14,-10,-9,11,43,76
49,79,-17,-47,-66,-101,5,118,20
316,408,-76,-20,-109,-168,124,420,895
33,44,1,6,-30,-28,18,63,107
423,445,-37,-12,-132,-301,95,506,987
65,284,-19,-110,121,-72,63,212,544
24,42,-3,-5,-11,7,26,33,113
78,101,-33,-1,-36,-42,-5,117,179
-59,-17,-55,-71,-77,-82,-57,74,-344
-4,3,-4,-40,-97,-59,-33,89,-145
52,106,-90,-105,-85,-231,-36,178,-211
66,107,-45,-46,-85,-119,-21,182,39
-23,-6,-36,-17,-79,-44,-22,70,-157
6,7,-11,3,-26,-47,-11,32,-47
163,186,-62,-83,-97,-139,18,236,222
69,136,-31,-63,-55,-158,-42,218,74
73,102,-286,-225,-382,-497,-67,389,-893
77,169,-40,-20,-65,-102,36,183,238
-11,19,-6,-16,-17,-36,-1,31,-37
17,9,-14,-3,-10,-8,16,2,9
49,67,-58,-100,-10,-156,-23,142,-89
580,812,124,107,36,-10,405,800,2854
6,19,-32,-20,-57,-40,-10,43,-91
-1,23,-8,-6,8,-3,10,30,53
85,115,65,22,20,-2,57,142,504
22,33,2,0,-12,-37,-5,7,10
256,342,18,23,12,-134,96,399,1012
141,186,7,-8,-14,-102,40,184,434
18,48,5,-4,-76,-105,-7,79,-42
19,164,-203,-80,-307,-329,-3,277,-462
6,19,-3,13,-9,-15,6,15,32
0,43,-13,-5,-81,-56,15,65,-32
109,149,-39,-54,-75,-71,57,186,262
84,129,-26,-15,-103,-119,19,158,127
12,58,-48,-48,-86,-93,-29,84,-150
23,47,0,-6,-7,-35,28,79,129
82,103,-80,-30,-264,-249,-21,172,-287
51,50,-20,-38,-68,-156,-53,130,-104
101,136,-72,-10,-67,-122,8,111,85
-14,28,-45,-35,-59,-91,-22,70,-168
349,454,199,-10,4,-97,99,512,1510
46,118,4,-8,-24,-52,44,89,217
-24,88,-82,-86,-223,-300,-60,299,-388
26,42,10,-2,1,1,23,35,136
18,25,-29,-37,-53,-40,15,75,-26
-6,23,-26,-22,-30,-57,-16,48,-86
14,25,-10,-5,-14,-23,9,23,19
14,39,-24,-42,-42,-33,6,46,-36
257,502,-40,-84,-188,-297,124,556,830
12,-14,-73,-26,-96,-132,-40,65,-304
-40,138,-82,-91,0,-5,52,200,172
-3,44,-73,-40,-32,-8,21,51,-40
47,20,-67,-107,-104,-113,-19,113,-230
97,102,31,5,-1,11,94,97,436
54,85,-43,-23,-22,-51,19,117,136
-26,12,-34,-47,-87,-91,-39,55,-257
244,163,-19,34,-95,-149,131,272,581
-2,29,-16,-3,-48,-57,-12,46,-63
129,343,-202,-188,-501,-672,-125,669,-547
2,35,-5,-7,-2,-34,-12,55,32
-2,34,-8,-8,-12,-26,-5,53,26
3,48,-12,-12,-71,-39,-3,94,8
22,2,-18,-10,-30,-42,6,30,-40
93,146,28,-9,27,-27,37,148,443
26,57,16,-32,-7,-54,-16,111,101
-8,20,-20,-23,2,-62,-23,50,-64
191,172,-145,-44,-230,-146,184,372,354
153,242,-90,-4,-160,-271,32,264,166
53,172,-21,-45,-139,-177,-4,242,81
19,29,-5,3,-10,-12,7,30,61
-23,-11,-17,-14,-30,-30,-18,36,-107
11,131,24,7,-100,-158,-5,235,145
20,49,-28,10,-138,-175,-43,145,-160
55,107,-225,-151,-248,-332,-57,283,-568
146,162,-106,-122,-156,-254,31,320,21
135,140,45,6,-38,-85,-60,224,367
184,315,-78,11,-171,-183,37,283,398
-34,5,-52,-41,-66,-100,-39,106,-221
-44,32,-73,-16,-139,-84,-28,112,-240
156,330,-90,3,-219,-219,5,232,198
57,156,-30,2,-15,-1,80,122,371
5,23,-35,-49,-56,-73,-16,91,-110
-17,67,-104,-58,-42,-32,50,150,14
45,69,-105,-77,-142,-231,-73,184,-330
20,30,0,-2,2,-7,3,21,67
29,45,-11,3,2,-4,15,32,111
50,66,1,6,-9,2,21,53,190
75,86,11,7,-13,-5,28,92,281
12,61,20,-31,-12,-41,3,85,97
35,37,-24,-37,-35,-42,-1,81,14
-8,30,-45,-60,-82,-144,-34,97,-246
-8,17,-44,-31,-62,-53,-5,77,-109
33,51,-60,-31,-107,-88,16,136,-50
-18,22,-32,9,-114,-130,-35,108,-190
-4,-10,-31,-64,-34,-153,-56,77,-275
32,34,-10,-2,-14,-29,26,51,88
-57,-24,-73,-86,-115,-127,-62,90,-454
43,64,10,-9,15,-27,36,79,211
123,160,33,-4,-24,-130,19,233,410
33,79,-32,-39,-49,-48,12,54,10
-75,16,-76,-59,-93,-137,-76,94,-406
-15,-6,-24,-31,-7,-25,-11,26,-93
341,405,-62,20,-101,-147,127,491,1074
-15,1,-27,-8,-42,-54,-8,42,-111
18,19,-23,-3,-44,-74,-13,52,-68
232,302,-4,37,-70,-13,153,243,880
22,74,-10,-36,-40,-110,2,102,4
172,215,-70,-39,-96,-62,49,270,439
-49,-48,-66,-42,-78,-108,-38,32,-397
4,19,-23,-6,-30,-10,18,27,-1
48,151,42,-33,-26,-70,7,176,295
65,92,-65,-76,-120,-163,-8,183,-92
-13,17,10,-11,4,7,-6,44,52
80,124,-59,-42,-114,-179,-27,229,12
33,24,-57,-18,-117,-171,-25,69,-262
-21,9,-64,-18,-91,-98,-40,57,-266
5,35,-16,-14,-25,-19,17,25,8
260,364,-131,17,-231,-181,209,329,636
-17,24,-10,-8,-16,-11,-9,33,-14
10,60,-46,-50,-84,-93,-26,85,-144
32,42,-15,13,-67,-60,19,60,24
44,44,-33,-33,-32,-48,-5,63,0
2,275,-230,-202,-489,-725,-168,627,-910
2,18,-30,-48,-60,-99,-36,60,-193
63,111,-13,-6,-54,-164,-23,209,123
232,337,-27,56,-273,-211,158,335,607
2,41,-25,-27,-34,-53,1,94,-1
82,164,-108,-39,-175,-154,26,142,-62
28,57,23,-38,22,-83,-33,90,66
96,106,-10,-34,10,-55,36,138,287
27,114,-55,-65,-37,-81,19,96,18
61,69,-28,40,-83,-62,31,78,106
35,56,-56,-34,-67,-100,16,48,-102
40,45,-35,-29,-34,-54,18,44,-5
22,48,6,5,-23,-18,20,48,108
-44,13,-89,-11,-148,-142,-40,129,-332
82,61,-33,6,-31,-33,56,84,192
-1,6,-12,29,-54,-59,-32,47,-76
7,220,-197,-165,-390,-619,-199,312,-1031
7,33,-20,-17,-33,-47,8,78,9
3,75,-67,-8,-105,-165,-40,109,-198
35,9,-9,-50,-32,-111,-46,86,-118
114,189,-43,1,-85,32,114,153,475
-20,38,-2,-13,-8,-28,-12,33,-12
203,231,-34,202,-209,1,-44,294,644
85,186,-75,1,-41,-22,119,170,423
8,37,-4,1,-20,-41,-1,32,12
65,142,-52,-77,-142,-273,37,230,-70
5,8,-5,8,1,-31,-8,16,-6
-11,-3,-14,-29,-25,-45,-17,26,-118
240,252,38,3,-30,-21,140,283,905
3,11,-5,-28,7,-26,-4,25,-17
55,178,-62,-100,23,-121,45,227,245
-23,-12,-37,-20,-86,-68,-31,52,-225
57,164,-148,-97,-255,-210,-74,282,-281
166,247,32,33,-33,-79,71,203,640
356,434,-119,-123,-191,-156,147,485,833
37,41,-39,-11,-62,-73,10,54,-43
105,170,-12,-27,-6,-147,14,198,295
-4,29,-40,-15,-24,-78,-14,59,-87
-27,96,-9,-25,-43,-146,-64,86,-132
-13,76,-4,-60,-57,-129,-47,101,-133
4,53,22,-7,25,2,10,54,163
12,44,-58,-44,-104,-113,-17,112,-168
42,125,-44,-21,-46,-64,28,150,170
-32,95,-98,-60,26,30,57,77,95
306,454,-10,-21,-113,-198,148,447,1013
6,30,-16,-6,-52,-10,10,50,12
16,16,-7,1,-5,2,15,11,49
6,121,-40,-96,-74,-121,-17,191,-30
16,23,-12,-7,-7,-27,-1,17,2
-74,-35,-142,-164,-184,-250,-122,191,-780
21,52,20,15,-14,-19,15,32,122
204,364,-22,-63,-187,-293,38,483,524
12,16,-24,-35,-21,-104,-23,52,-127
480,581,136,66,-65,-64,196,689,2019
68,140,5,-16,-1,-65,33,154,318
51,45,5,-9,-21,-19,39,49,140
19,25,-12,-40,-53,-91,-14,61,-105
50,47,28,26,-10,-37,-2,74,176
65,63,-22,8,-47,-43,3,87,114
115,367,-221,-490,-548,-556,-49,841,-541
104,267,-13,4,-99,-127,-20,180,296
95,49,-65,2,-69,-101,43,90,44
217,668,24,-289,-255,-760,-47,1032,590
14,16,-30,-16,-57,-63,15,50,-71
43,45,38,21,15,0,19,84,265
35,57,3,-5,-23,-16,35,87,173
47,105,43,30,-26,12,34,136,381
49,124,-32,-22,-9,-34,35,146,257
2,32,-18,-8,-43,-34,3,67,1
209,215,-66,-18,-101,-181,107,207,372
6,20,-2,2,-23,-29,-2,38,10
23,52,-32,-2,-5,-17,18,26,63
28,45,-24,-10,-38,-42,22,50,31
30,104,-159,-80,-245,-248,-28,216,-410
82,80,-61,-47,-44,-92,8,91,17
-7,35,-38,-37,-44,-27,-15,62,-71
34,49,-29,-7,-52,-46,0,42,-9
177,220,-25,-42,-75,-139,16,369,501
365,406,64,-38,160,-119,177,440,1455
75,137,8,-25,-36,-77,53,142,277
8,36,-70,-42,-133,-157,-42,100,-300
-14,63,-82,-70,-141,-188,-44,116,-360
-28,64,-91,-107,-189,-235,-61,178,-469
57,166,-127,-130,-198,-279,-67,158,-420
40,43,-2,3,-10,-7,18,57,142
13,32,-7,-8,0,-42,-5,49,32
-17,396,-49,-278,-478,-313,-233,843,-129
46,38,-13,26,-27,-4,36,59,161
5,21,10,5,-14,-8,15,53,87
271,330,-73,-9,-205,-189,76,368,569
149,206,-55,-16,-36,-41,35,287,529
-61,11,-45,-46,-100,-127,-79,94,-353
508,986,147,-63,178,-127,372,993,2994
-6,0,-27,-22,-17,-18,-7,27,-70
14,94,-92,-96,-134,-108,1,137,-184
468,726,-53,-213,20,0,292,218,1458
-1,17,-19,-8,-36,-40,-16,27,-76
111,110,26,-53,34,-68,17,98,275
30,63,-34,-21,-51,-45,27,82,51
4,7,-19,-8,-25,-30,-10,27,-54
25,77,-11,-13,-29,-31,-24,98,92
77,46,-25,-3,-71,-49,39,115,129
22,19,-90,-68,-141,-224,-95,150,-427
7,-4,-19,-4,-25,-28,3,13,-57
28,48,-53,-25,-105,-104,-3,57,-157
13,15,-60,-49,-74,-103,-19,59,-218
24,17,-39,-47,-103,-96,-14,65,-193
62,86,-154,-59,-295,-242,-35,225,-412
51,63,-71,-69,-98,-121,-3,110,-138
57,99,-64,-48,-91,-59,30,138,62
19,45,17,32,-23,9,21,64,184
-61,-35,-126,-123,-169,-264,-108,130,-756
81,142,-43,28,-16,4,85,109,390
140,182,-67,-44,-118,-55,90,278,406
-38,166,-169,-35,-388,-576,-195,335,-900
-10,7,-13,-17,-10,-22,-8,20,-53
18,51,-34,-15,-67,-93,11,81,-48
65,64,-44,-22,-90,-88,12,101,-2
41,97,-62,-109,-141,-204,-25,140,-263
294,332,47,36,8,-101,143,320,1079
60,45,-26,-37,-92,-178,-29,82,-175
-34,-14,-76,-44,-185,-284,-129,144,-622
21,99,-23,-15,-44,-116,-22,98,-2
5,62,-25,-14,-13,-80,5,49,-11
26,32,13,-3,-4,3,22,34,123
16,19,6,9,-15,-33,0,41,43
328,628,-558,-251,-1177,-1347,-287,1297,-1367
-20,-10,-33,-14,-54,-40,-33,34,-170
93,176,-63,-40,-54,-166,-2,208,152
47,77,14,-7,-15,-36,24,75,179
24,6,-15,-25,2,-42,0,33,-17
9,53,26,13,-1,11,15,51,177
7,45,40,22,0,22,15,46,197
16,192,-77,-126,-156,-128,8,320,49
-2,33,-53,-29,-26,-32,9,98,-2
21,54,1,-7,13,2,28,43,155
114,191,-88,-55,-154,-182,4,233,63
12,34,-25,-21,-74,-104,-29,100,-107
26,61,-57,-16,-60,-102,-4,59,-93
436,515,-33,-103,-140,-223,219,600,1271
51,95,-51,-26,-100,-112,1,81,-61
359,569,-68,-148,-166,-189,131,639,1127
89,156,-38,-81,-58,-160,6,205,119
272,382,-166,-73,-181,-269,125,383,473
-72,66,-133,-96,-229,-239,-150,242,-611
100,151,1,-8,29,-17,83,144,483
31,40,-17,-6,-71,-27,37,91,78
110,203,-135,-13,-208,-173,-10,119,-107
31,47,-12,-2,-35,-24,13,73,91
17,31,-14,-8,-32,-22,17,40,29
171,234,0,-14,19,-22,107,259,754
22,40,10,-5,-72,-74,9,126,56
336,393,86,103,-126,-75,54,523,1294
12,25,-23,-9,-27,-54,-4,47,-33
-49,55,-91,-88,-131,-247,-104,131,-524
38,71,42,-16,38,8,33,89,303
-11,15,-15,-14,-11,-42,9,44,-25
34,86,-43,-2,-56,-85,-5,134,63
-3,0,-49,-46,-97,-102,-40,33,-304
16,12,4,-4,-9,-7,30,49,91
-81,-41,-186,-140,-251,-233,-119,200,-851
1,27,-1,-9,-14,-10,-17,40,17
-1,14,-8,-24,-6,-33,-4,34,-28
117,245,122,-31,87,108,101,228,977
18,67,26,19,-11,81,16,54,270
-5,63,42,28,-19,33,15,51,208
2,60,37,26,-18,37,15,51,210
0,64,37,21,-14,28,14,51,201
-5,60,43,19,-13,34,14,49,201
-1,-14,-75,-20,-88,-124,-20,71,-271
179,294,-7,-78,-128,-142,75,434,627
27,78,-11,-5,-33,-67,-1,87,75
-18,33,-58,-41,-73,-109,-35,39,-262
70,224,-67,-69,-101,-127,7,193,130
160,260,-18,-19,-90,-172,43,326,490
30,67,5,-25,-9,-33,15,42,92
-5,58,35,17,-5,26,15,46,187
-1,62,43,30,-18,31,10,51,208
-19,21,-8,-21,-10,-53,-25,38,-77
34,67,-46,-69,-63,-129,6,96,-104
13,34,-46,-13,-36,-50,-5,52,-51
76,109,-41,-5,-39,-69,32,110,173
112,108,-104,5,-189,-143,1,254,44
14,81,-69,-54,-62,-74,13,84,-67
98,205,-100,-38,-135,-220,1,341,152
18,41,-7,-2,10,7,24,28,119
17,59,1,-14,16,-6,20,16,109
195,293,-154,-147,-189,-260,47,377,162
293,385,-6,33,-93,-60,171,368,1091
64,88,-5,-18,-58,-23,26,146,220
55,96,-9,3,-61,-45,19,114,172
32,63,-20,-60,-40,-71,5,89,-2
204,278,13,-92,-21,-88,69,318,681
74,94,11,-6,-23,-19,49,104,284
94,92,8,31,-13,-81,17,147,295
62,90,-54,-20,-149,-151,21,76,-125
53,102,-5,-15,-26,-37,11,141,224
16,67,-20,-25,-50,-100,-9,82,-39
-6,22,-28,-35,-91,-107,-44,59,-230
-85,-45,-94,-68,-129,-114,-50,91,-494
193,405,-156,62,-268,-330,-34,307,179
-40,38,-25,-12,-38,-102,-56,49,-186
48,30,-29,8,-26,-54,24,27,28
-8,36,-61,-79,-113,-120,-16,100,-261
-6,10,-25,-28,-48,-71,-26,36,-158
16,54,20,16,-8,18,13,44,173
13,52,22,20,-7,21,13,39,173
-1,55,26,22,-14,24,10,39,161
-1,50,35,10,-3,19,6,40,156
4,50,37,15,1,17,20,42,186
6,50,36,17,-2,16,16,42,181
40,26,-43,8,-29,-47,6,35,-4
69,27,-86,24,-154,-184,-25,39,-290
24,6,-25,15,-27,-20,15,12,0
143,448,-105,-51,-138,-268,95,343,467
-207,-72,-247,-244,-342,-336,-228,207,-1469
116,177,-109,-22,-120,-163,111,190,180
85,136,-38,-34,-96,-68,22,177,184
126,297,293,120,129,206,99,359,1629
233,335,-115,-109,-121,-239,52,377,413
47,159,-32,-56,-82,-175,-9,242,94
233,370,-169,-23,-232,-299,31,311,222
156,407,-234,-240,-563,-900,-237,713,-898
34,62,-59,1,-28,-68,12,62,16
-1,4,-10,-3,-66,-28,-10,38,-76
17,12,-8,-2,-15,-24,5,32,17
40,10,13,-21,-5,-46,8,72,71
20,24,2,0,-5,-3,8,40,86
16,14,-46,-11,-72,-59,-5,66,-97
11,9,-28,-43,-74,-88,-12,52,-173
23,87,-13,-50,-67,-35,37,169,151
194,295,70,-69,-52,-179,50,319,628
73,76,-30,-5,-31,-57,33,136,195
-9,58,-32,-62,-53,-157,-35,113,-177
1,67,36,24,-4,26,19,45,214
206,364,-60,-109,-144,-38,130,459,808
38,209,-271,-193,-303,-428,17,341,-590
159,235,-87,-37,-118,-184,87,282,337
316,451,26,-7,-70,-112,198,481,1283
241,280,-72,-34,-112,-68,160,358,753
126,121,-1,-18,-45,-100,61,227,371
-21,23,-37,-36,-10,-22,-18,30,-91
45,73,-6,-33,-75,-85,22,74,15
50,63,-45,-37,-85,-105,-19,122,-56
18,127,-45,-64,-215,-238,-32,357,-92
25,-27,-131,44,-208,-199,-68,103,-461
31,110,33,-13,34,-18,72,169,418
1,138,-35,-93,-45,-112,25,183,62
33,12,-24,-19,-52,-87,7,58,-72
-2,17,0,6,-13,-4,-4,25,25
11,22,6,-8,15,-20,4,22,52
14,5,-83,-39,-81,-82,-9,-7,-282
139,213,-25,49,-151,-109,57,209,382
-34,-15,-113,-19,-166,-185,-65,125,-472
52,73,-2,1,-103,-68,19,99,71
19,40,-49,-45,-59,-133,-35,88,-174
44,37,-17,-12,-12,-28,35,62,109
31,44,-20,-26,-87,-60,15,109,6
71,133,-31,-16,-81,-148,27,149,104
17,41,5,8,-14,-4,35,33,121
17,41,-9,-1,-32,-21,6,41,42
-2,9,-25,-31,-47,-107,-29,59,-173
34,40,1,-14,-11,-26,-4,37,57
54,43,-23,13,-8,-23,48,52,156
7,27,-19,-52,-34,-54,-12,42,-95
1,60,-65,-51,-113,-200,-60,123,-305
29,71,6,-3,-7,-25,26,71,168
-48,-3,-27,-18,-33,-82,-51,18,-244
1,70,-83,-3,-184,-154,0,115,-238
394,490,153,104,39,-130,127,585,1762
-7,5,-2,2,-5,-14,-1,17,-5
126,345,-144,-127,-406,-534,-103,539,-304
71,65,1,-11,5,-13,29,109,256
256,587,-239,-369,-586,-885,-43,1155,-124
325,664,-67,-90,-184,-222,195,680,1301
116,113,-176,-190,-198,-349,-52,244,-492
65,302,-43,-67,-40,-168,68,216,333
-26,166,-126,-42,-244,-498,-167,301,-636
92,161,-50,-42,-35,-91,23,105,163
135,211,-96,-58,-175,-226,20,352,163
48,82,-57,-67,-84,-113,6,135,-50
-21,-2,-11,-30,-36,-27,-12,22,-117
-4,94,-116,-54,-26,-44,62,253,165
78,154,-111,-41,-178,-155,23,142,-88
2,75,-26,-37,-42,-168,-61,86,-171
-60,3,-63,-44,-101,-112,-66,63,-380
491,653,-176,135,-571,-442,61,258,409
30,38,-34,-7,-71,-71,-4,35,-84
211,399,6,-40,0,-224,127,449,928
12,34,-9,-16,-5,6,32,18,72
-36,28,-17,-18,-37,-116,-48,49,-195
50,72,-5,-12,1,-37,21,102,192
16,86,57,41,-21,-38,14,135,290
123,112,16,18,-103,-97,42,240,351
24,62,-96,-98,-113,-203,-14,157,-281
9,18,-6,-6,-15,-25,-4,19,-10
95,89,-17,11,-69,-86,44,142,209
60,110,-67,-106,-50,-200,-32,210,-75
138,199,-46,-48,-88,-76,52,229,360
18,40,-46,-15,-48,-65,-15,52,-79
103,201,26,29,-103,-207,-4,254,299
-48,28,-40,-27,-92,-99,-57,80,-255
-5,53,2,17,-68,-21,-1,83,60
40,114,-60,-83,-127,-207,-32,145,-210
294,563,-235,-114,-414,-461,65,762,460
-9,32,-91,-88,-135,-184,-35,101,-409
-15,98,-46,-60,-1,-26,16,136,102
2,23,1,-10,2,-13,1,27,33
38,14,11,-33,-32,-105,-23,102,-28
76,53,-82,-64,-112,-240,-11,158,-222
1,26,-16,-6,-33,-34,-1,42,-21
21,25,0,1,-2,-3,10,25,77
-3,9,-20,-20,-62,-65,-12,67,-106
800,1327,-773,-332,-1904,-1186,425,1825,182
60,104,-39,5,-44,-49,35,95,167
132,253,18,-2,31,-91,67,248,656
610,1011,-217,-36,-352,-394,254,895,1771
178,304,-115,-116,-251,-314,0,374,60
7,15,-8,-3,-10,-3,9,7,14
3,2,-2,-14,-1,-20,1,10,-21
6,14,-25,-56,-49,-33,18,52,-73
403,494,57,-3,-15,-134,91,639,1532
16,47,-39,-45,-71,-74,1,79,-86
8,22,-56,-23,-90,-86,-16,42,-199
188,281,-7,-61,-71,-176,25,336,515
4,74,-22,-61,-64,-178,-74,87,-234
18,33,-7,-6,-44,-110,-36,75,-77
-23,80,-7,-35,-47,-155,-68,80,-175
93,94,-13,-26,-47,-78,23,142,188
34,97,8,-38,34,-46,15,108,212
28,44,-86,-58,-113,-22,43,95,-69
25,81,29,-49,-22,-101,4,149,116
37,44,-13,-5,-11,-18,24,58,116
74,127,-78,-53,-168,-119,41,220,44
100,125,18,-28,-68,-113,39,207,280
26,46,-116,-52,-256,-96,-22,193,-277
104,242,-41,-58,12,50,124,137,570
61,153,-64,-31,-107,-101,26,185,122
15,65,-67,-8,-167,-217,-48,177,-250
137,254,-147,-21,-222,-175,7,134,-33
16,44,5,-23,-5,-30,1,31,39
87,162,-128,-153,-183,-193,47,307,-54
3,-2,-17,-1,-21,-4,10,10,-22
-85,-28,-58,-14,-92,-208,-88,60,-513
195,399,2,-50,-6,-232,133,456,897
377,703,-181,6,-424,-563,-20,619,517
20,-2,-32,-68,-44,-102,-7,91,-144
-75,81,-240,-297,-472,-332,-80,556,-859
21,14,-9,1,-1,-23,11,7,21
24,49,-3,-15,-113,-91,19,106,-24
88,105,-104,-137,-263,-279,-38,322,-306
404,743,-10,-123,-95,-233,243,716,1645
127,218,17,-43,-78,-172,47,283,399
-4,63,-18,-15,-82,-121,-35,74,-138
26,14,-10,15,-25,-24,10,34,40
76,134,-72,-111,-89,-145,40,198,31
63,136,-49,-33,-132,-114,9,171,51
98,211,31,-13,-67,-109,11,238,400
18,52,-15,-21,-23,-17,21,67,82
15,34,0,-5,7,-8,11,24,78
79,159,-111,-42,-178,-156,24,143,-82
-33,11,-50,-61,-56,-101,-26,68,-248
-23,12,-54,-38,-68,-125,-50,73,-273
12,24,29,-9,9,-3,21,40,123
66,93,16,-35,19,-53,34,133,273
101,65,-25,27,-76,-108,36,88,108
83,148,-15,-55,-84,-133,26,170,140
45,57,-68,-62,-95,-103,-1,112,-115
104,192,-77,-136,-167,-156,12,312,84
-5,92,-6,-22,21,8,39,95,222
44,135,-31,1,-240,-112,-136,357,18
414,648,52,-45,2,-171,216,626,1742
-22,-20,-34,-21,-37,-50,-8,34,-158
-8,2,-33,-28,-55,-48,-14,35,-149
24,37,-37,-17,-61,-37,19,67,-5
75,143,-87,-86,-109,-142,13,182,-11
84,232,-79,-5,-104,-120,39,226,273
209,414,6,-40,-4,-223,135,455,952
17,31,-26,-52,-74,-57,12,40,-109
16,30,-3,-17,7,-35,-7,22,13
73,134,-79,-109,-138,-158,31,303,57
10,9,-24,-51,-32,-83,-24,63,-132
7,9,-7,-27,-29,-60,-9,47,-69
13,68,17,-3,-103,-82,24,126,60
70,140,-55,-37,-124,-113,14,174,69
11,21,-65,-11,-67,-102,-14,40,-187
-16,156,-230,-99,-453,-615,-186,375,-1068
-20,52,-110,-41,-121,-154,-47,151,-290
-56,-30,-49,-40,-53,-91,-44,30,-333
164,327,-130,-35,59,-48,163,208,708
96,133,-8,-68,37,-78,58,178,348
33,51,-42,-38,-53,-99,-12,58,-102
99,165,-44,-24,-48,-130,33,177,228
-11,17,-84,-83,-124,-134,-32,140,-311
-12,93,-6,-63,-53,-135,-60,103,-133
-11,92,-23,-30,-46,-143,-57,104,-114
5,68,-22,-40,-47,-169,-65,86,-184
-51,97,-22,-33,-31,-163,-76,99,-180
319,585,-108,-134,-294,-388,100,735,815
-5,18,-10,-62,-71,-108,-28,56,-210
92,141,-14,-15,-42,-92,37,129,236
84,120,-51,-49,-47,-80,81,216,274
186,239,-70,-47,-143,-246,54,311,284
65,195,-68,-40,-10,-59,79,222,384
15,26,7,0,-25,-11,-14,86,84
42,73,2,-19,-33,-30,11,90,136
-4,12,-4,-5,-35,-41,-13,69,-21
42,73,-43,-24,-89,-110,-20,74,-97
22,87,13,-38,-39,-63,-7,130,105
24,18,-8,6,-10,-24,2,40,48
5,71,-29,-38,-51,-172,-63,85,-192
-11,91,-25,-29,-46,-145,-57,103,-119
4,-14,-36,-32,-60,-109,-43,61,-229
13,-13,-42,-27,-70,-108,-37,89,-195
8,67,40,6,-4,-99,-36,152,134
-8,-1,-35,-1,-52,-50,-4,60,-91
-47,-21,-29,-37,-47,-47,-52,28,-252
-7,53,-32,-55,-32,-46,-12,69,-62
74,226,-128,-132,-193,-373,-78,319,-285
75,77,20,17,-7,10,47,105,344
99,327,279,101,109,138,-32,299,1320
-8,31,-23,-10,-32,-58,-9,42,-67
129,249,-61,-154,-260,-335,-114,512,-34
61,235,-239,-60,-412,-488,-45,360,-588
177,404,40,-42,85,-109,113,394,1062
196,401,2,-55,-2,-238,132,457,893
17,47,-11,-37,-52,-72,0,82,-26
76,245,-185,-217,-120,-220,27,298,-96
89,87,-12,-9,-3,-73,69,172,320
44,119,-33,-26,-54,-56,37,129,160
-5,10,-32,-29,-89,-57,-4,80,-126
2,2,-19,-3,-51,-51,-17,26,-111
8,-10,-29,-22,-74,-95,-20,85,-157
12,-7,-22,-19,-43,-45,-10,23,-111
76,108,-49,8,-52,-38,54,127,234
10,38,-51,-15,-71,-124,4,64,-145
293,428,161,32,37,-36,113,457,1485
10,-10,-3,-8,-17,-16,-16,6,-54
122,194,-124,-18,-209,-201,3,58,-175
-32,29,-26,-33,-28,-66,-38,40,-154
151,322,-155,-179,-252,-410,0,525,2
77,145,5,35,-88,-72,34,172,308
25,11,-102,-89,-93,-204,-20,98,-374
53,26,-18,-20,-73,-63,35,80,20
-10,22,-28,-14,-81,-116,-27,83,-171
186,298,-93,-37,-223,-282,66,385,300
193,320,-93,-66,-185,-174,67,425,487
17,22,-37,-50,-72,-85,-19,79,-145
205,325,-45,17,-184,-128,102,332,624
25,20,-15,-27,-4,-28,20,44,35
137,244,31,-19,20,-38,87,245,707
-19,10,-20,-11,-18,-44,1,25,-76
10,27,-20,-12,-2,-15,34,45,67
2,28,-36,-12,-47,-81,-20,55,-111
-28,-5,-40,-30,-36,-73,-24,34,-202
56,80,-116,-33,-212,-218,-37,207,-273
-10,-36,-41,-55,-79,-113,-52,75,-311
38,148,-43,-11,-82,-156,-39,167,22
107,252,-31,-7,-89,-112,6,240,366
-46,4,-55,-75,-91,-106,-34,86,-317
-39,10,-15,-17,-30,-28,-29,31,-117
119,230,-42,-33,-139,-203,-8,331,255
-2,53,-15,-9,-98,-95,-10,101,-75
13,72,-91,-98,-112,-263,-78,141,-416
-44,-7,-56,-43,-61,-90,-40,81,-260
6,18,1,-14,-22,-8,-11,62,32
30,38,27,-3,4,-17,-3,46,122
7,18,2,4,-11,-22,7,37,42
-15,-8,-18,-14,-6,-46,-19,24,-102
20,33,-28,-7,-38,-36,13,39,-4
11,24,-80,2,-113,-114,-17,89,-198
11,27,24,-11,11,-5,21,41,119
100,154,11,17,-98,-96,15,254,357
17,44,-6,-8,-64,-123,-25,122,-43
17,48,-19,-22,-65,-32,8,91,26
55,105,13,54,-157,-68,-28,146,120
47,70,-6,0,-20,-24,14,63,144
-2,29,-52,-42,-94,-102,-23,85,-201
8,5,-21,2,-31,-19,12,23,-21
78,62,25,34,-19,-51,33,116,278
19,24,6,-12,-1,2,14,45,97
-1,20,-15,-14,-30,-17,-14,23,-48
50,135,-130,-127,-252,-409,-123,243,-613
5,95,7,-46,-29,-59,4,106,83
66,91,-12,-47,-96,-134,-22,118,-36
33,115,-100,-102,-173,-170,15,264,-118
5,-6,-184,-148,-159,-233,-25,136,-614
-1,28,-4,-34,-33,-41,1,64,-20
5,37,-5,0,-2,-18,3,23,43
44,52,-34,-23,-137,-95,1,180,-12
17,183,-9,-19,-90,-245,-78,200,-41
8,-1,-25,-6,-13,-22,-2,-4,-65
45,211,-65,-87,-45,-38,120,260,401
199,259,-97,-9,-119,-155,77,345,500
1,13,-33,-10,-67,-67,-3,75,-91
-133,7,-192,-144,-265,-394,-170,221,-1070
11,-2,-60,-23,-47,-76,-18,62,-153
57,111,-21,-37,-46,-141,36,160,119
137,529,-526,-482,-920,-1407,-241,999,-1911
47,83,3,-11,-38,-51,14,73,120
17,90,-44,-82,-156,-99,13,283,22
224,379,110,-43,53,-112,89,449,1149
-64,9,-80,-70,-160,-180,-100,108,-537
160,161,-47,-22,-170,-161,75,214,210
28,68,-5,-5,-29,-78,29,101,109
333,395,-86,-2,-75,-175,154,399,943
25,66,8,-24,-24,-42,17,71,97
14,72,-51,-39,-118,-141,-14,146,-131
50,80,-20,-5,-23,-15,46,96,209
51,86,-4,-11,-44,-55,16,154,193
20,17,-10,0,-25,-23,13,35,27
45,52,-20,-80,27,-20,40,76,120
32,73,-10,-45,-58,-107,-19,111,-23
-27,12,-69,-34,-97,-167,-25,98,-309
101,167,-3,-23,4,-15,89,162,482
44,103,-51,-95,-158,-223,-22,241,-161
154,238,-80,-67,-101,-160,55,310,349
137,231,11,-48,22,-60,82,274,649
117,288,-99,-42,-282,-298,-44,174,-186
66,162,-108,-75,-190,-296,-33,239,-235
77,97,-23,21,-23,-54,57,161,313
37,86,-30,-51,-75,-114,20,177,50
-27,61,-40,-45,-58,-112,-45,76,-190
207,313,-29,-41,-75,-185,92,326,608
6,40,-12,-59,-72,-148,-20,117,-148
41,73,26,11,8,-22,17,89,243
37,129,-126,-47,-188,-102,81,203,-13
21,9,-21,-58,-75,-77,-3,98,-106
107,180,-8,22,-54,20,102,134,503
83,183,13,-26,-68,-255,-23,275,182
126,137,-35,8,-169,-181,23,143,52
67,73,-54,-43,-135,-136,-8,112,-124
1,23,-2,-29,-48,-53,-4,83,-29
90,155,-34,-40,-41,-66,57,213,334
1425,1861,-1007,-800,-652,10,-69,1707,2475
-46,-5,-73,-73,-126,-153,-53,81,-448
86,80,-54,-27,-78,-125,0,134,16
108,55,-45,-50,-143,-151,-34,182,-78
21,95,-111,-74,-213,-177,-24,108,-375
74,128,8,7,-21,-72,-4,146,266
-4,67,-70,-44,-116,-99,-12,113,-165
38,44,-33,-18,-41,-52,2,92,32
-42,10,-91,-47,-150,-182,-76,146,-432
281,414,-77,-89,-299,-52,152,692,1022
82,280,-95,-96,-251,-352,-9,341,-100
22,49,-72,-63,-79,-159,-19,207,-114
9,-11,-53,-46,-85,-99,-41,89,-237
21,5,-137,-37,-259,-300,-66,220,-553
122,159,0,-35,-92,-148,0,274,280
133,195,-112,-133,-227,-282,-18,258,-186
246,361,20,1,-109,-172,68,470,885
77,108,-46,5,-85,-176,-38,145,-10
-9,48,-111,-124,-206,-199,-24,168,-457
144,275,4,11,8,79,132,269,922
52,83,20,0,11,2,29,67,264
3,37,-26,-31,-33,-30,2,54,-24
45,179,-71,-96,-22,-147,33,237,158
15,40,-56,-55,-61,-96,5,103,-105
89,125,-22,15,-89,-107,-2,98,107
8,12,-4,-44,-78,-71,-2,62,-117
202,438,-40,-92,-11,-208,96,402,787
202,211,-14,8,-75,-161,25,262,458
39,113,-14,-30,-95,-228,-31,178,-68
596,740,18,-76,-212,-187,183,971,2033
-65,-47,-111,-107,-134,-222,-103,128,-661
-15,118,-1,-34,44,23,45,159,339
126,436,-183,-141,-436,-746,-102,584,-462
96,218,-15,-19,7,-72,89,164,468
59,137,-55,-44,-100,-110,26,218,131
197,729,-42,-187,-8,-65,337,751,1712
380,622,-217,-204,-421,-400,130,861,751
31,99,-25,-72,-14,-30,3,86,78
130,214,55,-36,17,-67,45,280,638
49,281,-53,-56,-215,-201,18,380,203
-8,85,-82,-62,-18,5,30,68,18
-8,59,-43,-33,-23,-11,60,141,142
72,129,-90,-37,-188,-299,-55,217,-251
-33,66,-57,-27,4,-19,36,112,82
250,233,10,-11,-34,-124,70,283,677
45,57,-3,-36,-40,-112,-16,77,-28
34,84,0,-13,-23,-64,17,87,122
9,33,-12,-12,-13,-32,-4,33,2
30,23,-20,-14,-27,-52,-5,34,-31
26,30,-14,5,-12,-19,21,29,66
41,73,-59,-98,-105,-136,21,162,-101
17,34,-1,-14,-22,-67,-4,46,-11
-74,-20,-102,-90,-189,-191,-96,136,-626
-11,11,-37,2,-29,-47,-13,42,-82
215,333,-39,-31,-53,-96,98,358,785
33,29,-43,-15,-91,-52,10,64,-65
22,34,7,5,-23,-24,6,29,56
33,77,-54,-38,-79,-77,19,125,6
198,357,-21,-108,-200,-443,-122,550,211
235,266,-111,0,-250,-215,61,246,232
98,160,54,-32,33,-56,49,162,468
2,18,-4,2,4,-17,11,6,22
-3,-8,-39,-14,-53,-29,8,28,-110
29,104,17,-30,-12,-29,11,94,184
33,90,-25,-12,-126,-127,-77,63,-181
37,79,-51,-39,-115,-103,-50,72,-170
23,32,-24,-31,-43,-63,4,67,-35
2,3,-21,-9,-13,-14,4,30,-18
176,345,-127,-85,-135,-145,54,464,547
81,180,-120,-26,-284,-318,-32,311,-208
76,83,23,-17,-18,-58,-3,96,182
-55,11,-129,-72,-198,-199,-58,218,-482
238,319,68,45,-141,-54,89,490,1054
18,126,1,-32,9,-36,67,177,330
137,320,-52,-63,-230,-247,65,317,247
-6,35,-8,-2,-21,-40,-16,36,-22
2,79,-40,-39,2,22,58,77,161
38,134,63,15,-51,-60,-33,195,301
5,75,-42,-59,-65,-79,7,95,-63
43,78,-23,-8,-50,-103,17,103,57
54,53,-26,-17,-73,-60,39,125,95
7,-1,-19,3,-48,-59,-22,20,-119
2,8,-5,-6,-43,-56,-14,48,-66
-6,11,-2,-20,-3,-18,-4,30,-12
29,86,-33,-35,-27,-87,17,97,47
8,37,-16,-48,-19,-41,-9,48,-40
-7,29,-36,-22,-39,-48,-3,51,-75
152,300,-49,-29,-168,-346,-8,391,243
111,78,25,12,0,-73,49,128,330
24,52,1,-19,-8,-43,-7,85,85
43,94,1,3,-34,-4,58,115,276
5,39,-103,-33,-119,-135,-12,96,-262
54,132,-119,-115,-154,-216,-3,255,-166
16,31,-35,-37,-65,-94,-18,54,-148
63,103,12,-39,-19,-51,15,100,184
52,135,-29,-40,1,-87,19,160,211
3,37,-38,-27,-26,-42,25,63,-5
32,29,22,-17,1,-2,23,145,233
31,58,-3,10,-32,-52,17,97,126
22,44,-34,-31,-71,-101,-8,68,-111
24,19,-41,16,-99,-111,-10,57,-145
27,53,-7,-9,12,-7,30,69,168
43,136,-67,-83,-118,-219,-51,213,-146
97,153,-51,-83,-121,-213,-11,232,3
15,91,-4,-38,-32,-44,16,132,136
149,268,3,-30,-82,-135,23,263,459
22,49,-10,-13,13,0,28,57,146
191,362,-8,-37,-180,-369,28,295,282
-61,-55,-75,-79,-105,-116,-75,79,-487
59,105,89,180,-66,68,4,228,667
-50,6,-20,-42,-37,-83,-27,75,-178
-2,30,-12,-22,-29,-51,-20,38,-68
-42,85,-90,-52,-47,-55,60,169,28
40,53,-15,18,-21,-11,27,64,155
14,21,1,-4,-3,-3,19,34,79
-15,13,-12,-1,-29,-27,-13,57,-27
25,105,-117,-105,-200,-153,-13,199,-259
152,200,-86,-52,-225,-218,13,387,171
69,188,22,-7,-58,-157,-11,201,247
24,52,3,-3,-4,4,22,39,137
194,393,19,-29,-136,-354,-4,382,465
15,53,-40,-64,-40,-69,25,66,-54
18,12,-23,3,-37,-18,11,32,-2
28,75,-44,-11,-60,-75,4,86,3
60,80,6,12,-24,15,40,75,264
-12,48,-68,-12,-110,-107,-23,105,-179
6,49,0,-12,-3,-48,-4,39,27
-4,33,-46,-39,-77,-113,5,79,-162
17,8,-23,-1,-25,-43,-2,16,-53
29,67,4,-20,4,-27,33,73,163
-2,57,-57,-50,-64,-190,-34,114,-226
-7,10,-21,-5,-79,-36,-9,57,-90
114,210,55,30,-39,-93,40,234,551
7,16,-55,-81,-111,-112,10,150,-176
37,62,-24,-15,-42,-40,10,81,69
-22,-4,-26,-28,-53,-73,-43,55,-194
95,265,-158,-209,-284,-481,-94,544,-322
1,54,-6,-24,-33,-75,-13,87,-9
98,147,-13,-37,-32,-46,22,118,257
115,140,-1,-18,50,-136,7,125,282
25,93,21,9,-38,-38,12,155,239
6,36,-20,-10,-41,-48,-10,30,-57
18,83,-14,-43,-44,-99,-42,90,-51
26,18,-52,-54,-167,-176,-18,134,-289
-2,15,-93,-77,-202,-136,-13,178,-330
41,34,-3,5,-39,-48,3,41,34
4,-8,-68,-32,-119,-71,-8,53,-249
6,13,-15,-20,-37,-71,1,50,-73
22,33,-40,-26,-64,-77,2,65,-85
111,116,-32,-19,-56,-120,44,133,177
26,61,-6,-8,-33,-54,12,55,53
26,52,-82,-53,-110,-128,2,110,-183
-13,31,1,-16,-18,-35,-4,47,-7
30,45,-1,16,-28,-50,7,83,102
48,41,-6,-9,-46,-43,14,58,57
49,53,-34,-33,-29,-55,16,107,74
37,45,40,37,-25,-8,4,113,243
-14,20,-31,-52,-60,-71,-24,76,-156
-27,-8,-39,-15,-54,-57,-24,51,-173
5,22,-25,-24,-48,-66,-34,50,-120
-8,36,-48,10,-65,-142,-40,80,-177
55,71,-135,-133,-317,-283,-65,426,-381
31,51,-102,-120,-288,-234,-52,325,-389
-13,5,2,-23,-10,-1,-14,20,-34
91,189,-48,-73,-68,-79,47,202,261
4,46,-10,-12,4,-68,-11,76,29
85,241,3,-81,-117,-198,47,361,341
25,55,-89,-35,-93,-151,-18,104,-202
61,78,-33,-35,-43,-37,33,83,107
-59,-20,-64,-64,-80,-115,-79,65,-416
-57,-12,-56,-68,-91,-96,-68,54,-394
-61,-20,-46,-54,-83,-113,-55,69,-363
-47,-23,-63,-53,-63,-130,-59,49,-389
-58,-16,-52,-66,-80,-125,-73,58,-412
-67,-21,-62,-47,-100,-115,-70,78,-404
-64,-15,-55,-66,-86,-132,-74,51,-441
-62,-29,-67,-28,-108,-143,-59,57,-439
-75,1,-58,-65,-89,-106,-55,71,-376
-76,-36,-67,-61,-98,-117,-78,65,-468
-86,-40,-67,-68,-94,-119,-45,62,-457
-66,-16,-59,-60,-93,-119,-67,64,-416
-70,13,-46,-63,-58,-137,-63,71,-353
9,0,-39,-18,-25,-61,-18,56,-96
8,9,-30,-45,-8,-71,-5,31,-111
220,331,-40,46,-46,-114,98,366,861
30,86,-18,-17,-34,-71,16,94,86
51,79,-93,-79,-128,-255,-71,148,-348
27,73,-14,-26,-40,-48,10,70,52
129,231,-61,-47,-77,-116,31,146,236
11,6,-20,-2,-9,-24,-6,4,-40
18,32,-21,-22,-35,-58,1,53,-32
26,49,1,-32,13,-61,3,53,52
5,20,-13,-28,-42,-80,-7,49,-96
20,49,-32,-8,-42,-67,-5,77,-8
20,24,3,-6,-14,-11,27,46,89
68,106,14,-40,-18,-50,13,101,194
54,88,3,4,20,19,65,32,285
45,28,-45,-6,-53,-106,14,54,-69
79,77,4,1,-22,-22,65,54,236
46,13,-38,-36,-22,-72,1,71,-37
32,138,-42,-47,0,-50,53,238,322
15,35,-18,-18,-34,-37,-4,40,-21
261,332,67,-73,-4,-109,125,315,914
24,105,-112,-136,-173,-336,-72,272,-428
104,266,-79,-104,-94,-85,105,407,520
63,91,-27,-2,-82,-42,58,107,166
183,359,-12,-86,-81,-155,65,416,689
4,21,-26,-7,-27,-20,7,22,-26
7,25,-26,-68,-110,-116,-36,122,-202
76,53,-78,-60,-107,-87,33,122,-48
8,40,8,3,-12,-9,2,49,89
8,83,19,8,-10,-50,-28,92,122
-8,215,-40,-72,100,-41,102,170,426
17,-35,-112,-99,-199,-294,-54,155,-621
35,42,25,-44,27,-43,21,61,124
-81,-2,-88,-56,-110,-193,-121,129,-522
-6,44,-26,-47,-72,-118,-34,70,-189
134,185,7,7,19,13,113,140,618
27,-47,-44,-15,-157,-126,-20,111,-271
22,68,-101,-88,-180,-251,25,167,-338
9,24,7,-25,-12,-51,-9,54,-3
7,15,-9,10,-28,-46,-16,60,-7
-7,13,-32,-18,-39,-40,-10,44,-89
81,117,-74,-54,-51,-50,11,136,116
38,98,-51,-5,-126,-74,0,93,-27
427,607,-208,-169,-360,-457,78,711,629
-7,27,-52,-25,-149,-99,-10,70,-245
76,118,14,-34,10,-58,20,120,266
-24,65,28,39,-79,78,-5,34,136
-34,80,63,85,-101,118,-1,51,261
-23,70,35,54,-88,87,-6,31,160
-33,51,35,44,-72,64,-6,21,104
-43,126,91,149,-139,166,0,85,435
-24,104,51,61,-119,118,-13,54,232
-52,122,93,136,-133,163,14,80,423
56,64,-45,-28,-121,-110,7,157,-20
-18,-4,-12,-37,-32,-28,-12,26,-117
131,170,4,-106,-61,-188,47,253,250
51,0,-82,-110,-113,-197,-85,232,-304
81,19,-22,1,-31,-45,36,73,112
-2,29,25,16,-4,-20,-10,49,83
113,153,-117,-51,-191,-16,57,233,181
11,70,3,-21,-46,-95,-24,112,10
20,84,-9,-27,-29,-49,-2,57,45
6,118,-35,-80,-154,-152,-42,197,-142
18,34,-22,-42,-90,-143,-21,140,-126
390,525,-25,10,-99,-250,108,682,1341
135,292,-45,-230,-403,-403,-140,641,-153
160,260,-98,-69,-55,-81,75,349,541
23,54,-29,-17,-55,-99,-22,63,-82
33,48,-129,-47,-173,-262,-75,98,-507
-55,-20,-86,-36,-111,-187,-97,87,-505
16,37,-4,-22,-13,-29,4,78,67
44,44,-13,1,-34,-50,19,77,88
83,176,53,13,21,10,34,159,549
31,75,-75,-113,-134,-108,0,196,-128
73,86,-54,-86,-91,-103,26,155,6
58,4,-40,-61,-100,-210,25,94,-230
84,185,-28,-22,-99,-92,77,134,239
-39,70,-82,-51,-147,-281,-75,154,-451
10,-5,-73,-37,-86,-102,-20,48,-265
74,86,14,17,1,-38,8,113,275
13,22,-27,-10,-15,-56,2,13,-58
15,159,10,-10,26,-14,88,126,400
38,81,-75,-35,-80,-88,4,108,-47
-78,28,-76,-6,-109,-143,-86,110,-360
2,11,-31,-29,-71,-164,-56,151,-187
33,43,5,-4,19,20,41,28,185
6,41,-3,-27,-17,-22,8,43,29
-17,23,-45,-81,-53,-162,-65,87,-313
92,55,-15,-27,-39,-54,-1,131,142
42,74,23,15,-47,-23,25,60,169
76,135,2,18,-20,2,58,117,388
8,8,-15,-24,-14,-40,-2,40,-39
6,50,-6,-15,-58,-69,7,110,25
22,60,24,26,-23,3,32,72,216
-23,155,-48,-30,-120,-240,-89,163,-232
82,175,28,24,-96,-237,-20,169,125
36,69,-69,-12,-117,-131,2,84,-138
16,57,27,8,3,-18,-3,105,195
99,178,2,-73,24,-29,93,173,467
-4,23,-70,-19,-131,-104,-19,54,-270
15,22,-57,-21,-43,-38,4,41,-77
5,29,-100,-64,-118,-135,0,120,-263
-18,37,-71,-20,-118,-135,-16,145,-196
14,32,-40,-54,-106,-85,3,124,-112
171,236,-18,7,-39,-106,84,275,610
93,148,58,11,-3,-38,36,173,478
31,133,-118,-90,-151,-230,-65,175,-315
29,78,-83,-34,-189,-281,-94,160,-414
13,133,-53,2,-97,-225,-56,173,-110
2,0,-5,-6,-1,-3,-2,13,-2
33,65,-25,-45,-106,-96,3,203,32
-33,7,-56,-57,-69,-156,-47,115,-296
-91,-4,-124,-106,-145,-239,-80,143,-646
-57,-13,-87,-15,-128,-171,-73,103,-441
309,370,7,-13,44,-7,231,320,1261
65,90,-31,-15,-105,-156,-8,152,-8
4,45,-2,11,-14,-64,1,62,43
-8,17,13,16,-21,-11,5,33,44
11,10,3,1,6,-16,-10,9,14
9,20,-19,0,-1,-5,14,14,32
-64,-31,-89,-49,-149,-138,-88,115,-493
4,31,-3,-17,-6,-14,10,27,32
7,22,3,-44,-30,-39,-34,89,-26
6,35,-39,-8,-74,-90,-23,70,-123
24,17,-31,-9,-36,-39,13,46,-15
31,106,-78,-38,-89,-117,-15,171,-29
28,44,-8,-17,-79,-80,-19,113,-18
135,244,-44,-58,-53,-137,77,218,382
4,138,6,-25,47,-6,33,153,350
-11,156,-57,-33,-37,-48,9,203,182
28,38,-73,-19,-175,-131,-10,84,-258
39,46,-81,-55,-127,-178,-30,127,-259
-13,3,-41,-25,-24,-61,-10,42,-129
48,95,-34,-74,-31,-95,37,121,67
11,49,-23,-35,-37,-66,2,109,10
-5,25,-34,-16,-73,-109,-52,73,-191
47,84,-26,-18,-100,-124,-5,83,-59
-10,65,-54,-49,-102,-169,-47,99,-267
45,50,-19,-10,-27,-31,20,53,81
39,56,-11,8,-58,-79,3,46,4
12,10,-24,-12,-33,-10,9,26,-22
-31,32,-50,-53,-96,-143,-63,121,-283
-12,57,-63,-69,-93,-148,-49,112,-265
187,213,-35,61,-199,-145,37,222,341
63,56,-18,-35,-34,-40,26,81,99
116,231,2,-13,5,-42,127,169,595
40,64,30,-7,23,-18,19,51,202
-22,-23,-50,-29,-62,-95,-21,42,-260
35,41,-10,18,-37,-20,25,50,102
48,112,-50,-24,-93,-63,34,78,42
146,171,-15,-41,-56,-98,66,211,384
48,40,16,2,9,-26,11,50,150
22,36,-27,-18,-42,-92,-9,52,-78
21,57,23,-21,7,-29,3,77,138
22,96,-20,-14,-44,-76,10,92,66
-15,1,-29,-47,-70,-127,-54,71,-270
-5,25,-9,-11,-18,-70,-23,45,-66
163,222,-119,-83,-106,-142,71,330,336
285,552,14,-44,-83,-225,155,621,1275
76,173,-98,-113,-287,-252,20,370,-111
14,19,-17,-3,-12,-21,7,24,11
20,21,-118,-86,-149,-290,-82,181,-503
-95,-44,-89,-36,-92,-187,-97,54,-586
115,110,-73,-119,-176,-372,-104,343,-276
82,54,-87,-69,-80,-64,49,82,-33
-26,-18,-30,-5,-54,-60,-29,32,-190
33,32,-31,-4,-39,-28,11,30,4
-23,48,-24,-54,-46,-64,1,86,-76
109,198,33,1,-27,16,75,252,657
11,147,3,-65,6,-22,56,180,316
-10,13,-15,-14,-28,0,10,43,-1
-17,28,-65,-68,-116,-146,-49,106,-327
53,189,-38,-74,-113,-190,-8,281,100
33,67,-98,-52,-111,-73,38,132,-64
223,198,-59,-62,-97,-184,91,193,303
-4,13,-16,-21,-46,-53,-8,53,-82
-22,-6,-39,-40,-54,-120,-40,66,-255
29,21,-27,-32,-64,-71,5,92,-47
13,76,-38,4,-126,-80,20,141,10
17,47,-50,-28,-80,-81,15,68,-92
12,57,-48,-29,-66,-67,-16,58,-99
88,151,28,-19,-11,-76,32,170,363
66,92,-159,-100,-175,-307,16,296,-271
12,14,5,-5,-8,-54,-2,40,2
-14,70,-65,-50,-4,-17,55,112,87
20,63,-76,-52,-90,-122,7,128,-122
32,30,-20,-34,-41,-92,-23,72,-76
3,40,-64,-30,-17,-48,24,75,-17
44,178,-81,-84,-23,-209,19,219,63
197,312,-96,-33,-263,-339,-12,361,127
94,246,-44,-8,-114,-150,45,200,269
-15,3,-35,-50,-64,-111,-33,48,-257
22,28,-30,-36,-56,-35,22,85,0
25,58,-12,-19,-27,-55,-8,77,39
-3,20,-31,-40,-72,-81,0,67,-140
0,45,-94,-71,-210,-223,-42,157,-438
128,-19,-194,-333,-256,-615,-113,408,-994
-9,109,-140,-108,-235,-334,-116,309,-524
47,85,-29,-15,-27,-48,28,103,144
66,89,-84,-67,-66,-102,55,145,36
75,115,-43,-49,-99,-209,-26,193,-43
111,162,55,16,-35,-53,13,254,523
-54,130,-114,-84,-46,19,82,186,119
7,22,-15,-4,-27,-25,-8,12,-38
104,264,-71,-8,-97,-156,50,186,272
87,169,-73,-54,-84,-205,-41,264,63
-16,42,-83,-73,-185,-259,-97,144,-527
29,49,-55,-75,-76,-78,18,136,-52
55,59,27,16,-16,3,8,61,213
85,77,19,-30,-31,-85,25,119,179
-3,36,-45,-32,-86,-95,9,85,-131
9,63,-45,-39,-93,-123,-35,91,-172
-32,-16,-86,-23,-113,-143,-56,109,-360
-7,17,-50,-33,-72,-85,15,81,-134
27,12,-50,-47,-71,-131,-55,89,-226
7,42,7,-11,-32,-60,-10,56,-1
94,121,-12,-25,-34,-81,27,129,219
27,32,-26,-52,-35,-133,-23,81,-129
3,28,-1,2,-18,-13,7,53,61
120,271,-68,-40,-121,-118,94,346,484
-1,24,-13,-23,-49,-43,10,34,-61
19,69,4,-40,-37,-101,-27,95,-18
3,86,-71,-75,-142,-217,-75,172,-319
207,303,-159,-58,-250,-142,119,399,419
31,106,-5,20,-95,-146,4,137,52
3,23,4,-46,-31,-31,-9,82,-5
35,43,-11,18,-33,-23,28,44,101
2,21,-41,-14,-33,-26,16,27,-48
-7,25,-23,-17,-32,-54,-6,38,-76
56,73,-58,5,-139,-145,6,91,-111
98,158,-24,-43,-63,-96,58,185,273
21,17,-7,-9,-6,-9,3,33,43
28,3,-28,-17,-50,-106,-36,65,-141
-5,0,-20,-10,-14,-41,-15,31,-74
1,100,-51,33,-157,-266,-83,149,-274
17,19,-2,-15,-3,-32,7,23,14
3,54,-7,-21,-39,-69,-47,90,-36
70,180,-39,-75,-45,-196,18,197,110
32,39,5,-26,-30,-76,2,63,9
100,120,-21,9,-43,-11,67,103,324
18,13,-36,-6,-99,-114,-17,35,-206
58,72,-49,-36,-84,-30,79,91,101
-26,16,-48,-35,-48,-60,-32,46,-187
34,67,-5,-22,-40,-105,-5,102,26
80,167,-77,-86,-121,-155,15,250,73
58,153,-68,-49,-145,-182,-13,171,-75
-12,138,-22,-66,-13,-5,48,164,232
2,24,-34,-86,-133,-118,-27,125,-247
-20,73,-51,-69,-18,-17,70,151,119
36,66,-14,-6,-42,-66,-8,119,85
15,159,-17,-22,-206,-300,-102,273,-200
83,182,-65,-17,-99,-120,4,160,128
21,72,-23,-6,-29,-59,3,54,33
-15,82,-67,-53,-122,-305,-146,192,-434
11,7,-2,-35,-17,-61,-28,30,-95
16,22,-22,-15,-38,-45,6,59,-17
9,134,-29,-48,18,-72,32,136,180
73,121,-19,-73,-25,-86,-6,144,129
27,64,-7,-12,-54,-44,28,68,70
17,21,-7,-15,6,1,15,21,59
49,80,-40,3,-88,-82,36,138,96
153,176,-103,-33,-64,-117,87,235,334
24,30,-27,-5,-79,-56,3,86,-24
-24,27,-105,-61,-177,-151,-40,104,-427
29,59,-22,-10,-50,-50,-10,92,38
94,181,-23,-4,-140,-144,15,238,217
18,40,-86,-47,-98,-143,-25,101,-240
104,263,83,-38,74,-60,67,216,709
222,168,-124,3,-184,-234,25,220,96
45,35,-21,-27,-77,-82,2,75,-50
-2,7,5,-6,-5,-33,6,40,12
14,49,-53,-58,5,-41,44,140,100
84,119,5,5,-69,-71,19,156,248
-2,54,-30,-44,-63,-70,-27,119,-63
54,75,-5,-22,-53,-65,22,110,116
0,73,23,-17,-23,-10,-10,72,108
36,27,8,-11,-1,-63,3,46,45
-45,0,-37,-37,-42,-68,-43,29,-243
-16,25,-18,-22,-34,-54,-20,47,-92
-1,-8,-50,-39,-105,-91,-15,86,-223
53,132,37,-26,-40,-217,-25,184,98
27,121,-35,-41,-12,-3,29,180,266
14,-6,-57,-5,-96,-113,-9,46,-226
16,49,-50,-16,-41,-54,15,70,-11
66,47,-55,-39,-156,-120,26,105,-126
16,40,-2,26,9,25,29,43,186
111,293,-66,-98,-154,-177,49,419,377
-26,45,-69,-62,21,-27,38,141,61
99,147,3,-32,4,-46,50,150,375
81,1,-251,59,-509,-545,-136,211,-1089
53,60,8,-36,-8,-43,-20,82,96
85,108,-14,-41,-60,-61,50,198,265
10,33,-33,-18,-27,5,28,47,45
32,5,-19,-16,-26,-71,-19,17,-97
35,52,-49,-28,-97,-142,-3,61,-171
7,10,-52,-47,-54,-58,2,58,-134
-35,-37,-30,-25,-42,-77,-50,8,-288
50,71,-74,-36,-112,-158,-6,124,-141
55,52,-43,-17,-90,-66,28,98,17
-13,75,-31,-94,-74,-148,-5,120,-170
50,111,53,37,-22,-62,7,169,343
47,36,-107,-32,-132,-81,36,126,-107
-16,26,-15,-5,-25,-63,-28,61,-65
30,67,-11,0,-18,-8,32,60,152
43,40,-10,16,-25,-8,30,72,158
35,8,-50,-21,-83,-60,22,47,-102
-28,8,45,18,-72,-33,-12,131,57
26,58,-5,-16,-29,-34,6,43,49
55,149,-270,-215,-399,-544,-51,384,-891
86,139,-29,-45,18,-39,63,77,270
-1,55,-10,-7,-49,-52,-10,63,-11
110,172,-32,-129,-159,-175,73,300,160
23,20,-46,-20,-52,-63,-4,35,-107
-50,152,-8,-41,-53,-176,-35,214,3
-46,16,-64,-57,-124,-153,-58,95,-391
14,-16,-42,-31,-111,-114,-37,74,-263
56,76,9,-10,-4,-55,31,95,198
-7,8,-46,15,-101,-64,-12,50,-157
74,100,-64,-10,-145,-93,37,147,46
1,47,-64,-24,-145,-141,-47,95,-278
9,60,-27,-77,-40,-118,-17,129,-81
31,30,-10,-20,-22,-44,6,44,15
43,75,5,-4,-28,-34,-7,108,158
106,141,30,-29,8,-22,42,174,450
54,124,4,0,-25,-104,-18,121,156
20,42,-12,-28,-25,-24,1,44,18
11,123,-27,-84,-56,-152,19,212,46
215,336,39,-28,0,-86,176,333,985
47,143,-79,-24,-176,-283,-54,169,-257
48,124,39,11,-114,-180,-48,196,76
116,127,-38,-62,-109,-182,2,237,91
127,216,-27,-41,-91,-146,26,317,381
46,63,21,-13,32,-61,7,75,170
144,170,-20,-60,-28,-89,48,200,365
118,180,-34,-11,-118,-176,11,177,147
62,103,-40,-7,-27,-5,85,69,240
12,30,-28,-31,-76,-46,18,70,-51
17,14,-7,7,-18,-29,10,28,22
7,106,-40,-12,-14,-16,54,142,227
31,117,-85,-49,-151,-280,-40,230,-227
204,278,1,-54,87,1,140,314,971
5,5,-17,-29,-77,-50,0,62,-101
11,44,-25,-14,-52,-78,6,79,-29
184,266,-127,-168,-222,-267,13,345,24
48,72,-8,-27,-42,-20,9,91,123
-8,43,-27,-17,-43,-55,-9,50,-66
5,60,-69,-48,-131,-124,-22,124,-205
-69,-8,-61,-75,-109,-144,-72,82,-456
334,639,-120,-12,-243,-263,340,565,1240
30,74,12,-9,-16,9,27,82,209
5,54,-32,-2,-7,4,27,4,53
-53,-5,-89,-56,-167,-148,-68,92,-494
-7,72,-51,-85,-118,-100,-42,147,-184
-19,34,-26,-25,-65,-39,-9,57,-92
33,4,-98,-101,-188,-324,-89,227,-536
-6,21,47,3,12,15,14,63,169
229,422,-301,-167,-272,-309,134,552,288
52,65,-44,-15,-50,-112,-20,74,-50
25,36,16,-3,14,-22,9,46,121
-30,20,-43,-42,-80,-16,-15,76,-130
-36,-26,-48,-33,-64,-48,-25,31,-249
26,48,-20,-84,-71,-82,6,112,-65
-23,-19,-35,-27,-59,-119,-24,50,-256
-8,75,-45,1,-128,-114,-20,165,-74
35,61,-16,-4,-43,-42,21,65,77
42,53,-22,-3,-74,-98,6,90,-6
-41,55,-111,-63,-222,-235,-103,266,-454
52,57,-12,-6,-49,-38,27,50,81
29,15,-26,21,-40,-40,-5,14,-32
73,202,-147,-86,-262,-313,-37,327,-243
87,247,-132,-147,-352,-475,-151,422,-501
60,87,-43,-10,-83,-118,7,113,13
37,52,13,-15,-36,-40,32,93,136
106,94,17,34,3,-13,63,108,412
241,275,7,-126,-193,-175,70,547,646
4,3,1,-10,-29,-41,-4,35,-41
7,33,13,-9,-1,-22,-4,20,37
19,24,10,4,6,6,14,33,116
-18,-3,-21,-9,-45,-55,-22,26,-147
65,108,10,34,-57,-48,23,127,262
69,113,2,16,-45,-64,35,119,245
84,155,15,-26,-27,-94,24,216,347
84,203,-53,-17,-153,-165,21,218,138
66,78,-26,-11,-44,-100,-1,142,104
40,107,-21,-18,-3,-25,26,142,248
1,10,-33,-26,-71,-81,-37,52,-185
33,87,-79,-58,-50,-104,1,148,-22
54,82,-14,-39,-29,-68,27,130,143
164,163,-3,-16,-4,-42,92,161,515
85,107,-30,-49,-34,-75,49,110,163
22,90,-61,-32,-167,-199,-42,110,-279
11,41,-26,-29,-40,-36,7,72,0
14,8,-37,-6,-39,-57,-11,47,-81
-50,-8,-68,-51,-140,-187,-113,113,-504
65,76,-90,-20,-163,-152,45,176,-63
450,522,-63,-82,-94,-215,173,622,1313
-27,13,-18,6,-51,-135,-37,77,-172
-63,-39,-46,-44,-91,-92,-63,61,-377
57,89,-45,23,-153,-153,6,166,-10
-11,94,-93,-82,-147,-179,-13,128,-303
122,240,-178,21,-297,-373,-63,200,-328
-17,6,-61,-69,-142,-102,-43,117,-311
18,79,-74,-68,-124,-139,-6,122,-192
-59,-15,-68,-36,-89,-102,-46,61,-354
-3,83,-49,-45,-8,-15,15,87,65
-45,113,-134,-141,-150,-230,-51,224,-414
69,68,21,4,6,16,51,66,301
-2,11,10,-34,-72,-20,-10,106,-11
22,80,-80,-75,-255,-176,-28,242,-270
388,700,-208,-95,-94,-248,165,529,1137
661,882,-342,-128,-51,-237,436,538,1759
-5,-5,-8,-9,-10,-20,-18,16,-59
-21,38,-21,-7,-74,-112,-48,71,-174
176,212,-9,-18,-102,-175,14,266,364
154,205,14,-81,-13,-26,81,164,498
-3,-1,-47,-17,-64,-62,-23,48,-169
16,26,-15,-40,-28,-74,-10,33,-92
180,227,105,44,31,-112,36,262,773
181,200,100,32,-22,-105,26,261,673
73,154,-55,8,-98,-146,-10,164,90
195,401,-143,-99,-432,-508,41,612,67
-34,48,-97,-151,-226,-301,-91,250,-602
-15,-3,-27,-22,-38,-23,-26,17,-137
6,26,-20,-62,-71,-164,-37,121,-201
2,34,-12,6,-46,-30,1,78,33
-4,46,-44,-56,-67,-116,-23,95,-169
-10,25,2,0,1,-36,-19,37,0
-1,43,-5,12,-24,-34,-4,52,39
-6,1,-11,-21,-14,-23,-14,8,-80
45,67,-32,-33,-45,-67,21,101,57
-2,21,1,-8,-30,-52,-41,48,-63
59,97,6,-19,-131,-131,5,166,52
24,16,-75,-66,-59,-111,-4,67,-208
-17,17,-13,5,-27,-61,-30,41,-85
4,15,-5,0,-24,-17,11,18,2
-24,-18,-32,-18,-47,-45,-20,20,-184
27,111,7,-21,-33,-127,10,169,143
15,52,3,-20,-21,-35,-1,94,87
36,45,-5,-17,10,-37,22,48,102
66,203,-50,-5,-142,-193,-31,143,-9
-8,9,-14,1,-25,-14,-10,15,-46
13,14,-23,-26,-13,-31,0,34,-32
-19,-9,-21,-22,-39,-33,-24,27,-140
-19,6,-50,-80,-131,-126,-47,109,-338
9,28,-6,-6,-27,-60,-8,48,-22
40,110,-22,-40,-69,-101,7,132,57
-53,-39,-58,-38,-48,-80,-50,38,-328
65,88,-21,-38,-32,-30,-11,131,152
43,56,4,18,-39,0,21,92,195
-54,34,-126,-72,-200,-205,-73,144,-552
0,30,-17,-3,-37,-16,-1,53,9
-9,31,1,-11,7,-10,2,31,42
-3,80,-15,-40,-130,-94,-16,196,-22
41,104,-11,-33,-120,-125,-2,202,56
7,-16,-19,7,-39,-51,-21,42,-90
13,-3,-24,-28,-90,-142,-21,78,-217
-31,-7,-62,-63,-96,-130,-40,91,-338
-1,33,-35,-5,-50,-52,-23,63,-70
5,39,-5,-10,-31,-41,-10,61,8
-2,13,-2,4,3,1,-11,17,23
0,0,-36,-21,-88,-57,9,45,-148
-61,-24,-59,-80,-50,-126,-36,74,-362
28,82,-8,166,-141,-12,40,174,329
-4,-6,-21,4,-43,-23,-7,8,-92
-6,6,-5,-19,-8,-18,-8,25,-33
27,2,-21,-29,-47,-89,-21,90,-88
-1,21,-9,-1,-23,-9,-2,10,-14
5,25,-3,-3,-12,-15,-13,33,17
3,21,-10,-12,6,-33,-24,18,-31
6,50,31,-21,-15,-167,-57,146,-27
3,16,-9,-47,0,-66,-3,66,-40
11,33,-22,-20,-41,-29,-7,57,-18
28,21,-17,-40,-46,-107,-10,85,-86
-6,12,-19,-1,-39,-40,-4,41,-56
-1,19,-16,-8,-24,-45,-6,36,-45
48,53,-20,-1,-75,-84,32,148,101
-15,13,-14,-21,-22,-45,-23,32,-95
27,100,5,0,-48,-85,-15,177,161
29,6,-57,-40,-92,-149,3,126,-174
7,58,2,-16,-34,-57,-5,75,30
-5,20,-33,-34,-78,-76,-7,83,-130
20,75,-41,-31,-67,-91,7,106,-22
-78,1,-66,-62,-123,-222,-110,91,-569
64,102,-38,-24,-32,-47,47,102,174
45,47,11,9,-108,-98,-39,120,-13
33,55,-14,2,-68,-95,-14,102,1
17,54,-10,-30,-46,-50,3,78,16
37,63,-27,5,-39,-55,9,77,70
5,21,0,0,-14,-15,0,42,39
9,48,10,3,-5,-49,-7,62,71
-27,4,-33,-14,-39,-56,-34,28,-171
8,51,-37,-50,-66,-75,18,97,-54
5,34,-13,-11,-15,-37,-4,18,-23
23,40,0,-21,-32,-39,14,72,57
-7,46,-17,-16,-15,-58,-6,47,-26
-37,-13,-52,-33,-66,-89,-44,60,-274
21,112,-25,12,-109,-180,-47,199,-17
34,26,-41,-69,-100,-92,11,119,-112
40,33,-2,-23,-39,-98,-2,69,-22
9,75,-1,3,-35,-116,-14,91,12
14,34,-30,16,-49,-41,-17,85,12
-25,24,-19,10,-59,-126,-61,47,-209
69,92,103,44,38,-36,7,134,451
69,103,-1,-1,-50,-73,29,101,177
-19,15,-3,-22,-8,-12,-22,26,-45
14,41,1,-6,13,-7,17,48,121
-3,27,-12,-2,-26,-20,-12,19,-29
10,27,-8,0,-60,-70,-33,40,-94
62,108,-32,12,-52,-98,6,134,140
139,194,59,75,-89,-191,-39,300,448
-11,25,-13,-22,21,-22,-5,39,12
33,168,72,-66,-46,-119,-27,255,270
-21,38,-90,25,-167,-158,-36,115,-294
-7,24,-52,-41,-90,-79,-26,93,-178
154,164,10,5,1,-11,19,219,561
3,15,-3,10,-81,-75,-19,79,-71
68,118,-79,-46,-151,-77,-42,231,22
44,91,-6,-5,-16,-53,16,96,167
21,86,-29,-23,-59,-122,0,146,20
18,36,-29,3,-63,-63,-8,31,-75
33,83,23,47,-37,-11,1,75,214
38,98,43,-21,15,-10,4,90,257
-15,86,-19,-71,-105,-45,-33,175,-27
56,71,-68,-34,-163,-63,16,172,-13
28,121,25,-42,-10,23,4,132,281
91,102,-10,8,-101,-190,44,215,159
58,31,-47,-63,-132,-209,-49,191,-220
-21,3,-52,-50,-64,-79,-16,54,-225
139,165,-23,-30,-161,-297,-47,298,44
-15,46,-8,-11,-13,-14,-18,56,23
18,36,-25,-7,-2,-41,3,31,13
9,41,-11,-5,-39,-49,-23,70,-7
6,11,-40,-56,-59,-62,-9,64,-145
-7,6,-21,1,-26,-30,-7,25,-59
27,29,-27,-23,-46,-67,3,70,-34
14,22,-12,-1,-17,-54,2,62,16
20,8,8,-10,-1,-42,-12,33,4
30,66,8,-6,25,-11,25,64,201
8,38,-22,-10,-30,-95,-16,64,-63
7,62,7,-1,9,4,18,58,164
-6,11,-10,0,-26,-28,6,39,-14
5,18,-5,-8,-8,-39,8,37,8
11,16,-24,-30,-68,-92,-40,90,-137
7,30,-7,-12,-1,-22,11,38,44
-2,83,2,-36,-41,-141,-32,90,-77
29,35,1,4,-11,-15,21,42,106
5,6,-29,28,-48,-82,-15,64,-71
-4,30,-10,-28,-7,-19,-11,36,-13
7,29,-28,-41,-82,-88,-36,63,-176
-4,16,-12,-8,-36,-68,-43,52,-103
12,30,-16,7,-12,-43,8,45,31
4,36,-63,-13,-52,-11,28,68,-3
80,257,-30,-148,-121,-254,-44,452,192
0,42,-1,-12,1,10,5,49,94
99,137,28,-1,-24,-81,4,157,319
53,49,9,-95,-107,-203,-130,259,-165
6,53,-31,-24,-61,-34,0,73,-18
0,25,-16,-1,-38,-23,-10,47,-16
24,109,-72,-55,-146,-137,14,238,-25
41,121,-5,1,-93,-182,-63,126,-54
0,100,-43,-53,-119,-122,-9,173,-73
-6,93,36,-12,-14,-6,-21,71,141
10,17,3,-2,-17,-25,-3,34,17
153,363,215,18,127,41,100,391,1408
-5,113,10,-21,-59,-173,-55,179,-11
-19,3,-9,-13,-15,-27,-25,8,-97
39,41,1,-2,-35,-35,15,65,89
441,518,-358,-562,-1098,-819,-89,1420,-547
-19,58,-44,-42,-99,-145,-11,105,-197
163,245,-400,-441,-634,-703,-147,748,-1169
-15,42,-79,-86,-117,-157,-28,139,-301
19,4,-34,-25,-45,-69,-10,38,-122
-10,39,-50,-24,-26,-22,20,103,30
108,194,24,-124,17,-127,22,265,379
71,96,22,-38,12,-54,30,138,277
80,113,-30,-44,-30,-74,56,142,213
351,387,-33,-72,-105,-86,103,463,1008
120,124,27,32,-83,-69,9,218,378
76,94,-29,23,-89,-124,25,111,87
-13,34,-45,-47,-102,-59,-6,93,-145
7,12,-67,-47,-53,-137,-43,106,-222
152,262,-51,-47,-140,-107,71,324,464
25,43,-2,-3,-28,-19,15,43,74
368,420,-46,-87,-100,-275,152,483,915
-10,8,-12,-8,-16,-31,-10,24,-55
-42,6,-89,-106,-80,-189,-81,122,-459
344,586,-66,-85,-191,-112,-120,776,1132
-54,-19,-91,-101,-106,-99,-54,60,-464
28,48,-36,-31,-58,-79,-7,122,-13
184,255,-76,-35,-101,-160,70,200,337
324,450,-24,22,-75,-151,183,437,1166
-1,102,-5,-52,32,-6,26,111,207
0,9,-2,-8,-6,-24,-10,19,-22
210,363,-262,-370,-347,-419,64,748,-13
19,40,-93,-72,-162,-263,-91,140,-482
18,41,10,-5,-8,-4,13,36,101
11,43,13,-3,-20,-9,6,67,108
63,107,-27,-51,-28,-54,31,153,194
-11,14,-35,-62,-58,-57,-23,63,-169
-22,3,-43,-40,-85,-124,-43,88,-266
-4,31,9,-23,0,-33,-15,25,-10
23,32,-21,-17,-40,-36,4,20,-35
89,61,-3,-1,-54,-38,26,113,193
2,1,-15,-1,-22,-31,-6,23,-49
1,13,-6,-11,-4,-23,9,24,3
254,316,143,106,98,60,55,297,1329
-35,-21,-95,-116,-120,-152,-61,114,-486
58,77,-41,12,-136,-155,11,118,-56
-14,50,-47,-48,-130,-121,-51,98,-263
0,122,-31,-70,-170,-230,-33,201,-211
23,37,15,4,14,0,18,50,161
34,59,1,-9,-7,-36,6,44,92
9,61,-57,-97,-64,-111,6,112,-141
-5,19,-30,-71,-30,-102,-53,111,-161
184,347,-54,-110,-155,-270,-14,403,331
-43,-33,-73,-24,-91,-75,-26,47,-318
-1,32,-42,-56,-63,-103,-36,87,-182
82,127,24,12,-6,-100,15,168,322
293,410,-55,1,-69,-113,187,330,984
-84,-11,-114,-82,-147,-145,-61,120,-524
10,2,-2,-13,4,-13,2,19,9
35,125,-158,-157,-321,-297,-48,384,-437
-5,172,-213,-136,-431,-672,-175,352,-1108
-29,27,-35,3,-139,-109,-47,112,-217
1,5,-95,-32,-115,-84,8,74,-238
-3,11,-72,-54,-97,-96,-38,78,-271
40,48,-12,-11,-37,-107,5,87,13
-27,13,-47,-18,-79,-101,-45,87,-217
29,30,-17,-10,-68,-100,5,77,-54
-57,36,-39,-32,-144,-143,-81,129,-331
-16,-31,-55,-46,-52,-127,-60,43,-344
0,158,22,23,-21,-193,-79,149,59
78,153,-94,15,-199,-241,-33,155,-166
77,83,21,24,-43,-24,-6,165,297
55,109,30,2,-89,-76,-25,111,117
14,51,-8,-26,-37,-65,13,71,13
-1,15,-30,-35,-59,-96,-10,72,-144
36,69,39,3,-11,-52,2,123,209
105,208,-17,-44,-142,-135,30,221,226
38,78,-31,-11,-51,-105,-3,104,19
99,207,81,-2,-38,60,84,292,783
246,329,-11,46,-23,-230,97,442,896
-5,51,-17,-25,-70,-38,-17,98,-23
-11,0,-45,-58,-136,-59,-18,96,-231
1,141,-42,-9,-7,-19,28,131,224
41,52,-27,-7,-30,-53,2,34,12
72,119,2,-19,19,-26,36,149,352
93,173,-58,-57,-88,-108,83,226,264
41,136,-93,-95,-144,-128,-26,223,-86
11,42,-41,-24,-79,-65,2,96,-58
40,99,-54,-30,-91,-120,1,82,-73
19,56,-110,-122,-124,-238,-72,170,-421
37,119,-21,-10,-54,-66,0,87,92
-9,47,-78,-55,3,-6,23,82,7
38,137,-66,-60,-121,-152,-26,192,-58
39,141,-74,-28,18,12,57,188,353
9,115,-251,-222,-452,-293,-52,347,-799
216,386,109,-2,-1,-113,146,385,1126
16,87,-28,-71,-72,-63,-10,102,-39
16,94,-9,-3,4,-28,57,134,265
85,125,-61,-5,-133,-65,74,210,230
109,183,-75,-20,-188,-313,-37,129,-212
128,153,49,-46,63,-79,39,184,491
46,112,19,-17,16,-33,27,118,288
94,113,43,33,-77,0,6,243,455
10,107,-59,-56,11,-32,17,155,153
-18,81,-99,-70,-1,31,48,103,75
8,64,-38,-36,7,-17,23,95,106
45,107,-107,-97,-271,-272,-59,231,-423
24,79,20,19,2,28,69,98,339
71,147,63,55,-75,13,50,243,567
-49,95,-75,-89,-7,28,38,190,131
29,81,-87,-81,-146,-206,-43,176,-277
179,240,-21,-102,-82,-148,35,377,478
18,58,14,-28,-2,-71,7,91,87
2,89,-52,-82,-143,-205,-19,219,-191
10,61,-33,-56,-57,-114,-5,73,-121
67,170,-40,-41,-27,-125,85,258,347
-7,93,-43,-17,-6,26,55,131,232
68,74,-86,-50,-111,-154,5,126,-128
-77,-22,-69,-67,-93,-123,-62,63,-450
2,60,-30,-31,-3,-35,4,67,34
70,130,-56,-43,-98,-121,33,111,26
11,31,-15,2,-21,-34,-3,35,6
-42,126,-64,-91,15,27,48,245,264
229,324,62,-51,-12,-56,103,411,1010
-10,-8,-53,-81,-93,-126,-30,131,-270
11,44,5,-3,-4,-12,12,34,87
20,241,7,-109,12,82,99,171,523
-69,-30,-56,-45,-61,-147,-61,89,-380
93,112,3,-14,17,-19,24,133,349
-72,-61,-113,-61,-162,-187,-78,95,-639
52,116,-47,-18,-91,-69,22,123,88
71,147,-22,1,-99,-69,41,127,197
4,19,5,-39,-33,-69,-6,104,-15
-17,49,-56,-27,-9,-29,52,87,50
-24,137,-66,-89,19,2,42,187,208
65,82,1,6,-7,-61,34,112,232
32,69,-24,-47,-55,-95,-14,112,-22
25,110,-16,21,7,-3,77,131,352
5,4,-44,-76,-61,-64,-6,104,-138
151,429,-138,-132,-437,-823,-154,631,-473
3,38,3,-4,-8,-43,-2,47,34
221,389,-81,-19,-178,-206,128,436,690
10,23,3,-18,2,-17,11,33,47
-10,42,-11,-14,-49,-109,-36,86,-101
11,28,-9,8,-25,-51,2,42,6
19,62,-12,-40,-27,-117,-17,114,-18
7,44,-22,-33,-19,-54,-23,57,-43
177,243,-55,-45,-172,-198,30,297,277
-37,23,-47,-14,-80,-106,-54,65,-250
105,161,-54,-11,-120,-151,-5,100,25
18,25,2,-4,-16,-22,2,22,27
-42,-43,-44,-18,-53,-81,-58,47,-292
162,258,-168,-41,-305,-382,-58,291,-243
8,51,10,-6,-24,-6,15,54,102
8,18,31,17,-2,-11,3,35,99
-26,13,-13,-26,-22,-43,-17,43,-91
-41,-24,-39,-42,-40,-70,-21,74,-203
-75,-33,-107,-84,-126,-275,-116,104,-712
67,46,6,39,-26,-59,7,103,183
-63,22,-105,-44,-147,-148,-87,172,-400
182,468,45,-164,-18,-222,96,566,953
145,693,-255,-73,-340,-497,155,567,395
45,60,-1,-32,-25,-39,31,56,95
-25,29,-24,-31,-3,-35,18,23,-48
78,134,11,16,-15,-37,53,118,358
24,5,-5,-5,-8,-24,1,23,11
15,18,-57,-38,-68,-130,-23,81,-202
59,117,-9,-27,42,-75,90,73,270
43,66,10,37,-98,-119,1,107,47
15,21,-63,-39,-91,-134,-8,46,-253
-1,-1,-10,-21,-6,-36,-8,37,-46
64,104,48,32,21,-12,21,112,390
-31,88,-423,-414,-499,-874,-257,453,-1957
-17,21,-45,-58,-58,-114,-57,66,-262
-75,76,-153,-75,-3,18,16,94,-102
39,83,53,23,1,20,23,83,325
42,63,-14,4,-23,-78,-2,64,56
7,55,-11,11,-45,-47,-3,52,19
37,74,-8,14,-44,-91,11,70,63
-5,17,0,-17,-17,-30,-2,54,0
51,90,-69,-53,-95,-158,-20,104,-150
57,84,-17,-9,-6,-14,74,96,265
-67,54,-67,-106,-185,-247,-84,264,-438
191,454,-140,-214,-409,-385,16,647,160
283,326,43,-42,63,-147,97,319,942
35,77,-48,-69,-91,-132,-1,132,-97
177,244,-86,-41,-141,-225,-34,275,169
21,87,-4,11,-34,-44,16,71,124
66,95,55,-3,39,0,33,94,379
36,81,3,-12,-7,-52,24,97,170
-32,32,3,-31,-4,-41,-35,86,-22
36,99,-75,-35,-93,-189,-11,156,-112
-17,84,-154,-100,-305,-419,-133,267,-777
-58,-6,-24,-12,-34,-73,-48,63,-192
-7,204,-90,-134,-173,-453,-138,377,-414
686,1041,-20,-229,-115,-425,267,1200,2405
131,276,-26,-17,-81,-162,88,315,524
46,85,14,-22,-1,-51,25,98,194
-3,5,-11,-13,-25,-6,9,12,-32
216,264,17,-10,-50,-128,113,351,773
2,37,8,23,-30,-3,8,40,85
19,14,41,-26,39,20,19,63,189
24,3,-21,10,-40,-60,4,30,-50
48,48,16,-24,28,-16,14,57,171
41,45,1,20,-48,-15,31,63,138
54,54,1,-47,30,-105,-23,61,25
50,113,-3,-48,-52,-131,2,146,77
219,335,-12,-63,-91,-231,-34,376,499
3,57,-35,-24,-14,-10,37,108,122
8,256,-246,-306,-512,-718,-234,630,-1122
31,83,56,4,20,24,35,111,364
9,37,-13,-2,-11,-23,0,40,37
10,43,20,5,-6,-7,16,65,146
2,19,-10,-3,-19,-20,-13,28,-16
35,106,2,-14,-51,-155,-24,118,17
67,418,-288,-221,-522,-923,-248,725,-992
27,26,-29,-9,-84,-82,-5,45,-111
-21,18,-74,-30,-133,-112,-24,118,-258
0,15,-13,-8,-34,-21,-3,55,-9
55,86,44,20,-2,-6,27,87,311
-5,25,19,-5,-28,-113,-23,72,-58
7,50,34,-10,15,-5,26,47,164
8,21,3,4,3,-33,-10,21,17
98,165,-30,-39,-74,-104,21,232,269
6,70,-61,-50,-83,-76,-4,84,-114
35,89,4,-49,14,-83,29,98,137
96,119,-48,-30,-38,-51,45,103,196
13,62,20,-23,-60,-176,-39,130,-73
27,34,-2,-8,-6,-7,17,19,74
77,86,-40,-13,-69,-53,25,117,130
9,23,7,1,0,-18,12,40,74
-92,10,-92,-49,-156,-143,-70,98,-494
11,62,45,-1,18,4,17,62,218
25,51,-7,-11,-17,-29,34,59,105
-9,29,-9,-20,-10,-61,-24,64,-40
98,121,-3,17,-21,-25,52,122,361
0,52,-69,-35,-39,-43,43,100,9
-10,63,-100,-105,-141,-182,-63,212,-326
28,31,9,2,3,13,18,34,138
9,27,17,6,-1,-29,0,40,69
-13,-5,-7,-37,-16,-56,-10,14,-130
9,34,10,6,-10,-32,-1,48,64
90,182,31,7,-33,-91,46,223,455
233,406,-31,-33,-118,-180,75,352,704
205,288,-93,2,-130,-167,70,301,476
56,94,-137,-97,-210,-338,-103,244,-491
67,227,-152,-99,-318,-452,-100,409,-418
-7,13,-52,-4,-145,-159,-56,134,-276
40,71,-12,-15,-49,-52,27,70,80
103,104,-69,-16,-136,-201,14,126,-75
-4,16,-21,-28,-16,-20,12,42,-19
-3,13,-37,3,-83,-64,-1,71,-101
86,156,-79,-103,-80,-159,-8,218,31
120,116,-26,44,-128,-130,27,209,232
-11,23,-39,-12,1,9,10,35,16
43,66,38,16,30,-18,33,89,297
25,22,5,0,-11,-11,19,49,98
40,50,0,-17,7,-38,9,67,118
26,102,-22,-6,-78,-126,-28,136,4
57,84,-22,-30,-49,-106,28,126,88
40,36,-48,-40,-28,-72,0,65,-47
45,70,-104,-140,-148,-186,-27,225,-265
-39,185,-396,-535,-455,-644,-43,780,-1147
0,44,20,21,-8,7,9,54,147
33,37,-29,-25,-76,-59,-5,54,-70
77,154,44,18,-11,-18,64,216,544
52,34,-31,-11,-88,-80,18,50,-56
9,20,-18,-12,-29,-12,13,31,2
41,82,-6,-11,-26,-43,5,42,84
35,77,-45,-24,-75,-73,8,79,-18
328,472,-88,10,-61,-51,268,318,1196
18,67,-47,-11,-66,-115,-17,85,-86
149,190,14,-31,-9,-76,43,199,479
41,309,-119,-170,-152,-380,58,533,120
270,466,-62,-23,-43,-160,142,501,1091
102,148,4,2,-33,-61,45,178,385
176,331,-58,-66,-92,-233,119,422,599
186,352,-86,22,-171,-203,3,168,271
18,115,-132,-82,-230,-452,-80,241,-602
113,266,25,-82,27,-214,16,358,509
280,495,61,-27,59,-99,163,475,1407
44,60,20,-5,7,-23,23,86,212
34,91,-24,-75,-27,-159,-21,125,-56
2,33,-27,-26,-31,-40,-8,59,-38
39,35,-27,-4,-38,-74,10,52,-7
105,150,-63,-79,-71,-132,39,218,167
-35,34,-40,-27,-95,-121,-56,88,-252
0,76,-7,-27,-18,-32,13,64,69
140,141,-68,-46,-73,-147,73,211,231
22,79,-48,0,-51,-55,12,60,19
82,130,-34,8,-80,-97,27,104,140
75,110,-30,-8,10,5,63,85,310
70,110,-19,-64,-32,-127,15,194,147
18,-1,-9,0,-13,-46,2,41,-8
110,189,11,18,-47,18,113,150,562
21,112,-141,-135,-201,-326,-82,254,-498
20,61,-6,19,-22,-17,23,44,122
4,5,-37,-26,-65,-39,20,55,-83
83,237,-60,-55,-175,-229,7,266,74
-46,-19,-41,1,-76,-44,-41,29,-237
49,176,-107,-116,-270,-283,-33,307,-277
16,89,-28,-22,-85,-146,-38,136,-78
7,33,-9,-12,-3,-17,0,33,32
-1,8,-14,-16,-13,-19,-3,31,-27
40,112,-13,-31,10,-75,24,79,146
-21,16,-73,16,-122,-118,-27,69,-260
227,380,-128,-35,-152,-213,71,449,599
21,63,18,-2,-4,-24,19,65,156
9,31,-4,-8,-12,-17,11,31,41
17,77,-12,-28,-42,-80,30,103,65
184,299,83,15,59,18,115,328,1101
175,220,-46,-55,-109,-111,92,293,459
97,254,-64,-107,-204,-373,-113,349,-161
-52,-2,-21,-16,-12,-48,-50,33,-168
213,263,-15,23,-90,-39,106,279,740
3,18,-4,-17,-29,-28,8,41,-8
145,182,-1,-11,-122,-238,33,230,218
-17,-17,-39,-12,-47,-91,-42,56,-209
-2,73,-31,-28,-65,-87,5,72,-63
383,389,-154,-30,-315,-312,143,633,737
-8,16,-10,-21,-16,-28,-13,22,-58
129,95,-31,-33,-87,-120,27,141,121
8,30,-6,-6,-10,-12,17,35,56
13,48,34,23,-76,-72,-9,140,101
8,26,-7,-1,-29,-16,26,44,51
19,9,-3,-17,3,-32,7,24,10
111,159,44,-27,35,-85,18,161,416
133,183,8,-21,-39,-100,17,228,409
7,37,0,-1,-20,-10,1,48,62
13,62,7,-17,-67,-48,16,95,61
41,76,32,-21,6,-57,8,83,168
-36,-9,-50,-51,-66,-155,-55,77,-345
33,65,-21,-27,-86,-177,-40,49,-204
-103,20,-123,-116,-164,-251,-111,193,-655
62,115,-19,7,-40,-40,68,103,256
134,230,43,-33,12,-104,34,209,525
169,281,-6,-23,-6,-116,63,206,568
138,213,-149,-124,-137,-246,85,326,106
-3,69,-79,-73,-179,-166,-83,205,-309
101,152,-23,5,-136,-124,42,120,137
73,111,-14,-6,-55,-49,17,126,203
26,59,22,12,-29,-28,24,67,153
55,84,-61,-58,-136,-170,-12,184,-114
61,128,-106,-81,-251,-324,-90,302,-361
0,26,-14,-29,-33,-80,-14,59,-85
50,94,-52,-29,-158,-117,6,123,-83
75,483,186,-63,93,82,56,381,1293
25,23,-25,-32,-8,-53,-18,48,-40
-13,45,-51,-64,-115,-46,6,104,-134
9,2,-46,-29,-70,-145,-35,79,-235
-50,-25,-85,-54,-172,-167,-81,109,-525
-16,-2,-140,-77,-194,-305,-99,186,-647
4,-1,-11,-5,-15,-26,-14,13,-55
-39,101,76,107,-115,137,5,60,332
-33,72,50,61,-89,97,2,41,201
365,506,34,-38,-97,-155,225,522,1362
146,363,-522,-396,-825,-835,-89,875,-1283
5,25,-67,-72,-175,-163,-5,186,-266
26,114,-44,-37,-115,-146,-3,149,-56
147,288,-292,-304,-552,-1020,-290,780,-1243
36,87,-13,-39,-44,-97,-9,151,72
279,442,-10,-32,-103,-129,134,488,1069
407,428,36,-132,26,-172,138,490,1221
146,239,-42,-74,-62,-131,31,316,423
37,151,-13,-60,-23,-96,5,208,209
272,515,44,-69,-27,-176,103,602,1264
86,149,-90,-50,-128,-156,2,208,21
-24,-18,-46,-37,-61,-101,-41,48,-280
192,283,44,-13,-43,-153,69,396,775
-4,-11,-51,9,-102,-70,-7,57,-179
-3,8,-38,-9,-43,-58,-11,48,-106
2,-4,-20,-26,-15,-36,12,46,-41
56,162,-90,-74,-157,-326,-56,235,-250
79,132,4,-32,-48,-147,1,240,229
70,191,-27,-29,-12,-100,1,194,288
29,57,-49,-19,-60,-80,-27,84,-65
8,48,3,-5,-18,-39,-15,66,48
51,81,-45,-32,-56,-74,8,88,21
71,186,-157,-146,-263,-360,-48,331,-386
-14,25,-28,-23,-67,-95,-21,134,-89
50,84,-18,-7,0,-33,29,45,150
361,461,35,-23,82,-115,184,515,1500
40,19,0,-27,-18,-53,-2,49,8
47,49,-4,3,-15,-6,38,55,167
-8,30,-11,-34,-36,-33,-2,48,-46
11,31,-36,-8,-46,-56,-1,46,-59
11,22,-27,-15,-34,-9,8,24,-20
66,137,-46,-24,-59,-35,56,120,215
354,410,-1,-107,-109,-332,61,677,953
41,45,31,7,19,9,25,38,215
120,145,40,6,-35,-63,29,161,403
128,152,-32,-35,-77,-51,85,221,391
-8,6,-19,-20,-17,-12,-4,12,-62
4,53,-15,-22,-75,-62,-15,119,-13
16,78,42,1,-2,-14,21,83,225
-31,-9,-44,-21,-65,-98,-41,55,-254
-88,-17,-111,-75,-150,-164,-57,98,-564
111,206,98,21,32,-69,31,281,711
-1,0,-42,-38,-84,-76,-12,86,-167
7,22,-22,-5,-38,-8,6,29,-9
-11,20,-7,-10,-4,1,13,18,20
1,23,-3,-4,-7,-26,-6,38,16
8,23,-21,-11,-24,-17,5,40,3
31,28,-7,11,-14,-41,5,39,52
102,123,100,-97,105,-29,36,177,517
-21,570,445,196,-178,165,-125,650,1702
-12,-3,-13,-12,-11,-22,-7,11,-69
34,86,-121,-104,-244,-306,-42,212,-485
-98,5,-174,-117,-189,-320,-139,212,-820
-38,-26,-158,-124,-148,-255,-108,140,-717
147,246,35,-4,-23,-87,46,254,614
82,93,-46,-5,-47,3,79,90,249
4,13,-11,-6,-2,-48,-23,20,-53
189,190,-16,-1,-78,-88,14,202,412
27,75,-42,-73,-97,-208,-90,159,-249
-58,-2,-79,-25,-101,-123,-84,77,-395
229,303,-79,-60,-94,-111,107,290,585
111,194,-17,-44,-84,-146,39,163,216
169,339,-34,-103,-151,-239,72,437,490
97,174,-46,-16,-79,-117,15,181,209
186,200,20,-65,-12,-183,76,285,507
5,69,-43,-63,-32,-9,58,193,178
320,472,-58,18,-94,-53,227,505,1337
92,283,70,28,-197,-103,77,330,580
131,240,-46,-76,-61,-66,128,226,476
35,180,-18,-84,-86,-233,-21,253,26
176,285,56,3,-13,-75,58,265,755
203,293,-13,-53,-182,-236,52,511,575
304,381,-29,-40,-117,-331,54,408,630
-27,54,-55,-62,-78,-90,4,108,-146
214,209,-225,-137,-225,-320,66,313,-105
65,39,-147,-88,-236,-179,16,147,-383
135,166,-5,-30,-63,-94,49,261,419
-29,25,-47,-42,-63,-126,-27,84,-225
121,206,-147,-110,-172,-53,108,224,177
61,89,-59,16,-92,-144,-28,69,-88
-36,-11,-72,-18,-134,-165,-36,162,-310
24,44,4,-2,-5,-46,-3,70,86
5,37,-26,-16,-33,-9,8,45,11
99,115,90,-46,56,-81,28,143,404
83,158,15,-9,-50,-229,-40,203,131
68,135,-44,-58,-118,-120,11,194,68
27,36,-40,-28,-46,-93,-12,64,-92
48,64,-18,-13,-31,-52,40,88,126
-45,-33,-88,-43,-132,-180,-67,109,-479
44,29,-83,1,-100,-110,-15,60,-174
9,34,-57,-56,-27,-92,1,72,-116
9,59,-55,-72,-65,-111,3,91,-141
82,108,-68,-15,-114,-165,-12,103,-81
2,32,-129,-100,-157,-270,-70,164,-528
-23,6,-39,-35,-50,-98,-38,83,-194
3,9,-38,14,-104,-27,3,52,-88
21,48,-15,-15,-54,-100,-40,96,-59
72,203,-78,-125,-172,-271,6,271,-94
21,12,-61,-24,-101,-118,-34,70,-235
100,181,72,7,1,-8,62,246,661
70,126,-7,14,-70,-84,18,111,178
-12,90,-54,-62,8,-42,0,106,34
40,74,-28,17,-50,-61,-1,77,68
114,34,-114,21,-235,-101,67,171,-43
42,47,-11,-2,-39,-88,-1,63,11
27,70,7,-4,12,1,66,79,258
0,51,-25,-35,-67,-109,-18,65,-138
79,82,1,-8,8,-33,34,110,273
40,100,-72,-13,-99,-170,4,126,-84
123,199,-47,-16,-13,16,125,137,524
56,91,-38,-50,-69,-79,34,68,13
40,45,-3,7,-7,-48,4,71,109
31,78,-15,-6,-31,-67,-9,100,81
8,4,-37,-48,-71,-76,-15,63,-172
2,78,-96,-120,-219,-356,-86,217,-580
108,219,-81,-21,-87,-125,72,199,284
59,129,13,14,-17,-66,21,136,289
-8,2,-60,-36,-82,-106,-14,67,-237
73,152,97,1,32,-23,35,229,596
-13,-4,-42,-48,-37,-105,-8,76,-181
11,31,-16,9,-51,-92,-27,82,-53
-9,14,-24,-33,-40,-104,-19,64,-151
-17,-12,-52,-34,-99,-83,-15,63,-249
-10,19,-76,-83,-112,-114,18,104,-254
2,29,-69,-54,-101,-103,-1,55,-242
8,-3,-45,-114,-83,-145,-32,125,-289
44,35,-35,-40,-86,-94,2,84,-90
5,61,-68,-57,-97,-126,-31,158,-155
11,32,-68,-98,-124,-187,-50,90,-394
18,18,-22,0,-34,-16,12,38,14
9,54,-67,-75,-160,-180,3,123,-293
134,250,-53,16,-169,-171,37,252,296
76,129,-47,-32,-14,-77,21,141,197
31,78,-26,-30,-21,-41,34,66,91
31,90,-38,-7,-51,-89,-3,111,44
50,80,-8,-8,-98,-59,20,83,60
-4,87,-62,-33,-100,-224,-49,196,-189
24,39,-51,-23,-64,-64,15,33,-91
-5,3,-35,-31,-77,-66,-23,39,-195
-8,55,-62,-53,-4,27,62,93,110
-23,47,-37,-45,-93,-182,-68,178,-223
47,98,-25,-16,-81,-108,12,159,86
2,7,-39,-15,-24,-48,-9,55,-71
302,372,-97,-8,-193,-238,102,519,759
-31,-6,-151,-63,-193,-198,-60,194,-508
38,24,-23,13,-59,-40,18,48,19
45,100,-19,-21,-55,-54,14,80,90
32,96,-3,-71,-61,-144,-18,167,-2
93,125,-23,-38,-64,-20,70,169,312
55,70,-12,60,-81,-46,39,88,173
34,33,-40,-48,-39,-153,-51,115,-149
9,-29,-57,-41,-60,-89,-1,45,-223
-2,0,-47,-46,-58,-76,-17,52,-194
26,62,-60,-28,-92,-128,-6,78,-148
75,138,-1,-27,8,-42,60,136,347
-47,32,-94,-31,-143,-162,-45,148,-342
20,55,-30,-51,-48,-116,-16,114,-72
-53,-8,-96,-13,-142,-108,-47,82,-385
339,532,-125,-102,-167,-350,166,482,775
-33,104,-117,-73,-136,-335,-97,152,-535
54,83,-32,44,-287,-328,-46,230,-282
-63,-11,-58,-40,-68,-161,-117,74,-444
42,56,3,-2,-6,-4,24,65,178
54,71,14,18,-37,-74,4,109,159
-56,15,-96,-50,-158,-211,-88,109,-535
-60,-2,-81,-67,-141,-183,-91,114,-511
69,89,-25,36,-173,-85,-17,109,3
2,54,-70,-60,-133,-249,-109,171,-394
38,28,-17,-11,-2,-9,23,35,85
46,16,-12,-5,-5,-1,22,35,96
35,29,-11,-8,3,-7,25,37,103
43,39,-12,-6,4,2,30,30,130
-37,23,-41,-54,-119,-162,-55,127,-318
35,48,3,7,-29,-28,4,47,87
41,66,5,1,-24,-43,21,62,129
35,87,5,5,-40,-48,12,93,149
72,64,15,10,-28,-13,30,63,213
68,62,32,27,16,-16,32,91,312
38,51,20,-12,3,-21,7,74,160
29,330,-40,-71,-199,-614,-148,383,-330
-8,8,-9,-18,-23,6,-4,-4,-52
25,28,-30,-4,-33,-65,-11,40,-50
56,72,-3,-25,-37,-37,39,98,163
6,20,-22,-26,-44,-38,10,73,-21
45,110,-129,-48,-272,-379,-117,215,-575
-15,77,-61,-7,-129,-285,-49,205,-264
-43,45,-110,-25,-222,-254,-101,176,-534
-36,7,-78,-61,-141,-135,-68,101,-411
-80,-18,-78,-45,-131,-147,-74,97,-476
-65,25,-85,-18,-109,-169,-72,99,-394
-77,5,-91,-43,-127,-171,-82,59,-527
-12,-5,-24,-12,-55,-26,-1,50,-85
-29,6,-40,-35,-84,-42,-10,62,-172
-10,174,-27,-50,-204,-141,38,311,91
-16,84,-58,-73,-126,-90,-34,227,-86
10,39,30,1,-41,-26,-8,88,93
-26,58,-39,-45,-87,-96,-36,155,-116
55,79,-50,-13,-91,-125,-7,123,-29
47,134,-18,-44,-169,-51,24,279,202
13,77,-29,-41,-47,-36,29,90,56
9,19,-6,-7,-14,-35,-16,26,-24
17,27,-15,-5,-44,-13,18,53,38
-82,-4,-89,-87,-124,-169,-108,123,-540
-68,-26,-109,-117,-212,-226,-99,180,-677
294,394,-65,34,-44,56,199,333,1201
-7,1,-38,-36,-117,-219,-88,216,-288
17,17,3,-2,-14,-9,3,34,49
71,86,-80,-49,-139,-138,24,191,-34
36,101,16,5,-13,-4,27,110,278
122,138,-60,-95,-119,-114,15,247,134
-26,-22,-170,-140,-247,-298,-142,218,-827
-6,25,-28,-35,-57,-34,-15,61,-89
4,24,-38,-23,-36,-65,-7,51,-90
26,42,0,0,-11,2,25,34,118
217,263,-152,-94,-214,-312,36,438,182
122,219,-287,-161,-412,-602,-162,478,-805
310,578,-36,-127,-92,-278,158,582,1095
63,129,-130,-83,-243,-207,45,210,-216
-3,42,-22,-8,-108,-114,-46,152,-107
52,105,9,-13,-7,-34,18,90,220
285,503,-188,-265,-333,-435,-9,626,184
-23,153,-24,-63,0,30,76,206,355
140,134,-7,-27,-116,-81,17,238,298
-70,-51,-153,-70,-175,-246,-91,94,-762
-11,12,-159,-129,-229,-279,-58,225,-628
-3,41,-46,-37,-26,-51,15,92,-15
1,0,-32,2,-12,-18,4,7,-48
19,28,-14,-25,-75,-33,-25,87,-38
236,332,-28,-43,-135,-219,61,365,569
33,75,-28,12,-88,-74,-35,147,42
-5,39,-57,-68,-128,-201,-43,229,-234
34,64,-16,-34,-60,-39,6,84,39
17,67,-41,-47,-122,-107,19,153,-61
33,35,-11,-99,-28,-135,-16,163,-58
117,242,-124,-6,-170,-172,-12,149,24
89,154,-76,-44,-101,-196,-27,169,-32
-98,-9,-148,-106,-223,-241,-115,231,-709
88,206,48,3,-31,-51,60,234,557
45,98,-16,-39,-58,-133,3,90,-10
68,70,-6,-31,-34,-79,24,112,124
1,177,-26,-31,43,14,57,152,387
46,37,-119,-91,-184,-305,-60,178,-498
240,302,-186,-42,-295,-350,21,424,114
183,245,-101,-131,-131,-175,85,460,435
82,64,-42,-38,-78,-150,4,126,-32
-96,-34,-102,-42,-139,-150,-81,91,-553
60,77,-149,-92,-221,-343,-87,206,-549
-3,46,14,-3,-28,11,-15,31,53
-63,9,-40,-47,-81,-111,-56,63,-326
169,320,-125,-114,-310,-266,-42,439,71
3,141,-198,-150,-426,-493,-124,406,-841
-67,83,-123,-184,-185,-314,-115,175,-730
-52,61,-74,-49,-2,1,54,96,35
46,68,-2,54,-151,-98,-28,103,-8
42,57,6,44,-142,-94,-44,100,-31
46,61,-2,29,-141,-90,-46,113,-30
45,74,13,45,-123,-76,-33,96,41
13,42,-24,-32,-41,-51,3,21,-69
35,69,-85,-125,-125,-136,-5,163,-209
49,71,-83,-93,-184,-186,13,183,-230
184,321,-117,-227,-220,-412,-18,503,14
-77,25,-132,-141,-177,-216,-112,124,-706
-77,88,-58,-56,-153,-221,-95,176,-396
-44,61,-57,-44,-159,-227,-90,175,-385
291,409,-217,55,-492,-439,89,265,-39
44,472,219,-128,-407,-145,-167,1250,1138
76,508,172,-141,-367,-281,-97,1154,1024
33,153,-89,-48,-206,-148,18,243,-44
10,38,-51,3,-86,-106,-6,72,-126
135,228,-47,13,-52,-12,61,256,582
-53,-12,-83,-62,-50,-118,-60,66,-372
-9,35,-33,-49,-34,-47,-2,42,-97
33,50,2,-8,-9,-1,37,49,153
1,4,14,-26,-58,-78,-48,112,-79
135,159,9,6,-36,-46,39,227,493
32,242,-256,-148,-522,-596,-140,582,-806
-69,89,-161,-203,-291,-511,-181,473,-854
19,13,-26,-23,-64,-61,-2,18,-126
-21,61,-41,-86,-69,-159,-30,113,-232
239,311,-92,-103,-334,-320,-42,427,86
13,74,-16,-16,-47,-69,-5,89,23
92,160,-210,-88,-268,-303,17,288,-312
55,127,-119,-70,-273,-383,-77,194,-546
4,23,-10,-1,-9,-11,-7,29,18
85,166,57,-5,-36,-113,-27,216,343
14,-1,-17,-10,-18,-18,5,13,-32
-5,32,-16,-49,-31,-93,-5,86,-81
17,23,-25,-12,-47,-45,1,40,-48
25,62,18,-4,4,-4,17,52,170
75,183,-69,-89,-103,-229,19,233,20
22,43,-57,-68,-48,-112,1,84,-135
34,80,26,11,8,-30,23,65,217
5,28,-30,-28,-16,-46,1,44,-42
-4,-22,-31,-28,-17,-89,-33,42,-182
24,142,-28,-58,-99,-109,8,145,25
1,4,-6,-9,-2,-22,-1,25,-10
69,40,-204,-25,-343,-410,-89,132,-830
12,34,-14,-26,-56,-98,-32,79,-101
3,65,-4,-12,-24,-37,15,74,80
45,183,-170,-155,-303,-320,-42,316,-446
27,17,-58,-29,-142,-150,-24,87,-272
56,51,-21,19,-119,-95,31,136,58
46,73,-79,-15,-187,-207,-55,126,-298
18,21,-11,10,-47,-31,9,59,28
202,274,-162,-106,-401,-256,67,429,47
17,33,15,-13,3,-51,0,54,58
-17,26,-50,-61,-61,-92,-26,100,-181
64,116,-79,-81,-156,-159,11,116,-168
8,48,6,-8,9,-20,2,38,83
106,193,-40,-30,-2,-86,96,288,525
223,270,-68,-25,-31,-9,146,178,684
1,10,-27,-26,-88,-47,0,62,-115
-1,-6,-21,1,-42,-25,-10,8,-96
-24,22,41,44,-38,20,-16,23,72
-9,-11,-35,-15,-35,-33,-8,14,-132
19,28,-73,-121,-188,-82,-13,209,-221
35,64,-57,-40,-132,-107,2,103,-132
173,266,-89,-56,-120,-212,33,327,322
106,118,15,0,-10,-61,39,115,322
203,370,-230,-159,-339,-5,158,518,516
348,478,56,-8,20,-134,212,459,1431
-13,35,14,-10,-54,-27,4,81,30
-2,7,-25,-19,-45,-20,-1,20,-85
-6,15,-9,-6,-29,-23,2,23,-33
-21,12,-15,-11,-26,-6,3,26,-38
29,68,-10,-4,-31,-61,25,69,85
18,49,-25,1,-6,0,27,31,95
-1,10,-22,-13,-29,-24,-4,9,-74
95,202,21,-24,-63,-73,19,197,374
-52,-10,-59,-56,-60,-127,-70,96,-338
-44,15,-44,-35,-78,-93,-45,83,-241
23,36,-15,-17,-60,-88,-6,80,-47
472,664,17,57,65,-139,254,645,2035
4,0,-226,-152,-353,-401,-129,285,-972
137,243,-117,-77,-153,-226,-46,302,63
4,24,22,31,-12,-25,-14,39,69
105,157,-57,-52,-134,-87,63,173,168
30,42,23,19,-41,-2,-8,101,164
-5,33,-16,-49,-32,-23,8,44,-40
41,91,17,-1,-59,-214,-23,217,69
168,143,-11,25,-61,-38,91,189,506
48,96,-106,-91,-165,-238,-65,278,-243
-10,6,-43,-39,-52,-94,-10,53,-189
177,247,-144,-153,-448,-343,73,657,66
-25,-4,-48,-44,-91,-47,-31,46,-244
417,2948,518,1467,-2823,1784,323,3399,8033
102,96,48,-11,-9,-60,27,186,379
47,117,-124,-58,-181,-207,-2,212,-196
180,149,22,-44,-11,-152,7,180,331
-77,-47,-98,-28,-118,-109,-63,66,-474
13,72,-11,-6,-60,-42,-1,109,74
69,107,36,-19,25,-26,50,123,365
-4,23,6,-39,-13,-94,-5,59,-67
61,61,-8,-28,-42,-103,-3,102,40
40,51,-2,-47,-44,-65,3,100,36
-7,10,-62,-68,-122,-131,-19,98,-301
-93,-69,-77,-93,-95,-129,-90,61,-585
16,37,-31,-31,-64,-88,-6,38,-129
-2,9,-35,-36,-76,-77,2,68,-147
61,126,-17,-46,-57,-107,29,151,140
34,52,-14,-20,-45,-54,11,85,49
-9,83,-54,-39,-143,-190,-33,159,-226
36,43,9,-62,-10,-29,9,69,65
51,72,-11,-50,-60,-34,20,74,62
8,37,-22,-30,-36,-60,-5,63,-45
44,92,-61,-14,-126,-73,27,81,-30
151,172,-64,-127,-109,-205,5,252,75
460,635,-73,-94,18,9,284,552,1791
52,67,-29,-13,-66,-117,-11,63,-54
150,238,-71,-79,-155,-207,-21,350,205
13,26,1,-10,-29,-37,-15,60,9
173,326,-34,34,-111,-72,164,314,794
35,50,-7,3,-14,-7,23,59,142
165,204,-39,-2,-160,-88,94,310,484
60,91,9,5,-50,-51,40,119,223
71,85,-38,-42,-116,-156,12,96,-88
6,64,-65,-62,-67,-119,-20,116,-147
1,75,-16,-27,-61,-72,-10,122,12
69,141,-2,-12,-39,-92,52,138,255
43,73,-32,-34,-26,-84,-9,111,42
13,24,-36,-53,-68,-125,-10,102,-153
5,7,-12,0,-36,-27,-3,33,-33
24,19,-19,-14,-26,-37,14,51,12
66,114,3,-1,-9,-2,50,132,353
120,167,15,3,-166,-50,54,303,446
26,31,9,-10,-31,-61,-25,97,36
9,78,-11,-60,-120,-181,-53,152,-186
17,26,-41,-35,-50,-60,-7,83,-67
43,79,-21,-42,-40,-86,-18,75,-10
234,300,31,22,-22,-124,91,298,830
49,94,-13,0,-77,-97,-16,103,43
18,17,-15,7,-53,-26,25,44,17
-6,34,-28,-7,-56,-51,-33,50,-97
44,40,-26,15,-13,-34,-10,76,92
5,71,-4,-46,-34,-124,-23,89,-66
478,809,-400,-275,-809,-1052,-85,1113,-221
20,35,-15,0,-29,-44,-1,24,-10
66,182,13,-32,-84,-197,-1,174,121
132,120,19,51,-48,-16,31,211,500
-7,111,-239,-184,-397,-532,-189,243,-1194
-62,-26,-52,-26,-75,-106,-64,70,-341
10,113,82,97,-182,-7,-15,202,300
377,641,-216,43,-395,-523,-71,436,292
31,17,-40,-1,-106,-89,17,55,-116
47,109,-34,-40,-62,-137,-16,157,24
136,383,-117,-32,-156,-88,83,290,499
-103,-13,-101,-66,-162,-182,-125,95,-657
-5,16,2,7,-8,-12,-7,22,15
-13,16,-21,-12,-5,-12,-17,18,-46
58,41,-54,3,-63,-94,-9,84,-34
66,53,-20,-32,-59,-52,6,84,46
-2,18,-34,-30,-89,-45,-29,86,-125
53,81,25,9,-37,-37,-5,122,211
137,145,30,16,-48,-3,97,213,587
20,25,-11,-15,-20,-33,12,28,6
177,315,-90,-170,49,-12,102,345,716
81,97,-7,-51,9,-57,26,129,227
32,27,-24,7,-33,-26,18,33,34
70,506,-370,-438,-745,-740,-57,1056,-718
13,78,-27,-22,-36,-89,-4,67,-20
-9,20,-28,-18,-34,-37,-2,49,-59
10,61,-4,-47,-29,-74,-5,61,-27
50,55,-16,-34,-42,-57,26,80,62
-41,-17,-34,-13,-76,-66,-47,47,-247
10,17,3,-4,-4,-7,-9,24,30
9,23,-16,-11,-11,-18,8,1,-15
89,171,35,13,29,-7,107,217,654
50,61,-5,7,-15,-11,40,104,231
-6,77,-91,-100,-154,-199,-9,158,-324
-8,75,-58,-83,-138,-246,-92,145,-405
88,141,31,8,-13,-5,59,148,457
17,181,-16,-28,7,0,57,169,387
53,521,321,227,-128,-214,-124,764,1420
37,96,-75,-25,-228,-259,-10,243,-221
33,32,6,5,-52,-115,-12,79,-24
99,115,-82,-132,-127,-122,45,239,35
-16,11,-34,-10,-72,-75,-37,69,-164
36,53,-37,-26,-43,-20,10,73,46
8,65,-27,-8,-30,-19,43,62,94
8,35,-19,-49,-11,-45,-9,30,-60
5,47,-13,-75,-54,-71,-12,126,-47
14,34,-18,-16,-45,-81,-11,59,-64
115,21,37,-6,-61,44,59,192,401
11,52,-13,-19,4,-41,26,38,58
11,17,-18,-5,-9,-18,0,14,-8
-20,86,-33,-14,-137,-110,-22,193,-57
-4,9,-13,-12,-45,-30,-9,43,-61
63,113,16,7,-6,8,76,83,360
-7,11,-11,-16,5,-43,-13,31,-43
15,19,-1,-1,-29,-36,4,52,23
16,49,-11,-43,-91,-143,-48,161,-110
45,59,-71,-102,-286,-144,-17,236,-280
4,-27,-22,-31,-57,-92,-31,67,-189
-45,20,-51,-21,-65,-122,-40,65,-259
-59,10,-41,-32,-73,-136,-70,58,-343
23,108,-50,-58,-113,-157,-45,194,-98
213,353,-72,-48,-169,-251,50,307,383
-91,-4,-68,-34,-108,-109,-88,110,-392
5,65,-121,-124,-310,-320,-123,364,-564
4,47,-15,-17,-39,-122,-37,122,-57
85,201,-78,5,-149,-154,6,136,52
-3,23,-41,-25,-75,-102,-28,36,-215
50,51,-16,-53,-43,-106,19,94,-4
66,54,-6,-83,-41,-121,-17,106,-42
60,144,40,-76,20,-94,1,144,239
52,92,-38,-16,-102,-118,24,73,-33
1,22,4,20,-40,-26,-2,38,17
-7,2,-4,-12,-16,-11,3,13,-32
8,14,-23,-3,-25,-28,-7,30,-34
-7,17,11,-12,-28,-9,-8,79,43
34,93,-14,-13,-70,-74,17,148,121
0,18,-17,-11,-12,-26,-1,32,-17
34,33,-3,30,-26,-31,4,23,64
75,122,-80,-97,-113,-103,-3,189,-10
26,-1,-40,-3,-139,-65,-17,102,-137
-37,131,-63,-40,-23,6,17,169,160
121,145,-108,-108,-150,-276,-22,175,-223
75,251,-85,-37,-112,-171,57,189,167
129,226,-77,-43,-126,-181,21,273,222
103,218,-26,-17,-30,-64,30,155,369
41,77,-12,-27,-10,-126,-18,155,80
-10,-9,-33,-27,-22,-42,-7,47,-103
-21,43,8,-20,4,-37,-7,62,32
311,526,-129,-17,-288,-219,213,649,1046
122,186,38,-57,-4,-155,3,204,337
206,308,-23,-100,-75,-146,157,440,767
133,202,-57,15,-125,-93,116,246,437
66,124,-23,5,-28,-56,26,71,185
-29,1,-41,-16,-90,-81,-50,69,-237
112,53,0,-93,-79,-121,47,155,74
79,174,29,-1,-72,10,22,222,463
54,252,-87,-81,-100,-215,21,325,169
15,46,-83,-76,-101,-148,10,192,-145
17,26,-3,-5,-107,-80,-25,72,-105
29,55,-48,-21,-50,-65,6,67,-27
30,99,-24,-8,-52,-42,12,145,160
48,85,4,-28,-36,-81,8,73,73
-11,24,-38,-17,-76,-74,-13,70,-135
47,73,-58,-71,-154,-66,28,161,-40
53,29,-36,-69,-68,-189,-12,143,-149
8,57,18,-16,-8,-45,19,70,103
28,54,-51,-40,-94,-146,-28,89,-188
-1,4,-3,2,-12,-11,-5,15,-11
20,35,-15,10,-11,-21,9,23,50
10,28,-2,-7,-14,-6,12,23,44
54,41,-56,-18,-116,-149,-6,118,-132
30,51,-79,-16,-207,-292,-89,141,-461
19,26,-61,-40,-121,-155,-50,100,-282
-18,45,-14,-25,-65,-83,-7,92,-75
106,176,-81,-31,-120,-112,66,247,251
26,-76,-101,-7,-146,-189,-60,55,-498
-13,1,-2,-24,-2,-42,-19,34,-67
69,87,-24,-3,-62,-61,43,131,180
17,33,-50,-16,-174,-171,-19,110,-270
19,41,-20,-12,-41,-142,-39,101,-93
14,33,-11,-1,-46,-17,18,39,29
22,42,-12,-4,-27,-32,13,60,62
25,131,-54,-48,-141,-196,-16,153,-146
43,70,22,1,-23,-1,36,118,266
73,101,-62,-75,-88,-118,-1,104,-66
57,56,10,-28,3,-50,-9,114,153
234,234,-86,-139,-191,-287,33,355,153
26,58,-19,-14,-69,-70,25,78,15
68,20,-66,-51,-100,-172,-20,113,-208
10,47,-7,-10,-47,-43,-3,74,21
49,85,2,-15,-41,-32,19,154,221
-68,-21,-90,-58,-101,-115,-48,73,-428
65,107,-17,-44,-41,-117,-1,106,58
92,138,-44,-8,-62,-83,43,57,133
14,48,-7,-18,-30,-67,2,46,-12
-27,33,-26,-51,-43,-72,-31,65,-152
25,116,-19,-24,18,5,44,158,323
-79,43,-95,-54,-158,-154,-63,114,-446
10,34,-21,-17,-50,-46,10,49,-31
-107,51,-118,-117,-12,-43,51,123,-172
132,219,-63,14,-60,-38,83,176,463
6,35,-21,-14,-67,-173,-61,143,-152
77,182,-39,-27,-96,-96,18,171,190
-21,-11,-48,-22,-76,-85,-56,52,-267
144,179,18,-10,-25,-154,-1,186,337
66,95,-24,-10,-1,-35,39,86,216
-87,21,-148,-94,-186,-133,-74,135,-566
-39,174,-298,-278,-514,-772,-274,607,-1394
103,265,-149,-8,-313,-357,-13,277,-195
171,208,-7,-27,-38,-76,89,224,544
-40,1,-77,-50,-110,-108,-22,59,-347
298,346,-8,-110,-60,-92,143,414,931
27,64,17,-3,-2,-106,-23,124,98
61,113,34,16,-7,-154,-41,137,159
16,0,-34,-24,-38,-39,-7,38,-88
108,117,-57,-51,-144,-173,-9,228,19
233,365,-219,13,-264,-296,69,251,152
756,885,-171,-124,-163,-577,220,1115,1941
24,64,-62,-49,-124,-105,-48,169,-131
26,102,-116,-105,-198,-151,-16,198,-260
-26,-41,-51,1,-74,-62,-35,42,-246
19,73,9,-19,-23,-22,32,107,176
-20,328,-520,-505,-1001,-1728,-762,1249,-2959
-22,0,-16,-30,-40,-14,-6,37,-91
40,56,16,9,-16,-33,-2,64,134
46,72,10,21,-62,-74,7,125,145
273,592,-16,-164,-115,-92,220,529,1227
221,295,-22,-68,-135,-232,46,300,405
44,146,12,-27,-44,-86,36,166,247
30,147,-57,-47,-170,-307,-66,202,-268
41,72,-15,-5,-20,-45,29,72,129
458,561,436,158,230,44,172,685,2744
211,428,-64,-42,-149,-188,95,360,651
204,235,78,13,73,-52,97,276,924
1,37,4,6,-11,-6,3,36,70
47,138,-102,-100,-170,-187,19,217,-138
-7,50,-31,-28,-30,-60,-6,45,-67
-8,51,-29,-28,-28,-58,-4,45,-59
-46,15,-39,-45,-66,-120,-59,59,-301
15,26,1,-3,-10,-37,-8,35,19
244,380,-95,-96,-214,-358,55,529,445
114,154,-124,-83,-256,-299,-55,249,-300
27,19,16,43,-82,-43,-8,73,45
90,117,-7,-22,-68,-67,34,196,273
12,121,-60,-140,-160,-138,-38,246,-157
65,82,-28,-43,-67,-100,25,116,50
37,72,-42,-45,-98,-152,-13,143,-98
71,73,1,-4,-54,-52,17,144,196
24,27,-12,-1,-29,-44,24,27,16
31,5,-76,-69,-92,-149,-17,64,-303
96,110,-7,14,-65,-72,12,151,239
321,329,-129,-3,-111,-217,138,493,821
39,124,-77,-88,-181,-160,-1,229,-115
2,54,-76,-42,-138,-141,-15,135,-221
-57,-16,-40,-51,-36,-110,-32,74,-268
22,45,-22,-32,-36,-33,44,78,66
-9,11,-23,-31,-37,-52,-2,30,-113
17,64,-27,-55,-67,-121,12,113,-64
93,151,23,-49,4,-82,28,195,363
235,355,-36,3,-124,-108,111,342,778
95,70,-55,5,-69,-20,88,116,230
-2,111,-90,-53,-1,26,49,121,161
41,47,55,72,-56,7,25,90,281
-45,19,-68,-41,-101,-138,-70,111,-333
-11,50,-19,-47,-66,-81,-20,32,-162
44,95,-100,-67,-101,-238,-66,169,-264
12,16,-3,-27,-11,-46,5,30,-24
62,38,-25,-46,-130,-167,-21,150,-139
3,168,51,45,-230,-23,60,323,397
74,173,-79,-75,-146,-185,11,237,10
-10,7,-43,-25,-98,-76,-6,71,-180
-46,52,-50,-8,-83,-231,-75,145,-296
135,126,12,-48,4,-62,64,154,385
205,291,118,100,37,23,73,321,1168
-84,-4,-84,-32,-113,-111,-74,74,-428
66,206,-125,-155,-169,-127,44,305,45
-46,-6,-13,-26,-36,-99,-21,75,-172
327,115,-162,57,-288,-371,88,227,-7
34,62,-10,-30,-2,-54,5,60,65
105,327,-105,-85,-237,-236,-4,363,128
2,68,-41,-53,-68,-116,-32,184,-56
4,61,-27,-53,-81,-144,-42,191,-91
78,128,-91,11,-199,-291,-36,136,-264
180,93,-228,-89,-449,-535,-71,277,-822
-14,-14,-70,-59,-100,-89,-26,49,-323
61,133,-2,6,-46,-75,31,184,292
-82,0,-110,-46,-213,-175,-74,160,-540
379,409,5,-24,49,58,210,290,1376
-7,60,-22,-16,-77,-89,-19,56,-114
102,141,-64,-25,-82,-172,2,126,28
150,211,-74,-90,-119,-124,51,276,281
31,133,-158,-149,-312,-402,-131,207,-781
155,222,-32,6,-27,-114,54,171,435
150,209,6,-3,-38,-28,95,234,625
82,159,-106,-37,-16,5,119,149,355
62,77,-18,-34,-48,-136,-19,126,10
127,191,2,-28,-114,-152,63,257,346
71,66,-21,-1,-69,-119,10,106,43
32,57,-119,-134,-177,-252,-48,237,-404
84,146,-66,33,-199,-168,-51,114,-107
5,28,-37,-11,-50,-99,-17,35,-146
51,75,-52,-29,-97,-58,5,161,56
37,326,-151,-139,-442,-793,-286,519,-929
65,108,-76,-48,-150,-192,-35,114,-214
-63,0,-88,-28,-145,-177,-83,126,-458
26,108,-16,-7,-84,-78,-4,140,85
5,26,-27,13,-34,-49,-11,43,-34
32,98,-28,-42,-103,-128,-1,139,-33
79,95,11,28,-60,-16,38,130,305
49,109,-16,-49,-65,-83,13,175,133
-41,-21,-73,-47,-106,-139,-41,56,-412
39,38,-35,-14,-92,-55,-8,83,-44
57,108,-30,10,-76,-77,-12,122,102
-27,-34,-23,-67,-41,-109,-39,62,-278
38,47,-21,-21,-18,-13,21,81,114
-18,10,-45,-67,-44,-136,-41,112,-229
16,114,-34,-16,-35,-42,54,130,187
10,124,-63,-86,-125,-374,-123,182,-455
44,113,-73,-50,-120,-378,-121,215,-370
19,122,-66,-39,-92,-158,-11,140,-85
-4,87,-32,-105,-152,-306,-91,251,-352
-41,1,-71,-43,-121,-141,-59,82,-393
10,25,-41,-53,-31,-82,-26,80,-118
4,45,-17,-5,-60,-71,2,76,-26
-8,16,-17,-15,-37,-42,-22,46,-79
27,101,-43,-43,-93,-94,20,120,-5
17,60,-29,10,-44,-32,-1,59,40
151,168,-71,-79,-76,-162,32,212,175
6,31,-37,-16,-27,-30,26,37,-10
10,29,-3,-19,-41,-71,-24,59,-60
163,252,-35,-10,-84,-233,16,205,274
4,16,-23,-27,-18,-65,-5,61,-57
1,119,-94,-133,-184,-191,-5,178,-309
-66,29,-98,-30,-165,-212,-55,117,-480
57,136,-34,-21,-25,-73,31,132,203
-67,40,-65,-14,-123,-143,-81,94,-359
5,57,-6,-16,-52,-121,-21,104,-50
4,11,-20,-31,-32,-49,-11,17,-111
20,19,-73,-14,-74,-106,-12,112,-128
29,47,-27,-56,-43,-99,-9,99,-59
56,208,-185,-183,-292,-425,-45,444,-422
11,54,-39,-12,-16,-44,-2,53,5
-39,-7,-38,15,-71,-64,-35,36,-203
-7,197,-171,-354,-1026,-466,-186,1289,-724
27,394,-38,-37,-244,-651,-113,468,-194
57,151,-85,-12,-174,-197,-6,171,-95
41,81,12,-8,-39,-147,-40,132,32
23,89,-8,-24,-53,-181,-41,121,-74
-37,-37,-71,-33,-52,-147,-54,64,-367
151,173,-29,-15,-92,-152,31,153,220
-4,28,-14,-11,-28,-66,-34,46,-83
155,138,26,5,22,-10,38,178,552
0,15,2,-21,-13,-27,-1,33,-12
31,42,-39,-22,-50,-26,10,27,-27
28,60,-6,-10,0,-39,12,54,99
119,133,40,-2,4,-27,52,156,475
-11,6,-14,-28,-32,-56,-16,38,-113
128,156,-34,-60,-63,-86,26,199,266
-32,2,-19,-24,-73,-34,-32,82,-130
9,1,-97,-43,-181,-220,-88,93,-526
3,66,-45,-50,-66,-128,-55,75,-200
28,35,-14,-17,-148,-109,8,105,-112
17,52,-5,2,-22,-61,-18,68,33
0,28,-6,-14,-21,-26,-5,26,-18
-10,37,-20,-11,-75,-139,-54,78,-194
6,12,-2,1,-8,-8,0,9,10
30,35,-18,-2,0,-5,30,37,107
64,85,-115,-89,-192,-253,-1,199,-302
15,202,-12,-44,24,36,104,210,535
89,125,-52,-9,-93,-110,-7,71,14
84,263,-110,-164,-206,-377,-58,401,-167
-32,-6,-17,-15,-28,-80,-42,36,-184
24,84,-32,-47,-37,-51,25,96,62
79,81,-64,-11,-117,-128,2,158,0
115,101,26,-36,-44,-67,15,142,252
-3,62,6,-20,-31,-154,-63,83,-120
31,97,-52,-50,-44,-98,-3,95,-24
174,182,25,30,-29,1,95,230,708
45,99,-56,-59,-107,-125,25,202,24
106,103,-44,-15,-37,-59,50,105,209
31,45,-23,14,-170,-90,-13,174,-32
42,99,33,40,3,-19,36,74,308
-19,-5,-12,-28,-28,-25,-14,25,-106
11,31,-43,-10,-79,-86,-12,68,-120
0,49,-20,-28,-56,-85,-2,58,-84
8,31,-12,-15,-34,-71,-25,61,-57
79,201,-30,2,24,27,102,144,549
0,5,-24,-20,-39,-64,-6,52,-96
-39,214,-302,-119,-639,-726,-239,393,-1457
78,80,9,27,-39,-46,38,92,239
102,147,-6,-18,-72,-124,1,271,301
61,22,-35,-32,-75,-101,0,45,-115
25,31,-76,-53,-78,-151,3,80,-219
3,31,-9,-11,-91,-54,17,71,-43
9,18,-11,-20,-3,-40,-9,47,-9
74,85,41,-19,64,-8,36,77,350
60,88,-40,-9,-30,-75,8,87,89
41,114,-175,-76,-176,-156,4,116,-308
-33,104,-173,-132,-237,-317,-106,220,-674
26,3,-31,-21,-32,-60,3,44,-68
55,81,-41,-37,-95,-123,29,65,-66
5,46,-22,-29,-63,-113,-19,71,-124
139,232,-63,-26,-33,-83,71,253,490
76,14,26,-36,-152,-20,16,295,219
57,91,-7,8,-17,-52,6,85,171
-6,52,-45,-45,-60,-13,13,137,33
148,148,-55,-43,-145,-181,44,199,115
-36,9,-66,-85,-151,-168,-85,173,-409
-17,136,-68,-82,36,-33,-3,156,125
272,277,-2,12,-84,-126,22,430,801
112,110,4,27,-94,-42,51,200,368
47,116,-34,-23,-101,-235,-22,178,-74
100,134,-144,-65,-258,-245,17,281,-180
156,148,19,42,-109,-37,58,295,572
-13,-8,-26,-16,-53,-38,-30,48,-136
-37,-17,-71,-58,-80,-144,-69,52,-424
36,137,-43,-45,-117,-173,-26,138,-93
12,46,-5,-28,-9,-40,-12,53,17
25,47,-3,-19,-26,-48,-6,59,29
89,157,-62,18,-95,-106,17,119,137
22,35,-24,-33,-49,-60,-26,78,-57
-1,24,-53,-72,-104,-83,-15,96,-208
63,70,-13,-5,-24,-60,15,66,112
12,82,-26,-45,-38,-103,4,103,-11
-26,55,9,-27,-19,-61,-34,72,-31
38,79,-49,-47,0,-43,30,146,154
16,40,-37,-35,-68,-68,5,39,-108
134,561,-207,-352,-553,-485,-35,1000,63
148,157,-11,19,-88,-37,52,183,423
73,109,-9,-45,-53,-40,32,186,253
41,51,-23,-35,-66,-94,7,110,-9
81,168,-107,-98,-139,-260,-35,236,-154
98,221,185,97,72,147,56,218,1094
-25,48,-67,-49,-11,-47,33,93,-25
183,359,52,26,-69,-94,119,411,987
3,8,-8,6,-6,-16,2,10,-1
5,8,-9,9,-7,-13,3,8,4
7,23,-11,-11,-18,-29,8,32,1
5,17,-14,-11,-22,-30,5,30,-20
37,92,-37,-9,-106,-66,-3,146,54
-40,32,-60,-42,-104,-167,-81,141,-321
53,35,-54,-31,-66,-90,7,77,-69
107,93,-7,-56,-70,-169,20,219,137
-10,-14,-29,7,-44,-35,-8,16,-117
47,95,-4,54,-173,-77,-42,126,26
46,67,-143,-56,-242,-319,-78,138,-587
1,20,-9,-20,-15,-25,-21,22,-47
21,38,14,-2,-37,-46,1,50,39
33,46,-40,-17,-87,-77,-6,71,-77
129,223,2,-60,-35,-104,47,255,457
45,93,-2,-58,-12,-82,33,97,114
208,420,-129,-133,-262,-379,23,645,393
15,26,-36,-9,-105,-78,-4,48,-143
32,39,-39,-35,-26,-88,-14,84,-47
143,333,-54,-82,-69,-193,30,344,452
28,129,46,2,-73,-289,-98,183,-72
19,72,11,-14,-28,-40,-5,132,147
40,61,-16,5,-76,-110,-20,116,0
56,94,25,-22,-27,-48,-16,138,200
114,172,-3,-6,24,-22,81,145,505
-59,58,-87,-59,4,-19,43,88,-31
127,178,-85,-37,-96,-168,43,201,163
-1,22,-35,-15,-76,-111,-45,62,-199
56,121,-57,-42,-4,-61,31,190,234
24,28,-37,1,-108,-113,-31,100,-136
56,73,3,-31,13,-22,17,77,186
8,74,36,9,-22,-16,0,101,190
15,32,-33,-48,-114,-124,-24,109,-187
61,100,-37,-49,-95,-113,8,135,10
37,40,-4,6,-19,-28,18,52,102
11,27,-32,-22,-59,-19,-4,49,-49
66,60,-43,6,-72,-78,-7,76,8
-28,-19,-33,-11,-40,-77,-37,50,-195
204,359,-4,-49,8,-161,84,317,758
116,183,-53,-21,-104,-70,83,186,320
0,39,-11,-2,-40,-56,-15,48,-37
22,7,-79,-71,-102,-106,-11,108,-232
107,96,-16,-2,-103,-145,15,96,48
67,134,9,5,-58,-84,0,130,203
47,170,-118,-68,-140,-239,-21,196,-173
83,163,-11,-30,-90,-139,-5,108,79
0,20,-27,-17,-62,-33,-13,45,-87
58,107,-92,-97,-164,-197,-27,279,-133
-71,-27,-124,-60,-149,-214,-71,78,-638
89,96,-69,-74,-236,-142,7,210,-119
-37,42,-43,-50,-73,-58,-23,96,-146
116,265,-29,-53,-109,-206,51,229,264
295,446,69,86,-11,-75,121,509,1440
34,12,-27,-27,-50,-83,-16,75,-82
25,161,-27,-14,-104,-230,-37,164,-62
-1,29,-84,-59,-88,-140,-62,131,-274
23,81,-14,-17,-42,-61,0,110,80
-21,-1,-14,-9,-23,-19,-11,11,-87
277,397,-78,-97,-328,-493,-19,590,249
686,1696,1449,1540,358,1211,256,2288,9484
204,212,-107,-53,-283,-234,43,412,194
7,-14,-87,-82,-190,-270,-56,182,-510
84,94,-33,-21,-52,-115,10,100,67
23,26,28,9,-25,-6,3,75,133
132,155,-8,-9,-117,-182,-42,281,210
-4,18,-4,-3,-3,2,4,15,25
10,41,-20,-7,-21,-53,-16,51,-15
62,126,6,-15,-16,-85,33,148,259
52,65,-6,-22,-5,-73,21,104,136
-14,116,-61,-43,-112,-226,-70,192,-218
6,122,-7,-51,-147,-140,-40,174,-83
111,111,-13,26,-57,-73,83,118,306
34,26,-55,-21,-104,-66,8,79,-99
-48,-17,-73,-82,-44,-134,-53,54,-397
7,-2,-43,-18,-85,-116,-16,60,-213
17,21,1,-20,23,-35,15,30,52
-104,48,-240,-185,-294,-453,-192,344,-1076
-3,64,6,-34,4,24,12,47,120
-13,3,-13,-6,-14,-9,-8,11,-49
-12,19,-6,-9,0,-11,-2,24,3
-22,32,41,55,-42,25,-15,32,106
0,61,29,21,-35,16,-18,53,127
-13,55,9,-14,-38,22,-2,44,63
-5,3,16,18,-18,8,-18,10,14
-22,11,23,4,-22,6,-16,23,7
61,85,-105,-19,-160,-224,-20,132,-250
166,209,21,-22,-30,-154,29,216,435
13,29,-13,-60,-78,-86,-40,102,-133
155,327,-98,36,-193,-247,0,167,147
37,87,-44,-26,-92,-93,4,94,-33
38,23,-19,-9,-20,-17,28,31,55
59,58,-14,7,-4,-25,30,67,178
19,19,-24,3,-36,-18,13,36,12
18,59,-53,-38,-82,-94,-28,85,-133
25,79,-31,-48,-24,-105,-11,80,-35
-25,74,30,7,-56,45,-28,29,76
336,688,-179,-75,-342,-386,142,596,780
46,37,-9,-1,-37,-46,37,66,93
53,56,-33,-25,-92,-66,51,122,66
-63,-19,-79,-55,-107,-202,-91,107,-509
-47,-69,-82,-58,-126,-171,-66,75,-544
-19,65,-35,-32,-113,-204,-46,174,-210
50,73,-6,5,-28,-25,21,103,193
14,73,-15,-35,-90,-57,-16,106,-20
31,42,-18,-32,-61,-90,-3,110,-21
0,45,-8,-8,-54,-36,-3,72,8
130,179,-4,-66,-66,-128,103,271,419
97,151,1,-13,-6,-217,-31,212,194
16,43,0,6,-38,-64,-20,70,13
10,-5,-16,-18,-34,-122,-34,65,-154
-12,38,-30,-31,-33,-56,-5,68,-61
21,12,-47,-14,-55,-43,-5,31,-100
-5,7,-83,-35,-183,-288,-90,160,-517
130,165,-38,-53,-41,-128,49,174,258
0,58,-96,-62,-173,-226,-81,123,-457
-40,-10,-47,-53,-33,-113,-44,40,-300
49,82,-15,-15,-90,-130,-6,80,-45
19,65,-21,-21,-39,-3,23,105,128
-17,8,-38,-28,-37,-54,-17,47,-136
9,-37,-43,-59,-24,-94,-17,26,-239
107,199,-75,-104,18,-141,116,254,374
14,84,-16,4,-67,-41,-5,106,79
12,92,-2,-43,-17,-47,13,94,102
32,97,-27,-70,-123,-215,-69,175,-200
19,-7,-33,-24,-135,-88,4,78,-186
31,57,-18,-17,-87,-113,3,117,-27
30,85,25,18,-26,-35,-17,97,177
27,101,-11,-7,-39,-90,15,105,101
47,10,-49,-37,-97,-146,-23,84,-211
24,66,-14,-21,-47,-143,-39,111,-63
16,62,10,-11,3,-6,0,61,135
-19,-1,-48,-51,-120,-104,-37,85,-295
14,40,4,-6,-6,-57,6,53,48
129,107,-52,16,-74,-72,70,148,272
32,139,-141,-155,-211,-394,-153,282,-601
24,66,-62,-48,-112,-102,0,171,-63
21,68,-46,-96,-111,-232,-50,193,-253
9,33,-60,-34,-85,-89,0,62,-164
26,17,-39,-11,-70,-91,-12,38,-142
10,81,4,-22,-61,-131,-22,125,-16
11,52,-47,-49,-30,-57,-3,47,-76
46,63,3,-10,-33,-29,26,71,137
141,214,11,-51,-40,-185,10,268,368
41,54,12,2,13,-2,23,42,185
28,70,-55,-71,-61,-161,-43,178,-115
59,127,6,-18,-8,-57,17,135,261
149,208,-37,-41,-94,-101,104,221,409
-16,20,-71,-76,-117,-169,-52,84,-397
38,60,7,5,4,-7,24,37,168
-58,-35,-104,-55,-103,-215,-92,136,-526
55,57,6,15,-69,-65,21,95,115
2,75,-28,-41,2,-18,46,105,143
36,66,-50,-24,-49,-48,42,91,64
57,104,-2,1,-42,-9,41,58,208
187,341,-129,-77,-193,-288,8,412,261
131,295,22,5,38,-105,75,280,741
1323,2273,-457,-168,-262,-365,1340,1716,5400
18,179,-536,-561,-945,-1236,-364,647,-2798
222,371,-74,-38,-193,-323,32,482,479
91,178,-112,-22,-203,-258,-64,144,-246
93,154,-125,-96,-175,-327,-49,231,-294
72,120,-204,-132,-275,-387,-129,293,-642
2,9,1,-3,3,-6,3,7,16
167,205,-15,9,-48,-133,43,269,497
-7,61,-30,-44,-68,-79,-22,84,-105
74,151,-19,-112,-30,-159,16,220,141
62,99,-47,15,-84,-105,-25,122,37
-33,20,-78,-44,-133,-157,-81,125,-381
0,13,-6,2,-28,-24,-2,44,-1
-2,12,1,1,-5,-15,-9,18,1
503,793,-100,41,-338,-232,135,870,1672
581,804,-59,35,-324,-261,177,934,1887
37,25,-43,-54,-108,-183,-24,96,-254
91,123,-34,-23,-96,-197,7,108,-21
-2,25,-28,-4,-70,-75,-34,59,-129
49,73,-49,-13,-31,-41,48,54,90
3,33,-1,-31,-16,2,34,35,59
-47,-31,-91,-27,-125,-205,-87,93,-520
19,29,-14,2,-16,-2,21,15,54
13,34,13,-2,-10,-8,15,38,93
2,8,-11,4,-48,-24,-9,28,-50
-31,76,-22,-29,-4,-26,13,100,77
-53,-19,-33,-58,-16,-76,-38,36,-257
10,38,-41,-14,-91,-98,41,94,-61
29,58,-35,20,-161,-176,-17,122,-160
147,161,15,-36,-75,-51,96,168,425
146,194,-24,-52,-79,-142,69,255,367
48,162,-26,-52,-159,-83,50,271,211
14,87,-88,-63,-160,-218,-20,238,-210
-1,9,-29,-25,-32,-43,-14,34,-101
13,40,-107,-246,-368,-311,-78,343,-714
48,37,-26,-19,-8,-50,23,80,85
-38,-6,-30,-35,-52,-71,-38,47,-223
-10,33,2,6,2,-9,-8,60,76
30,86,-48,-64,-44,-75,13,155,53
109,96,-67,3,-122,-113,69,143,118
-44,-2,-82,-6,-189,-105,-51,143,-336
4,15,-5,-8,-15,-22,-5,35,-1
19,29,-43,-14,-68,-69,13,107,-26
-21,23,-42,-37,-23,-85,-21,77,-129
97,126,23,-8,-38,-32,29,185,382
116,160,-31,-44,-170,-209,-4,257,75
-24,73,-80,-43,6,-20,16,67,-5
41,42,-6,2,-18,-62,8,35,42
20,42,-25,-61,-74,-99,8,82,-107
10,35,-48,0,-113,-76,-20,98,-114
64,51,-2,-5,-29,-33,18,47,111
41,134,-11,-68,-66,-225,-97,259,-33
35,57,25,49,-104,-82,16,143,139
-2,36,-59,-45,-49,-116,-20,73,-182
-22,45,-7,-34,-67,-152,-80,131,-186
82,207,16,-17,-87,-146,76,244,375
-12,47,-129,-77,-159,-190,-68,205,-383
39,64,-116,-74,-165,-200,-35,153,-334
-78,-59,-152,-102,-185,-211,-130,87,-830
29,92,-89,-78,-91,-69,23,137,-46
11,65,-52,-49,-54,-174,-40,77,-216
193,398,5,-51,-4,-233,132,456,896
164,351,-53,-94,-127,-282,52,393,404
0,18,-46,-33,-78,-52,7,90,-94
133,333,-78,-86,-55,-175,39,339,450
186,261,-159,-16,-171,-71,164,185,379
45,76,-1,-23,-27,-35,34,76,145
-20,42,-40,-44,-121,-176,-45,142,-262
73,130,-75,18,-118,-131,-6,142,33
29,34,-31,-11,-23,-54,0,50,-6
125,194,-34,-56,-106,-210,-59,255,109
45,50,-21,-64,-60,-195,-60,157,-148
-14,58,-72,-88,-31,-156,-20,97,-226
7,11,-7,-4,5,-21,-7,10,-6
15,89,-37,-18,-62,-87,11,52,-37
0,73,-123,-126,-124,-138,9,130,-299
511,824,-231,-214,-360,-337,250,975,1418
236,462,-168,76,-315,-417,-83,343,134
81,128,-42,-68,-269,-304,-75,343,-206
29,38,31,9,-3,8,4,78,194
22,36,44,5,8,9,-3,80,201
22,26,-6,-10,2,-45,8,25,22
3,34,8,1,-34,-12,2,32,34
2,17,13,-11,-5,-17,1,36,36
624,861,154,254,-226,-37,470,855,2955
50,86,-17,-2,-34,-48,20,90,145
72,152,-11,-70,-67,-106,48,196,214
120,139,-60,-52,-97,-154,31,241,168
-33,44,-71,-73,-64,-107,-52,69,-287
40,109,-23,-11,-14,13,32,108,254
17,1,-20,-11,-27,-49,2,19,-68
-22,41,-49,-30,-58,-61,-31,50,-160
104,460,-138,-94,-394,-598,-114,568,-206
-16,20,-97,-101,-131,-266,-120,116,-595
319,374,-17,-55,-76,-350,-26,441,610
-40,-12,-78,-41,-122,-119,-58,82,-388
68,98,-11,-48,-24,-139,-31,176,89
37,92,-44,-76,-46,-93,-1,214,83
12,47,-64,-53,-44,-105,-20,80,-147
56,52,0,-18,-69,-78,1,111,55
53,73,-103,-124,-235,-84,30,284,-106
-41,101,-191,-181,-366,-445,-135,331,-927
0,181,-136,-171,-257,-409,-77,354,-515
129,183,-52,-61,-66,-91,14,231,287
31,25,-66,-31,-117,-105,12,100,-151
-42,-27,-81,-81,-105,-126,-38,65,-435
83,76,-138,-55,-256,-286,-75,100,-551
307,240,142,-47,116,-80,111,294,1083
40,182,61,30,-87,58,-10,228,502
63,201,-31,-46,-45,-77,110,250,425
104,293,-39,-44,-142,-294,-38,363,203
506,503,-41,42,-440,-414,73,795,1024
-8,20,-3,-17,-29,-48,-13,36,-62
8,87,-52,-78,-117,-115,-28,160,-135
20,64,-81,-82,-146,-130,-41,165,-231
139,129,-71,-44,-39,-100,83,136,233
169,266,-27,-57,-61,-146,73,256,473
159,264,-98,-55,-191,-225,49,255,158
21,38,-52,-53,-133,-100,-15,129,-165
15,-8,-47,-42,-48,-62,-29,44,-177
82,123,-50,-19,-123,-95,73,176,167
278,278,87,-6,63,-95,90,373,1068
218,328,-152,-90,-63,-186,103,225,383
94,170,18,-20,17,-71,46,174,428
12,50,-105,-123,-143,-162,15,119,-337
24,15,-22,-8,-31,-29,-1,37,-15
143,335,-64,-84,-82,-183,37,350,452
27,35,-9,-38,6,-59,21,46,29
49,164,63,13,-62,55,8,221,511
83,80,-33,-42,-48,-93,2,107,56
147,178,4,-21,-15,-165,-7,186,307
20,34,-21,8,-32,-39,-13,41,-2
5,27,-11,3,-69,-53,-7,42,-63
20,-15,-55,-61,-89,-192,-42,133,-301
12,25,-27,-16,-52,-41,7,63,-29
-65,-31,-54,-59,-90,-126,-62,73,-414
138,147,-3,-2,-138,-115,35,320,382
12,21,-46,14,-66,-121,-33,67,-152
71,75,-11,-17,-15,-44,16,81,156
-1,5,-113,-66,-153,-195,-67,100,-490
56,99,-64,-77,-138,-181,14,220,-71
9,62,-64,-73,-107,-135,-16,125,-199
26,20,-82,-93,-86,-153,-43,119,-292
22,78,-24,-11,-33,-82,-9,69,10
293,470,24,23,-66,-108,178,519,1333
230,260,-31,51,-71,-69,105,342,817
10,42,-29,-67,-56,-109,-2,118,-93
74,47,-34,-76,-37,-155,-5,115,-71
12,33,-11,6,-21,-18,-2,53,52
-34,-22,-34,-36,-63,-38,-18,27,-218
37,33,-33,-17,-36,-29,17,39,11
8,11,-19,-9,-8,-25,11,28,-3
-24,25,-33,-5,-50,-117,-44,43,-205
35,38,15,-17,27,-26,35,73,180
9,60,-21,-43,-79,-39,-17,101,-29
69,66,43,-1,11,-53,-3,88,220
55,49,38,6,47,-14,18,59,258
128,111,6,-14,36,-21,42,68,356
48,22,-64,-45,-124,-119,-14,122,-174
-4,51,-149,-58,-182,-165,-6,170,-343
35,45,-31,-28,-55,-40,2,71,-1
-3,13,8,-25,-34,-81,-25,64,-83
33,176,19,-42,-24,-229,-41,152,44
18,85,-76,-80,-79,-145,-68,184,-161
93,114,7,-27,1,-78,45,160,315
35,77,-44,-8,-84,-150,-27,81,-120
45,108,-36,-1,-84,-17,45,84,144
61,111,-35,-18,-117,-85,-2,164,79
140,227,-37,-69,-84,-154,-27,309,305
68,103,29,-25,34,-42,17,116,300
116,209,57,-199,179,-152,80,160,450
-64,-24,-82,-42,-135,-140,-76,79,-484
25,38,-10,-1,-46,-52,7,81,42
81,232,26,-63,24,-81,50,205,474
59,144,-60,-35,-73,-106,6,151,86
19,28,-44,-55,-41,-61,18,88,-48
7,36,-15,-25,-45,-48,1,62,-27
214,350,1,-21,-10,2,162,397,1095
74,134,59,111,-73,-11,54,230,578
62,235,-42,-121,-272,-239,-15,336,-56
48,177,-127,-124,-231,-205,-25,189,-298
44,118,-228,-183,-225,-492,-117,331,-752
22,94,-50,-52,-138,-232,-72,163,-265
2,46,-13,-7,-46,-88,-20,80,-46
13,13,-28,-6,-25,-31,1,13,-50
228,281,-26,5,-82,-102,112,275,691
-23,31,-64,-44,-132,-194,-50,151,-325
98,179,-120,-106,-185,-218,101,252,1
73,64,46,13,-7,2,26,96,313
-14,35,-21,-31,-56,-71,-15,55,-118
0,4,-64,-43,-146,-151,-39,103,-336
-51,-47,-54,-37,-66,-97,-29,34,-347
-42,-3,-95,-35,-119,-122,-39,79,-376
45,55,-73,-40,-73,-112,-7,96,-109
33,75,-28,-6,-15,3,34,58,154
195,241,-69,25,-131,-151,64,226,400
81,140,9,37,-66,-164,22,164,223
87,191,-116,-79,-146,-138,77,205,81
31,131,-72,-85,-96,-224,-15,98,-232
-16,69,-35,-47,-56,-48,12,103,-18
115,151,-94,-54,-195,-209,-15,202,-99
412,627,60,-5,-33,-191,208,617,1695
-24,37,-34,-42,-51,-103,-53,56,-214
202,346,-68,-36,-155,-247,9,261,312
119,183,-72,-53,-63,-48,73,233,372
66,63,-20,-10,-30,-34,14,110,159
102,156,-13,-14,-52,-78,14,198,313
50,51,-9,2,-4,-13,30,40,147
32,12,-65,-55,-65,-135,-26,76,-226
314,541,30,-88,189,69,288,419,1762
118,107,-44,22,-124,-162,13,127,57
95,119,4,58,-49,-27,47,134,381
61,122,-103,-77,-106,-211,26,154,-134
40,74,-91,-86,-114,-163,0,175,-165
-5,113,-124,-42,5,11,79,101,138
44,91,-33,-56,-71,-52,32,170,125
16,12,-14,-16,-57,-63,0,71,-51
284,374,-103,-166,-336,-369,22,619,325
87,80,-7,-17,-14,-50,4,108,191
47,204,-167,-67,-189,-216,7,122,-259
113,233,-64,8,-142,-154,39,159,192
202,219,-14,6,0,-35,135,195,708
24,39,-116,-40,-229,-338,-72,142,-590
94,183,55,-16,20,-99,26,165,428
136,241,-52,-91,-66,-74,83,272,449
49,49,7,2,-16,-37,0,67,121
24,75,-83,-31,-171,-194,-8,107,-281
5,83,-23,-59,30,27,86,142,291
52,78,45,3,46,-16,11,104,323
36,33,-45,-59,-97,-128,-11,103,-168
35,123,-73,-26,-95,-116,4,130,-18
105,159,17,-8,-40,-113,54,160,334
48,86,-25,-59,-88,-131,5,81,-83
36,18,-65,-98,-69,-159,-23,84,-276
51,64,-3,-18,-21,-54,4,91,114
33,125,-31,-22,-115,-126,25,156,45
85,99,-5,0,-16,-25,41,105,284
-67,-33,-66,-67,-90,-125,-88,51,-485
121,233,-72,-69,-95,-174,44,192,180
6,24,-3,-78,-41,-65,-25,88,-94
6,54,-71,-50,-78,-136,-26,102,-199
24,50,-63,-51,-107,-74,-2,109,-114
8,60,-78,-42,-20,-29,21,77,-3
20,31,6,-9,22,12,28,25,135
48,24,-7,13,12,-39,12,55,118
-17,-4,-43,-41,-78,-71,-32,43,-243
-30,40,-54,-57,-78,-106,-42,67,-260
3,19,-77,-53,-181,-170,-12,157,-314
-3,-13,-113,-101,-164,-180,-63,72,-565
60,120,-70,-48,-170,-214,-29,142,-209
21,63,1,-8,-67,16,0,104,130
65,123,-51,-48,-101,-136,-32,167,-13
37,5,-33,9,-91,-88,6,86,-69
23,108,-31,-25,-97,-189,-6,166,-51
124,159,-8,24,-68,-92,68,130,337
26,75,-3,-19,-8,-51,-2,94,112
32,20,2,-2,-21,-24,8,48,63
81,97,-64,20,-154,-68,74,175,161
-8,36,-49,-70,-90,-248,-104,165,-368
107,175,-81,22,-157,-198,-9,102,-39
45,62,-53,-46,-127,-127,-16,92,-170
143,212,-7,11,-109,-112,7,323,468
40,85,-27,-89,-144,-221,-83,239,-200
78,89,7,-14,-64,-103,-20,140,113
20,25,-67,-18,-70,-78,11,78,-99
20,54,-36,-27,-56,-67,-2,66,-48
144,321,-376,-70,-653,-799,-32,528,-937
84,142,-48,-40,-88,-136,4,185,103
114,201,-24,-37,-29,-25,82,171,453
6,80,-36,-30,-14,2,32,93,133
-6,-5,-57,-54,-53,-115,-52,42,-300
119,233,13,-20,24,-64,39,218,562
5,65,-1,-12,-32,-75,17,91,58
64,89,-5,-62,60,-35,58,85,254
62,139,-52,-22,-40,-85,27,83,112
151,240,-49,-1,-69,-100,66,174,412
28,35,-49,-9,-125,-123,-38,122,-159
47,55,-57,-65,-111,-159,-10,101,-199
3,24,-75,16,-159,-155,-26,123,-249
10,-1,-72,-54,-88,-172,-58,114,-321
-4,55,-36,-17,-29,-33,15,64,15
66,142,29,8,32,-108,36,182,387
142,197,-58,-97,2,-92,103,204,401
0,123,-42,-37,10,-1,41,149,243
112,159,-1,-40,6,-93,55,164,362
129,133,-64,-32,-156,-150,7,126,-7
61,108,-20,-34,-101,-207,-14,175,-32
-9,9,-37,-4,-46,-36,1,60,-62
88,105,21,-3,57,-71,29,129,355
21,94,-51,-47,-112,-118,19,131,-63
43,78,-23,-54,-52,-67,29,116,70
-3,-4,-31,-24,-36,-82,-33,29,-184
65,89,-59,34,-219,-196,-2,144,-144
-24,3,-42,-21,-54,-62,-38,21,-217
99,202,-126,-119,-210,-135,-5,273,-21
103,108,-60,29,-62,14,104,124,360
48,78,-62,-54,-94,-125,-3,112,-100
339,686,600,205,346,410,162,870,3618
-3,78,-51,-45,-7,1,35,106,114
138,185,57,33,35,-28,34,177,631
408,530,113,-76,-9,-140,149,684,1659
91,152,-65,-13,-42,-89,45,214,293
-82,1,-89,-9,-147,-187,-85,138,-460
112,274,-151,-253,-214,-460,-90,458,-324
39,141,-57,-100,-42,-167,-36,193,-29
-137,18,-262,-289,-347,-456,-165,349,-1289
-43,95,-146,-152,-328,-208,-81,396,-467
-38,11,-132,-91,-214,-167,-53,171,-513
-48,35,-23,-17,-94,-192,-90,143,-286
15,175,-77,-16,-212,-315,-92,257,-265
223,510,-454,-409,-660,-580,-126,903,-593
-63,10,-112,-110,-198,-162,-72,179,-528
141,192,-88,-129,-186,-251,46,470,195
5,38,-25,-17,-27,-69,-21,32,-84
5,35,-26,-18,-24,-76,-23,32,-95
39,108,-27,-41,-147,-212,-81,200,-161
117,183,-169,-101,-364,-332,94,441,-131
43,94,-5,-31,-44,-100,-12,135,80
4,8,0,-15,-26,-51,-9,65,-24
-54,-10,-85,-79,-98,-165,-104,99,-496
420,441,55,116,-13,-137,118,578,1578
173,407,86,-45,-20,-262,31,438,808
21,33,-8,-27,-28,-101,-18,62,-66
14,15,-7,-10,-22,-12,12,38,28
83,118,-28,-62,-41,-88,33,176,191
-94,-21,-104,-60,-125,-184,-89,95,-582
21,62,-28,-47,-48,-75,-27,130,-12
-5,-1,-15,-6,-14,-12,-1,13,-41
142,94,40,-23,-33,-51,1,179,349
68,106,14,-40,-18,-50,13,101,194
54,27,-29,-10,-41,-48,25,27,5
30,57,-26,-14,-5,-15,24,55,106
47,78,-29,-43,31,-79,-8,109,106
30,103,-76,-92,-215,-238,-97,314,-271
130,346,-278,-307,-641,-882,-155,867,-920
260,311,15,-18,-18,-171,94,369,842
-6,6,-34,-28,-67,-70,-23,49,-173
46,47,-8,-7,-5,-19,31,46,131
10,-3,-40,-21,-44,-50,3,29,-116
-12,-7,-37,-37,-39,-35,-18,43,-142
57,42,-166,-84,-241,-270,-36,192,-506
-6,34,-631,-438,-1011,-613,15,791,-1859
-5,9,-58,-49,-42,-75,-6,55,-171
24,41,-19,-13,-9,-4,24,22,66
39,55,-24,-28,-7,-21,17,33,64
62,80,-82,14,-42,-11,78,100,199
1,50,-157,-134,-354,-305,-64,244,-719
31,59,-23,-11,-42,-30,24,59,67
30,-32,-111,-92,-188,-329,-90,274,-538
41,115,-73,-96,-196,-72,7,221,-53
-24,-28,-50,-35,-55,-55,-29,44,-232
-15,-9,-57,-44,-97,-87,-16,40,-285
96,217,47,-17,-25,-76,47,257,546
195,323,-162,-174,-181,-304,71,391,159
87,292,-123,-140,-322,-655,-113,482,-492
8,22,-10,-3,-16,-20,1,41,23
-11,24,-6,-12,-50,-90,-21,132,-34
-17,15,-44,-3,-68,-49,-1,31,-136
36,103,-55,6,-62,-76,19,65,36
-17,13,-58,-38,-64,-97,-32,73,-220
29,14,-15,7,-17,-11,15,38,60
16,44,-7,-15,-9,-28,-11,52,42
18,94,-26,-28,-83,-20,8,119,82
-6,13,1,-25,-12,-32,-28,23,-66
94,137,-6,-12,-16,-117,21,142,243
-29,-7,-30,-12,-60,-61,-32,35,-196
8,39,2,-12,8,-22,-6,40,57
62,67,-22,2,-44,-74,17,67,75
17,23,-62,-74,-91,-123,-11,136,-185
7,-3,-25,-27,-63,-104,-57,87,-185
11,120,-32,-40,-263,-282,-24,187,-323
44,27,-45,-85,-80,-202,-86,175,-252
10,37,-60,-45,-7,-46,25,65,-21
15,45,-12,-8,-7,-55,10,76,64
29,108,-40,-46,-91,-128,-29,118,-79
20,30,-55,-21,-78,-76,21,67,-92
92,120,-92,6,-150,-91,52,155,92
40,66,1,2,25,-37,32,82,211
-68,-31,-57,-72,-87,-123,-57,57,-438
-53,-35,-73,-54,-94,-127,-79,85,-430
22,3,-26,-20,-47,-60,7,33,-88
49,82,-5,-36,-24,-12,45,93,192
125,191,-44,-54,-140,-143,52,269,256
35,77,-61,-10,-94,-95,4,104,-40
29,28,-32,-9,-68,-85,8,83,-46
-8,108,-36,-40,-127,-77,-11,180,-11
22,23,-12,-1,-21,-27,19,16,19
126,204,-2,-42,-64,-132,38,240,368
-2,0,-10,-6,-6,-17,-15,13,-43
112,119,-27,-24,-48,-66,43,136,245
36,82,5,-26,-18,-36,-3,143,183
49,34,-23,18,4,-15,21,55,143
2,53,1,4,-20,-58,-12,54,24
28,52,2,-11,-11,-33,-5,59,81
-5,18,-51,-69,-40,-150,-41,78,-260
80,17,18,-45,-21,-122,-3,119,43
50,104,-102,-135,-285,-315,-36,294,-425
10,17,-43,-52,-39,-50,13,71,-73
28,49,-46,-22,-63,-65,-33,117,-35
-64,-50,-76,-63,-111,-151,-83,64,-534
10,31,-45,-11,-48,-21,27,52,-5
5,67,-25,-6,-15,-53,0,35,8
-26,74,-92,-36,-177,-198,-84,161,-378
44,45,-43,0,-56,-35,-7,76,24
-7,68,-8,-32,-52,-161,-22,119,-95
1,32,-55,-43,-121,-82,-39,82,-225
218,291,-11,8,-81,-224,61,197,459
-26,1,-22,-24,-32,-53,-28,31,-153
-102,58,-220,-217,-302,-489,-206,346,-1132
20,8,-29,-28,-59,-94,0,73,-109
-40,95,-52,-43,-3,-27,55,111,96
0,50,-32,-22,-116,-41,-4,117,-48
36,102,11,-29,-23,-57,5,159,204
24,35,-21,-22,-48,-96,-18,66,-80
41,35,-33,-54,-66,-156,-18,121,-130
-44,-11,-54,-67,-87,-118,-64,53,-392
-49,9,-53,-50,-72,-126,-50,61,-330
33,98,20,6,-67,-70,2,167,189
94,173,-131,-152,-134,-158,96,279,67
44,117,28,-12,-95,-132,-6,121,65
56,79,-12,-32,-103,-123,9,156,30
-57,-27,-62,-65,-93,-123,-68,52,-443
103,216,-69,-25,-84,-232,35,239,183
10,35,-41,-22,-76,-84,-7,63,-122
8,35,-22,-21,-19,-5,24,32,32
1,91,-73,-54,-11,-26,25,158,111
90,162,-43,-60,-108,-93,38,234,220
146,163,-40,18,-126,-155,69,227,302
11,47,-39,-20,-71,-54,-5,57,-74
7,13,-7,-20,23,-46,-3,47,14
-6,-20,-29,-22,-66,-74,-19,33,-203
51,62,-90,-61,-215,-212,-64,122,-407
-15,-17,-62,-80,-71,-120,-53,88,-330
25,62,2,12,-16,-27,22,70,150
21,24,14,-32,30,-40,8,36,61
16,38,3,3,-37,-25,-11,47,34
-10,78,-2,-28,-78,-116,-48,73,-131
49,57,-61,-69,-155,-247,-48,157,-317
79,279,24,-25,-25,-284,-56,273,265
201,355,49,5,-19,-35,122,449,1127
274,350,-22,-29,-67,-86,149,348,917
29,90,-72,-95,-73,-141,15,165,-82
50,152,-32,-39,-90,-131,28,152,90
58,91,-39,-62,-57,-96,5,150,50
135,317,-147,-265,-201,-419,-28,418,-190
9,35,-6,-30,-41,-31,6,58,0
-15,49,-68,-96,-85,-135,-6,147,-209
4,46,0,-15,-6,-30,-2,63,60
-1,15,-29,-35,-24,-82,-29,87,-98
51,105,12,15,-2,-61,6,94,220
22,66,-54,-81,-51,-170,-29,162,-135
82,52,-68,-9,-156,-167,-34,149,-151
17,40,-29,-24,-58,-24,10,58,-10
14,108,4,43,-155,-72,-23,138,57
4,78,36,-47,21,-31,37,92,190
218,473,-26,-55,-129,-32,220,558,1227
24,35,-4,-12,-27,-48,3,74,45
16,52,-9,-6,-20,-47,3,71,60
-36,-5,-70,14,-113,-94,-22,83,-243
-30,28,-150,-131,-225,-240,-92,166,-674
-40,2,-53,-93,-176,-71,0,138,-293
0,37,-5,9,-27,-14,7,48,55
190,404,-74,-92,-285,-341,7,481,290
64,144,-52,-44,-8,-114,59,184,233
22,54,37,44,-40,25,28,86,256
19,67,3,-6,-1,-43,13,64,116
77,329,-199,-168,-427,-741,-138,486,-781
41,106,28,20,-3,-74,-4,106,220
77,109,-10,17,-39,-45,25,135,269
18,76,-66,-31,-158,-175,-28,116,-248
6,20,-26,-5,-30,-14,17,27,-5
154,203,-2,-13,-58,-77,27,221,455
9,15,-4,-8,-14,-39,-4,34,-11
15,74,-126,-23,-238,-292,-68,180,-478
165,236,-114,50,-258,-240,50,168,57
12,22,-6,-19,-21,-14,2,53,29
9,45,-5,-7,-35,-48,-8,68,19
13,28,-18,-9,-43,-62,1,59,-31
11,45,-2,2,5,-19,12,67,121
10,52,1,-31,-22,-63,-13,75,9
214,558,-124,-158,-433,-667,8,886,284
4,34,10,-4,-15,-23,-9,46,43
4,197,13,-103,-191,-105,-62,367,120
1,28,-29,-13,-23,-58,-12,58,-48
9,43,-44,-14,-92,-90,-38,88,-138
-1,25,-17,8,-28,-16,-10,45,6
20,47,-21,-10,-10,-40,-4,58,40
54,90,-20,0,-106,-170,-33,142,-43
13,48,-37,-11,-114,-129,4,127,-99
-24,-2,-19,-15,-24,-64,-38,31,-155
27,96,14,14,-67,-20,14,123,201
6,106,-30,-50,-2,-25,43,125,173
42,75,-20,-49,-67,-90,-17,84,-42
5,-11,-24,-38,-69,-82,-1,72,-148
0,20,-34,-29,-21,-56,-17,56,-81
-43,-24,-66,-18,-68,-104,-43,27,-339
195,242,18,-23,-71,-11,137,208,695
189,319,-168,-93,-301,-192,35,231,20
63,30,-36,-74,-93,-182,-36,192,-136
15,37,-14,-47,33,-72,10,68,30
36,98,-27,3,-84,-97,22,99,50
204,466,281,65,55,69,69,491,1700
4,13,-16,23,-25,-46,-14,23,-38
-7,-4,-49,-20,-66,-94,-26,41,-225
21,120,-15,-47,-38,-70,-7,135,99
16,35,11,18,-11,13,24,52,158
266,460,125,85,-7,-118,99,575,1485
26,23,-22,2,-34,-24,10,22,3
23,19,-10,-4,-2,-4,20,13,55
118,153,-66,-25,-59,-74,39,189,275
189,201,-86,-74,-126,-36,66,263,397
1,123,-47,-72,-105,-142,-21,157,-106
59,74,-9,-11,-16,-35,48,71,181
-24,-7,-64,-99,-100,-134,-53,83,-398
7,31,7,-9,-12,-46,3,46,27
31,27,-33,-86,-51,-88,-27,151,-76
-17,7,-54,-46,-103,-70,-17,63,-237
2,10,-48,-41,-55,-84,-33,26,-223
-12,18,-5,-6,-28,3,-7,-4,-41
107,120,-17,-36,-42,-111,28,154,203
-59,-30,-52,-43,-58,-127,-63,63,-369
178,148,-11,18,-58,-122,42,176,371
-32,10,-52,-6,-82,-140,-64,86,-280
67,127,41,-10,15,-6,24,131,389
-61,42,-91,-34,-113,-185,-83,129,-396
21,31,-39,-46,-63,-100,1,59,-136
51,58,18,8,6,-4,5,56,198
51,64,-6,-13,-46,-86,-22,96,38
71,84,-24,-32,-16,-97,-31,133,88
84,109,-98,-32,-124,-148,9,142,-58
7,211,32,-51,106,-12,129,245,667
-13,9,-108,-8,-174,-309,-135,149,-589
217,289,26,-27,-100,-227,17,400,595
73,180,-38,-57,-116,-99,4,246,193
24,91,-284,-310,-451,-593,-161,405,-1279
84,116,-32,-20,-174,-100,12,211,97
293,406,-49,51,-292,-76,202,380,915
74,94,-24,-56,-102,-194,-15,172,-51
19,11,-4,-4,-4,-32,3,25,14
220,322,4,-6,43,-56,97,293,917
-18,6,-32,-2,-114,-141,-90,114,-277
-16,12,-81,-63,-96,-120,-34,75,-323
0,23,-18,-13,-24,2,7,35,12
6,36,-18,-42,-73,-82,-16,97,-92
8,69,-62,-65,-54,-117,-26,101,-146
117,218,10,-16,-24,-74,47,238,516
26,46,-30,-35,-62,-64,-1,72,-48
21,51,-52,-67,-98,-73,-14,98,-134
-27,41,-24,-31,15,8,23,43,48
620,1129,-447,-143,-539,-520,542,1196,1838
146,191,-97,29,-120,-103,68,140,254
41,148,-180,-120,-315,-399,-99,300,-624
0,86,-19,-38,-29,-155,-28,97,-86
53,101,-84,-77,-102,-125,9,137,-88
-23,102,-97,-82,-133,-156,-65,209,-245
29,100,-14,-72,-70,-133,-14,124,-50
83,150,-74,-119,-189,-159,22,327,41
13,33,-3,11,-10,-20,1,24,49
98,104,-110,-106,-207,-310,-88,249,-370
279,340,9,-10,28,-91,165,358,1078
248,309,-90,-24,-120,-102,114,335,670
95,166,-49,13,-102,-88,42,146,223
61,21,-38,-57,-148,-131,28,128,-136
59,30,-12,-65,-70,-248,-31,137,-200
-13,7,-58,-16,-71,-79,-33,40,-223
22,60,-19,-41,-59,-53,28,95,33
1,25,-32,-38,-49,-62,4,75,-76
59,132,-29,-53,-18,-21,29,170,269
40,15,-30,-40,-74,-57,18,64,-64
63,65,-23,-9,-35,11,58,145,275
-19,-4,-30,-19,-57,-66,-21,55,-161
37,39,-27,-17,-68,-94,1,123,-6
44,151,20,8,-52,-50,19,186,326
58,67,-95,-39,-115,-142,4,101,-161
34,33,-29,-61,-95,-85,6,118,-79
18,49,-66,-56,-86,-127,-9,82,-195
-97,-35,-104,-69,-179,-130,-79,94,-599
73,53,-41,-51,-97,-103,15,152,1
63,107,-1,-34,-40,-38,23,143,223
34,48,-121,-64,-183,-146,-5,124,-313
92,40,-64,14,-111,-97,44,57,-25
83,132,20,-6,5,-27,56,122,385
43,93,-22,-65,-111,-120,-23,209,4
21,34,-16,-35,-26,-72,-10,58,-46
19,92,-27,-32,-98,-155,-37,119,-119
1,90,-25,-46,-89,-132,-17,115,-103
-62,13,-68,-42,-105,-170,-86,135,-385
11,44,-46,-2,-14,-54,8,53,0
16,35,-86,-95,-158,-111,-43,148,-294
22,40,-20,-12,-66,-71,-14,62,-59
66,87,-41,-7,-40,-2,35,67,165
24,58,-16,-9,-35,-81,1,103,45
-12,3,-26,-62,-72,-121,-35,90,-235
55,28,-15,-4,-31,-55,11,65,54
-8,22,-20,-50,-86,-129,-62,87,-246
87,109,24,1,27,-27,51,97,369
1,32,-4,-10,1,-29,1,43,35
232,642,-138,-28,-346,-550,-28,436,220
19,52,-27,-19,-80,-47,-11,59,-54
209,270,-44,-113,-92,-99,105,380,616
10,36,-39,-32,-42,-34,-4,74,-31
19,33,-31,-22,-50,-62,2,36,-75
41,25,-10,-4,-11,-78,-11,54,6
-12,63,-49,-41,-132,-152,-41,150,-214
-32,35,-34,-46,-70,-112,-60,69,-250
-47,-13,-70,-49,-76,-76,-42,56,-317
-4,21,-31,-18,-35,-35,-11,26,-87
35,68,-14,-34,-5,-75,9,125,109
-5,5,-6,-8,-3,-12,-6,8,-27
2,14,-30,-54,-57,-93,-14,76,-156
-5,13,1,10,-32,-30,-17,33,-27
22,55,-7,-5,-87,-106,-2,107,-23
-14,13,-35,-47,-39,-28,2,57,-91
45,58,-1,-25,-8,-24,15,68,128
24,102,-3,-8,-23,-72,4,74,98
-69,-26,-99,-58,-144,-214,-150,151,-609
5,5,-8,5,-8,-46,-2,46,-3
28,48,-30,-15,-141,-127,-38,115,-160
45,114,-73,-64,-130,-109,-12,154,-75
3,-17,-103,-39,-193,-222,-84,92,-563
11,23,-33,-3,-23,-43,2,35,-31
60,138,-39,-27,-61,-96,28,163,166
7,30,-49,-20,-98,-64,13,86,-95
17,22,-3,-1,3,-9,16,26,71
94,164,-26,-53,-19,-66,18,166,278
-30,18,4,-1,-56,-95,-54,56,-158
31,46,-27,-60,-54,-114,-27,72,-133
0,-19,-40,-12,-78,-102,-21,87,-185
4,70,3,-5,-21,-73,-14,76,40
-11,8,-30,-18,-79,-41,-9,50,-130
41,67,-49,-35,-127,-162,-70,128,-207
10,11,-16,-3,-23,-39,-14,39,-35
-69,9,-94,-43,-162,-174,-58,95,-496
-24,-11,-53,-7,-71,-129,-42,67,-270
-5,132,-102,-90,-9,-39,53,237,177
133,231,-51,-22,-84,-140,44,196,307
41,96,-39,3,-95,-85,3,54,-22
12,20,-25,-4,-45,-45,8,47,-32
-7,25,-42,-26,-53,-55,-19,35,-142
31,128,-18,-20,-62,-146,0,145,58
19,35,-7,-5,2,1,16,34,95
54,78,-11,20,-72,-108,-30,86,17
12,90,-23,-54,-8,-127,-9,125,6
70,180,12,0,0,-5,84,185,526
100,199,-52,-18,-85,-60,55,216,355
20,27,-8,-27,-31,-59,-18,32,-64
36,35,-36,-9,-17,-18,22,59,72
96,145,-42,-55,-104,-59,23,221,225
104,172,-101,-49,-131,-88,58,230,195
44,37,-67,-9,-133,-174,-21,107,-216
-9,69,-65,-31,-26,-16,42,114,78
22,84,3,28,-69,-78,16,143,149
102,128,-41,34,-105,-73,35,126,206
-38,-22,-57,-44,-67,-136,-63,53,-374
-28,13,-45,-12,-35,-101,-52,82,-178
40,115,-124,-108,-223,-147,20,242,-185
6,18,-30,-41,-29,-36,-9,45,-76
196,212,98,-48,6,-40,68,290,782
52,43,-15,-38,-121,-137,3,143,-70
-14,17,-16,-39,-23,-80,-9,65,-99
78,182,-11,9,-5,32,91,145,521
3,0,-14,-10,-11,-16,-3,6,-45
48,104,-115,-36,-143,-160,-7,116,-193
55,47,-6,5,-22,-67,-6,43,49
129,192,-43,-45,-55,-132,49,232,327
24,54,-17,-42,-78,-64,22,146,45
17,43,-11,-39,-9,-70,-27,59,-37
-4,0,-44,-25,-87,-78,-22,81,-179
46,64,-13,-11,-42,-18,19,61,106
45,92,-12,-31,-45,-97,1,111,64
25,-2,-18,-6,-37,-47,-9,58,-36
2,16,-18,-6,-11,-34,-5,30,-26
24,51,14,-19,12,-23,11,52,122
-1,14,-12,-28,-54,-73,-27,39,-142
28,23,12,7,-14,-43,-3,34,44
-20,3,-25,-1,-32,-69,-14,35,-123
24,54,10,-7,14,-20,10,51,136
14,27,-7,-23,-13,-32,11,43,20
40,65,-36,-7,-11,-20,20,62,113
226,265,-64,-31,-52,-137,120,299,626
114,229,-24,-40,-114,-190,38,246,259
1,36,-11,-20,-79,-81,-29,84,-99
44,84,-24,-17,-9,-2,49,103,228
47,87,-39,-39,-77,-95,45,121,50
0,20,-35,-27,-85,-184,-36,110,-237
50,82,26,-9,8,-73,-2,83,165
-12,2,-36,-24,-47,-63,-16,78,-118
111,205,-61,-21,-70,-113,58,264,373
54,112,-47,-78,-59,-170,6,160,-22
-3,1,-20,-3,-35,-28,-9,12,-85
43,45,-11,-15,-16,-53,18,68,79
29,19,-44,-9,-51,-56,19,57,-36
60,83,-53,-64,-39,-107,22,116,18
6,25,-33,-24,-57,-79,-34,77,-119
7,22,-51,-43,-83,-109,-11,83,-185
42,76,-18,-9,-33,-48,10,76,96
-17,27,-108,-119,-154,-180,-48,176,-423
-29,-20,-67,-31,-64,-111,-50,90,-282
69,213,14,-28,-69,-243,-53,282,185
-14,28,-26,-61,-38,-72,-13,84,-112
-1,16,-12,-9,-11,-42,7,15,-37
-63,-7,-48,-36,-85,-115,-61,65,-350
4,44,-67,-74,-115,-90,-43,104,-237
63,42,-52,-46,-140,-170,-19,162,-160
37,192,-53,-33,-39,-128,34,157,167
-32,12,-46,-6,-64,-104,-40,24,-256
12,25,-14,1,-32,-30,4,52,18
69,101,-15,-48,-53,-100,24,146,124
-47,-39,-62,-39,-71,-65,-50,50,-323
145,129,34,-64,-17,-100,7,169,303
6,17,-21,-49,-5,-39,-17,24,-84
-8,6,0,-5,2,-14,-9,11,-17
0,20,3,-2,-6,-7,5,25,38
122,131,108,-32,63,-19,64,146,583
-91,-47,-139,-44,-185,-180,-121,121,-686
-39,22,-102,-2,-188,-168,-54,104,-427
6,40,-6,-20,-26,-60,-21,87,0
-11,167,-96,-68,-186,-187,-39,330,-90
10,26,-9,-18,2,-26,12,33,30
17,100,8,8,-67,-24,12,141,195
-19,38,-18,-44,-53,-61,-24,70,-111
24,8,-32,13,-81,-90,-26,53,-131
-2,21,-44,10,-73,-49,-21,50,-108
23,36,-4,-18,10,-21,16,51,93
20,28,-3,-8,-52,-67,6,50,-26
-3,26,-7,-8,9,-4,-4,34,43
40,55,-21,-35,-6,-64,-7,52,14
9,50,-61,-49,-65,-131,-22,125,-144
47,315,-43,-69,-233,-171,51,425,322
120,113,-49,47,-90,-66,62,125,262
61,25,-48,13,-77,-58,44,17,-23
-23,-8,-27,-12,-31,-56,-28,37,-148
14,10,-21,-17,-32,-12,-12,34,-36
72,51,5,10,7,-26,41,66,226
30,43,-70,-78,-63,-126,11,57,-196
81,159,-25,-13,-68,-140,26,99,119
-24,5,-23,-1,-30,-50,-29,37,-115
-7,19,-19,-15,-11,-53,-3,36,-53
12,40,-45,-11,-60,-68,5,41,-86
-48,3,-18,-10,-56,-86,-57,58,-214
14,23,-18,-18,-44,-70,12,81,-20
22,75,-92,-59,-160,-176,-21,155,-256
6,5,-31,-11,-53,-33,3,43,-71
10,27,-13,-32,13,10,22,12,49
44,59,11,9,-40,-48,1,64,100
50,44,-20,-2,9,-14,30,38,135
5,8,-16,-9,-28,-25,1,13,-51
18,14,-14,4,-19,-14,1,6,-4
46,126,-22,-28,3,-103,19,161,202
12,42,-28,-31,-43,-80,-23,43,-108
-2,113,26,-4,-25,-29,-20,141,200
54,58,-74,-22,-126,-150,-13,124,-149
16,84,-57,-77,-127,-153,13,128,-173
1,-1,-13,-12,-15,-5,0,17,-28
40,47,-56,-65,-39,-122,12,124,-59
8,22,2,6,-28,-44,-12,56,10
17,87,-72,-54,-99,-154,-10,164,-121
88,70,7,37,-40,-23,15,130,284
53,83,-17,-41,-21,-56,22,73,96
51,62,37,20,-9,21,37,83,302
-46,19,-51,-37,-125,-131,-62,143,-290
-1,0,-19,-10,-24,-27,-6,25,-62
67,109,-42,-13,-60,-69,8,97,97
59,80,-13,-11,-72,-78,39,118,122
125,173,-20,45,-106,-156,46,169,276
8,119,-77,-122,-194,-209,-28,237,-266
-7,34,-23,-56,-12,-104,-18,96,-90
115,253,-39,-41,-42,-31,91,164,470
32,132,-30,-29,-22,-28,46,129,230
12,37,12,-5,-9,0,20,45,112
33,48,-8,2,-18,-46,23,38,72
9,68,23,-24,-47,-39,-18,137,109
22,21,-17,-30,-46,-73,-11,55,-79
-31,-32,-49,-16,-85,-90,-49,35,-317
9,103,-104,-82,-195,-236,-30,238,-297
13,42,5,-7,10,-14,11,40,100
-11,48,-15,-24,27,3,8,34,70
-9,18,10,-45,-40,-75,-52,87,-106
10,35,-34,-43,-52,-60,2,79,-63
14,51,-31,-11,-30,-45,1,72,21
62,52,-48,-37,-34,-94,-8,59,-48
-26,-2,-28,-34,-51,-119,-56,74,-242
11,59,-28,3,-77,-103,-13,59,-89
-41,-28,-48,-54,-70,-50,-34,62,-263
-28,0,-30,-42,-70,-60,-23,74,-179
95,106,1,-87,32,-24,42,124,289
25,53,-18,7,-12,-48,9,39,55
1,66,2,-17,-17,-42,6,78,77
39,33,7,9,-10,-3,35,52,162
127,111,-27,-23,-57,-65,64,131,261
20,42,22,2,5,-44,-7,78,118
143,197,-8,13,-41,24,113,220,661
-18,129,-69,-26,9,36,66,155,282
11,20,0,-12,-20,-21,14,47,39
4,7,-17,-30,-35,-30,-3,48,-56
-35,93,-109,-17,-6,-10,51,138,105
-2,17,-48,-39,-88,-95,-13,39,-229
46,35,-55,-32,-107,-122,-44,115,-164
-10,20,-16,3,-32,-86,-42,43,-120
110,201,71,-25,58,30,42,156,643
6,6,3,5,-26,-40,-7,41,-12
-8,86,-117,-21,-16,30,74,94,122
59,43,10,21,-4,-33,2,70,168
55,87,-6,-7,4,-20,34,88,235
31,8,-60,-38,-74,-114,-14,61,-200
4,27,-18,-9,-11,-31,-11,21,-28
31,71,-11,-30,-58,-17,33,109,128
90,94,-49,-81,-68,-95,39,160,90
89,162,179,64,65,111,68,256,994
12,22,0,-9,-8,-34,-3,39,19
77,151,-8,-28,-37,-50,32,187,324
84,205,-230,-167,-244,-320,73,343,-256
223,287,399,273,52,177,18,402,1831
41,106,64,-5,57,-63,20,124,344
79,109,-26,1,-68,-39,27,128,211
3,42,-9,24,-37,-31,7,55,54
39,81,19,5,-7,10,39,84,270
118,273,-11,51,-34,15,112,31,555
308,382,-97,-96,-223,-362,40,541,493
30,35,-3,-24,5,-27,5,72,93
41,76,-42,-26,-50,-65,-6,73,1
3,73,-83,-63,-106,-103,-1,167,-113
-42,20,-44,-33,-95,-127,-60,80,-301
-2,9,-1,-13,-12,-19,5,28,-5
27,36,15,11,-28,-47,19,50,83
18,10,-17,-9,-17,-12,16,30,19
-12,17,-50,-14,-93,-112,-25,91,-198
-39,31,-2,-5,-49,-88,-44,77,-119
23,82,-46,-7,-100,-102,22,68,-60
-6,144,-64,-74,6,-31,43,165,183
32,56,-23,-43,-28,-67,39,96,62
98,179,-75,-72,-87,-141,20,209,131
19,55,-9,-45,-20,-59,7,96,44
65,78,1,-84,29,-80,17,107,133
35,106,-30,-48,-59,-119,19,121,25
-20,93,-72,-75,-47,-12,42,171,80
70,94,-52,-32,-37,-71,54,117,143
26,55,-6,5,6,-19,0,39,106
77,192,0,-56,87,-69,83,203,517
56,6,-111,-59,-302,-332,-95,155,-682
103,134,-94,-46,-140,-114,56,184,83
23,32,-7,-11,2,-26,15,41,69
35,63,-28,-36,-56,-61,9,87,13
-9,6,-28,-57,-60,-87,-38,109,-164
97,147,12,-42,-57,-118,35,107,181
-52,-24,-27,-42,-57,-47,-53,32,-270
5,9,-2,-5,-3,-37,-18,35,-16
30,50,16,32,-18,6,16,59,191
20,165,79,25,50,4,31,163,537
127,242,-95,-12,-167,-209,13,159,58
1,42,-18,10,-48,-76,-41,81,-49
0,15,-8,-20,-30,-38,-27,39,-69
83,68,8,38,-14,-45,32,98,268
-1,17,-19,-25,-34,-45,-5,51,-61
7,34,-15,-21,-5,-20,15,57,52
9,32,-19,-5,-37,-40,8,37,-15
47,71,21,23,-4,11,50,61,280
18,5,-32,-25,-50,-52,6,54,-76
-38,104,-87,-74,-12,2,39,169,103
1,27,-8,-12,-11,-26,-10,22,-17
106,128,-25,-43,-126,-115,50,207,182
-29,65,-53,-24,42,43,59,86,189
3,34,-26,-24,-28,-83,-23,54,-93
36,85,-3,-18,-64,-78,16,73,47
-22,44,-9,-33,-41,-35,17,52,-27
-13,20,-7,-21,-82,-24,-18,93,-52
-6,16,-6,-27,-15,-24,4,25,-33
5,27,-3,-10,-14,-35,3,36,9
-46,3,-33,-18,-59,-91,-29,46,-227
3,74,-9,-26,-42,-55,17,65,27
-3,5,-64,-37,-98,-113,-10,70,-250
-60,-3,-77,-44,-108,-103,-63,101,-357
-3,32,-52,-2,-84,-71,-11,54,-137
29,26,9,-14,-24,-58,-9,122,81
3,31,-19,-30,-28,-37,-4,36,-48
173,222,9,1,-78,-30,53,172,522
32,94,-25,-26,-79,-74,-16,119,25
89,82,-31,25,-36,-113,26,137,179
-7,110,-9,-62,-48,22,11,147,164
44,79,-92,-29,-132,-148,-3,141,-140
81,81,-30,1,-63,-94,-3,127,100
-8,39,3,-3,-3,-16,-9,38,41
48,123,-12,-38,-53,-52,37,162,215
-10,17,-46,-57,-58,-98,-31,58,-225
-12,-14,-41,-28,-78,-109,-44,36,-290
22,51,-33,-24,31,14,40,37,138
34,73,38,-7,28,-6,9,92,261
101,123,-26,-21,-96,-47,15,178,227
-28,90,-45,-51,25,42,54,115,202
-3,35,-2,-5,-31,-35,12,67,38
27,48,6,-1,1,-7,29,56,159
2,35,-22,-36,-18,-27,7,31,-28
208,265,31,54,-10,-68,86,271,837
-6,9,-18,-25,-45,-31,13,39,-64
31,65,-37,-9,-46,-26,32,62,72
46,88,-53,-68,-116,-190,-40,207,-126
85,184,-115,-82,-172,-202,-1,180,-123
56,93,-14,-33,-213,-313,-54,242,-236
-24,-8,-26,-12,-50,-91,-43,73,-181
36,92,11,-18,-12,-85,-8,110,126
-44,104,-83,-37,31,61,125,145,302
-12,36,-9,-12,-25,-31,12,47,6
13,33,-13,-48,-35,-37,14,59,-14
42,77,-11,3,-62,-87,-15,111,58
-3,70,-20,-37,-17,-14,7,114,100
56,110,-14,30,-58,-79,-2,43,86
15,19,-33,-39,4,-44,-1,74,-5
-15,-7,-20,-15,-35,-36,-9,14,-123
35,35,-44,-26,-81,-112,-13,68,-138
147,253,-82,-52,-177,-205,95,237,216
12,33,-49,-32,-82,-127,-15,102,-158
57,122,-137,-87,-140,-88,66,189,-18
44,151,-35,28,6,35,66,80,375
8,-8,-28,-5,-72,-80,-8,62,-131
-9,5,-26,-39,-45,-94,-35,57,-186
-12,64,-68,-35,-12,-17,67,123,110
59,127,40,-14,18,-28,44,134,380
23,19,-6,6,-21,-24,9,41,47
109,174,-67,-43,-191,-227,49,148,-48
121,220,20,-18,-29,-69,80,244,569
34,33,-64,-26,-35,-46,22,72,-10
-32,25,-25,-38,-51,-126,-19,79,-187
15,77,14,-30,-11,-57,6,72,86
-35,66,-40,-47,-18,-6,64,78,62
43,83,-18,-3,3,-33,36,96,207
5,24,7,-4,-13,0,6,39,64
-11,28,-4,-34,-74,-82,-2,108,-71
88,80,-77,-21,-121,-69,48,124,52
56,97,-36,-2,-106,-133,22,98,-4
32,36,-36,-51,-66,-74,-6,96,-69
71,106,-30,-23,-107,-68,33,171,153
16,66,11,6,-24,-71,-16,75,63
30,30,-4,-14,-12,-11,16,67,102
33,62,36,2,19,0,26,94,272
3,69,11,-25,-2,-2,30,63,147
31,79,-29,7,11,17,44,48,208
21,47,30,0,15,-19,11,53,158
13,33,-15,-15,-4,-21,18,23,32
33,55,-66,-54,-71,-165,-56,122,-202
16,43,-41,-39,-70,-108,-27,72,-154
18,31,-15,-3,-9,-29,14,42,49
159,189,-42,-25,2,-76,97,140,444
31,89,-34,-46,-62,-64,33,160,107
-19,24,38,49,-39,22,1,60,136
10,99,-44,-25,-78,-97,-5,106,-34
4,54,-34,-36,-103,-109,-28,90,-162
85,63,-25,-28,-18,-109,50,110,128
192,351,-123,-75,-216,-283,43,427,316
190,348,-15,170,-210,34,157,101,775
50,93,-23,-12,-66,-141,13,115,29
46,35,4,-9,-27,-8,25,82,148
-13,27,6,-6,-5,-41,-13,43,-2
40,71,-39,-45,-71,-96,4,110,-26
27,45,20,-17,19,8,31,66,199
3,22,-3,-11,-9,-28,-5,36,5
57,93,14,-10,28,-26,54,115,325
24,54,-29,-41,-5,-45,20,98,76
66,60,-2,-35,-13,-27,44,78,171
52,70,-24,-28,-44,-50,13,106,95
84,185,-53,-18,-93,-94,13,151,175
75,85,11,-41,-30,-94,21,124,151
12,44,-32,-24,-71,-57,0,101,-27
-67,-26,-132,-63,-146,-161,-56,100,-551
23,91,-75,-58,-119,-177,-38,185,-168
-26,56,-52,-21,-19,-31,26,98,31
100,106,-66,-16,-78,-133,-1,85,-3
29,48,-122,-98,-160,-168,-8,163,-316
19,7,-62,-11,-108,-150,-31,64,-272
71,77,-22,-22,-26,-37,53,127,221
-8,29,-62,-49,-67,-147,-28,112,-220
81,142,-16,-5,-22,-109,36,105,212
-11,55,-60,-64,-52,-89,-11,114,-118
99,112,45,-40,67,-101,35,102,319
51,200,-33,-96,55,-84,73,126,292
70,98,-70,-35,-152,-103,25,168,1
7,35,-10,-22,-72,-95,-10,126,-41
3,17,2,2,-2,-40,14,30,26
211,266,23,4,-14,-80,95,305,810
45,86,-20,-15,-19,-38,16,75,130
39,74,17,-9,15,-21,11,72,198
8,30,-6,-3,-15,-14,13,36,49
72,97,-69,-18,-180,-128,16,117,-93
28,88,-17,-34,-32,-81,1,68,21
12,50,-1,-7,-26,-12,10,52,78
3,7,-63,-76,-111,-149,-63,116,-336
42,129,-10,-4,-118,-195,-9,187,22
3,21,-4,-1,-21,-25,-10,44,7
88,146,39,-14,7,-63,93,172,468
96,120,4,-36,-62,-113,8,137,154
20,61,34,-10,15,-26,13,85,192
46,91,-25,-15,-54,-32,31,146,188
44,51,-84,-20,-168,-179,-28,120,-264
-14,25,-16,-15,-34,-40,-10,52,-52
136,186,-62,-84,-74,-127,50,364,389
69,65,-60,-34,-91,-92,1,124,-18
14,45,-6,1,-11,-17,13,32,71
32,38,-9,3,-16,-11,29,34,100
-11,-11,-51,-62,-73,-168,-27,114,-289
78,215,-67,-63,-112,-145,36,231,173
12,19,-28,-23,-71,-47,-2,55,-85
22,107,-5,-60,1,-23,34,107,183
65,132,16,-14,-3,-50,42,130,318
81,107,20,-40,-4,-38,15,116,257
-4,16,-66,-34,-107,-96,-8,80,-219
67,158,-91,-75,-202,-296,-75,260,-254
42,42,-37,-21,-14,-37,27,58,60
13,82,-59,-55,-76,-74,9,86,-74
164,291,-153,44,-194,-259,-5,166,54
18,24,-32,-3,-77,-63,7,65,-61
-7,16,-47,-16,-15,-57,47,140,61
81,63,-118,-12,-313,-389,-98,182,-604
-66,-43,-208,-160,-285,-309,-122,181,-1012
13,219,-113,-80,-14,63,97,231,416
68,111,-4,-18,-61,-72,13,187,224
248,339,-243,-124,-405,-422,-61,483,-185
28,48,-104,-63,-164,-139,12,130,-252
82,150,-88,-65,-236,-216,3,169,-201
-30,89,-115,-73,-148,-192,-35,218,-286
24,68,-28,-12,-33,-55,15,75,54
41,53,1,-11,11,-5,20,57,167
52,123,-9,-13,17,-30,52,126,318
26,59,32,-3,16,-18,13,71,196
-34,-30,-32,-23,-37,-63,-31,21,-229
-37,-39,-54,-45,-150,-87,-71,86,-397
82,187,44,-2,0,-86,9,197,431
40,96,-64,-36,-149,-138,-39,167,-123
21,48,4,9,-14,-26,13,50,105
50,99,-30,-52,-75,-130,-30,171,3
28,50,-19,-1,-63,-99,-17,131,10
-53,2,-38,-17,-46,-97,-63,52,-260
43,95,-16,-19,6,-73,17,93,146
-81,-39,-64,-25,-94,-178,-95,97,-479
3,-6,-34,-5,-81,-122,-15,69,-191
83,108,-18,-19,-67,-42,29,104,178
79,46,-58,-79,-73,-176,2,93,-166
48,4,-4,9,-4,-42,32,40,83
-41,-29,-133,-104,-196,-235,-90,162,-666
53,22,14,27,-18,-27,10,99,180
16,13,-18,-44,-33,-74,-10,64,-86
-26,13,-28,-44,-39,-93,-48,36,-229
-22,32,-21,-21,-67,-121,-30,76,-174
18,-5,-51,-12,-122,-140,-21,121,-212
-38,6,-91,-50,-110,-169,-65,95,-422
0,30,-29,-8,-91,-72,-11,74,-107
32,58,-74,-54,-164,-240,-64,161,-345
-45,58,-71,-12,-149,-151,-69,125,-314
19,104,-38,-21,-171,-131,31,179,-28
-19,9,-59,-26,-78,-72,-30,56,-219
-49,1,-27,-22,-56,-116,-70,57,-282
74,91,-19,3,-24,-72,55,140,248
107,122,-58,14,-117,-114,51,152,157
11,73,20,-24,35,-63,-7,80,125
-40,9,-131,-98,-222,-310,-129,163,-758
40,56,-47,-15,-45,-85,12,66,-18
31,47,-30,-28,-68,-50,29,117,48
16,40,-12,5,-36,-46,-8,30,-11
-22,21,-53,-36,-77,-152,-62,101,-280
29,14,-44,-32,-90,-120,2,59,-182
6,52,-17,-18,-59,-69,-11,74,-42
35,91,-10,-40,-42,-82,29,111,92
-76,-40,-85,-88,-115,-187,-96,122,-565
-8,30,-55,-17,-105,-65,2,98,-120
72,96,28,-22,29,-44,4,90,253
16,32,-33,-29,-66,-68,16,116,-16
63,63,-1,5,9,-11,28,103,259
5,51,-19,-21,-38,-62,-22,48,-58
18,50,15,-9,14,-6,22,77,181
28,112,26,-5,9,-16,13,126,293
52,62,-31,-33,-9,-13,21,75,124
24,50,-2,-10,4,-8,31,27,116
1,38,-49,-37,-69,-46,4,115,-43
47,115,26,19,-66,-176,-7,175,133
88,104,36,12,-4,36,72,134,478
60,67,-23,-27,-27,-61,-5,95,79
68,107,-61,-13,-151,-121,16,66,-89
50,131,-49,-73,-65,-144,15,181,46
25,57,-43,-53,-71,-56,3,121,-17
1,-6,-19,-36,-11,-69,-31,34,-137
192,276,37,-9,24,-102,74,210,702
54,47,-2,-23,-35,-25,26,82,124
3,112,100,106,-74,29,10,167,453
14,75,25,6,-2,-17,28,105,234
121,45,-89,-7,-118,-77,27,89,-9
3,32,-5,-30,-43,-99,-25,75,-92
-75,-19,-84,-21,-164,-138,-79,139,-441
158,224,25,-29,-27,-57,59,238,591
18,49,-18,-50,-55,-56,9,102,-1
62,119,-3,-18,-92,-130,3,172,113
9,17,-1,18,-76,-70,-18,83,-38
30,168,-6,-42,1,-63,45,145,278
11,19,-21,-28,-62,-110,-20,87,-124
-21,35,-77,-53,-188,-182,-71,147,-410
25,32,-2,-49,-36,-104,-5,71,-68
3,45,-3,-39,-39,-141,-34,154,-54
3,51,15,-52,-50,-20,-16,130,61
28,78,-58,-12,-11,3,54,116,198
-43,65,-34,11,-108,-166,-77,110,-242
8,47,-26,-61,-52,-127,-20,138,-93
-37,-5,-49,-32,-59,-77,-33,54,-238
26,95,2,-46,-3,-113,-21,122,62
8,70,-124,-118,-217,-209,-55,218,-427
168,367,-423,-358,-852,-1170,-318,758,-1828
60,108,-8,-22,-71,-36,33,169,233
129,265,-46,-8,-57,-81,111,217,530
7,53,-60,-26,-156,-180,-27,171,-218
61,129,-32,-40,-48,-58,44,187,243
40,60,-2,-7,-4,-5,27,52,161
-11,-1,-7,-11,-11,-33,-25,17,-82
-44,25,-47,-33,-83,-115,-46,105,-238
35,128,-9,-22,-16,-8,49,96,253
11,12,-38,-41,-100,-126,-39,116,-205
20,13,-41,-26,-44,-54,-3,58,-77
23,22,14,-17,-12,-56,-1,37,10
-29,7,-46,-25,-66,-59,-45,69,-194
-16,13,-22,2,-32,-67,-29,34,-117
-104,-63,-149,-124,-187,-202,-156,76,-909
14,55,-32,-50,-76,-47,14,105,-17
41,93,-43,-57,-1,-68,2,127,94
10,31,-33,-6,-27,-34,6,25,-28
84,217,-144,-10,-126,-154,44,188,99
62,111,19,-27,-2,-53,35,94,239
8,10,-5,4,-7,-10,-2,16,14
34,97,-27,1,-91,-138,26,145,47
52,106,35,47,-21,-49,-23,139,286
-11,39,-10,-18,-42,-47,-10,78,-21
6,34,-40,-67,-71,-107,-30,146,-129
172,206,-129,7,-258,-275,-50,148,-179
46,118,-5,-12,-29,-38,21,59,160
95,171,-8,-41,-28,-159,34,257,321
54,105,-82,-20,-95,-81,-1,80,-40
202,357,59,-26,-83,-268,14,452,707
137,213,-20,-25,-73,-124,42,183,333
23,50,44,25,-17,-3,0,62,184
105,202,-61,-16,-88,-209,2,178,113
78,120,39,36,-14,15,57,152,483
55,159,-49,-64,-133,-168,-13,241,28
44,101,-69,-56,-124,-95,-21,145,-75
36,19,-39,-46,-67,-112,-6,55,-160
87,156,-100,-64,-19,-66,55,226,275
125,195,37,32,-37,-82,50,217,537
22,10,-31,-20,-95,-96,-9,69,-150
18,24,-14,-1,-55,-54,14,59,-9
346,778,-117,-244,-1062,-641,255,1401,716
26,197,-187,-120,-418,-597,-180,267,-1012
49,129,-62,-81,-84,-110,27,195,63
29,79,6,1,13,-10,34,60,212
85,83,115,44,41,8,34,114,524
4,26,17,16,-8,-3,3,45,100
29,74,-43,-6,-53,-25,36,90,102
111,114,-32,-6,-80,-79,3,174,205
17,106,-130,-140,-288,-321,-32,299,-489
255,637,-156,-182,-166,-254,262,686,1082
23,31,-74,-28,-120,-127,1,96,-198
89,117,-17,1,-46,-109,3,143,181
274,295,-101,-56,-125,-221,62,297,425
129,220,73,-37,-13,-118,38,324,616
3,201,-223,-154,-359,-358,-44,305,-629
-11,10,-48,-7,-143,-83,-50,129,-203
3,39,-50,-37,11,13,77,101,157
-38,89,-101,-77,12,5,73,127,90
158,223,51,16,-65,-100,86,246,615
-15,-14,-31,-27,-44,-33,-24,47,-141
-38,0,-47,-35,-96,-142,-54,64,-348
35,210,-195,-93,-245,-225,-24,231,-306
589,705,267,321,12,22,134,864,2914
28,74,-60,-45,-25,-21,26,128,105
-10,53,-236,-54,-340,-426,-88,175,-926
186,297,51,-20,48,-146,76,319,811
-66,3,-68,-28,-155,-96,0,156,-254
220,376,-34,-65,-131,-182,86,410,680
12,46,-16,-9,-11,-1,25,58,104
-14,31,0,-24,-15,-46,-19,57,-30
1,2,-35,5,-71,-97,-21,21,-195
2,41,10,-3,1,-21,2,46,78
62,34,-30,21,-59,-51,35,48,60
30,79,0,-12,3,-60,14,69,123
156,125,11,-5,-116,-131,20,262,322
162,275,-1,-101,-24,-158,7,257,417
31,52,-15,-24,-57,-143,-33,84,-105
-60,-4,-117,-70,-103,-196,-88,65,-573
-68,-42,-79,-60,-122,-151,-82,66,-538
64,100,-112,-26,-182,-201,-7,141,-223
35,114,-154,-111,-154,-271,-13,253,-301
45,116,-70,-75,-104,-156,-16,190,-70
13,29,-32,-38,-63,-51,-3,69,-76
-7,105,-63,-26,-160,-227,-62,170,-270
129,187,-29,-37,-22,-88,49,164,353
187,140,17,-6,20,-53,62,240,607
31,54,-24,-8,-127,-81,12,115,-28
45,62,-24,-53,-63,-149,18,123,-41
-3,4,-16,-25,-14,-34,-9,21,-76
75,184,-121,-27,-74,-115,93,206,221
-22,10,-30,-58,-47,-98,-32,74,-203
3,23,-24,-15,-74,-76,-16,60,-119
-3,25,-19,-18,-10,-50,-23,32,-66
3,29,-22,-10,-22,-45,-8,69,-6
169,234,57,-29,11,-99,34,298,675
28,79,-16,-38,-92,-86,10,108,-7
1,-16,-46,-22,-35,-85,-10,35,-178
43,126,-31,-20,-47,-110,23,149,133
95,123,-81,-89,-102,-216,-34,164,-140
34,75,-9,15,-40,-138,-60,251,128
-3,88,-61,-61,-101,-127,2,145,-118
7,19,11,-3,25,-1,13,30,101
0,86,-60,-87,-150,-201,-70,164,-318
120,167,-91,3,-179,-176,48,202,94
38,118,-90,-10,-33,-50,32,66,71
78,109,-64,-24,-54,-49,49,125,170
9,8,-23,-28,-45,-63,0,38,-104
82,88,-5,-11,-4,-28,44,80,246
72,77,-38,-32,-90,-83,60,101,67
7,154,-28,-68,-16,-101,7,166,121
39,83,-55,-41,-41,-181,-20,120,-96
82,131,-76,27,-69,-77,37,29,84
-6,0,-27,-19,-51,-44,11,51,-85
46,94,-36,-13,-43,-52,27,76,99
-35,56,-48,-71,15,-23,28,107,29
-13,24,-43,-64,-52,-89,-14,63,-188
17,46,-41,-46,-40,-67,-17,50,-98
35,115,0,-52,-69,-131,-13,232,117
75,219,-60,-58,-108,-117,29,238,218
-5,67,-92,-60,-2,-25,44,98,25
3,68,-69,-64,-152,-123,-35,144,-228
139,223,-23,0,-86,-109,54,300,498
81,119,-69,-125,-78,-169,6,195,-40
76,130,-81,-65,-151,-244,-72,242,-165
103,226,-112,-111,-133,-230,-6,280,17
115,186,-76,-37,-44,-160,56,154,194
107,187,26,-38,15,-19,88,217,583
0,39,8,-1,-44,-45,-3,71,25
-21,53,-74,-72,-2,-16,64,123,55
9,33,-19,-18,-11,-46,-11,44,-19
18,42,-17,-16,-22,-19,14,44,44
18,77,-129,-70,-126,-239,-94,137,-426
6,6,-52,-52,-135,-99,-15,85,-256
39,52,-17,-42,-55,-95,-3,73,-48
-7,12,-1,0,2,-16,-8,16,-2
-12,11,-5,-14,3,-6,1,20,-2
295,409,-93,121,-252,-171,188,469,966
16,69,-4,-21,9,-23,0,99,145
38,29,-26,-30,-57,-101,2,46,-99
-12,3,-144,-99,-157,-263,-73,118,-627
77,76,-82,-30,-149,-184,7,127,-158
19,-8,-38,-61,-49,-89,-18,56,-188
67,142,-189,-158,-284,-319,-17,374,-384
467,582,29,-24,-32,-182,201,748,1789
-26,69,1,-18,-15,-98,-23,56,-54
-40,4,-39,-6,-81,-109,-66,111,-226
-5,18,-32,-5,-14,-32,-1,22,-49
-6,2,-4,-12,-3,-17,-12,9,-43
-11,9,-7,-12,-12,-12,-9,2,-52
0,25,-30,-22,-74,-45,-10,63,-93
359,566,-33,15,-168,-244,114,607,1216
22,34,-21,-16,-49,-54,19,83,18
27,46,-67,-53,-88,-131,-22,82,-206
115,118,7,-16,17,-31,44,123,377
58,84,-20,-42,-46,-100,-9,122,47
24,-29,-174,-92,-328,-342,-83,216,-808
1133,1412,158,-307,-20,-403,442,1613,4028
-6,41,-28,-48,-99,-74,-31,97,-148
18,27,-69,-51,-122,-127,14,76,-234
114,201,-236,-188,-349,-550,-45,491,-562
183,244,168,65,29,-45,51,343,1038
46,78,-23,6,-29,-64,4,45,63
1,80,32,-12,-29,2,20,82,176
917,1691,-1068,-319,-1998,-2484,-540,1588,-2213
-6,89,-16,-38,-35,-30,55,158,177
127,198,-52,-109,-179,-294,-54,391,28
45,92,7,-15,-30,-59,29,85,154
-72,-32,-61,-72,-71,-126,-70,50,-454
570,916,-257,-57,-487,-56,414,975,2018
39,50,-68,-21,-164,-243,-18,152,-273
25,33,-7,-5,-27,-18,17,34,52
650,658,302,362,46,15,249,940,3222
-47,1,-77,-114,-144,-142,-47,163,-407
8,50,-18,-28,-63,-164,-14,115,-114
20,94,-30,-32,-83,-100,3,178,50
29,45,17,-17,-55,-65,-20,103,37
-6,-4,-16,-28,-51,-55,-8,76,-92
54,93,8,-18,-5,-22,33,118,261
180,150,-22,31,-39,-110,91,190,471
-14,78,-17,-69,-68,-124,-8,174,-48
58,46,-20,10,-73,-65,34,57,47
-34,1,-66,-38,-57,-129,-44,60,-307
-49,-44,-78,-77,-116,-108,-54,80,-446
67,102,27,97,-84,-13,22,151,369
22,70,-55,-28,-136,-189,-27,140,-203
0,57,-22,-15,-30,-63,-7,68,-12
-1,31,8,-33,-3,-110,-41,75,-74
-39,97,-141,-50,-221,-364,-146,203,-661
33,103,-57,-49,-74,-132,-25,202,1
81,198,-25,-23,-87,-146,-6,248,240
3,14,-11,-16,-2,-38,-12,31,-31
99,114,-16,-62,-152,-128,52,249,156
7,34,-9,-21,-17,-14,9,38,27
125,236,-258,-265,-692,-636,-153,725,-918
13,62,-49,-16,-89,-118,-3,124,-76
6,33,-50,-31,-100,-162,-47,148,-203
86,106,-37,-12,-71,-79,30,132,155
-27,-22,-22,-20,-29,-22,-19,5,-156
52,121,-98,-24,-92,-135,2,60,-114
16,128,-11,-56,-61,-191,-26,150,-51
-74,-41,-78,-71,-121,-144,-51,115,-465
72,158,9,-37,15,-91,41,187,354
52,139,-19,10,-124,-40,-57,204,165
17,21,-36,-41,-73,-136,-11,114,-145
12,28,-29,-51,-79,-156,-49,94,-230
16,11,-8,17,-33,-29,12,20,6
15,15,8,-23,14,-11,17,28,63
17,60,-43,-23,-32,-69,-8,100,2
361,558,-153,-120,-200,-237,159,694,1062
19,36,1,-22,-54,-72,2,75,-15
10,45,-7,-37,22,-57,10,93,79
266,588,607,174,282,400,173,741,3231
74,77,-32,31,-69,-90,20,110,121
4,45,-31,-36,-116,-57,12,84,-95
156,204,-65,-32,-113,-129,72,246,339
25,23,-27,1,-41,-33,10,51,9
168,189,-48,-97,-98,-151,27,318,308
23,4,-83,-74,-129,-112,-26,104,-293
5,92,-101,-110,-153,-220,-27,249,-265
35,21,-50,-85,-73,-194,-77,174,-249
110,82,55,-26,-63,-201,-21,218,154
87,89,-47,-6,-119,-88,24,32,-28
-48,0,-65,-69,-94,-129,-60,104,-361
22,44,-47,-39,-106,-51,12,90,-75
-22,92,-65,-38,-137,-206,-41,150,-267
30,89,-29,-40,-52,-101,-3,57,-49
93,122,-59,-121,-155,-197,-31,290,-58
-39,-18,-51,-27,-70,-63,-48,36,-280
151,165,10,-16,-58,-59,89,183,465
336,377,-156,-213,-345,-438,-24,599,136
-10,10,-4,-8,5,-11,3,14,-1
21,21,0,15,-18,-26,3,39,55
27,80,-114,-69,-142,-226,-77,156,-365
7,35,-13,-5,-31,-70,23,84,30
161,138,0,15,-31,-18,99,155,519
39,71,-65,-44,-121,-172,0,116,-176
13,28,-39,-48,-59,-94,-20,86,-133
-76,-37,-75,-68,-108,-121,-71,72,-484
-36,-25,-45,-28,-74,-132,-58,51,-347
-25,-26,-33,-17,-74,-138,-62,51,-324
-78,-31,-87,-60,-120,-124,-72,75,-497
-70,-54,-55,-34,-92,-123,-58,48,-438
-73,-40,-60,-56,-87,-103,-65,72,-412
-69,-35,-68,-58,-95,-109,-66,56,-444
-65,-26,-69,-65,-99,-137,-75,66,-470
-73,-37,-61,-48,-87,-114,-56,53,-423
-56,-15,-48,-47,-85,-124,-72,61,-386
-66,-16,-58,-38,-74,-114,-56,66,-356
-65,6,-50,-43,-99,-133,-70,80,-374
-35,20,-30,-33,-95,-114,-66,68,-285
-43,11,-49,-32,-83,-130,-63,68,-321
-66,-7,-47,-49,-99,-127,-78,65,-408
-53,-14,-62,-33,-101,-118,-64,65,-380
-63,-18,-75,-59,-103,-110,-44,69,-403
-57,-7,-55,-44,-91,-122,-73,72,-377
-31,12,-35,-10,-78,-99,-34,68,-207
-81,-36,-63,-65,-74,-132,-76,64,-463
-76,-10,-54,-36,-76,-114,-65,55,-376
-62,-15,-61,-65,-69,-101,-65,57,-381
-70,-48,-79,-78,-105,-138,-80,45,-553
-49,-29,-58,-66,-67,-115,-66,55,-395
-67,-54,-68,-73,-108,-126,-53,48,-501
-65,-47,-65,-68,-59,-118,-67,62,-427
-83,-45,-75,-84,-86,-115,-66,59,-495
-68,-1,-53,-49,-89,-130,-71,73,-388
-65,-11,-57,-69,-66,-129,-63,81,-379
-69,-37,-57,-77,-85,-121,-57,41,-462
-45,-34,-55,-60,-96,-119,-71,38,-442
-53,-40,-56,-45,-99,-119,-57,33,-436
-78,-7,-61,-88,-111,-119,-66,76,-454
-63,-22,-59,-66,-87,-110,-60,81,-386
-85,-33,-64,-60,-68,-97,-66,62,-411
-84,-47,-55,-72,-69,-110,-68,69,-436
-78,-41,-58,-65,-68,-128,-66,45,-459
-67,-48,-62,-68,-112,-115,-53,48,-477
-68,-41,-49,-69,-77,-122,-54,60,-420
-75,-27,-70,-75,-87,-116,-68,66,-452
-77,-27,-71,-88,-104,-122,-77,74,-492
-52,-32,-51,-71,-92,-118,-56,82,-390
-62,-30,-35,-61,-84,-119,-68,59,-400
-67,-44,-76,-63,-92,-100,-40,58,-424
-68,-11,-66,-61,-85,-116,-89,52,-444
-46,-20,-62,-44,-86,-111,-73,70,-372
-60,0,-68,-67,-94,-118,-57,62,-402
-38,3,-44,-53,-70,-111,-33,66,-280
-70,-4,-51,-51,-85,-110,-60,71,-360
-70,-9,-44,-68,-76,-103,-54,64,-360
-67,-45,-86,-58,-97,-116,-63,45,-487
-77,-35,-80,-50,-129,-125,-60,71,-485
-70,-31,-49,-56,-112,-112,-44,76,-398
-91,-20,-66,-55,-103,-142,-64,60,-481
-52,-25,-64,-40,-94,-116,-67,49,-409
-67,-35,-69,-50,-103,-126,-73,54,-469
-60,-39,-96,-56,-114,-121,-77,64,-499
-68,-31,-79,-78,-113,-107,-64,65,-475
-80,-40,-56,-61,-104,-126,-81,41,-507
-66,-37,-76,-66,-97,-130,-72,56,-488
-61,-22,-75,-60,-103,-138,-76,62,-473
-62,-44,-88,-62,-112,-148,-75,72,-519
-67,-26,-78,-64,-105,-134,-80,69,-485
-52,-23,-66,-67,-94,-106,-74,62,-420
-77,-43,-87,-80,-89,-137,-87,57,-543
-59,-1,-67,-63,-69,-113,-61,85,-348
-50,7,-64,-53,-90,-122,-68,70,-370
-52,-24,-72,-61,-93,-113,-73,80,-408
-60,-11,-69,-65,-86,-98,-61,72,-378
-44,-18,-61,-52,-87,-129,-61,73,-379
-73,-4,-64,-58,-108,-123,-67,92,-405
-83,-6,-67,-52,-100,-121,-71,97,-403
-46,-23,-62,-61,-86,-131,-63,65,-407
-84,-49,-65,-93,-90,-121,-48,57,-493
-63,-41,-63,-66,-83,-113,-41,50,-420
-46,-18,-47,-31,-103,-124,-60,79,-350
-69,-38,-66,-71,-90,-114,-56,39,-465
-52,-24,-49,-33,-103,-132,-65,69,-389
-63,1,-34,-60,-72,-113,-58,54,-345
-57,-9,-30,-75,-70,-123,-62,67,-359
-72,-21,-63,-64,-88,-106,-65,71,-408
-74,-31,-67,-51,-97,-111,-72,54,-449
-58,-42,-78,-53,-109,-109,-70,64,-455
-63,-24,-60,-40,-83,-117,-68,67,-388
-48,-16,-52,-65,-66,-123,-65,64,-371
-87,-49,-79,-73,-96,-107,-37,66,-462
-95,-50,-78,-77,-81,-128,-61,56,-514
-87,-44,-65,-80,-93,-126,-49,56,-488
-76,-48,-52,-74,-98,-141,-92,69,-512
-70,-41,-67,-63,-91,-126,-60,71,-447
-73,-35,-65,-64,-89,-125,-66,68,-449
-55,4,-43,-35,-85,-141,-51,64,-342
-82,-41,-68,-87,-100,-136,-63,58,-519
-69,-22,-43,-64,-87,-121,-45,82,-369
-99,-23,-61,-65,-80,-130,-90,61,-487
-95,-43,-72,-92,-98,-114,-71,64,-521
-66,-53,-75,-33,-118,-138,-55,42,-496
-70,-52,-74,-42,-120,-136,-56,51,-499
-81,-15,-63,-59,-104,-117,-60,64,-435
-56,-23,-58,-27,-112,-123,-48,77,-370
-79,-50,-89,-84,-92,-140,-84,68,-550
-69,-28,-55,-62,-94,-122,-78,65,-443
-63,-30,-75,-75,-83,-129,-88,72,-471
-63,-34,-59,-69,-102,-120,-71,58,-460
-56,-31,-69,-56,-76,-127,-69,57,-427
-62,-26,-87,-74,-95,-115,-67,60,-466
-57,-9,-70,-54,-78,-145,-69,51,-431
-63,-36,-58,-64,-90,-113,-80,53,-451
-68,-11,-65,-63,-97,-115,-83,49,-453
-68,-40,-60,-70,-79,-113,-62,64,-428
-82,-41,-85,-78,-112,-120,-86,57,-547
-64,6,-39,-50,-108,-97,-56,74,-334
-60,-18,-56,-68,-84,-122,-62,59,-411
-68,-18,-48,-60,-84,-141,-75,55,-439
-73,-27,-77,-57,-116,-122,-59,48,-483
-66,-22,-61,-66,-89,-109,-57,65,-405
-62,-18,-55,-73,-82,-118,-59,71,-396
-67,-15,-48,-58,-85,-114,-61,72,-376
-63,-19,-43,-53,-76,-121,-59,74,-360
-58,-22,-41,-34,-70,-100,-73,59,-339
-68,6,-53,-65,-91,-97,-57,66,-359
-57,-32,-60,-53,-101,-113,-77,61,-432
-61,-25,-73,-62,-101,-134,-78,56,-478
-81,-37,-71,-75,-97,-86,-58,49,-456
-74,-57,-86,-70,-91,-102,-62,42,-500
-61,-31,-61,-50,-80,-112,-72,51,-416
-58,-17,-63,-63,-83,-117,-76,69,-408
-59,-44,-79,-58,-90,-113,-70,63,-450
-50,-31,-62,-40,-109,-119,-74,62,-423
-67,-63,-66,-47,-105,-134,-64,40,-506
-63,-29,-61,-60,-87,-117,-90,79,-428
-74,-24,-67,-55,-84,-135,-84,55,-468
-57,-25,-60,-41,-104,-136,-84,49,-458
-61,-39,-76,-47,-103,-117,-83,61,-465
-52,-6,-63,-23,-102,-127,-56,60,-369
-52,9,-73,-63,-78,-129,-32,69,-349
-32,-16,-68,-14,-109,-143,-56,63,-375
-35,-20,-60,-30,-104,-130,-48,51,-376
-60,4,-78,-64,-82,-107,-46,65,-368
-50,-27,-36,-36,-84,-137,-69,50,-389
-57,3,-60,-56,-54,-126,-51,62,-339
-57,-15,-55,-43,-74,-137,-53,56,-378
-52,-23,-60,-54,-83,-119,-56,55,-392
-44,-1,-55,-58,-75,-135,-84,68,-384
-51,-11,-51,-59,-80,-125,-61,60,-378
-50,-9,-61,-51,-93,-138,-68,61,-409
-53,-18,-63,-56,-98,-131,-72,77,-414
-60,-25,-82,-42,-95,-112,-79,86,-409
-64,-36,-92,-49,-112,-137,-81,76,-495
-51,-29,-96,-67,-119,-115,-59,67,-469
-49,-17,-69,-78,-78,-119,-82,67,-425
-51,-27,-76,-82,-83,-120,-83,70,-452
-51,-16,-77,-75,-75,-111,-88,66,-427
-55,-5,-67,-46,-99,-125,-85,68,-414
-71,-10,-75,-43,-87,-136,-44,65,-401
-79,-16,-57,-72,-72,-116,-76,61,-427
-62,-29,-56,-57,-93,-122,-78,74,-423
-62,-3,-51,-51,-66,-119,-75,70,-357
-79,-35,-64,-62,-91,-107,-71,43,-466
-74,-44,-66,-65,-87,-126,-81,66,-477
-12,18,-38,-3,-100,-124,-33,62,-230
36,84,-38,-25,-72,-132,-5,113,-39
-81,-35,-63,-62,-85,-128,-78,46,-486
-73,-27,-64,-74,-106,-136,-100,73,-507
-67,-19,-69,-59,-90,-138,-87,58,-471
-65,-51,-65,-61,-82,-135,-69,54,-474
-70,-12,-50,-56,-86,-132,-73,74,-405
-79,-49,-86,-69,-96,-126,-79,55,-529
-82,-13,-52,-68,-83,-127,-76,60,-441
-33,11,-43,-31,-78,-131,-53,61,-297
-57,-17,-50,-65,-77,-124,-70,57,-403
-78,-36,-78,-71,-93,-124,-89,53,-516
-62,-14,-61,-60,-86,-122,-71,72,-404
-83,-51,-66,-57,-96,-134,-90,72,-505
-59,-55,-60,-46,-105,-124,-68,38,-479
-55,-39,-58,-52,-96,-133,-52,60,-425
-65,-21,-67,-77,-82,-131,-69,49,-463
-68,-25,-63,-34,-99,-127,-71,61,-426
-101,-45,-84,-91,-103,-116,-80,59,-561
-67,-24,-54,-75,-77,-126,-65,65,-423
-79,-22,-61,-54,-100,-117,-76,36,-473
-61,-50,-90,-59,-117,-121,-81,48,-531
-71,-41,-77,-70,-86,-91,-58,56,-438
-78,-39,-60,-45,-80,-116,-59,56,-421
-49,-5,-57,-56,-72,-115,-60,67,-347
-57,-9,-60,-38,-101,-129,-87,69,-412
-71,-51,-81,-79,-108,-113,-69,31,-541
-55,9,-62,-62,-88,-127,-78,66,-397
-71,0,-61,-50,-92,-117,-72,70,-393
-64,-26,-75,-55,-117,-130,-72,52,-487
-50,-14,-66,-52,-71,-103,-44,58,-342
-53,-24,-76,-53,-72,-133,-55,55,-411
-40,-16,-82,-52,-98,-124,-77,41,-448
-48,-25,-62,-52,-64,-130,-59,48,-392
-33,6,-44,-25,-86,-131,-55,59,-309
-47,-26,-67,-55,-104,-120,-46,47,-418
-83,-24,-61,-61,-66,-128,-77,50,-450
-48,-3,-76,-58,-92,-139,-54,66,-404
-72,-25,-62,-45,-75,-116,-62,65,-392
-46,13,-33,-40,-104,-140,-63,57,-356
-28,39,-43,-36,-80,-128,-50,87,-239
-49,-42,-60,-48,-77,-131,-79,49,-437
-69,-28,-63,-44,-88,-116,-54,52,-410
-63,-29,-71,-54,-91,-125,-68,64,-437
-87,-36,-63,-88,-83,-100,-80,46,-491
-63,-15,-59,-68,-72,-104,-68,58,-391
-58,-39,-52,-58,-97,-134,-80,43,-475
-55,-8,-75,-43,-107,-138,-66,69,-423
-54,-13,-58,-72,-101,-136,-71,79,-426
-58,-3,-48,-54,-79,-119,-68,62,-367
-79,-25,-61,-70,-83,-112,-77,62,-445
-50,-40,-91,-54,-107,-114,-71,56,-471
-77,-47,-65,-65,-94,-105,-62,55,-460
-57,-37,-52,-57,-78,-141,-74,62,-434
-69,-46,-73,-73,-99,-139,-99,58,-540
-70,-51,-57,-65,-88,-112,-61,60,-444
-48,-22,-49,-59,-80,-148,-70,49,-427
-98,-49,-77,-82,-104,-115,-53,52,-526
-86,-55,-72,-76,-95,-126,-72,57,-525
-72,-22,-66,-47,-116,-108,-41,74,-398
-64,-30,-56,-62,-100,-138,-81,64,-467
-105,-56,-78,-78,-102,-109,-60,67,-521
-66,-26,-64,-60,-104,-126,-43,82,-407
-58,-19,-53,-67,-71,-133,-56,58,-399
-69,-25,-54,-46,-88,-142,-66,59,-431
-72,-17,-63,-47,-139,-125,-55,91,-427
-55,-18,-61,-42,-60,-136,-74,56,-390
-74,-15,-59,-85,-104,-129,-75,48,-493
-61,-17,-51,-47,-92,-117,-69,54,-400
-64,-36,-57,-69,-78,-96,-60,45,-415
-60,-8,-56,-32,-85,-130,-69,69,-371
-53,-26,-62,-53,-106,-135,-75,62,-448
-83,-28,-83,-80,-85,-123,-77,56,-503
-73,-20,-49,-69,-70,-118,-69,55,-413
-69,-20,-53,-57,-71,-129,-81,59,-421
-81,-16,-63,-79,-96,-98,-62,71,-424
-68,-34,-76,-70,-90,-120,-66,58,-466
-46,-9,-66,-46,-98,-102,-67,69,-365
-58,-23,-62,-54,-90,-97,-65,70,-379
-52,-19,-63,-44,-103,-102,-67,66,-384
-70,-26,-57,-73,-79,-118,-88,83,-428
-49,-27,-66,-63,-96,-126,-63,61,-429
-53,-17,-66,-96,-78,-125,-61,76,-420
-20,-4,-40,-20,-35,-65,-22,26,-180
-62,-16,-53,-57,-96,-116,-69,85,-384
-68,-23,-62,-42,-90,-122,-79,44,-442
-42,4,-40,-28,-90,-139,-75,86,-324
-45,-15,-46,-26,-87,-121,-64,63,-341
-67,-69,-65,-54,-68,-121,-70,65,-449
-73,-65,-66,-65,-82,-119,-66,68,-468
-68,-31,-83,-83,-99,-93,-62,76,-443
-68,-28,-61,-58,-100,-130,-80,76,-449
-70,-41,-71,-76,-81,-98,-49,65,-421
-55,-20,-54,-83,-102,-101,-58,78,-395
-60,-40,-75,-51,-76,-126,-54,39,-443
-30,-19,-22,-10,-26,-30,-23,9,-151
0,21,-9,0,-7,0,21,8,34
43,63,4,45,-50,-11,33,79,206
81,131,-41,-61,-91,-121,24,221,143
27,34,-77,-57,-137,-145,-33,100,-288
56,128,10,-17,-23,-85,31,132,232
41,84,2,-26,-18,-40,-3,140,180
69,148,10,7,-67,-69,18,177,293
-5,9,-17,9,-75,-13,-16,84,-24
99,315,-25,-152,-19,-150,127,330,525
0,-5,-49,1,-66,-98,-12,46,-183
33,65,-61,-48,-76,-115,-16,92,-126
28,80,-57,-36,-75,-142,-27,116,-113
55,33,-6,-12,-89,-149,-38,131,-75
58,116,-64,-25,-87,-148,-31,125,-56
21,89,-47,-38,-98,-38,7,85,-19
10,84,-94,-56,-93,-113,12,94,-156
4,-18,-25,-18,-35,-51,-8,41,-110
1,10,-13,-10,-36,-32,-11,27,-64
27,27,29,42,-11,-19,1,64,160
-27,5,-33,-4,-46,-45,-33,37,-146
-33,22,-43,-32,-86,-92,-32,99,-197
-84,-8,-87,-58,-151,-140,-81,105,-504
16,31,-101,-68,-145,-150,-48,75,-390
83,67,-6,-12,-30,-41,4,113,178
36,43,-3,-6,-16,-4,23,35,108
11,9,-140,-180,-235,-367,-116,270,-748
-48,-20,-51,-72,-58,-80,-39,86,-282
79,113,-136,-129,-193,-231,35,229,-233
3,35,-49,-38,-77,-38,-24,44,-144
103,130,-46,-42,-145,-73,14,224,165
-40,-25,-42,-37,-44,-47,-37,26,-246
28,28,18,6,5,-12,20,60,153
53,107,52,92,-8,-1,29,148,472
-1,3,-11,-1,-15,-28,-11,22,-42
30,22,-55,-20,-93,-64,4,61,-115
6,3,-9,-1,-5,-29,5,13,-17
62,91,29,-8,10,-2,26,81,289
-70,7,-93,-63,-173,-296,-146,160,-674
-8,86,-37,-60,-52,-104,-10,155,-30
78,101,-61,-29,-173,-140,0,224,0
149,273,34,-50,35,-42,95,281,775
6,47,-4,-25,-58,-65,-15,83,-31
41,172,-66,-48,-31,-36,88,232,352
35,55,0,-14,-21,-31,31,58,113
10,37,7,0,-1,2,4,32,91
115,176,-93,-65,-109,-108,39,227,182
26,84,-97,-81,-108,-125,1,153,-147
21,14,-13,3,-18,-42,-10,37,-8
79,300,-268,-121,-164,-275,41,269,-139
14,44,-15,-4,-34,-25,16,75,71
9,34,2,-24,-37,-39,1,74,20
-1,-10,-13,-20,-24,-43,-18,51,-78
207,378,-64,-139,-368,-233,14,536,331
34,105,-62,-42,-164,-218,-46,251,-142
2,20,-3,-9,-66,-73,-27,64,-92
36,38,-23,3,-77,-105,11,77,-40
30,107,-75,-25,-78,-59,61,174,135
53,31,-83,-14,-101,-168,6,107,-169
93,161,-107,-67,-134,-175,5,228,4
74,80,20,47,-88,-69,15,84,163
40,95,-44,-17,12,10,42,38,176
-10,78,-15,-44,29,33,63,133,267
7,45,2,-20,-20,-39,-9,56,22
3,-8,-51,-25,-89,-37,-7,34,-180
-1,41,-23,-32,-61,-34,-1,40,-71
-5,8,-81,-69,-138,-149,-34,95,-373
109,161,-84,-159,-218,-189,18,325,-37
42,64,4,-8,-12,-22,9,80,157
17,31,5,-6,-5,-21,8,20,49
5,13,-20,-24,-17,-1,1,24,-19
20,21,1,-5,-45,-76,-9,41,-52
-24,-41,-27,4,-61,-65,-9,54,-169
23,40,-21,-7,-18,-33,9,31,24
-114,33,-127,-66,-192,-232,-130,180,-648
9,12,-12,3,-23,1,13,12,15
89,130,23,-51,21,18,92,141,463
24,52,-5,13,-33,-11,12,49,101
-34,6,-61,-66,-113,-102,-56,75,-351
35,48,-36,7,-53,-34,53,44,64
68,32,-63,-74,-134,-146,-21,119,-219
-3,28,6,-11,-8,3,11,36,62
-26,60,-54,-33,37,-30,34,132,120
-37,-18,-42,-9,-62,-50,-39,25,-232
25,22,-32,4,-43,-41,8,70,13
33,56,-16,-7,-18,-27,23,70,114
42,62,-103,-94,-123,-236,-65,129,-388
18,46,0,-18,-3,4,31,41,119
-20,4,-29,-29,-47,-20,-15,44,-112
51,64,-64,-29,-145,-71,27,120,-47
40,83,1,21,-36,-58,-3,88,136
70,115,-27,-48,-22,-74,51,122,187
11,47,8,-6,0,-38,-33,43,32
-15,97,-62,-82,-132,-166,-63,182,-241
34,-2,-40,-6,-110,-157,-34,118,-197
47,71,-35,-25,-14,-34,24,60,94
7,13,-14,-10,-17,-34,-15,8,-62
-3,62,-52,-74,-107,-141,-21,134,-202
54,92,23,-22,27,-36,42,98,278
31,63,62,21,7,19,30,89,322
256,210,-61,-71,-67,-182,125,301,511
-23,144,-62,-22,5,12,86,140,280
18,17,-38,-25,-63,-68,-23,84,-98
20,12,-51,-24,-91,-124,-4,97,-165
53,53,16,21,-6,-44,33,59,185
33,96,-62,-71,-79,-84,31,160,24
21,54,-32,-45,-76,-112,-5,130,-65
11,24,10,-11,-7,-8,11,33,63
61,61,-12,60,-74,-36,46,114,220
-10,111,-26,-46,9,25,77,172,312
36,77,-46,0,-41,-18,22,45,75
11,65,-5,-44,-53,-150,-33,98,-111
7,9,-41,-30,-111,-67,-18,59,-192
9,31,8,-5,-37,-11,11,56,62
6,96,-25,-42,-25,-25,53,114,152
17,42,-11,-22,26,-48,23,71,98
115,97,-5,-78,39,-32,1,134,271
6,55,-39,-43,-47,-104,-5,81,-96
67,76,10,9,-13,-1,34,93,275
-3,40,-60,-27,-8,-28,11,55,-20
28,53,1,-15,-43,-59,-8,69,26
61,26,5,26,8,-43,13,61,157
80,100,10,-8,-92,-168,-5,158,75
156,236,-30,-78,-52,-210,19,263,304
13,24,4,5,-7,0,7,33,79
1,43,-33,-31,-44,-96,-15,79,-96
7,53,-14,-9,-79,-38,17,86,23
8,22,-19,-56,-32,-69,4,69,-73
37,81,-43,-30,-66,-65,2,80,-4
77,134,-16,-34,-131,-155,0,166,41
-30,22,-78,-22,-101,-131,-17,106,-251
37,79,7,-42,35,-84,-9,80,103
2,36,-60,-32,22,-6,31,129,122
213,201,-3,77,-195,-193,18,339,457
54,92,-56,-67,-32,-80,17,146,74
-6,7,-42,-12,-122,-53,8,101,-119
22,13,-53,-45,-113,-167,-47,151,-239
145,186,-72,-11,-166,-142,8,179,127
7,35,-19,-31,-19,-35,6,46,-10
44,93,-27,-89,-106,-115,-23,209,-14
62,109,33,20,-9,-13,36,141,379
-82,-28,-164,-60,-249,-210,-106,142,-757
46,126,-8,-34,-80,-114,21,207,164
3,5,-23,-61,-71,-101,-24,96,-176
76,164,-14,23,-14,-77,52,119,329
182,268,92,-7,88,-50,88,244,905
-40,-45,-28,-25,-32,-80,-44,13,-281
1,9,-16,-26,-34,-68,-15,42,-107
-50,-14,-77,-79,-95,-109,-33,75,-382
-3,15,-25,-17,-75,-53,-24,34,-148
1,35,-27,-4,-49,-47,-16,33,-74
19,34,-40,-12,-37,-23,19,58,18
-8,-6,-48,-36,-82,-67,-10,44,-213
49,84,-29,-18,-92,-76,-3,52,-33
8,16,-50,-33,-113,-77,-5,86,-168
-7,15,-41,13,-77,-55,-18,75,-95
27,57,-31,-35,-68,-73,26,126,29
-42,-17,-75,-65,-79,-68,-52,67,-331
23,76,-17,14,-32,-32,18,149,199
24,30,-24,-3,-102,-131,-14,89,-131
70,85,-19,-1,-27,-12,9,75,180
-33,-13,-23,-10,-29,-36,-21,25,-140
51,53,-8,16,-38,-36,17,82,137
29,71,-44,-11,-66,-73,23,55,-16
60,147,-21,-64,-64,-163,-3,196,88
34,45,21,3,-8,-33,-6,73,129
-24,-9,-68,-51,-94,-68,-19,58,-275
-21,-9,-18,-16,-24,-24,-23,13,-122
5,18,-13,-10,-10,-50,-13,36,-37
7,14,3,-14,-8,-14,2,22,12
-46,-8,-36,-36,-52,-91,-50,54,-265
13,22,-42,-22,-47,-70,-2,104,-44
18,21,-37,-58,-92,-106,-10,126,-138
169,322,-89,52,-155,-253,-19,179,206
6,131,-141,-131,-193,-215,-11,217,-337
110,223,-74,-53,-96,-182,-15,214,127
73,202,-83,-102,-78,-180,35,172,39
44,90,-8,-38,-59,-66,6,185,154
-28,91,-40,-48,25,13,46,114,173
47,80,-46,-36,-28,-49,19,76,63
-10,78,-65,-43,2,29,79,99,169
-11,7,-25,-40,-33,-69,-29,58,-142
169,165,-14,-21,-31,-69,131,205,535
28,85,-62,-78,-91,-168,-42,145,-183
-22,4,-36,-6,-72,-82,-27,84,-157
16,8,-7,-2,-23,-14,-5,34,7
133,172,-65,-15,-99,-161,-7,173,131
-39,74,-47,-56,-2,-50,-9,139,10
-10,20,-49,-30,-74,-81,-32,78,-178
51,108,-68,-64,-160,-72,-38,204,-39
39,36,-59,-39,-32,-26,14,31,-36
32,55,-21,-32,-40,-83,15,102,28
28,142,2,-20,15,-53,33,144,291
18,49,-35,-26,-68,-100,-2,94,-70
89,152,-79,30,-149,-34,66,181,256
39,111,-23,-44,-49,-134,-27,146,19
45,113,-96,-128,-120,-152,-15,216,-137
90,93,-32,-29,-114,-116,14,151,57
77,83,-14,-9,-51,-42,42,127,213
-9,36,-42,-35,-71,-32,19,68,-66
56,103,61,8,18,-17,17,147,393
63,69,-75,-44,-116,-159,7,118,-137
8,47,-21,-31,-89,-88,-2,93,-83
57,50,-25,-17,-43,-88,11,78,23
17,21,-15,-4,-28,-59,4,51,-13
-11,23,-35,-65,-112,-96,-36,76,-256
-64,-15,-68,-63,-109,-124,-42,61,-424
15,30,-36,-33,-20,-88,-2,36,-98
-2,25,-19,-20,-13,-17,11,33,-2
-63,14,-52,-39,-100,-149,-66,117,-338
-6,0,-18,-16,-13,-12,-3,10,-58
7,32,-9,-46,-18,-52,-12,34,-64
6,6,-46,-48,-35,-51,-13,58,-123
6,-12,-73,-41,-89,-105,-26,45,-295
-14,-10,-7,-39,-18,-23,1,25,-85
1,23,-25,-26,-28,-42,3,35,-59
38,166,-116,-65,-203,-302,-88,192,-378
15,45,-45,-60,-68,-67,28,99,-53
19,58,-20,-49,-116,-247,-57,184,-228
-4,41,12,-11,-1,-38,-8,45,36
18,10,-4,-8,17,-11,7,40,69
6,26,-42,-57,-44,-101,-51,64,-199
-44,-75,-117,-50,-183,-218,-63,139,-611
143,220,-41,-56,-195,-140,34,275,240
-17,36,-60,-64,-97,-198,-77,129,-348
-10,29,-39,-56,-61,-29,-12,58,-120
43,97,-120,-96,-219,-134,22,144,-263
-17,74,-33,-44,-101,-49,-5,155,-20
29,13,-7,-4,-42,-60,11,47,-13
-18,39,-32,-24,-70,-123,-53,105,-176
6,52,-73,-50,-106,-145,-23,128,-211
-84,-41,-117,-95,-170,-158,-77,79,-663
-33,-14,-65,-24,-86,-130,-49,77,-324
-87,-6,-111,-70,-145,-178,-78,101,-574
723,1215,-216,-311,-393,-374,418,1345,2407
7,128,-82,-146,-139,-288,-61,282,-299
95,207,-126,-107,-332,-400,-41,349,-355
5,57,24,-8,23,-24,-8,54,123
22,48,1,-43,-79,-100,-54,136,-69
-49,-34,-84,-87,-124,-123,-67,64,-504
7,35,-52,-39,-43,-74,-5,58,-113
52,91,-49,-14,-97,-163,21,136,-23
-17,-2,-12,-14,-12,-17,-12,2,-84
15,41,-8,-7,-2,-53,-7,52,31
38,108,-41,-89,-126,-269,-33,191,-221
54,38,5,-6,-9,-21,-7,80,134
0,6,-10,-6,-9,-11,-3,15,-18
6,10,-6,-16,-20,-52,-21,34,-65
-9,26,-27,-27,-32,-74,-28,40,-131
56,82,-16,-36,-65,-111,11,140,61
57,73,-63,-17,-101,-117,-5,52,-121
112,170,-70,4,-177,-233,-32,144,-82
57,149,8,-38,22,-74,34,204,362
13,146,-40,-17,-172,-122,-31,241,18
-66,51,-98,-40,-165,-172,-74,189,-375
8,5,-64,-34,-93,-113,-3,95,-199
16,88,-78,-27,17,-3,57,81,151
374,507,-184,-159,-238,-418,110,672,664
18,5,-47,-22,-146,-78,14,110,-146
136,242,-59,14,-212,-201,30,147,97
4,9,-12,2,-8,-36,-11,20,-32
29,49,-13,-15,-19,-36,20,31,46
-18,92,-55,-47,-245,-294,-99,251,-415
-3,15,-48,-47,-87,-58,-13,57,-184
-17,6,-31,-55,-64,-1,14,52,-96
112,174,-13,-16,-17,-51,72,151,412
130,142,-515,-428,-773,-1116,-255,657,-2158
163,236,-147,-195,-400,-193,71,555,90
19,8,-21,2,-24,-48,-1,4,-61
44,39,-47,-48,-87,-150,-10,86,-173
35,89,-41,-70,-94,-177,-17,103,-172
69,88,-2,16,-16,-24,47,112,290
62,41,-42,11,-74,-28,36,71,77
43,138,-99,-64,-94,-75,44,197,90
-76,-15,-91,-40,-157,-138,-75,112,-480
53,51,18,26,3,-26,28,70,223
94,224,76,-25,-26,-71,68,258,598
105,165,-109,-64,-115,-96,82,211,179
77,144,90,56,45,16,6,172,606
-50,-35,-71,-89,-116,-160,-110,86,-545
2,18,-14,-6,-12,-23,-11,39,-7
11,50,-37,-78,-62,-45,-11,142,-30
31,143,42,-49,-20,-129,-19,188,187
-19,28,-44,-41,-88,-88,-15,74,-193
36,157,-149,-94,-224,-272,-76,237,-385
19,49,-22,-11,-37,-32,-2,21,-15
226,335,-138,-108,-104,-292,108,403,430
40,110,-86,-42,-127,-159,9,227,-28
13,-6,-105,-7,-120,-201,-45,137,-334
198,385,-236,-237,-555,-686,-105,800,-436
-3,71,-88,-33,-134,-172,-44,112,-291
20,40,-11,-13,-56,-49,10,47,-12
-6,30,7,0,-16,-6,-18,35,26
322,473,-85,-127,-259,-321,43,471,517
-38,72,-68,-57,-113,-161,-50,109,-306
-6,41,-37,-28,-88,-128,-39,115,-170
78,142,-41,32,-67,-100,17,210,271
27,37,-53,-34,-14,-39,30,83,37
-60,-33,-51,-51,-59,-101,-55,52,-358
13,21,-19,-28,-14,-19,9,37,0
6,8,-27,-17,-47,-56,-13,64,-82
-9,54,-33,-18,-67,-65,-21,62,-97
2,-39,-30,-24,-56,-71,-14,51,-181
145,217,-97,-71,-80,-41,93,134,300
97,77,-51,4,-98,-70,63,115,137
35,62,-21,-7,-13,-28,22,47,97
-52,-29,-60,-89,-64,-140,-58,75,-417
-21,51,-22,-21,-79,-122,-35,142,-107
-46,32,-38,-30,-78,-123,-52,86,-249
60,58,-26,-8,-39,-188,-51,113,-81
-43,-9,-41,-38,-55,-82,-51,56,-263
2,40,-37,5,-85,-150,-48,71,-202
-23,-12,-100,-46,-119,-156,-33,88,-401
-10,16,-74,-43,-70,-118,-16,97,-218
-50,-4,-39,-39,-105,-136,-73,78,-368
-49,4,-79,-24,-101,-122,-59,59,-371
5,68,-77,-89,-98,-256,-75,172,-350
6,8,-99,-41,-121,-172,-10,99,-330
84,180,-39,-20,-80,-54,20,219,310
301,362,-465,-623,-1119,-817,-63,1177,-1247
-3,20,-12,-4,-21,-74,1,37,-56
25,57,-62,-41,-54,-118,-8,86,-115
24,7,-32,-30,-35,-70,2,37,-97
160,422,-128,-121,-449,-585,-62,805,42
115,296,-169,-110,-254,-416,-49,299,-288
-7,42,-59,-39,-85,-116,-10,57,-217
126,197,-27,7,-116,-182,25,261,291
153,228,-57,-47,-175,-258,67,396,307
120,175,-44,-17,-174,-259,15,230,46
31,69,12,-29,1,-82,-20,70,52
30,85,40,36,-57,-68,4,150,220
39,76,-25,-3,-49,-65,15,92,80
-81,-15,-116,-119,-199,-249,-112,187,-704
180,137,-86,8,-150,-156,62,217,212
-60,-18,-145,-87,-195,-189,-77,149,-622
71,193,-26,-64,-91,-100,20,259,262
83,250,21,-8,-74,-44,46,335,609
64,163,-11,-30,-78,-101,-4,241,244
69,206,-2,-51,-100,-79,44,292,379
57,187,7,-9,-92,-21,65,343,537
84,163,7,-30,12,-109,19,163,309
141,172,-6,-52,-97,-122,68,166,270
-1,16,-17,-20,-28,-35,-8,23,-70
182,242,-561,-444,-982,-1235,-310,741,-2367
83,124,-81,-64,-130,-138,34,209,37
76,151,-8,-12,-100,-115,44,204,240
39,149,-124,-41,-279,-420,-57,286,-447
76,110,-23,-61,-34,-124,17,154,115
31,109,-24,-60,-144,-234,-18,144,-196
-8,72,-34,-46,-19,-116,-19,108,-62
21,56,-50,-42,-71,-94,24,97,-59
-12,65,-94,-142,-118,-277,-61,145,-494
17,47,-23,-13,-25,-9,18,47,59
62,77,-5,-38,-75,-69,26,118,96
18,25,-27,-26,-112,-34,28,131,3
2,20,1,15,-36,-93,-32,61,-62
70,205,6,-59,-52,-45,63,278,466
10,46,-66,-84,-89,-91,-6,93,-187
-1,18,-36,-24,-10,-34,-1,41,-47
-77,-12,-93,-38,-137,-126,-100,131,-452
82,189,-39,-43,-83,-121,19,183,187
40,74,13,8,13,-29,22,53,194
5,33,7,-12,-5,-38,-8,36,18
154,209,-2,-82,-23,-220,38,265,339
152,201,-31,-4,-155,-111,95,277,424
318,429,-74,65,-229,-268,81,495,817
27,80,-66,-74,-163,-257,-95,184,-364
35,171,-231,-181,-510,-354,40,586,-444
279,506,-136,-161,-403,-407,70,773,521
106,142,-56,-57,-147,-156,27,210,69
26,224,-169,-101,-262,-317,-21,335,-285
-56,69,-128,-23,-192,-401,-111,257,-585
81,223,77,19,-140,-6,18,336,608
115,372,-53,-40,-191,-280,59,428,410
274,379,-47,48,-126,-157,123,245,739
4,39,-77,-72,-121,-177,-11,180,-235
198,314,-113,-163,-246,-264,29,458,213
59,65,-23,-12,-45,-76,13,119,100
19,44,12,-6,-4,-20,9,56,110
88,158,-86,-82,-124,-221,-6,236,-37
260,346,1,-78,-132,-143,126,370,750
16,47,-33,-34,-47,-62,13,66,-34
181,311,26,-68,-36,-100,82,274,670
13,141,-150,-36,-237,-420,-84,191,-582
34,98,-16,-25,-34,-88,17,111,97
53,120,-61,-80,-148,-153,20,208,-41
-27,-24,-48,-8,-56,-128,-48,66,-273
248,348,2,-16,14,38,159,274,1067
85,90,-99,-123,-207,-302,-40,186,-410
4,0,-11,1,-18,-21,3,16,-26
-1,7,-16,-15,-18,-17,-1,21,-40
-1,133,-108,-11,-251,-419,-122,272,-507
-29,97,-181,-59,10,56,85,142,121
221,214,-153,66,-399,-238,88,139,-62
33,118,-38,-17,-120,-92,-10,148,22
103,173,-82,-60,-132,-179,45,177,45
1,57,-75,-41,-1,-20,28,100,49
28,187,-41,-44,-22,-44,46,196,306
150,221,-56,-92,-139,-193,8,332,231
17,66,-27,-39,-108,-123,-5,151,-68
94,128,3,33,-46,-46,42,153,361
-33,188,-17,-46,37,63,73,197,462
34,81,-118,-144,-207,-245,-43,197,-445
54,117,-24,-34,13,-23,57,174,334
80,160,22,-30,-10,-119,60,219,382
118,186,-24,47,-188,-157,74,238,294
-43,-18,-182,-141,-287,-328,-149,239,-909
31,71,27,-14,1,-36,11,114,205
29,30,-52,-23,-73,-49,17,66,-55
-6,31,-51,-27,-87,-35,12,54,-109
24,57,35,-16,-59,-180,-87,202,-24
82,127,-48,-15,-47,-56,78,230,351
-70,33,-89,-34,-112,-121,-47,114,-326
450,654,98,5,-15,-167,175,681,1881
180,200,99,-52,92,-45,45,203,722
92,213,-7,-83,-41,-91,13,247,343
48,64,-13,-22,-32,-43,44,85,131
23,51,12,3,21,9,19,35,173
-6,16,11,-3,-3,-12,-6,13,10
54,66,-24,-13,9,-24,43,31,142
33,50,-86,-33,-56,-124,24,86,-106
2,11,-20,-11,-47,-37,-15,54,-63
-2,1,-65,-42,-122,-203,-61,119,-375
0,157,-67,-63,11,-53,43,228,256
39,111,41,0,-17,-34,14,136,290
5,17,-5,-38,-47,-84,9,63,-80
27,32,8,-9,-50,-22,3,85,74
5,16,-1,-11,-6,-22,-3,51,29
7,127,-140,-76,-109,-190,-17,169,-229
27,91,-7,-45,-73,-62,1,80,12
32,117,46,47,-68,-77,-5,132,224
-12,14,-53,-55,-78,-138,-6,139,-189
48,75,5,1,-8,-17,29,80,213
90,181,-121,-38,-216,-276,-41,221,-200
-15,23,-50,-68,-74,-82,-20,39,-247
-16,24,-45,-55,-64,-78,-22,91,-165
27,55,-27,-65,-4,-120,10,88,-36
6,15,-46,-26,-29,-54,-13,56,-91
-2,17,-21,-30,-26,-46,4,50,-54
21,22,-37,-20,-36,-70,-16,49,-87
33,35,-35,-50,-26,-86,-9,85,-53
18,33,-75,-25,-113,-88,-12,99,-163
-100,-67,-113,-87,-174,-257,-132,123,-807
136,91,13,-36,-29,-69,17,153,276
8,31,12,2,-25,-39,14,32,35
-2,29,-8,-1,-20,-21,-11,37,3
13,38,5,-17,-17,-4,17,72,107
125,104,24,0,-25,-93,52,182,369
-6,10,-64,-54,-154,-169,-33,186,-284
-8,28,-24,-22,-65,-105,-22,91,-127
20,23,5,-21,-6,-26,6,58,59
4,66,-92,-51,-157,-225,-42,143,-354
87,83,1,54,-45,-30,54,97,301
27,86,-68,-19,-43,-37,38,78,62
35,86,-38,-68,-16,-45,15,92,61
105,203,4,-40,-7,-158,69,256,432
60,66,-41,-48,-77,-135,-11,104,-82
20,91,31,-23,-28,-123,-9,111,70
30,76,3,19,-11,-23,13,94,201
82,124,-37,-32,-27,-49,31,101,193
1,23,-31,-20,-60,-30,-2,40,-79
23,54,-30,-4,-24,-23,21,15,32
-58,-2,-70,-28,-126,-139,-67,87,-403
-4,35,-30,-60,-68,19,7,75,-26
234,254,74,-4,18,-98,64,256,798
23,26,-64,-50,-89,-83,28,66,-143
-47,32,-38,-15,-117,-206,-73,105,-359
-1,23,-1,-21,-9,-23,-6,24,-14
34,28,-104,-67,-209,-259,-79,160,-496
1,30,-12,20,-38,25,5,46,77
128,267,15,-14,-29,-184,44,307,534
-6,2,-19,-18,-40,-40,19,41,-61
14,43,6,-7,-26,-29,0,59,60
25,38,-44,-97,-148,-147,-55,310,-118
-3,6,-30,-31,-45,-47,-13,30,-133
61,113,-99,-68,-299,-294,-56,287,-355
174,75,-60,-9,-159,-173,-14,173,7
-48,48,-119,-41,-201,-132,-38,157,-374
26,31,-9,-19,-14,-46,8,40,17
47,73,-23,-60,7,-64,19,63,62
132,177,-61,-48,-57,-80,70,177,310
19,37,-24,1,-25,-23,21,39,45
-14,13,-32,-61,-71,-88,-47,85,-215
99,143,0,-3,-72,-201,-16,217,167
-14,26,-40,-8,-78,-89,-22,58,-167
89,126,15,43,10,-34,69,159,477
0,35,-13,7,-48,15,16,84,96
-3,28,0,-23,-30,-18,-8,80,26
6,-3,-7,-7,-16,-11,-4,7,-35
-87,2,-90,-56,-121,-153,-70,101,-474
1,1,-19,-13,-23,-36,-24,35,-78
59,104,-47,-13,-87,-120,1,97,-6
4,42,-14,-26,-33,-83,-18,42,-86
622,793,7,-94,-207,-483,158,967,1763
1,29,-11,14,-59,-51,1,47,-29
15,63,-63,-59,-51,-122,-8,103,-122
40,63,9,-16,2,11,46,75,230
-2,22,-18,-9,-14,-16,-8,18,-27
-9,24,-45,-16,-70,-70,-36,89,-133
37,73,-2,-22,-63,-106,-11,143,49
-25,-8,-31,-7,-40,-67,-48,29,-197
0,26,-24,-39,-29,-55,-4,45,-80
90,193,36,-33,48,-4,64,179,573
137,112,8,-29,20,-29,60,164,443
15,69,-7,13,-47,-71,-5,66,33
25,42,-35,-27,-30,-16,54,137,150
81,70,-23,-18,-30,-92,14,128,130
55,130,-22,-21,-52,-87,52,143,198
43,61,-15,21,-37,-57,-1,65,80
-9,15,-54,-35,-97,-116,-53,84,-265
9,52,-4,-17,-38,-54,-4,53,-3
-45,13,-97,-68,-107,-151,-29,132,-352
-2,25,-37,-35,-35,-46,-14,34,-110
30,23,-72,-42,-77,-129,-12,73,-206
47,66,-14,-10,-34,-26,39,57,125
25,54,-27,-20,-76,-165,-14,101,-122
124,190,-63,-63,-137,-228,62,248,133
225,244,-4,-18,-3,-69,101,185,661
-7,17,-18,-31,-50,-79,-27,24,-171
21,35,-9,-31,0,-28,15,58,61
28,29,-29,-21,-63,-29,4,54,-27
3,-27,-37,-11,-57,-73,-13,16,-199
21,47,-28,-21,-57,-54,-7,105,6
-36,9,-19,1,-34,-38,-15,38,-94
7,45,-32,-36,-46,-79,-15,71,-85
12,13,-8,-12,-32,-22,12,33,-4
-5,33,-20,-33,-25,-69,-33,31,-121
21,36,-21,6,-31,-27,15,34,33
-5,1,-5,-13,1,1,8,19,7
25,21,-12,1,-4,4,37,29,101
14,22,-6,-13,-23,-18,4,29,9
21,42,-10,-6,-25,-17,22,51,78
26,75,-12,-33,2,18,50,53,179
25,25,-11,1,-11,-20,12,11,32
19,27,-15,-11,-42,-69,-15,45,-61
3,41,-14,-45,-44,-61,-3,86,-37
81,104,-96,-134,-214,-312,-73,285,-359
61,17,-84,-63,-147,-183,-21,111,-309
14,27,-24,-1,-47,-49,17,86,23
12,75,-11,-33,-41,-94,-23,101,-14
19,30,-19,-10,-44,-68,-26,28,-90
-68,10,-69,-44,-113,-200,-111,103,-492
26,26,-23,-33,-63,-60,-3,80,-50
18,107,24,-28,-63,-88,8,185,163
139,290,-124,-108,-83,-131,97,222,302
139,104,-29,2,-75,-140,29,209,239
52,144,-14,-50,-96,-103,-28,137,42
-26,30,-67,-56,-96,-101,7,106,-203
34,50,-23,-21,-91,-74,1,142,18
1,6,-1,-14,3,-16,-9,15,-15
-2,-52,-65,-69,-146,-140,-43,108,-409
24,19,-37,-43,-32,-93,-28,51,-139
-15,12,-34,-32,-34,-90,-33,84,-142
-29,10,-54,-62,-94,-42,-32,105,-198
91,41,-11,-30,-141,-149,-23,154,-68
-11,9,0,-13,-18,-34,2,32,-33
47,52,-17,22,-23,4,40,57,182
14,61,-14,-15,4,-42,7,51,66
20,47,-21,-7,-8,-19,19,32,63
5,73,-19,-26,-44,-7,35,62,79
59,51,-62,-37,-102,-155,-11,20,-237
9,31,3,-30,-31,-88,-4,98,-12
29,28,-19,-3,-8,-21,20,34,60
34,17,-1,-13,-6,-36,6,36,37
-7,19,4,-8,-12,-66,-36,39,-67
8,0,-28,-21,-30,-29,-8,17,-91
-13,40,18,11,-26,20,1,49,100
207,258,-7,-63,-45,-134,88,332,636
-67,-27,-62,-8,-87,-87,-60,59,-339
13,24,-45,-31,-158,-147,0,131,-213
20,29,-15,-8,-43,-43,4,35,-21
6,8,-16,2,-22,-55,-20,61,-36
14,8,15,27,-37,-12,-15,60,60
44,63,7,0,-12,-28,-7,74,141
32,50,-17,3,-32,-40,4,14,14
1,51,-40,-43,-45,-59,1,63,-71
22,55,-7,8,-32,-140,-36,121,-9
10,24,-49,-7,-67,-77,12,63,-91
-4,0,-30,-32,-23,-35,-19,21,-122
51,53,-7,-11,-4,-26,19,84,159
33,53,-21,-72,-59,-105,-1,115,-57
9,0,-5,-9,-8,-34,-4,3,-48
22,6,-35,-37,-34,-59,-6,9,-134
-12,10,-14,-24,-11,-15,-5,30,-41
12,58,-7,16,-42,-53,10,78,72
10,70,-64,-43,-88,-136,-28,79,-200
31,55,-73,2,-89,-60,24,76,-34
300,437,-68,-122,-176,-186,113,423,721
-79,-34,-155,-74,-224,-216,-113,117,-778
120,188,-89,-47,-83,-73,58,173,247
79,170,-47,-53,-109,-125,69,159,143
134,350,-158,-19,-132,-271,88,366,358
26,50,9,2,12,3,25,36,163
325,335,97,36,56,14,160,413,1436
15,0,-40,-7,-47,-43,15,27,-80
167,389,2,-88,-102,-283,11,423,519
101,123,-44,-8,-42,-70,30,122,212
9,44,-23,-29,-71,-60,-13,41,-102
175,336,-124,-164,-219,-230,129,488,391
47,73,-16,-55,-82,-162,-53,158,-90
-5,337,57,-4,-409,-125,-204,543,190
44,92,63,18,-35,-62,15,121,256
13,24,-5,1,-18,-19,7,34,37
-54,-38,-96,-57,-128,-229,-68,102,-568
52,105,-49,-31,-63,-156,-37,108,-71
16,1,15,38,-27,-15,-10,71,89
5,13,-71,-51,-96,-78,3,75,-200
79,119,-27,-1,-80,-59,28,140,199
34,104,-19,-53,-11,-47,29,95,132
113,176,29,-46,-33,-117,29,190,341
-14,7,-32,-15,-94,-118,-47,62,-251
-100,9,-137,-73,-204,-222,-98,131,-694
57,87,-55,5,-126,-83,27,125,37
16,47,-7,-6,-35,-14,16,49,66
0,27,-13,-20,-5,-6,11,19,13
1,28,-24,-58,-55,-90,-61,95,-164
3,11,-16,10,-28,-17,1,29,-7
40,57,-5,-32,3,-43,2,42,64
-124,43,-252,-218,-271,-423,-153,323,-1075
-145,28,-300,-204,-423,-453,-182,355,-1324
-30,64,18,-38,-74,-23,-29,135,23
1,0,-16,-19,-36,-39,-17,45,-81
0,66,12,-4,-31,-5,31,80,149
23,105,-66,-41,-70,-211,-50,101,-209
288,316,-17,-73,-100,-197,125,446,788
24,113,-91,-50,-127,-319,-82,138,-394
0,9,-2,-14,-14,-24,-13,24,-34
34,137,-68,-5,-139,-158,-36,109,-126
-17,24,-42,-51,-29,-146,-78,99,-240
105,236,-52,-29,-17,34,117,136,530
-4,-1,-30,-26,-48,-67,-26,41,-161
21,73,-90,-40,-55,-68,28,154,23
8,12,-10,0,-7,-24,-1,9,-13
11,4,-5,-5,-4,-22,0,5,-16
-100,-19,-90,-86,-107,-226,-151,173,-606
77,79,-74,-30,-62,-120,-23,59,-94
4,17,-15,-15,-31,-28,-6,31,-43
347,401,8,9,-49,-132,157,483,1224
248,330,77,-6,-38,-169,58,402,902
85,227,-15,-14,-88,-190,-6,241,240
163,157,14,-102,-54,-167,39,272,322
70,108,11,-22,12,25,57,114,375
74,97,20,20,-22,-18,55,110,336
5,29,-1,-4,-27,-29,2,37,12
9,8,17,-1,5,-7,1,47,79
24,26,-76,-53,-121,-133,-24,100,-257
48,112,-12,-8,-52,-48,13,72,125
2,49,-31,-40,-42,-87,-14,63,-100
197,346,-77,-88,-223,-302,30,463,346
12,14,-15,-8,-11,-28,-8,21,-23
-198,280,-826,-807,-1722,-1310,-404,1752,-3235
675,1285,-790,-305,-1285,-1914,-469,1368,-1435
105,178,17,66,-88,-10,59,212,539
-4,-2,-51,-21,-104,-112,-41,56,-279
45,76,2,-55,-16,-87,13,116,94
-8,42,-23,-35,-57,-65,-13,55,-104
142,212,-35,-87,-99,-161,15,251,238
23,74,-20,-28,-89,-142,-14,90,-106
42,58,-58,-52,-134,-128,9,126,-137
2638,4679,-1365,-1264,-2294,-1574,159,5289,6268
2,3,-14,-22,-18,-37,-10,42,-54
116,156,1,-3,-71,-85,52,192,358
-21,-3,-30,-70,-43,-93,-51,51,-260
13,3,-57,-42,-137,-181,-29,82,-348
12,19,-41,-10,-96,-95,-14,56,-169
16,36,-23,-23,-80,-115,-40,64,-165
24,55,11,21,-29,-7,26,91,192
8,4,-33,-30,-95,-90,-25,90,-171
98,121,-116,-101,-247,-275,-38,340,-218
45,43,-12,5,-15,-12,12,41,107
-42,-2,-25,-28,-54,-68,-36,41,-214
-2,23,13,61,-98,-35,-28,139,73
108,233,85,-45,-43,-54,46,339,669
66,93,14,-37,19,-54,36,136,273
36,32,-80,-6,-113,-109,15,45,-180
99,168,-76,-30,-167,-190,-43,113,-126
144,131,-530,-474,-734,-1111,-256,571,-2259
48,34,-27,-19,-61,-44,20,13,-36
332,413,141,-81,212,-127,131,425,1446
-106,9,-128,-19,-201,-227,-104,131,-645
60,142,-91,-78,-228,-199,6,301,-87
-17,28,-20,-2,-53,-90,-36,74,-116
166,305,-131,-49,-11,-41,122,245,606
51,56,-11,25,-29,-56,12,64,112
7,55,20,-50,30,-61,-40,40,1
74,113,-28,-43,-97,-148,56,226,153
6,40,-28,-37,-122,-104,-34,91,-188
97,140,-29,-27,-40,-47,62,172,328
-19,16,-28,0,-35,-57,-21,31,-113
63,166,-122,-42,-138,-151,13,89,-122
61,111,-50,-32,-90,-93,6,174,87
29,94,-34,-74,-91,-167,-33,107,-169
407,630,-56,-49,-111,-162,173,739,1571
36,47,-10,-18,-14,-27,13,37,64
29,70,-28,-40,-57,-45,25,71,25
13,15,-92,-80,-132,-117,2,106,-285
59,130,-3,-35,-185,-197,-83,377,63
9,54,-15,-6,-14,-32,9,35,40
155,261,-33,-28,-89,-198,42,311,421
8,27,-29,-27,-32,-105,-34,54,-138
39,134,-26,-37,-83,-79,41,191,180
63,173,-56,-68,-73,-190,-12,202,39
226,447,-141,-199,-395,-408,82,681,293
40,44,-7,23,-16,-20,27,53,144
6,30,-8,-8,-33,-35,-12,42,-18
111,177,-19,-52,-49,-63,73,216,394
178,318,63,84,-67,-53,70,433,1026
50,184,-18,-70,-123,-210,-9,266,70
29,45,9,7,-8,9,21,85,197
-12,39,-27,-43,-77,-95,-22,43,-194
4,54,-34,-19,-71,-83,-21,52,-118
11,8,-21,-3,-22,-42,-5,40,-34
8,12,-9,-9,-6,-31,-7,28,-14
2213,4051,-5073,-4986,-6086,-2383,2400,7561,-2303
33,59,8,2,12,-44,15,67,152
-1,46,11,0,-7,-14,1,43,79
-5,18,-65,-62,-140,-137,-41,124,-308
167,258,-204,-121,-274,-320,-43,416,-121
10,23,-6,-22,-30,-55,-9,43,-46
56,22,-56,11,-95,-94,27,81,-48
48,72,-11,-26,-50,-59,0,85,59
311,352,-63,0,-276,-299,81,459,565
183,282,46,-9,-77,-194,23,346,600
17,25,-12,-14,-40,-59,-16,80,-19
18,46,-2,-9,-10,-51,23,59,74
-66,-21,-73,-39,-82,-140,-77,78,-420
-57,-17,-79,-77,-125,-117,-82,77,-477
-81,-17,-84,-64,-114,-97,-71,64,-464
27,42,-24,12,-34,-50,-16,26,-17
32,58,-56,-84,-86,-128,-10,145,-129
44,57,-129,-123,-204,-236,-40,228,-403
-63,-5,-36,-32,-72,-139,-86,79,-354
-2,3,0,-3,4,-12,-4,16,2
111,103,-53,58,-179,-175,27,132,24
12,35,0,-21,-20,-2,22,46,72
41,76,-58,-103,-101,-144,13,157,-119
47,62,-66,-96,-111,-140,2,167,-135
12,27,-31,-19,-47,-84,3,81,-58
-5,24,-25,-35,-82,-91,-34,96,-152
8,16,-32,-52,-44,-78,-27,83,-126
34,43,7,-28,-55,-62,-5,98,32
-8,-7,-32,-12,-30,-16,-20,20,-105
93,113,22,-1,-15,-74,12,154,304
-43,-7,-23,12,-81,-79,-40,61,-200
41,-6,-23,-42,-84,-124,-42,100,-180
38,-10,-17,-27,-73,-102,-10,78,-123
30,41,13,-6,-78,2,-27,133,108
22,60,-67,-47,-121,-92,6,158,-81
174,221,-41,2,-108,-199,57,306,412
22,77,-79,-116,-155,-139,-2,138,-254
-33,91,39,55,-61,-75,-44,176,148
5,18,-27,-18,-103,-44,3,86,-80
-105,157,-312,-287,-518,-850,-245,460,-1700
-5,46,-29,-49,-47,-82,-11,94,-83
4,-13,-46,-12,-61,-40,-7,40,-135
-82,-8,-39,-87,-41,-191,-113,121,-440
59,66,-45,25,-39,5,60,50,181
23,19,-72,-56,-115,-214,-33,147,-301
-2,8,-102,-62,-198,-121,-26,78,-425
14,18,-30,-20,-56,-74,-23,43,-128
98,148,-18,-21,-50,-104,27,169,249
39,54,27,-33,2,-51,-8,70,100
-46,-15,-65,-26,-78,-100,-58,57,-331
-82,-29,-113,-83,-139,-163,-63,118,-554
7,70,-6,-6,-60,-45,-14,95,41
129,248,-151,-173,-298,-509,-94,406,-442
117,168,-84,-55,-93,-143,38,242,190
252,266,6,10,-60,-142,67,376,775
159,212,-73,-3,-75,-52,106,204,478
32,45,-45,-43,-155,-197,-26,183,-206
78,233,-74,-59,-147,-265,-8,263,21
-79,-44,-106,-97,-110,-180,-80,107,-589
244,383,-128,-107,-221,-251,77,686,683
10,78,-16,-61,-39,-63,17,114,40
164,218,-155,-109,-235,-264,54,407,80
55,129,7,-30,-18,-59,24,111,219
47,57,-49,-8,-89,-130,-17,78,-111
35,65,-93,-85,-135,-195,-68,118,-358
123,163,31,-108,18,-110,34,180,331
115,152,-41,-73,-108,-100,29,204,178
18,20,-19,-30,-32,-93,-38,65,-109
36,78,-85,-126,-147,-175,-17,189,-247
41,70,-30,3,-52,-38,10,78,82
41,23,-25,-21,-16,-82,-37,45,-72
34,41,-62,-62,-63,-169,-54,148,-187
54,3,0,6,-37,-31,18,67,80
67,28,-48,-58,-78,-107,-24,61,-159
110,151,-37,-32,-32,-152,8,188,204
2,5,-26,-22,-49,-51,-22,50,-113
155,282,-17,-65,-102,-263,-42,303,251
100,101,-61,-19,-115,-58,48,107,103
380,617,-102,-126,-103,-153,237,617,1367
-46,-11,-93,-52,-157,-224,-98,154,-527
4,10,-10,1,-17,-21,-5,20,-18
311,333,73,101,-6,-122,86,429,1205
29,56,-17,-5,-90,-59,25,107,46
121,81,-132,-51,-146,-162,31,158,-100
29,92,-54,-39,-94,-103,10,89,-70
-9,8,-37,-38,-75,-112,-24,39,-248
-28,-25,-59,-52,-75,-103,-40,43,-339
80,110,-248,-206,-297,-435,-101,301,-796
107,155,-36,-23,-101,-155,-12,243,178
206,358,-49,-56,22,-120,115,465,941
17,48,33,-13,-58,-135,-49,146,-11
82,165,-69,-57,-70,-117,33,217,184
295,495,-203,-12,-372,-427,33,415,224
165,157,-11,-41,-41,-125,81,210,395
70,303,-394,-167,-728,-873,-192,450,-1531
300,356,59,-193,183,-188,82,326,925
223,284,9,23,-52,-28,157,366,982
137,246,-108,-6,-229,-222,33,267,118
124,203,-137,-162,-183,-168,80,216,-27
19,213,-171,-197,-435,-649,-179,407,-992
131,194,-47,-10,-136,-189,41,288,272
18,30,-7,9,-28,-28,19,36,49
-9,-7,-109,-29,-175,-205,-83,99,-518
160,272,-9,-5,-143,-208,21,303,391
63,84,-36,-125,-227,-271,-16,329,-199
182,332,-33,5,-168,-163,68,432,655
1,51,-34,-22,-64,-44,-18,57,-73
36,78,-30,-15,-73,-79,8,171,96
-38,-39,-58,-72,-105,-114,-59,93,-392
33,82,-57,-90,-126,-198,-36,242,-150
-16,30,-21,-21,-41,-47,-5,73,-48
9,28,-39,-45,-57,-106,-22,90,-142
-11,53,-64,-42,-6,-40,11,90,-9
51,77,-61,-38,-37,-78,37,92,43
131,213,-77,-51,-161,-156,75,250,224
-18,62,-42,-25,-16,-69,3,98,-7
147,158,-112,-231,-341,-381,-131,495,-396
17,42,-79,-28,-132,-210,-63,200,-253
127,187,-30,2,-80,-106,24,223,347
-84,-5,-71,-35,-88,-177,-78,76,-462
13,12,6,8,-12,3,11,22,63
47,93,19,0,20,-56,-2,65,186
40,105,-26,-19,-71,-75,23,166,143
36,96,-9,-22,-80,-224,-72,103,-172
27,144,-40,-83,-94,-146,-26,163,-55
57,50,-66,-110,-297,-278,14,308,-322
-3,49,-21,-15,-31,-52,-7,44,-36
39,104,-14,-15,-89,-86,-12,137,64
138,141,27,26,20,-65,41,161,489
126,116,23,15,-9,-16,36,145,436
123,420,-479,-376,-835,-1226,-223,914,-1682
6,23,-11,-19,-41,-43,-6,26,-65
156,154,-25,-35,-9,-117,44,219,387
30,67,-64,-58,-132,-23,30,135,-15
22,14,-23,3,-67,-57,3,96,-9
16,23,-11,3,-33,-37,6,35,2
94,228,-181,-79,-259,-60,68,265,76
89,170,-72,-108,-317,-125,12,325,-26
18,42,-67,-32,-121,-94,-41,95,-200
92,86,0,-2,-50,-117,3,121,133
-10,35,-36,-25,-91,-140,-42,100,-209
46,107,2,18,-134,-107,-23,86,-5
12,43,-34,-28,-53,-64,9,75,-40
288,423,-145,-32,-101,-216,200,492,909
24,25,-21,-20,-69,-57,5,74,-39
28,170,-107,-21,-210,-192,35,218,-79
28,84,-61,-72,-43,-86,10,108,-32
128,128,-13,-32,-45,-73,31,212,336
-5,29,-9,-10,-70,-103,-10,57,-121
6,68,-18,-15,-19,-51,8,37,16
117,98,-36,-4,-72,-141,22,131,115
43,70,17,-20,-15,-47,-1,88,135
59,95,3,-20,1,-56,9,85,176
150,128,-46,-35,-78,-137,54,208,244
64,12,-51,7,-62,-151,-10,44,-147
569,637,143,50,-37,-153,261,886,2356
361,688,-6,-41,-73,-162,239,699,1705
84,89,22,-44,-139,-71,15,200,156
75,180,-156,-98,-283,-349,-1,263,-369
75,85,-72,-70,-56,-90,34,184,90
81,70,9,-60,-7,-42,15,161,227
81,171,249,232,-32,206,-12,220,1115
118,188,-124,4,-158,-203,44,134,3
-1,12,-67,-45,-78,-104,-19,75,-227
284,509,-268,-61,-481,-433,108,275,-67
-74,-24,-92,-59,-125,-133,-92,99,-500
-9,-8,-46,-13,-51,-78,-19,63,-161
108,139,-112,-148,-215,-191,32,367,-20
50,322,6,-45,-123,-35,-88,305,392
75,40,11,22,-21,-6,21,83,225
24,44,-31,-48,-67,-95,7,115,-51
49,104,-59,-71,-65,-111,25,201,73
38,103,-100,-46,-130,-119,43,197,-14
2,119,36,-66,-100,-38,-50,151,54
163,319,-67,-41,-148,-78,142,342,632
122,221,-37,-45,-148,-69,65,297,406
123,249,-53,-138,-32,-161,33,325,346
67,104,13,3,-16,-48,40,94,257
37,81,26,14,-28,-26,23,122,249
-5,-32,-97,-6,-194,-209,-43,64,-522
66,91,-9,-6,-105,-92,19,153,117
7,-8,-36,14,-54,-57,-1,28,-107
78,97,-12,-48,-19,-85,0,91,102
21,47,-93,-104,-153,-228,-87,112,-485
-46,-10,-78,-61,-82,-126,-72,84,-391
35,67,-42,-20,-99,-113,-3,130,-45
47,66,-87,-75,-109,-150,-6,219,-95
108,103,20,14,-29,-58,31,122,311
193,241,-92,-185,-197,-178,13,488,283
151,120,-27,-55,-90,-145,-1,220,173
-1,27,-3,-31,-29,-46,-4,54,-33
50,5,-31,-28,-78,-92,1,66,-107
4,31,-7,-16,-47,-31,-26,57,-35
98,278,-169,-115,-266,-254,-71,193,-306
63,43,-53,56,-138,-136,10,124,-31
34,-1,-26,-6,-45,-53,-7,46,-58
67,53,-15,-18,-35,-61,14,51,56
-51,72,-226,-181,-399,-444,-186,395,-1020
125,241,-43,-48,-61,-187,2,214,243
8,114,-117,-92,-172,-218,-25,182,-320
28,17,-10,-27,-18,-45,24,65,34
31,177,-89,-95,-187,-241,-20,182,-242
111,137,-13,-21,-207,-145,7,280,149
9,55,-54,-62,-41,8,41,104,60
11,100,-59,-33,-97,-196,-47,154,-167
-65,-16,-63,-58,-75,-137,-59,80,-393
61,21,1,-32,-16,9,14,87,145
31,16,-54,0,-69,-76,-15,56,-111
134,154,62,115,-37,-22,33,229,668
-49,50,-97,-16,-180,-209,-105,129,-477
27,64,-25,-7,-27,-18,13,85,112
12,49,-18,-13,-12,-24,19,63,76
27,48,-19,-22,-24,-25,15,62,62
75,105,1,-30,-49,-57,43,94,182
50,149,-35,-87,-61,-187,11,225,65
228,179,-41,-37,-62,-184,112,255,450
80,91,1,-11,-28,-81,41,112,205
7,20,-34,-8,-56,-39,-2,26,-86
0,0,-40,-25,-55,-39,-15,27,-147
181,242,-10,-8,-92,-238,29,254,358
38,53,26,12,11,8,26,79,253
53,94,-8,-29,-49,-160,13,166,80
87,96,157,86,-86,97,59,210,706
17,34,-13,2,-105,-90,-14,76,-93
74,53,1,4,-8,-76,22,110,180
15,61,-30,-73,-110,-125,-39,129,-172
75,154,-93,-89,-101,-195,0,212,-37
570,476,-289,-239,323,78,102,407,1428
-9,40,-25,-26,-55,-14,3,72,-14
-47,28,-79,-27,-166,-166,-64,163,-358
13,21,-36,-39,-56,-33,9,22,-99
3,19,-31,-52,-39,-81,-45,41,-185
51,23,-13,13,-81,-64,-9,117,37
16,21,-125,-112,-173,-295,-118,134,-652
132,251,-80,-112,-128,-208,26,208,89
21,40,-29,-28,-33,-43,15,66,9
1,10,-25,1,-44,-53,-16,39,-87
54,94,27,-22,-14,-80,8,120,187
61,75,6,7,6,-40,25,77,217
-13,42,-31,-52,-65,-59,-10,102,-86
-8,75,-51,-34,-82,-171,-82,136,-217
39,83,-31,-68,-31,-89,3,119,25
33,138,-59,-23,-145,-129,6,158,-21
62,78,-56,-76,-114,-180,23,191,-72
124,169,75,-12,-17,-62,33,257,567
197,144,-131,-219,-404,-668,-183,520,-744
92,97,-74,-154,-71,-233,-43,203,-183
37,102,5,-35,19,-79,-10,92,131
21,138,-80,-68,-205,-165,3,256,-100
53,54,-121,-43,-166,-232,-69,120,-404
27,77,-23,-30,-33,-62,-5,56,7
28,41,-30,12,-30,-23,23,27,48
-63,-11,-87,-123,-132,-221,-81,174,-544
119,121,77,-23,28,27,7,168,524
41,26,-11,0,-5,-53,27,42,67
25,-12,-94,-107,-133,-201,-11,127,-406
-12,-9,-37,-27,-51,-87,-40,59,-204
226,261,-70,-19,-169,-125,105,338,547
268,484,-125,-126,-189,-420,30,644,566
122,163,-15,-5,-56,-86,64,231,418
17,14,-25,-1,-36,-19,9,34,-7
7,20,-26,-5,-29,-10,20,24,1
-3,23,-4,2,-29,11,-1,-4,-5
15,52,-150,-119,-306,-216,-27,189,-562
22,42,-45,-37,-79,-63,1,100,-59
10,29,-44,-2,-103,-75,16,57,-112
2,2,-13,-20,-7,-39,-21,35,-61
-2,-3,-30,-32,-32,-31,-12,22,-120
12,28,-16,-24,-84,-43,-4,59,-72
18,39,-6,16,-78,-44,4,67,16
30,20,-17,-26,-32,-67,1,106,15
5,67,-123,-160,-178,-235,-73,211,-486
5,20,-39,-40,-56,-69,-20,64,-135
-4,30,-9,-38,-40,-41,3,61,-38
-2,8,-19,-6,-35,-43,-4,31,-70
-4,21,3,-15,1,-10,2,22,20
-6,-25,-19,6,-52,-58,-2,51,-105
20,17,-4,20,-3,-31,3,42,64
50,88,3,-1,25,16,64,38,283
32,15,-22,-6,-40,-40,11,28,-22
34,17,-10,16,-41,-31,20,48,53
16,52,-6,-19,-20,-33,6,61,57
106,141,6,-50,44,-37,84,147,441
28,4,-52,-10,-102,-139,-17,92,-196
-24,103,-129,-94,-193,-271,-82,203,-487
49,81,9,-6,-42,-33,18,98,174
89,79,-17,-3,-37,-49,63,93,218
65,77,-4,11,-33,-48,38,84,190
-10,10,-6,-11,-24,-11,-7,38,-21
61,149,-23,-17,-8,-39,54,151,328
32,134,-22,-75,-103,-71,49,192,136
80,177,-38,-62,-35,-169,-14,204,143
-20,-1,-11,-17,-36,-39,-20,32,-112
17,7,-24,18,-41,-14,20,45,28
10,30,-1,-4,-16,-22,-8,36,25
17,20,-19,-28,-52,-56,1,67,-50
-66,0,-119,-63,-149,-183,-86,125,-541
37,179,-12,-28,-21,-33,59,145,326
39,54,-11,-17,-40,-51,8,44,26
11,21,2,-12,-37,-34,-4,69,16
59,79,-17,-30,-46,-57,-13,93,68
18,33,-41,-55,-95,-147,-49,42,-294
-35,8,-44,-18,-55,-82,-37,54,-209
-15,-14,-27,-18,-36,-78,-39,32,-195
10,4,3,-33,-28,-16,6,27,-27
8,12,-13,-23,-56,-86,-10,84,-84
26,103,-15,-47,-32,-83,-23,150,79
-15,14,0,-4,-27,-52,-50,50,-84
9,24,-17,-35,-12,-44,-11,23,-63
16,35,-67,-84,-65,-190,-63,113,-305
-70,-32,-75,-65,-137,-101,-60,73,-467
15,88,-28,15,-175,-69,33,145,24
8,37,-14,-40,-44,-87,-48,62,-126
43,38,-72,-65,-73,-89,30,79,-109
8,22,-9,-11,0,14,20,25,69
-7,57,-29,-26,-42,-48,0,70,-25
10,37,-19,3,-33,-55,-11,43,-25
4,-1,-41,-23,-59,-39,-10,8,-161
23,26,-63,-49,-67,-161,-39,49,-281
92,200,-27,-23,-111,-155,32,266,274
47,95,-57,-62,-81,-115,43,162,32
-8,41,-32,-48,-75,-85,-19,98,-128
-69,-38,-85,-44,-90,-120,-52,69,-429
31,91,13,3,0,-40,33,85,216
86,51,-54,-22,-74,-96,36,85,12
-34,-4,-24,-26,-32,-69,-48,17,-220
49,81,-46,-1,-133,-224,-10,143,-141
14,48,-104,-90,-197,-218,-45,126,-466
70,87,-7,0,-28,-110,1,70,83
32,50,1,-14,-22,-26,-3,46,64
-3,17,-29,-36,-55,-66,-19,60,-131
44,13,22,20,-25,-19,-2,67,120
37,29,-41,-73,-127,-159,-35,104,-265
-2,38,-16,-35,-50,-61,-1,76,-51
-46,-40,-65,-68,-106,-108,-61,63,-431
29,11,-99,-26,-166,-205,-32,112,-376
64,58,-56,-36,-119,-124,-23,42,-194
-18,63,-66,-48,-81,-72,-7,65,-164
218,347,-55,-36,-43,-170,46,342,649
-18,-20,-19,-1,-14,-25,-15,10,-102
-42,-15,-3,-59,-55,-99,-67,84,-256
59,52,16,19,7,-1,30,81,263
-15,40,-38,-33,7,-9,39,92,83
36,67,14,-19,3,-16,7,102,194
11,57,-21,-9,-3,-34,21,39,61
-49,-24,-36,-55,-80,-72,-63,63,-316
-6,69,-14,-48,-20,-33,10,104,62
-15,-13,-33,-51,-60,-49,-18,52,-187
32,4,-76,-84,-138,-147,6,161,-242
-20,27,-44,-87,-68,-111,-42,151,-194
44,101,-28,-20,-115,-133,-26,112,-65
32,107,-77,-9,-113,-227,-49,142,-194
11,35,-24,-60,-55,-70,1,62,-100
22,106,39,-9,-8,-30,4,132,256
21,63,10,-4,-3,-16,9,38,118
34,32,-11,4,-14,-47,6,37,41
22,41,-30,-10,-68,-45,-1,41,-50
-10,21,-26,-11,-32,-10,18,25,-25
20,43,-32,-46,-90,-108,3,71,-139
36,27,-36,-39,-88,-128,-4,73,-159
152,188,-33,23,-97,-100,50,90,273
14,33,-6,-9,-7,-11,17,44,75
16,11,-72,-50,-114,-114,-14,102,-235
-28,22,-43,-39,-74,-56,-28,76,-170
14,29,-13,-2,-20,-17,5,39,35
26,51,3,-21,-38,-36,6,102,93
-44,0,-61,-8,-95,-142,-59,75,-334
16,7,-22,-19,-34,-27,8,19,-52
85,67,-63,-45,-55,-79,5,89,4
15,23,-16,-50,-21,-12,15,31,-15
26,51,9,-5,-3,-20,21,72,151
26,54,-14,-10,-35,-62,5,61,25
14,-18,-28,26,-112,-69,-4,53,-138
28,76,-20,-28,-48,-61,14,94,55
57,65,-39,5,-56,-71,29,68,58
-37,-16,-69,-55,-60,-111,-34,72,-310
18,40,1,-29,-11,-31,18,83,89
-17,-1,-37,-24,-38,-39,-19,20,-155
2,16,-32,-31,-48,-29,-1,35,-88
38,101,6,-4,12,-23,20,66,216
13,54,-7,-23,-17,-65,4,71,30
63,93,-142,-50,-223,-294,-103,159,-497
-27,15,-59,-9,-114,-90,-9,88,-205
-5,1,-32,-34,-22,-31,-13,23,-113
91,71,-9,11,-7,-39,39,83,240
80,125,87,22,16,-6,25,145,494
45,126,119,60,23,42,24,164,603
14,22,-4,1,-1,-37,2,25,22
39,71,-34,-24,-103,-106,5,136,-16
-89,1,-90,-40,-129,-223,-134,104,-600
114,188,-95,-48,-179,-164,-11,70,-125
0,43,-22,-18,-43,-60,-10,44,-66
5,42,-19,-30,-39,-78,4,65,-50
28,32,-82,-33,-115,-157,-18,104,-241
112,252,11,-3,-76,-158,31,236,405
26,56,-35,-39,-81,-154,-18,125,-120
95,94,73,50,-63,70,49,162,530
66,75,-109,-71,-218,-310,-61,249,-379
-30,15,-11,-40,-67,-75,-45,109,-144
48,96,-39,12,-47,-80,-15,50,25
21,42,-2,-6,-27,15,-2,71,112
2,12,-27,-27,-46,-43,-13,28,-114
52,81,-29,-38,-62,-109,-6,66,-45
16,43,-27,-34,-52,-41,0,31,-64
13,-27,-30,-59,-22,-90,-27,46,-196
-53,0,-58,-58,-84,-122,-50,74,-351
34,51,-54,-13,-76,-175,-13,94,-152
63,146,-4,-14,-8,-83,16,160,276
13,89,-31,-42,-66,-100,-15,129,-23
43,117,7,-13,-39,-41,13,153,240
91,128,9,15,-20,-27,60,151,407
-16,45,-5,16,-75,-51,-28,80,-34
132,245,-9,-16,-25,-92,84,154,473
-4,39,-27,-6,-25,-62,-18,41,-62
41,73,-35,-10,-73,-89,-7,68,-32
55,65,20,-8,-11,-51,10,84,164
55,50,-19,-11,-8,2,26,40,135
16,8,6,-15,-46,-47,20,56,-2
170,265,-25,-32,-83,-108,105,282,574
12,15,12,8,-4,-30,-5,39,47
-6,40,-65,-47,-107,-165,-40,98,-292
4,13,-39,-21,-70,-50,-7,24,-146
54,99,-47,-53,-210,-144,47,206,-48
71,132,-71,-48,-93,-85,43,139,88
8,74,10,-60,-71,-74,-41,147,-7
336,408,-175,63,-486,-620,-32,623,117
11,14,-20,-17,-42,-52,-11,55,-62
13,31,-20,-27,-30,-38,-1,38,-34
85,108,-36,-13,-34,-35,61,122,258
10,33,6,-19,-3,-22,9,43,57
192,223,62,76,-43,7,111,212,840
-44,-19,-46,-46,-38,-107,-50,47,-303
115,126,-16,18,-101,-42,43,142,285
15,31,-38,-37,-57,-58,-4,43,-105
16,61,-19,-32,-18,-69,-20,69,-12
87,75,2,-13,4,-55,19,63,182
-16,-7,-36,-17,-38,-44,-21,27,-152
10,27,-8,2,-31,-23,-2,31,6
11,-6,-14,-3,-16,-27,-6,19,-42
19,78,8,-5,35,-7,28,62,218
32,52,-28,-41,-57,-72,2,105,-7
62,116,-30,13,-68,-101,45,124,161
-22,7,-15,-27,-21,-52,-12,33,-109
53,33,-32,-17,-52,-97,-15,88,-39
-27,23,-30,-12,-38,-56,-26,38,-128
87,223,-40,-58,-18,-40,48,218,420
92,137,-21,-18,-6,-144,8,131,179
-38,31,-62,6,-158,-194,-90,167,-338
94,174,-105,-62,-54,-72,58,198,231
16,21,-9,-28,-19,-61,-14,40,-54
12,48,-19,-37,-27,-42,-8,65,-8
36,66,13,-10,-15,-26,15,113,192
75,95,-40,-39,-118,-97,37,169,82
47,123,-30,-41,-4,-29,57,110,233
-11,-18,-20,-29,-26,-29,-30,39,-124
-40,59,-79,-24,-105,-163,-33,98,-287
-57,-28,-57,-31,-103,-94,-52,46,-376
-1,40,-32,-20,-20,-62,3,68,-24
34,107,-54,-63,-130,-235,-37,112,-266
86,84,-21,3,-11,-12,40,74,243
-13,-2,-41,16,-68,-18,4,25,-97
28,36,-26,-12,-83,-96,8,57,-88
0,8,-23,-15,-32,-30,-7,37,-62
57,35,-16,-12,-23,-84,2,89,48
83,176,3,-33,-45,-84,48,197,345
16,9,-36,-23,-72,-92,7,40,-151
18,23,-9,-5,-17,-21,16,9,14
28,29,-77,-99,-111,-62,27,116,-149
-7,9,-44,-12,-27,-34,-4,42,-77
2,35,-49,-69,-50,-124,-30,90,-195
35,29,-18,-11,-69,-78,-18,32,-98
38,9,-33,-71,-37,-129,-10,69,-164
32,13,-21,27,-25,-59,5,19,-9
-6,84,-42,-46,-34,-3,32,123,108
62,99,-35,-32,-34,-49,30,133,174
15,11,-24,-20,-34,-47,10,28,-61
58,74,-18,6,-19,-22,38,101,218
110,188,-12,-17,-63,-99,53,188,348
53,98,-34,-74,-83,-90,32,165,67
96,143,18,-15,-9,-68,17,136,318
48,138,9,-3,36,-9,85,154,458
4,47,-23,-31,-68,-39,1,72,-37
-18,16,-23,-51,-87,-77,-30,62,-208
-5,43,-52,-39,-78,-94,-28,104,-149
10,2,-21,-17,-9,-54,-8,41,-56
22,37,-42,-17,-54,-98,-16,51,-117
179,147,-250,-211,-387,-529,-53,488,-616
140,331,-101,-184,-215,-472,-13,579,65
22,51,44,51,-40,-40,-40,74,122
69,58,-23,-14,-82,-121,5,124,16
51,77,-23,-4,-10,-35,43,30,129
16,14,-49,-52,-57,-136,-30,67,-227
14,125,32,29,11,-14,13,158,368
16,36,-16,1,-29,-20,5,17,10
40,95,-22,-26,-85,-169,-46,94,-119
42,62,-63,-58,-161,-165,-25,127,-241
12,43,-39,-18,-123,-103,-26,109,-145
94,173,-87,-13,-161,-267,-30,201,-90
37,50,-21,21,-43,-43,19,36,56
12,21,-24,-31,-50,-42,-7,95,-26
52,155,-44,-31,-60,-52,40,182,242
15,65,-18,-41,24,-21,54,90,168
48,113,-63,-32,-138,-125,13,137,-47
-4,29,-66,-2,-118,-76,8,76,-153
-34,151,-152,-142,-264,-399,-126,309,-657
24,99,-9,-24,29,-14,58,95,258
68,74,-44,7,-65,-21,59,76,154
13,18,-30,-13,-11,-68,-16,26,-81
21,34,-13,-37,-55,-98,-11,65,-94
24,31,4,14,-22,-11,3,28,71
83,93,12,18,-42,-74,24,117,231
28,57,5,-9,-15,-43,38,59,120
8,30,-11,-13,8,-21,8,41,50
118,197,-39,19,-55,-21,52,152,423
35,27,-21,-20,-53,-96,-6,96,-38
14,109,-50,-101,-90,-146,0,174,-90
33,30,-56,-18,-120,-155,-11,72,-225
6,19,-35,-24,-46,-59,2,26,-111
-49,4,-44,-20,-80,-57,-58,45,-259
55,45,-24,8,-37,-48,23,75,97
15,35,-1,-17,7,-26,3,54,70
-5,51,25,-1,-19,1,2,73,127
-15,35,-36,-19,-88,-135,-46,72,-232
69,73,2,-20,-27,-9,15,92,195
53,121,-44,-14,-71,-44,88,186,275
27,54,-39,-21,-74,-61,5,106,-3
17,25,-7,-10,-34,-60,1,32,-36
-12,49,-73,-37,-152,-110,-11,110,-236
93,169,-89,-24,-185,-224,6,137,-117
127,147,-50,58,-188,-193,-5,115,11
-14,27,-44,-22,-83,-64,6,67,-127
109,227,-84,51,-154,-179,-16,117,71
30,43,-31,11,-18,-14,35,49,105
63,149,-18,-58,-67,-146,-26,200,97
-37,-20,-15,-32,-55,-107,-53,57,-262
-14,-1,-49,-15,-102,-66,-18,58,-207
40,48,-20,-1,-55,-82,2,46,-22
15,67,-33,-59,-26,-90,-6,82,-50
15,128,31,-47,63,-14,67,151,394
44,11,-11,6,-46,-38,-18,20,-32
97,104,-31,-2,-175,-113,-5,256,131
61,54,-50,5,-44,-35,47,17,55
25,52,-6,-10,-77,-80,-7,132,29
75,153,-51,4,-86,-122,15,97,85
22,26,-70,-60,-105,-58,30,93,-122
44,67,-78,-63,-192,-246,-65,160,-373
69,80,-20,-18,-65,-45,25,95,121
30,50,32,-15,-30,-80,-21,89,55
19,82,-7,-13,-36,-38,-3,81,85
-13,61,-23,-17,17,18,33,70,146
34,77,10,1,-52,-117,-24,113,42
-8,29,-17,-41,-32,-48,-7,52,-72
7,16,11,-4,-4,-32,-11,41,24
127,134,-73,-6,-138,-124,92,233,245
78,39,-7,-17,-35,-84,-7,33,0
23,9,-24,-33,-36,-46,10,45,-52
34,42,-27,-34,-53,-87,-7,105,-27
4,60,-58,-58,-65,-26,-30,111,-62
11,22,-60,-86,-112,-102,3,84,-240
32,48,-43,1,-117,-135,-10,67,-157
-2,29,1,-24,-7,-56,-18,44,-33
37,57,0,-23,-30,-63,13,72,63
223,197,15,-13,-25,-100,62,290,649
-7,23,-47,-37,-43,-84,-27,60,-162
24,28,-6,11,-32,-28,18,43,58
-11,21,-22,-7,-36,-23,5,51,-22
-5,1,-32,-32,-51,-26,4,33,-108
4,2,-18,5,-33,-11,8,27,-16
-15,16,-23,-42,-80,-71,-16,63,-168
5,9,-39,17,-64,-80,-12,54,-110
32,38,-12,-41,1,-31,-18,31,0
-4,83,-57,1,-142,-190,-52,125,-236
28,54,-41,-12,-87,-66,6,69,-49
12,-13,-49,-42,-43,-77,-29,49,-192
-5,55,-1,-21,-48,-113,-34,58,-109
-5,30,17,-25,-4,-28,-23,44,6
2,28,-3,-5,-39,-64,-6,32,-55
18,35,-6,5,-26,-16,10,34,54
1,18,-19,-15,-28,-35,-7,24,-61
114,111,-18,2,-60,-63,51,118,255
1,-3,-41,-30,-47,-29,6,33,-110
40,22,2,29,-38,-20,25,88,148
19,40,1,-7,-72,-42,15,90,44
-10,-40,-88,-99,-118,-151,-67,80,-493
56,67,-43,-74,-37,-125,11,126,-19
-1,45,-67,-88,-103,-154,-38,157,-249
-1,-3,-40,-19,-71,-88,-14,68,-168
48,293,105,-10,9,36,7,290,778
78,103,-132,-128,-239,-271,-18,185,-422
256,412,242,9,163,-79,34,497,1534
6,60,-26,-34,-68,-52,16,85,-13
0,1,-18,-27,-25,-39,-18,22,-104
6,49,-25,-28,-74,-85,-49,69,-137
135,236,-28,-69,-85,-127,37,258,357
19,-7,-32,-11,-28,-35,-3,12,-85
3,16,-18,3,-30,-49,-23,38,-60
-9,27,-13,-40,-28,-76,-5,104,-40
62,12,-657,-488,-961,-1379,-414,592,-3233
14,26,-72,-70,-72,-94,-23,60,-231
131,186,51,50,-68,-74,3,304,583
3,44,-31,-46,-74,-82,-14,113,-87
116,162,24,-9,30,-49,45,166,485
25,-4,-37,-23,-73,-66,12,64,-102
34,32,-16,-59,-8,-102,14,45,-60
-30,27,-41,-29,-67,-70,-21,61,-170
18,59,-38,-24,-92,-133,-17,124,-103
10,36,4,-1,-57,-73,-12,53,-40
71,90,-32,9,-58,-68,53,86,151
-12,43,-26,-7,-41,-42,-13,61,-37
41,89,-80,-10,-108,-107,3,47,-125
34,197,-68,-88,-99,-179,-5,232,24
-32,56,-41,-56,-46,-29,-6,107,-47
70,87,-19,-23,-49,-67,31,141,171
-30,9,-11,-3,-55,-90,-52,56,-176
-6,-22,-34,-18,-33,-59,-35,53,-154
49,94,34,-2,-10,-18,40,123,310
30,4,-48,-29,-70,-61,21,62,-91
24,33,0,-7,-30,-8,29,37,78
1,4,-4,-8,-22,-22,-3,28,-26
26,-5,-41,-22,-50,-39,-2,37,-96
12,33,-19,-21,-51,-97,-10,57,-96
37,68,-23,-17,-32,-131,-16,119,5
8,20,-13,-24,-26,-31,19,36,-11
130,160,109,31,12,22,4,131,599
26,52,-23,-26,-34,-47,11,56,15
1,15,-54,-66,-91,-144,-31,128,-242
20,17,-8,-17,-20,-62,-18,48,-40
12,38,-4,-5,-32,-57,-22,51,-19
88,175,-35,4,-119,-158,14,87,56
11,51,-37,-7,-86,-85,-17,111,-59
115,132,-34,-48,-79,-143,57,201,201
-16,-2,-48,-57,-65,-81,-26,48,-247
87,203,-73,2,-153,-193,-2,80,-49
25,33,-22,-14,-81,-51,12,99,1
8,18,-16,-13,-40,-37,-27,33,-74
2,57,-63,-57,-141,-145,-29,133,-243
5,36,11,-27,-53,-44,14,63,5
26,38,-33,1,-66,-90,-7,66,-65
33,38,-1,26,-91,-97,-9,108,7
59,145,39,-14,60,46,83,133,551
2,38,-30,-38,-54,-51,14,39,-80
7,11,-5,-12,4,5,10,17,37
10,18,-37,-27,-52,-56,8,37,-99
60,77,-8,9,14,10,58,33,253
79,151,-55,-42,-56,-86,43,149,183
59,64,-68,-7,-70,-63,53,100,68
4,21,-92,-47,-122,-198,-22,81,-375
-16,13,-22,-33,-16,-36,-21,30,-101
20,135,-32,-99,-72,-119,44,174,51
50,52,-17,2,-78,-87,8,79,9
57,97,31,-6,0,-45,29,98,261
-5,0,-21,-27,-39,-44,-3,32,-107
9,22,-3,-7,-28,-23,13,29,12
3,37,-47,-38,-84,-82,0,58,-153
59,93,-41,-39,-175,-157,16,226,-18
31,30,-28,-10,-58,-46,18,16,-47
84,214,-16,-30,-95,-237,-1,207,126
96,172,0,-39,-41,-63,40,168,333
70,96,89,11,27,11,34,141,479
-27,28,-45,-26,-87,-168,-54,99,-280
33,36,-48,10,-83,-87,-6,65,-80
2,32,-31,-47,-32,-59,4,34,-97
16,58,-61,-51,-116,-148,-35,88,-249
18,70,-35,-18,-92,-99,-26,72,-110
-24,67,-52,15,-94,-193,-97,84,-294
25,11,-36,-29,-60,-68,-11,38,-130
11,27,-22,-27,-34,-54,-7,78,-28
62,75,-31,-5,-22,-27,56,55,163
-1,8,-49,-33,-41,-76,-12,69,-135
333,455,198,-55,184,2,191,515,1823
50,99,-26,-3,-65,-97,-3,79,34
41,4,-32,-56,-55,-99,17,109,-71
0,-1,-22,-15,-8,-12,2,9,-47
-43,38,-37,4,-76,-92,-45,109,-142
54,84,-39,18,-106,-101,45,143,98
23,54,-11,0,-79,4,29,134,154
31,45,-26,-19,-18,-30,9,40,32
25,64,-27,-12,-42,-42,11,83,60
40,37,-93,-52,-151,-199,-47,103,-362
10,36,-39,-7,-48,-37,-2,55,-32
47,44,-14,-16,-60,-100,16,52,-31
-16,60,0,-15,-62,-45,-10,78,-10
85,115,-37,-32,-72,-96,1,107,71
144,103,-71,-6,-86,-52,8,147,187
-7,15,-109,-135,-220,-346,-89,205,-686
-14,-9,-25,-17,-57,-30,-15,9,-158
-4,29,-40,-30,-101,-59,-27,54,-178
62,65,-44,-1,-44,-74,12,62,38
-29,-1,-35,-43,-59,-53,-35,54,-201
38,88,-17,-30,-50,-112,8,79,4
119,154,98,144,-74,-26,39,255,709
35,174,-41,-75,-42,-220,10,237,78
57,67,-9,-28,-33,-68,19,79,84
19,66,-187,-173,-212,-382,-120,337,-652
18,105,12,1,1,-8,9,115,253
1,29,-9,-30,-21,7,13,43,33
50,113,-11,-44,-67,-70,22,148,141
26,44,-13,-12,-58,-9,16,94,88
4,48,-13,2,-47,-47,7,60,14
-5,86,-34,-42,-83,-140,-20,97,-141
20,38,-55,-45,-54,-59,-26,87,-94
28,184,-58,-51,-175,-139,65,229,83
-20,31,-32,-75,-90,-195,-49,169,-261
19,48,-30,-10,-53,-17,4,53,14
38,83,1,-17,-26,-16,39,45,147
29,86,-18,-13,5,-13,48,80,204
19,72,-37,-25,-69,-90,10,82,-38
18,19,-22,-6,-28,-25,9,19,-16
55,98,-1,-29,-9,-42,50,109,231
24,39,-56,-48,-61,-131,-14,86,-161
7,-9,-22,-8,-23,-15,-4,5,-69
20,35,-14,-42,-93,-60,-5,97,-62
-90,4,-78,-16,-172,-168,-113,143,-490
2,33,-31,-113,-56,-102,-3,86,-184
-24,-16,-31,-32,-63,-134,-57,68,-289
37,13,-66,-41,-73,-120,-31,104,-177
63,181,28,-34,-57,-111,15,180,265
11,13,-15,-7,-37,-32,-2,39,-30
5,8,-13,-5,-24,-27,-11,20,-47
13,25,4,6,-16,-3,14,22,65
146,223,-9,-55,-86,-226,33,322,348
43,114,15,13,-82,-105,9,189,196
38,43,0,0,-19,-37,11,45,81
41,94,-1,-2,-21,-77,-1,76,109
40,56,-38,-14,-83,-76,16,84,-15
-28,-7,-43,-9,-49,-78,-60,54,-220
55,54,-56,-46,-86,-164,-15,134,-124
25,31,-37,-23,-41,-64,4,66,-39
7,1,-10,-22,-7,-10,-2,14,-29
-12,29,-5,-21,-78,-34,4,68,-49
-46,-26,-40,-7,-62,-63,-57,19,-282
34,55,-24,-36,-21,-51,35,68,60
-31,-6,-44,-10,-82,-71,-42,32,-254
32,59,-19,-5,-31,-32,19,42,65
138,213,-97,-44,-166,-235,-5,193,-3
64,30,-98,-19,-84,-141,-29,118,-159
11,25,-49,-29,-88,-104,-10,46,-198
18,28,-20,-47,-36,-56,8,54,-51
-32,-44,-84,-45,-92,-138,-52,55,-432
48,62,-9,19,-17,-36,30,70,167
27,71,21,-11,-9,-11,10,80,178
33,71,-51,-21,-48,-60,25,71,20
15,17,-25,-26,-30,-49,-5,48,-55
64,121,39,8,-46,-72,38,159,311
25,87,-42,-19,-107,-118,18,66,-90
8,31,-7,-21,-18,-12,8,38,27
115,91,9,39,-112,-24,47,163,328
-2,38,-41,-23,-86,-115,-25,54,-200
-18,30,-14,7,-73,-147,-58,91,-182
-3,-3,-53,-5,-109,-138,-21,79,-253
3,56,-24,-18,-61,-100,-17,124,-37
100,114,-34,-38,-27,-102,23,119,155
-11,21,-41,1,-108,-81,4,80,-135
-7,26,-29,0,-43,-42,-18,55,-58
74,138,-40,-47,-52,-91,89,183,254
-45,-22,-81,-38,-108,-107,-40,85,-356
28,25,-30,-5,-71,-83,-8,58,-86
96,122,-16,-68,-16,-107,-10,173,174
12,49,-29,-36,-38,-81,11,74,-38
93,220,-103,-71,-60,-113,45,189,200
-27,103,-74,-35,29,10,49,131,186
10,39,-14,-12,-7,-26,15,31,36
2,13,-7,-6,-20,-10,3,35,10
-1,32,24,24,0,-8,-6,62,127
25,5,-37,-19,-29,-70,-15,33,-107
33,49,17,23,-37,-42,4,47,94
-27,48,-38,-41,-97,-89,-19,132,-131
22,34,-28,-38,-52,-25,18,84,15
0,16,-1,-13,-22,-15,-8,44,1
-9,4,-45,-53,-68,-81,-19,77,-194
65,63,-21,-37,-61,-70,23,102,64
63,59,-33,-10,-77,-86,13,112,41
50,84,-32,-50,-38,-50,28,100,92
127,269,59,27,33,55,81,244,895
32,44,-39,0,-103,-137,-39,98,-144
57,143,-136,-62,-156,-110,98,135,-31
15,7,-68,-26,-191,-135,-25,108,-315
-32,40,-7,-21,-12,-107,-35,76,-98
60,117,45,5,-31,-9,17,131,335
-4,28,-4,-17,-61,-52,-2,85,-27
21,38,-9,-5,4,2,20,25,96
28,45,0,-6,-20,7,35,37,126
36,55,0,4,-3,-25,19,56,142
77,180,-1,-7,-127,-113,38,238,285
14,27,-12,-55,-79,-138,-41,114,-170
24,33,-55,-53,-177,-148,-31,176,-231
4,15,2,-8,-2,-15,3,25,24
141,145,-51,-48,-105,-172,15,236,161
10,22,7,-12,-1,-16,5,13,28
-4,26,-30,-17,-44,-14,15,34,-34
58,78,-15,-19,-7,-4,40,103,234
69,77,17,-23,17,-27,40,70,240
-63,22,-87,-58,-133,-160,-61,123,-417
19,50,-44,-22,-37,-45,15,58,-6
25,64,-33,-46,-46,-75,-17,84,-44
3,31,-33,-2,-56,-64,-16,37,-100
4,25,-48,-20,-57,-70,-18,70,-114
26,42,-33,-4,-19,-51,7,37,5
-8,73,-87,-56,-10,-3,26,51,-14
11,63,-87,-103,-209,-250,-29,191,-413
-13,40,-50,26,-85,-142,-48,84,-188
-16,-3,-54,-39,-100,-49,-20,65,-216
16,49,-20,1,-42,-61,7,63,13
32,82,56,-4,13,-6,45,103,321
-1,34,-34,-18,-75,-115,-45,54,-200
352,405,-9,77,-42,-133,91,560,1301
58,85,48,11,1,-30,20,152,345
190,266,-49,-5,-251,-425,-21,282,-13
19,8,-10,-41,-19,-35,-13,43,-48
1,23,-15,-8,-69,-89,-33,50,-140
136,221,37,-15,-3,-105,57,195,523
92,97,-62,1,-90,-21,39,191,247
-4,77,21,32,-41,-15,-17,88,141
23,22,-26,-24,-62,-82,-9,62,-96
13,28,-32,-38,-37,-122,-37,80,-145
-1,8,-12,14,-62,-72,-10,45,-90
45,121,-5,-53,-4,-62,29,118,189
26,46,-13,-24,-13,-63,-20,47,-14
-18,-6,-12,6,-23,-29,-19,23,-78
-9,28,-23,-32,-54,-64,13,61,-80
-49,-24,-76,-33,-102,-84,-59,72,-355
70,83,-50,-10,-59,-71,8,136,107
85,134,-3,-44,-14,-83,10,222,307
77,130,-19,22,-6,0,56,77,337
-6,4,-23,-1,-67,-52,-33,78,-100
1,10,-13,-8,-25,-27,-2,21,-43
1,21,-42,-7,-99,-54,2,87,-91
59,75,63,-37,45,-93,-12,138,238
73,67,-76,-33,-157,-84,40,107,-63
159,273,-159,-197,-301,-567,-75,423,-444
-9,13,-31,-41,-74,-64,-14,58,-162
-12,-3,-35,2,-68,-100,-34,23,-227
2,106,-53,-31,0,-19,52,136,193
18,17,-3,5,-12,-35,3,14,7
29,12,-4,-1,-36,-37,4,35,2
144,151,32,-22,33,-68,42,199,511
-5,18,-43,-15,-43,-77,-23,32,-156
23,16,-12,-28,-36,-56,14,60,-19
13,23,-12,-1,-30,-26,8,18,-7
11,88,-77,-67,-178,-231,-48,113,-389
3,30,-25,-33,-52,-19,8,43,-45
-42,16,-33,-34,-47,-114,-52,49,-257
27,80,-123,-109,-216,-310,-52,174,-529
45,71,-44,4,-79,-36,41,70,72
25,92,-46,-65,-105,-167,8,217,-41
49,63,-1,15,-37,-49,7,58,105
7,4,-6,-16,0,-16,5,16,-6
8,55,-22,-7,-71,-97,-10,118,-26
38,38,-41,-30,-107,-82,20,126,-38
15,17,-8,5,-26,-12,12,26,29
77,82,-12,-7,-110,35,46,162,273
61,94,-40,-39,-62,-42,27,66,65
-5,53,-31,2,8,23,35,55,140
97,93,-21,-13,-74,-150,4,108,44
-7,0,-11,0,-22,-13,3,4,-46
6,13,-6,1,-23,-19,5,31,8
1,55,18,12,-94,-3,14,158,161
-10,18,-34,-56,-80,-98,-10,126,-144
46,114,-9,-51,-33,-74,44,129,166
16,57,20,-13,-25,-37,11,55,84
33,-2,-62,4,-148,-90,23,81,-161
7,121,-70,-61,-94,-204,-26,167,-160
25,63,-34,-73,-48,-83,24,107,-19
68,151,58,45,-26,-21,24,142,441
-16,59,-24,-56,-90,-111,-45,90,-193
106,155,-2,-51,-120,-164,10,210,144
-12,31,-22,-32,-57,-59,-10,110,-51
-32,-12,-38,-3,-72,-94,-30,55,-226
31,18,10,17,-41,-24,15,45,71
29,84,-11,-19,-105,-92,-10,126,2
21,20,-21,-3,-2,-29,3,33,22
18,25,-19,-11,-11,-39,16,31,10
10,25,15,-32,-79,-88,-26,92,-83
15,77,-16,-13,-57,-45,-14,111,58
91,112,34,0,49,-46,39,129,408
-38,161,-112,-106,26,-30,50,247,198
8,4,-3,-2,-7,-3,4,10,11
31,54,-13,5,-73,-63,20,95,56
32,38,12,4,-6,-40,26,58,124
77,177,-21,-58,5,-82,74,160,332
-1,4,-11,-12,-18,-10,-1,10,-39
54,64,14,8,-17,-21,20,30,152
2,17,-9,-11,-48,-38,10,69,-8
42,75,-66,-42,-120,-121,5,152,-75
-66,-3,-50,-59,-17,-97,-38,69,-261
85,79,22,-19,37,-76,25,77,230
-11,-6,-31,-21,-64,-86,-39,59,-199
-6,3,-21,3,-18,-13,-6,9,-49
-3,32,-18,-5,-14,-21,-4,11,-22
17,37,-60,-46,-46,-54,3,31,-118
-7,-20,-52,-54,-116,-92,-35,87,-289
78,108,-14,21,-44,-26,37,101,261
-36,-32,-63,-37,-50,-106,-56,19,-361
27,88,-45,-19,-58,-64,30,97,56
34,20,-25,-28,-57,-74,9,90,-31
73,151,-25,-26,-19,18,99,121,392
31,25,-46,-31,-75,-63,13,67,-79
70,117,3,-73,-71,-110,9,224,169
13,26,-27,-37,-63,-97,-11,87,-109
-66,59,-217,-170,-346,-369,-124,284,-949
-109,76,-175,-147,-342,-367,-140,325,-879
8,41,-25,2,-27,-29,2,32,4
80,46,-43,-62,-157,-117,0,158,-95
2,14,-3,-6,-31,-12,-20,36,-20
85,78,-27,48,-82,-86,28,111,155
65,92,-28,-9,-49,-41,37,86,153
250,401,35,-102,-35,-194,124,453,932
35,47,-72,-133,-129,-143,-14,162,-247
89,182,-32,-37,-162,-246,6,315,115
26,45,-55,-17,-111,-123,-10,99,-146
116,212,-70,-21,-47,-114,57,221,354
93,169,-545,-508,-952,-1201,-340,737,-2547
42,82,-110,-58,-156,-279,-76,155,-400
83,132,35,46,-17,-39,33,218,491
9,64,-62,-4,-131,-155,-26,94,-211
41,78,37,12,-108,-51,19,194,222
19,82,-49,-75,-79,-147,-5,121,-133
-6,85,-123,-91,-148,-275,-62,169,-451
-3,97,-50,-57,-6,16,44,101,142
91,110,30,-6,19,9,10,112,375
-5,5,-27,-61,-57,-76,-3,64,-160
164,215,62,65,-40,-117,66,318,733
248,211,-69,-39,-4,84,197,196,824
41,75,-12,-31,-37,-93,13,154,110
-65,183,-66,-65,-20,7,109,204,287
61,106,-119,-87,-191,-267,-54,173,-378
151,37,-114,5,-163,-145,74,163,8
1127,1468,379,92,474,-143,529,1446,5372
110,209,-52,-86,-166,-208,8,302,117
96,249,-27,-40,-148,-264,-29,241,78
5,170,-275,-136,-470,-808,-232,506,-1240
26,53,-71,-85,-138,-218,-57,106,-384
109,193,47,91,-27,-4,58,206,673
0,17,-68,-66,-102,-78,-23,76,-244
197,222,65,-54,-59,-98,40,329,642
63,88,40,-2,-78,-91,5,197,222
381,368,48,104,-30,-104,170,489,1426
41,117,-43,-40,-36,-68,67,158,196
279,400,-148,-195,-158,-349,116,726,671
225,305,10,-2,82,-36,121,266,971
137,391,-144,-109,-268,-336,-11,441,101
93,101,-26,-63,-4,-86,77,180,272
106,162,16,28,-18,-26,44,183,495
203,450,-84,69,-172,-287,-29,229,379
123,267,2,-17,-260,-171,0,475,419
21,11,-73,-61,-149,-207,-77,95,-440
233,388,0,-84,-113,-238,140,445,771
74,167,-78,-39,-35,-44,93,168,306
92,60,-72,-76,-201,-148,0,245,-100
501,540,-172,-119,-647,-766,46,915,298
181,261,-73,-70,-91,-162,58,339,443
-40,19,-8,2,-56,-37,-26,77,-69
70,71,-54,-76,-93,-150,25,178,-29
-50,56,-57,-29,-105,-180,-76,118,-323
-72,-2,-106,-53,-164,-157,-103,137,-520
4,44,-82,-61,-166,-156,-33,120,-330
45,39,-18,-33,-59,-67,8,119,34
63,110,8,4,-50,-43,22,128,242
45,95,5,-12,3,-36,32,116,248
-8,-23,-63,-78,-127,-142,-61,87,-415
41,24,-19,-3,-25,-30,8,49,45
-32,-19,-36,-46,-61,-84,-40,34,-284
77,83,-15,33,-62,-65,60,88,199
64,88,13,1,20,-9,38,87,302
25,44,-49,-8,-69,-102,10,76,-73
-7,9,-44,-35,-112,-142,-22,107,-246
-30,-14,-99,-85,-140,-171,-76,120,-495
53,124,-61,-18,-14,-28,124,143,323
104,81,13,-36,16,-76,25,158,285
-6,94,-48,-21,-19,-12,-2,89,75
163,211,-93,-93,-240,-296,-9,284,-73
-18,10,-136,-91,-239,-206,-89,201,-568
70,97,9,-3,-58,-41,30,139,243
68,302,-85,-91,-50,-154,22,369,381
-27,-22,-93,-66,-103,-165,-61,104,-433
30,21,-36,-41,-59,-78,15,60,-88
-23,-4,-40,-21,-50,-40,-30,25,-183
63,117,-76,-31,-62,-104,24,82,13
68,59,-76,-63,-88,-87,0,71,-116
14,62,-19,-36,-20,-69,11,105,48
57,9,-58,0,-99,-104,-1,129,-67
2,18,-2,6,-5,-8,-2,20,29
3,13,-18,-4,-1,-18,7,19,1
15,269,212,153,-79,156,-101,271,896
97,104,-55,-32,-69,-138,32,183,122
-1,31,-16,-20,-28,-65,-20,44,-75
31,125,-27,5,-168,-221,-72,172,-155
6,11,3,-2,-15,-30,9,21,3
7,34,-50,-36,-118,-133,-24,125,-195
-58,1,-57,-39,-73,-121,-72,54,-365
14,11,-26,-1,-33,-21,7,32,-17
141,280,-56,-74,15,54,184,256,800
56,62,9,-22,-42,-45,2,97,117
16,31,-53,-70,-102,-101,2,109,-168
111,68,-14,9,-47,-115,10,139,161
15,43,-12,-14,-10,-51,-10,73,34
157,237,-116,-43,-139,-277,34,301,154
25,44,-38,-31,-38,-34,34,95,57
30,92,-3,-27,-11,-53,9,110,147
29,113,-85,-66,-196,-218,-70,203,-290
-5,27,-40,-31,-84,-75,6,92,-110
51,91,-49,-22,-27,-57,21,37,45
262,302,-2,-48,-13,-121,86,374,840
156,252,-10,-81,-151,-145,77,354,452
221,130,-163,5,-295,-156,92,192,26
11,79,-31,-52,-98,-126,-31,119,-129
-14,36,-44,-12,-41,-35,6,52,-52
141,199,-49,-28,-27,-76,55,134,349
44,58,-2,6,-76,-23,37,87,131
22,54,-17,-6,-32,-52,4,42,15
9,22,-13,-5,1,-12,15,22,39
-2,31,2,2,-10,-21,1,40,43
-47,30,-33,-30,-90,-131,-70,79,-292
8,69,-46,-74,-77,-110,31,155,-44
61,288,-86,-104,-360,-303,31,464,-9
211,312,22,-34,5,-92,96,388,908
34,45,6,3,-24,-31,8,79,120
-7,3,-10,2,-19,-26,-13,20,-50
-3,29,-12,-7,-22,-27,-2,17,-27
-12,9,-28,-39,-55,-90,-50,56,-209
14,32,-57,-45,-56,-76,2,47,-139
27,60,-30,3,-43,-31,27,98,111
5,23,-12,-8,-11,-28,4,52,25
30,47,-32,-39,-3,-77,-9,63,-20
56,31,-30,-40,-39,-54,5,74,3
-5,32,-14,-5,-52,-69,6,75,-32
2,13,-18,-33,-23,-24,29,33,-21
24,31,-26,-28,-27,-39,-4,35,-34
85,151,21,-44,-44,-82,33,234,354
26,166,-115,-115,-226,-261,-77,298,-304
23,21,-6,12,-47,-39,-21,41,-16
-10,68,-22,-44,-46,-109,-55,108,-110
64,23,-29,-5,-92,-103,10,56,-76
505,775,-72,-66,-101,-224,265,809,1891
579,723,-212,-128,-494,-436,313,997,1342
6,23,-33,-34,-121,-62,4,136,-81
100,234,-165,-69,-257,-251,-14,224,-198
13,51,5,-21,11,-27,12,53,97
325,566,-25,46,-141,21,284,623,1699
33,96,-14,5,-108,-37,25,159,159
22,66,-14,-16,-67,-71,6,142,68
8,49,1,-8,-72,-53,9,86,20
-67,9,-33,-69,-76,-124,-85,86,-359
-79,4,-40,-61,-90,-126,-81,72,-401
-76,10,-46,-63,-82,-143,-74,76,-398
-72,8,-49,-58,-90,-139,-94,76,-418
94,140,-63,-19,-107,-108,-4,131,64
20,32,-7,1,-13,-16,12,28,57
-7,25,-12,3,-108,-58,3,100,-54
-37,-19,-18,-1,-91,-59,-30,75,-180
78,175,4,-15,-18,-95,23,240,392
15,50,19,-4,-7,-40,-6,65,92
19,56,-19,-21,-60,-57,-8,86,-4
73,134,-2,-15,-38,-128,17,154,195
15,-4,-26,-4,-32,-71,-31,45,-108
37,36,-16,-32,-52,-168,-43,127,-111
42,45,-11,-30,-61,-81,14,127,45
17,8,-38,-38,-58,-66,9,74,-92
-6,35,-31,-21,-102,-66,-9,65,-135
43,73,-5,-29,-32,-24,29,91,146
20,40,-26,-10,-27,-34,13,20,-4
58,110,-15,0,4,-95,21,124,207
-10,-9,-20,-15,-20,-38,-8,36,-84
39,71,-16,-10,-26,-74,1,76,61
35,8,-8,-19,-34,-48,-6,48,-24
4,30,-17,-7,-16,-10,17,29,30
22,26,-9,-5,-8,-15,23,46,80
29,22,9,-25,11,-43,13,23,39
4,29,24,-9,1,-34,-12,43,46
63,120,-39,1,-43,-87,-3,111,123
46,72,-4,-30,-20,-50,35,110,159
13,31,-53,-49,-37,-98,-5,37,-161
15,60,-8,-14,-25,-50,-4,46,20
-4,20,-13,-15,-29,-8,1,38,-10
23,40,6,-12,-21,-18,10,44,72
44,45,-12,-3,-12,-24,13,24,75
1,43,-44,-19,-79,-62,-8,59,-109
13,42,14,6,-7,-6,11,45,118
-65,-23,-40,-80,-61,-127,-67,72,-391
-15,20,-21,-29,-50,-100,-41,65,-171
-16,36,-42,-87,-86,-116,-40,98,-253
54,113,-43,-41,-9,-103,44,120,135
-21,14,-8,-11,-27,-7,-15,45,-30
115,88,-53,-89,-112,-112,27,263,127
10,114,-62,-36,-27,-22,46,188,211
-18,41,-20,-33,-51,-108,0,79,-110
59,40,-36,-27,-50,-129,-21,129,-35
14,33,2,-26,-19,-59,-9,61,-3
8,105,-28,-20,-12,-48,49,96,150
105,158,17,-26,-91,-145,37,129,184
22,79,-26,-24,-1,-80,23,114,107
97,121,11,13,-16,-29,57,148,402
58,57,-46,-3,-58,-66,18,90,50
19,23,-11,-27,-11,-35,2,27,-13
-8,16,-51,-9,-69,-108,-30,67,-192
84,204,14,-46,-10,-69,79,241,497
48,55,-3,-39,-32,-32,50,68,115
1,22,-3,-18,-34,-30,-1,39,-24
0,29,9,-10,14,-34,-7,60,61
-4,39,-82,-93,-64,-117,4,99,-218
68,67,-6,-29,-53,-63,34,132,150
40,60,-50,-60,-95,-125,-36,58,-208
29,41,-114,-78,-162,-189,-7,117,-363
170,165,-13,-19,-44,-52,83,154,444
12,31,1,4,-43,-33,6,33,11
102,168,-47,-20,-51,-130,33,179,234
25,121,-28,-9,6,-26,32,105,226
34,48,-68,-51,-53,-117,-18,89,-136
48,38,-57,-4,-60,-77,22,59,-31
73,163,-17,-2,-132,-134,-32,163,82
55,61,15,2,4,-1,40,58,234
40,91,-34,-67,-108,-202,-24,197,-107
1,28,3,-15,3,-40,5,50,35
190,368,-144,-88,-178,-199,99,355,403
25,34,0,-2,-16,-22,15,54,88
182,839,-302,-278,-706,-1542,-292,1048,-1051
40,152,-78,-44,-89,-163,-37,178,-41
63,126,-114,-13,-134,-77,25,47,-77
30,53,-54,-23,-119,-109,13,163,-46
21,30,-40,-77,-88,-129,-62,113,-232
30,55,-59,-14,-69,-71,1,45,-82
93,118,-66,-28,-108,-139,14,140,24
8,19,-42,-34,-45,-68,-3,52,-113
100,95,44,-5,23,-48,43,119,371
-2,30,-48,-78,-81,-161,-37,88,-289
7,35,-20,-20,-63,-92,-7,69,-91
76,131,-68,-28,-150,-233,-18,125,-165
105,189,-45,4,-69,-65,57,132,308
20,48,-42,-25,-28,-42,-3,4,-68
-64,-4,-86,-41,-137,-144,-60,128,-408
16,48,15,-17,-39,-11,37,86,135
17,10,-66,-11,-61,-128,-27,99,-167
6,43,-28,-7,-19,-25,4,43,17
31,199,-47,-50,-169,-232,-30,245,-53
52,152,-75,-34,-35,-33,80,152,259
11,21,2,2,-20,-22,12,38,44
35,65,-46,-32,3,-23,63,76,141
39,55,5,4,5,-2,39,53,198
28,15,-20,-10,-27,-48,33,61,32
39,55,-39,-9,-54,-29,20,67,50
111,140,-12,-5,22,-16,106,80,426
29,43,-13,-24,-24,-43,24,50,42
14,30,-34,-30,-53,-68,0,87,-54
64,85,5,10,-5,-13,41,70,257
-41,-35,-52,-39,-56,-96,-45,44,-320
5,116,-27,-69,-91,-111,3,187,13
-4,36,-20,-33,-58,-63,-8,43,-107
72,111,-83,-92,-213,-274,-50,269,-260
58,206,-49,-16,-173,-176,-14,235,71
43,55,-22,-58,-64,-142,-23,139,-72
30,61,-2,-8,-16,-14,46,102,199
16,74,-65,-30,-153,-143,33,125,-143
59,139,-29,-39,-19,-119,-8,166,150
-46,100,-99,-95,-144,-325,-116,136,-589
17,45,-31,-30,-36,-37,3,42,-27
59,94,-7,-14,7,-68,24,88,183
42,106,-51,-48,-71,-160,-7,164,-25
6,7,-20,-36,-37,-81,-20,30,-151
48,236,-136,-99,-234,-227,3,208,-201
25,40,18,3,-6,-7,17,55,145
-18,51,-130,-54,-62,-98,0,127,-184
227,380,26,-5,-94,-136,105,471,974
21,5,-37,-14,-109,-89,0,80,-143
7,36,-21,8,-59,-25,1,49,-4
-75,-26,-123,-70,-150,-237,-122,129,-674
109,187,-7,-20,-38,-121,41,228,379
11,29,11,-3,6,-8,3,30,79
76,292,-273,-182,-291,-357,0,340,-395
73,214,-66,-7,-119,-163,-13,160,79
0,81,11,-13,-10,-30,1,72,112
-33,87,-93,-45,-76,-25,30,135,-20
211,254,39,-82,17,8,122,213,782
28,7,27,5,-58,-52,-40,123,40
-52,-35,-68,-51,-77,-82,-51,58,-358
-47,-15,-52,-40,-42,-91,-47,67,-267
40,55,-29,11,-54,-32,25,39,55
29,25,-95,-70,-138,-196,-36,100,-381
62,48,-99,-37,-116,-129,17,117,-137
7,-8,-43,-12,-48,-66,-29,24,-175
85,243,78,-66,114,39,97,209,799
21,23,-11,-38,-73,-26,6,66,-32
126,101,-2,3,-36,-53,-2,131,268
114,157,-58,-20,-62,-112,63,146,228
0,37,-31,-28,-65,-105,-12,56,-148
13,43,11,-6,-4,-3,26,65,145
24,31,-7,-5,-11,-27,14,67,86
30,43,-19,-12,-13,-5,34,32,90
5,52,-24,-66,-77,-150,-42,110,-192
114,167,-96,-7,-153,-182,-17,45,-129
-8,29,-40,-48,-83,-168,-62,97,-283
8,62,-22,-25,18,-14,22,75,124
110,144,30,15,-31,-98,7,212,389
5,102,-99,-57,-10,-10,43,119,93
21,257,-436,-308,-699,-922,-252,608,-1731
-2,22,-20,-23,-26,-37,0,46,-40
-22,19,-23,-26,-24,-61,-21,55,-103
-9,80,-87,-47,-6,8,51,95,85
117,191,-31,-13,-63,-103,50,213,361
37,38,0,0,-17,-5,33,54,140
9,122,-32,-50,20,-20,28,159,236
183,218,-18,-34,-11,-35,110,285,698
-43,-4,-61,-7,-92,-183,-50,50,-390
135,246,-188,-222,-300,-512,-86,492,-435
-14,36,9,-5,-30,-15,5,47,33
12,17,-39,-8,-192,-119,2,128,-199
32,133,-2,-20,20,-40,52,121,296
-49,-37,-109,-80,-134,-247,-114,85,-685
23,97,-29,-6,-19,-36,20,76,126
57,82,-66,-51,-97,-111,27,138,-21
89,118,-52,17,-84,-69,37,68,124
73,118,-23,4,-86,-56,43,145,218
20,20,-18,-10,-12,-52,-19,42,-29
1,-18,-46,-39,-84,-79,7,58,-200
66,120,-35,-32,-51,-34,51,77,162
11,61,-33,-4,-11,-4,29,20,69
3,35,-31,-20,-31,-40,22,64,2
5,98,-57,-14,-50,-29,71,153,177
26,95,-45,-63,-79,-145,-19,150,-80
-2,34,-5,-21,-22,-61,-5,55,-27
86,125,-95,-7,-129,-125,11,72,-62
-8,73,-32,-27,-18,-30,2,121,81
-19,64,-62,-50,-8,-24,42,113,56
-16,105,-155,-139,-242,-363,-135,262,-683
54,84,-52,-89,-146,-179,-41,212,-157
-16,68,-69,-25,-37,-35,66,140,92
28,48,31,19,-12,-4,24,42,176
24,101,-6,-46,7,-32,29,143,220
8,17,-23,-27,-146,-180,-54,131,-274
-18,97,-25,-30,-5,6,80,150,255
36,60,0,-6,-2,-42,-1,93,138
10,73,-35,-27,-108,-116,-27,151,-79
36,53,-11,3,-61,-67,-8,98,43
-26,42,-85,-48,8,-42,33,117,-1
91,131,-96,-19,-167,-156,-14,116,-114
16,29,4,3,-17,-22,2,44,59
116,158,20,27,-1,-81,34,188,461
16,79,-43,-44,-131,-66,25,134,-30
16,53,25,13,14,2,13,54,190
-69,-53,-161,-135,-229,-272,-127,194,-852
55,83,44,-22,49,11,32,95,347
-19,4,-29,-21,-78,-63,-15,82,-139
-6,15,-7,-15,-16,-12,6,22,-13
40,26,-42,12,-141,-145,-2,70,-182
-8,15,7,-1,3,-15,-4,35,32
31,51,-4,21,-22,-27,13,54,117
54,33,-37,28,-36,-33,34,42,85
-6,-3,-13,-17,-42,-45,-24,33,-117
-48,1,-82,3,-116,-184,-102,104,-424
58,143,-2,22,-203,-195,-87,349,85
109,207,84,0,10,-98,49,183,544
-2,15,-50,-39,-117,-92,-24,58,-251
73,141,-103,-50,-208,-250,-10,242,-165
299,357,40,-67,-19,-221,48,431,868
0,82,-40,-30,-89,-73,13,113,-24
71,123,-6,18,-60,-110,29,183,248
175,134,-62,64,-144,-23,136,146,426
17,127,-26,-43,-70,-87,-1,164,81
38,114,-1,-22,-39,-113,18,143,138
98,121,36,-10,6,-95,20,161,337
44,84,23,7,-47,-58,4,106,163
8,45,1,-27,20,-21,3,38,67
-6,2,-35,-24,-49,-43,1,27,-127
34,65,-34,-13,-73,-140,2,110,-49
1,22,-52,-10,-70,-98,-18,100,-125
35,82,-30,-24,-67,-76,-5,78,-7
-20,164,-63,-69,-109,-292,-75,223,-241
90,137,-32,-22,-63,-97,12,156,181
44,138,0,-32,-119,-114,-13,253,157
69,261,230,-9,28,137,70,396,1182
103,147,-24,-3,-177,-146,35,266,201
126,237,-38,-150,-152,-318,37,295,37
111,138,-76,-23,-187,-193,5,170,-55
-9,30,-18,-42,-64,-32,18,101,-16
-27,79,-79,-72,-127,-157,-81,142,-322
21,18,-58,-35,-75,-108,-31,84,-184
67,142,-48,-31,-121,-100,14,179,102
-54,-21,-92,-75,-101,-103,-25,76,-395
-9,42,-109,-81,-146,-118,-12,119,-314
-60,-24,-79,-56,-105,-99,-59,75,-407
-69,-50,-63,-85,-107,-125,-76,73,-502
-4,39,-54,-19,-90,-133,-45,89,-217
6,9,-205,-97,-308,-346,-82,164,-859
58,74,12,1,-42,-78,-16,91,100
-41,10,-33,-27,-63,-109,-42,52,-253
-97,-64,-157,-116,-214,-235,-112,178,-817
28,34,-55,-15,-108,-92,-46,69,-185
13,9,-13,-21,-56,-90,-35,54,-139
40,58,-27,-35,-43,-77,0,91,7
-17,4,-17,-31,-33,-28,-22,28,-116
266,301,-16,-68,-99,-265,5,362,486
59,97,-71,-74,-131,-93,1,209,-3
0,18,-20,-18,-17,-7,7,55,18
56,82,-28,-18,-81,-167,-18,112,-62
-40,-4,-28,-37,-24,-69,-22,79,-145
-33,8,-24,-29,-66,-71,-15,92,-138
55,199,-14,31,-246,-300,-60,405,70
341,631,77,-26,-94,-219,153,653,1516
65,132,-76,-92,-178,-216,-45,208,-202
-3,17,-14,-24,-17,-23,-2,25,-41
25,100,-35,-19,-17,0,48,98,200
15,12,-27,-7,-49,-35,7,51,-33
37,94,-39,-91,-124,-113,-24,160,-100
25,60,-41,-61,-51,-74,-5,47,-100
-18,5,-20,-12,-28,-22,-10,21,-84
-6,15,-45,-30,-45,-90,-33,57,-177
58,103,37,16,19,21,51,99,404
-19,39,-49,-36,-141,-210,-52,145,-323
12,34,-2,-19,-4,-17,6,25,35
29,41,-14,3,6,25,41,27,158
11,88,-17,-20,-72,-69,5,160,86
218,126,-54,165,-248,-102,82,209,396
-4,11,-8,4,-11,-42,-25,26,-49
-10,-6,-42,-36,-61,-52,-20,73,-154
-13,70,-30,-44,-83,-98,-17,119,-96
-15,24,-21,-39,-15,-35,0,23,-78
40,70,19,4,13,-24,48,127,297
-99,-22,-223,-159,-297,-483,-181,292,-1172
242,357,64,-14,41,-153,94,455,1086
-1,27,-21,-23,-43,-63,-9,38,-95
41,59,-35,-9,-16,-44,21,70,87
66,76,-70,-26,-123,-165,3,113,-126
59,80,-88,-10,-125,-156,-2,122,-120
92,168,-53,-106,-190,-217,23,315,32
47,98,9,-20,-76,-58,-15,189,174
57,48,-20,2,-29,-37,16,50,87
12,115,-40,-42,5,-45,52,145,202
49,66,-54,3,-157,-187,-63,145,-198
2,58,-8,-27,-58,-144,-46,152,-71
2,38,-13,-27,3,-19,9,51,44
-3,3,-7,-4,-14,-19,-5,21,-28
-39,4,-52,0,-103,-89,-43,62,-260
23,35,-13,-15,-14,-24,37,65,94
22,36,-7,-17,-6,-26,41,62,105
70,141,-30,-74,-85,-39,14,180,177
117,114,-2,-114,15,-175,29,249,233
31,32,-47,-31,-56,-67,17,59,-62
30,36,-24,-19,6,-16,25,68,106
159,317,72,30,-88,-156,42,422,798
45,99,-17,-32,-58,-78,40,92,91
167,157,31,89,-43,-57,61,232,637
254,373,108,-3,122,3,121,383,1361
108,183,-8,-46,-85,-99,38,228,319
81,171,13,27,-54,-28,51,194,455
47,76,14,-28,-69,-196,-87,221,-22
168,332,7,-54,-149,-193,43,330,484
61,105,37,-7,25,16,63,109,409
112,116,-119,-113,-158,-282,-40,271,-213
121,262,-109,-96,-196,-206,99,290,165
40,63,-65,-71,-116,-124,5,134,-134
8,66,-79,-51,-79,-42,12,133,-32
68,441,155,-105,-395,-298,-218,1139,787
329,438,155,-12,84,-177,100,498,1415
25,110,-67,-110,-171,-230,-3,300,-146
87,245,-236,103,-602,-22,-26,350,-101
27,56,-57,-65,-142,-136,-31,133,-215
20,26,-50,-45,-57,-111,-31,57,-191
139,358,-431,-259,-934,-1028,-266,741,-1680
63,41,-59,-31,-134,-183,-36,108,-231
45,95,-55,-33,-58,-98,-1,71,-34
8,57,-24,-12,-38,-106,-9,104,-20
45,258,-148,-78,-298,-320,-72,435,-178
48,81,-50,-11,-61,-86,-1,131,51
9,-5,-16,-28,-19,-64,-21,8,-136
-27,-1,-26,-12,2,-112,-39,50,-165
19,47,-22,-46,-10,-38,26,58,34
208,423,-242,-68,-372,-326,6,415,44
-30,149,-59,-74,-82,-295,-67,215,-243
26,87,-45,-7,-37,-124,-10,84,-26
-4,2,-14,-7,-26,-16,-5,21,-49
281,380,-63,-94,-149,-315,15,458,513
124,287,199,118,65,55,57,382,1287
62,61,-54,-34,-78,-138,-25,101,-105
-65,-6,-95,-66,-135,-182,-110,106,-553
58,69,-11,-12,-30,-16,30,110,198
-18,22,-86,-4,-195,-169,-58,134,-374
279,472,-209,-71,-206,-312,127,508,588
119,238,-33,-46,-47,-240,1,258,250
7,33,-33,-38,-60,-100,-39,89,-141
55,80,-46,-28,-69,-99,11,101,5
254,231,-29,-116,38,-83,7,215,517
-15,-6,-37,-47,-89,-126,-30,135,-215
185,320,17,-51,184,-65,130,233,953
2,1,-14,-7,-32,-43,-24,10,-107
22,41,-8,-36,-27,-56,29,86,51
12,28,-98,-81,-155,-241,-83,131,-487
1,14,-3,-22,-13,-26,-8,31,-26
136,220,-67,-31,-161,-238,-7,337,189
3,8,-23,19,-39,-40,-9,29,-52
16,48,35,60,-57,4,26,82,214
-25,22,-39,-1,-90,-96,-24,77,-176
124,93,-40,31,-105,-132,67,138,176
17,32,-40,-29,-111,-67,16,84,-98
22,93,-202,-214,-318,-418,-70,392,-715
163,248,-18,-56,-59,-126,46,301,499
170,185,-133,-375,-379,-417,-65,488,-526
50,82,-19,-6,-21,-15,48,93,212
-1,40,-46,-46,-72,-138,-39,64,-238
-8,80,-128,-144,-215,-400,-140,239,-716
-10,133,19,-61,-38,-58,-30,144,99
11,21,-22,4,-32,-20,5,36,3
-6,44,-41,-54,-55,-161,-55,76,-252
232,383,-40,-148,-96,-39,142,458,892
7,10,-11,-18,-6,-23,-10,22,-29
159,341,-98,-5,-190,-318,-10,282,161
-61,-43,-74,-43,-87,-119,-67,65,-429
-42,-23,-67,-35,-80,-119,-51,63,-354
-63,-21,-60,-34,-77,-118,-74,66,-381
-76,-46,-82,-62,-97,-129,-79,69,-502
-53,-28,-51,-41,-81,-124,-72,58,-392
-69,-25,-53,-56,-71,-132,-73,40,-439
-52,-24,-62,-59,-82,-130,-71,62,-418
-55,-12,-61,-43,-79,-118,-71,68,-371
-67,-17,-67,-46,-97,-101,-53,69,-379
-80,-38,-79,-76,-105,-110,-70,51,-507
-62,-14,-58,-66,-73,-104,-64,56,-385
-64,-32,-68,-64,-81,-112,-61,71,-411
-39,-22,-55,-42,-93,-128,-64,57,-386
-68,5,-52,-45,-72,-122,-65,69,-350
-49,-19,-64,-54,-80,-129,-67,51,-411
-66,-13,-45,-39,-69,-114,-66,83,-329
-50,-21,-70,-60,-92,-107,-74,79,-395
-58,-17,-74,-71,-78,-117,-67,68,-414
-77,-60,-89,-91,-109,-124,-52,54,-548
-92,-42,-78,-78,-99,-126,-65,55,-525
66,47,-80,-41,-90,-167,4,145,-116
-11,25,-53,-32,-102,-132,-30,93,-242
52,137,-64,-42,-190,-153,-16,285,9
92,96,-21,22,-109,-58,41,157,220
-2,108,-70,-55,-54,1,54,141,123
82,73,-23,12,-35,-92,15,153,185
67,267,-54,-81,-213,-225,15,342,118
8,44,-29,1,-100,-162,-52,90,-200
18,61,-45,-34,-51,-77,19,79,-30
-61,-37,-67,-58,-123,-84,-61,92,-399
-40,-60,-81,-39,-127,-106,-44,72,-425
-73,-54,-67,-75,-74,-105,-55,57,-446
27,57,-9,-20,-1,-25,4,52,85
-1,32,-11,-18,-18,-31,14,27,-6
469,514,37,51,-21,-20,242,653,1925
66,63,21,13,18,-47,15,65,214
34,13,-85,20,-108,-170,-34,109,-221
110,225,-7,1,-69,-24,122,230,588
69,168,14,-8,-58,-100,12,252,349
49,178,-486,-361,-674,-701,-84,677,-1402
18,39,10,-19,18,6,28,21,121
-11,71,-103,-108,-210,-242,-63,290,-376
259,302,-11,-52,-15,-147,148,320,804
17,18,-11,-9,-9,-28,-1,36,13
47,74,4,-29,-33,-140,7,138,68
-26,20,-42,-64,-58,-111,-32,107,-206
48,49,-101,-67,-166,-133,41,137,-192
-3,-4,-37,-54,-76,-84,-13,92,-179
35,22,-106,-45,-201,-101,47,153,-196
30,34,-43,-38,-108,-150,-17,111,-181
28,89,-13,-81,-68,-139,-8,158,-34
50,153,2,-45,-50,-61,52,172,273
153,165,-16,-23,-64,-106,29,205,343
6,24,-55,-72,-105,-154,-53,114,-295
262,339,5,-77,-98,-241,-11,441,620
143,174,9,-13,-20,-155,-8,176,306
171,320,-17,-27,-246,-364,-3,489,323
67,71,-103,-110,-164,-275,-60,206,-368
109,123,-103,-75,-188,-256,-2,217,-175
92,89,-92,-66,-87,-110,20,114,-40
32,65,-35,-27,-45,-108,4,61,-53
9,58,-27,-48,-47,-66,13,97,-11
197,361,-118,-153,-394,-483,-112,697,-5
129,477,-282,-592,-1247,-416,1,1461,-469
241,398,58,32,-41,-120,94,447,1109
78,71,-185,-117,-317,-402,-46,200,-718
-31,-7,-37,-52,-42,-187,-71,125,-302
83,107,44,4,6,8,40,136,428
54,78,-44,-65,-115,-154,-14,185,-75
23,-6,10,-12,-27,-70,-16,56,-42
24,31,-9,-4,-34,-68,-12,30,-42
0,23,-11,-15,-56,-53,1,61,-50
-30,41,-69,2,-145,-221,-55,86,-391
120,212,-94,-69,-151,-249,7,242,18
17,58,-12,-20,-21,-84,-10,83,11
26,33,-42,-16,-71,-53,5,61,-57
23,24,-82,-36,-153,-181,3,110,-292
59,89,-6,-47,-30,-110,34,147,136
103,93,-50,-27,-119,-142,16,165,39
125,126,44,30,-66,-110,12,249,410
124,181,19,13,-9,-89,29,200,468
20,43,-64,-41,-84,-125,-21,60,-212
-20,-7,-28,-47,-48,-36,-3,50,-139
77,105,3,14,-40,-79,-24,111,167
9,45,31,-15,-35,-74,-2,76,35
35,62,4,-7,-6,-30,23,59,140
68,151,-45,-23,-54,-44,45,185,283
13,19,-9,-9,-5,-7,0,20,22
22,12,-11,-15,-5,-36,16,60,43
-68,-45,-93,-53,-122,-130,-55,61,-505
12,44,-39,-37,-43,-53,-1,65,-52
-68,-18,-80,-39,-120,-155,-89,99,-470
165,228,-49,-8,-117,-99,96,215,431
55,133,-60,-49,-60,-104,17,170,102
81,152,-137,-52,-230,-211,7,170,-220
118,93,-38,93,-118,-102,61,138,245
34,129,-38,-79,-77,-113,25,165,46
-10,28,-36,-39,-96,-158,-58,51,-318
5,97,-72,-48,-25,3,52,209,221
13,61,-100,-6,-156,-162,-29,93,-286
117,122,14,13,-38,-84,32,202,378
3,43,-7,-27,-52,-55,13,53,-29
66,98,-81,-34,-122,-111,10,128,-46
-51,-25,-49,-5,-44,-86,-65,35,-290
82,57,-9,-43,-66,-120,-32,149,18
-50,89,-86,-50,1,-10,79,153,126
-55,1,-45,-29,-132,-190,-73,89,-434
10,-4,-27,-11,-32,-42,13,36,-57
13,100,11,47,-25,-59,54,126,267
89,96,-19,-5,-65,-139,5,173,135
-9,10,-22,-34,-38,-71,-23,75,-112
202,496,-166,-18,-348,-425,-63,440,118
-13,116,-22,-41,13,32,74,175,334
98,89,23,-30,-6,-14,44,101,305
-4,77,-32,-32,-45,-152,-44,92,-140
-16,61,-81,-60,10,-28,29,108,23
253,320,49,-24,-1,-59,146,281,965
178,197,-66,-93,-197,-217,54,290,146
145,219,-63,4,-67,-184,21,168,243
76,109,-70,-66,-122,-114,5,166,-16
20,32,-41,-57,-76,-84,0,80,-126
37,47,-37,-41,-74,-146,-27,98,-143
69,252,7,-31,39,-53,81,259,623
38,57,16,-19,2,-49,13,58,116
18,113,-38,-61,-127,-139,1,131,-102
150,270,-71,25,-94,-25,153,141,549
148,218,-86,-27,-87,-93,81,216,370
191,492,-123,-117,-82,-113,187,402,837
161,141,63,27,-3,-105,68,232,584
220,285,87,-22,-37,-76,81,257,795
81,88,-26,-23,-113,-141,12,124,2
74,204,-44,31,-136,-173,-21,121,56
0,19,-11,-27,-27,-12,6,60,8
-63,-29,-60,-42,-83,-155,-72,95,-409
-13,43,-20,4,-58,-81,-35,62,-98
-33,26,-35,-12,-71,-88,-41,69,-185
861,1081,-225,-230,-272,-244,584,1003,2558
10,41,-12,-15,-40,-42,12,50,4
31,69,-35,-44,-64,-102,38,93,-14
-9,7,-36,-40,-60,-51,-7,30,-166
89,104,-76,-60,-81,-94,29,174,85
0,22,4,1,2,-17,1,35,48
21,152,-120,-77,-218,-410,-98,218,-532
-38,-10,-98,-59,-149,-220,-103,185,-492
94,137,-15,-33,-85,-38,39,161,260
-6,20,-5,-7,-35,-13,6,37,-3
93,130,-26,4,-32,-52,82,178,377
25,101,-73,-93,-151,-198,-53,187,-255
71,113,-69,-43,-117,-162,9,147,-51
34,83,-64,-71,-136,-162,8,176,-132
56,103,-23,12,-99,-115,-13,88,9
2,146,-15,-61,-52,-201,-35,224,8
-1,51,0,-25,-12,-37,-13,40,3
198,278,80,44,-32,-61,2,293,802
325,495,-62,-37,-324,-224,-48,715,840
51,73,64,-30,66,5,25,80,334
53,66,42,-22,42,-16,32,94,291
-43,24,-338,-263,-359,-496,-191,443,-1223
13,18,-96,-18,-114,-112,-41,97,-253
22,21,-19,11,-11,-21,9,13,25
39,23,-40,-32,-43,-105,-7,61,-104
10,7,-71,-76,-172,-200,-63,113,-452
29,36,-25,-19,-58,-10,14,47,14
5,136,7,-73,-84,-58,-52,134,15
-2,-4,-22,-21,-78,-49,-9,41,-144
-52,-34,-53,-4,-92,-40,-26,56,-245
37,45,-1,25,-41,-33,3,76,111
4,6,-19,-15,-9,-16,-3,22,-30
30,86,-56,-18,-10,-10,56,64,142
-1,1,3,-4,-28,-33,-8,39,-31
19,14,-35,-45,-77,-31,4,75,-76
87,41,-6,85,-63,-9,28,80,243
65,104,33,81,-148,-83,-26,127,153
120,98,-60,-51,-17,-53,60,129,226
90,160,-87,-44,-105,-162,54,130,36
31,56,-146,-44,-233,-222,-56,175,-439
-44,-1,-50,-50,-61,-100,-60,71,-295
149,553,294,165,17,-98,-58,464,1486
-15,80,-20,-37,-61,-262,-104,217,-202
57,79,-18,-23,-2,-44,27,115,191
8,42,9,8,-24,5,3,78,129
23,23,-25,9,-36,-36,4,32,-6
-2,17,-39,-20,-55,-80,-5,72,-112
-18,6,-35,-42,-62,-59,1,82,-127
208,319,15,43,-154,-144,73,436,796
49,48,-25,-13,-73,-72,-8,70,-24
13,12,-29,-1,-60,-28,18,43,-32
-30,-15,-74,-59,-116,-123,-60,87,-390
160,221,50,-35,-2,-40,53,224,631
115,119,42,12,-60,-79,-47,193,295
90,104,-42,-25,-118,-76,-19,176,90
7,26,-38,-62,-76,-106,-10,125,-134
11,62,-14,-19,-85,-50,0,112,17
37,74,-58,-46,-137,-129,-38,180,-117
-8,4,-21,-18,-31,-8,2,13,-67
-38,-19,-64,-71,-81,-151,-53,85,-392
44,33,-49,-3,-91,-100,27,87,-52
-5,0,-41,-53,-77,-100,-32,75,-233
41,70,-62,-35,-154,-85,4,103,-118
53,37,2,-17,-20,-93,14,125,101
70,74,-120,-16,-91,-101,63,77,-44
20,40,-3,-3,-3,-31,8,27,55
122,172,-126,-22,-115,-141,58,171,119
244,309,-42,-49,-150,-215,58,378,533
19,11,-23,-37,-72,-107,-29,117,-121
107,248,-9,-22,-23,-133,105,281,554
-13,100,-73,-95,-97,-179,-55,148,-264
218,200,9,-51,-231,-175,45,338,353
33,122,-165,-157,-258,-352,-37,285,-529
3,-17,-57,-44,-109,-75,-23,72,-250
-45,25,-47,-102,-71,-96,-21,110,-247
19,1,-58,-16,-98,-113,-8,85,-188
26,213,-89,-78,-61,-109,93,238,233
1,11,-15,-1,-36,-28,0,24,-44
11,23,-13,-3,-37,-30,6,48,5
63,15,-29,30,-47,-70,21,59,42
162,188,4,-65,-12,-110,64,219,450
7,14,-6,4,-2,-20,-5,12,4
332,447,36,-14,-54,-46,214,547,1462
73,115,-19,-38,-79,-109,8,135,86
98,99,13,-12,-2,-64,53,149,334
61,61,-34,-32,-53,-82,21,128,70
-2,23,-2,26,-42,-19,7,42,33
32,37,-23,-29,-54,-38,24,58,7
-13,28,-17,-19,-36,-14,-4,35,-40
122,183,-53,-35,-104,-109,31,220,255
45,35,-34,-24,-48,-80,13,72,-21
15,95,0,-13,-1,-20,18,93,187
83,83,-113,-51,-166,-185,3,153,-193
53,70,-24,10,-49,-57,20,51,74
73,-4,-90,15,-124,-150,-10,26,-264
1,14,-18,-5,-11,-19,4,16,-18
68,123,6,-12,27,-29,37,101,321
13,43,-2,6,-31,-50,0,64,43
19,10,-24,13,-39,-24,9,23,-13
25,40,-41,-17,-78,-65,10,66,-60
-88,-17,-109,-55,-133,-163,-67,116,-516
86,49,4,17,-30,-63,35,101,199
24,-4,-23,-10,-58,-56,7,47,-73
27,50,-36,-27,-59,-62,-1,54,-54
40,96,-17,-32,-23,-82,3,144,129
43,132,13,-16,-2,-129,15,139,195
-25,-4,-18,-1,-22,-62,-20,42,-110
20,29,-26,-56,-33,-117,-34,77,-140
27,67,-91,-107,-135,-192,-41,283,-189
19,25,-9,-31,-26,-37,5,33,-21
60,122,-73,-23,-156,-136,35,182,11
40,111,-39,-88,-103,-176,-11,225,-41
229,299,-189,-50,-302,-359,14,400,42
73,104,-6,26,-41,-50,37,79,222
-12,26,-46,-42,-55,-71,-17,60,-157
6,154,-66,-14,25,7,67,170,349
-48,-22,-85,-70,-108,-115,-55,91,-412
-61,11,-70,-40,-109,-117,-45,90,-341
-69,-22,-72,-72,-102,-123,-84,80,-464
-75,-17,-85,-109,-127,-125,-77,111,-504
42,128,-145,-145,-263,-304,-72,276,-483
31,135,-2,11,-2,-23,29,125,304
-6,28,-42,-17,-57,-94,-10,61,-137
56,63,31,-17,-5,-49,13,101,193
38,87,-31,-25,-52,-105,3,108,23
95,59,25,21,-32,-33,20,123,278
185,491,-368,-301,-763,-938,-207,957,-944
466,390,76,35,-7,-33,240,584,1751
86,114,-21,5,-21,-83,27,122,229
-30,14,-43,-18,-108,-101,-25,108,-203
30,50,-3,-30,-30,-40,1,122,100
-10,-6,-196,-120,-373,-277,-56,165,-873
150,267,-65,-71,-45,-119,93,224,434
-32,20,-69,-54,-91,-81,-35,67,-275
4,-4,-41,2,-89,-50,2,59,-117
322,408,-134,-308,-500,-157,112,866,609
72,82,24,-36,9,-57,43,153,290
13,46,-20,-50,-41,-66,3,51,-64
-22,-6,-35,-3,-62,-62,-24,44,-170
-3,42,-47,-23,-76,-134,-26,100,-167
-10,20,-12,-35,-37,-46,-8,40,-88
91,188,-37,-71,-105,-102,29,216,209
37,55,21,37,-40,28,30,85,253
3,16,-1,-13,-7,-21,-13,29,-7
19,18,14,-6,-14,-9,-4,37,55
53,30,-57,-47,-26,-68,21,87,-7
-17,-15,-23,-2,-36,-40,-27,36,-124
55,110,-52,-37,-97,-101,24,128,30
56,135,-12,-32,-32,-79,30,223,289
156,254,14,-52,-54,-165,57,294,504
46,22,-68,14,-94,-85,8,27,-130
25,45,-27,-27,-48,-51,5,31,-47
19,61,9,-7,-30,-32,-14,67,73
59,89,-47,-34,-55,-99,27,161,101
16,28,-19,-25,-17,-7,9,36,21
-39,30,-183,-142,-352,-484,-134,346,-958
92,115,3,-53,-61,-59,18,179,234
13,24,-2,-5,-24,-52,-16,25,-37
96,141,-23,-31,-109,-78,43,203,242
49,29,-19,-13,-113,-97,-21,87,-98
-41,-28,-65,-72,-83,-141,-81,91,-420
0,40,-34,-34,-80,-37,3,78,-64
39,63,-67,-61,-104,-216,-46,111,-281
15,54,-56,-41,-162,-101,-1,167,-125
46,71,-7,9,-5,-34,22,73,175
-107,-28,-133,-109,-113,-185,-91,101,-665
13,16,-38,-13,-51,-54,1,39,-87
-58,-22,-104,-49,-123,-155,-70,112,-469
96,53,-7,21,-37,-30,34,103,233
148,184,-5,-33,-12,-159,-7,245,361
53,68,9,-23,-48,-71,-1,71,58
10,29,-11,-33,-25,-60,-11,38,-63
25,43,-7,-24,-19,-62,-22,35,-31
45,31,-34,-20,-94,-109,0,118,-63
31,-1,-115,-38,-201,-119,0,67,-376
28,106,-50,-48,-112,-158,-13,173,-74
7,38,-31,-42,-74,-87,-6,53,-142
79,81,-34,0,-26,-37,38,54,155
61,42,-12,-2,-39,-68,22,96,100
108,118,-3,68,-55,-65,83,194,448
12,31,-42,-30,-28,-17,12,52,-10
25,58,-3,11,-63,-93,-11,54,-22
10,-11,-67,-55,-66,-92,-17,57,-241
5,22,-24,-4,-28,-8,20,29,12
13,10,-26,-3,-33,-21,5,30,-25
5,17,-22,-7,-27,-2,21,30,15
4,21,-22,0,-29,-13,21,27,9
-104,-8,-99,-50,-162,-235,-111,113,-656
-11,24,-10,-2,-66,-33,-4,70,-32
30,30,-17,-21,7,-5,27,34,85
-20,8,-61,-70,-95,-140,-62,81,-359
46,48,-6,5,-34,-17,23,48,113
87,120,56,53,8,-24,34,181,515
64,112,-19,-13,-44,-33,27,99,193
40,61,7,-54,10,-49,-7,84,92
134,254,11,-51,-1,-86,57,276,594
-10,23,26,8,13,3,4,59,126
-34,18,-21,-33,-57,-66,-19,54,-158
-13,65,-2,-17,-57,-25,-9,54,-4
47,54,13,-20,-10,-33,-2,100,149
38,79,-8,-4,-82,-59,8,88,60
38,45,53,-9,10,-26,18,65,194
26,73,-5,-11,-48,-88,0,122,69
98,74,-16,38,-59,-94,58,156,255
114,115,-18,-3,-189,-179,-7,275,108
40,90,-58,-27,-36,-70,12,76,27
22,84,-26,-14,-38,-53,13,65,53
29,61,-42,-34,-61,-55,-1,66,-37
17,70,-54,-68,-128,-83,-43,163,-126
51,46,0,8,-27,-38,8,65,113
59,24,63,59,5,-24,18,111,315
0,31,-19,-16,-13,-21,18,44,24
44,82,-26,-21,-108,-82,-13,91,-33
184,489,-114,-68,-450,-724,-97,635,-145
26,19,11,-48,12,-139,-50,112,-57
25,38,-26,-67,-100,-80,-1,195,-16
16,55,-39,-28,-52,-42,16,70,-4
39,92,6,-26,-43,-77,18,74,83
49,69,17,-6,20,-33,26,97,239
458,1068,-385,-58,-749,-862,-43,777,206
33,7,-38,-42,-53,-149,-44,45,-241
16,11,-61,-54,-154,-71,-5,98,-220
-4,15,25,-1,-15,-27,-6,38,25
-27,-18,-71,-67,-78,-101,-46,72,-336
-6,-9,-75,-50,-134,-81,-30,61,-324
16,22,-39,-25,-70,-51,7,77,-63
18,-2,-2,-15,-41,-77,-5,67,-57
-2,10,-40,-15,-73,-68,-17,48,-157
-7,2,-35,-9,-89,-48,-18,47,-157
17,89,-150,-89,-286,-302,-71,204,-588
34,13,-17,1,-36,-39,3,37,-4
41,46,-78,-44,-43,-95,6,81,-86
14,45,-60,-40,-134,-88,-7,103,-167
17,65,-42,-17,-59,-101,-35,57,-115
12,10,-7,1,-15,-15,13,10,9
14,32,-42,-28,-30,-18,13,53,-6
14,24,-13,-20,-31,-38,-4,39,-29
50,90,-41,-48,-88,-92,32,146,49
62,-6,-23,27,-107,-63,27,69,-14
0,36,2,-2,-22,-10,-6,27,25
7,9,-43,-40,-36,-52,-11,46,-120
43,51,18,-1,-13,-5,9,77,179
61,58,-15,-38,-21,-53,-20,63,35
8,34,-8,-24,-7,-27,14,48,38
-29,16,-72,-72,-103,-126,-44,96,-334
59,164,-28,-30,-124,-62,70,206,255
7,22,-7,0,-10,-12,8,23,31
-13,1,-14,-11,-5,-24,-23,22,-67
22,43,-20,-17,-42,-78,-9,40,-61
-7,12,-36,-36,-48,-66,-7,60,-128
14,126,-100,-70,-131,-156,35,188,-94
46,48,9,33,-8,19,38,55,240
11,34,-17,-27,-19,-59,3,75,1
-62,65,14,-43,-68,38,-49,2,-103
28,65,-24,-16,-63,-77,32,102,47
13,59,-32,-2,-81,-60,2,48,-53
69,136,-8,-48,-70,-166,4,211,128
11,70,-22,-25,-19,-32,5,65,53
21,51,1,-5,4,-43,-2,75,102
69,29,-51,-26,-137,-94,8,140,-62
64,85,18,-23,-25,-39,28,89,197
-17,2,20,-25,-32,-42,-15,92,-17
42,68,-16,-17,-32,-76,39,107,115
27,76,-33,-15,-72,-84,-11,93,-19
-11,94,-9,-62,6,-58,10,149,119
-12,25,-25,-11,-44,-53,-25,45,-100
23,30,4,-4,4,-15,20,55,117
-30,4,-22,-16,-46,-60,-36,36,-170
45,108,-37,-28,-68,-162,-4,95,-51
12,-13,-17,-12,-16,-22,6,18,-44
10,20,4,1,4,-14,7,19,51
30,43,-6,-30,-13,-44,-7,57,30
12,34,-12,-13,-59,-51,16,52,-21
2,2,-45,-40,-88,-87,-17,76,-197
24,15,-50,-15,-98,-71,-19,67,-147
57,75,10,0,8,-40,38,101,249
73,77,-10,-6,-5,-11,29,72,219
123,293,-45,-84,-97,-173,7,318,342
142,274,-136,-36,-146,-328,2,310,82
51,100,33,-14,-53,-109,-14,151,145
4,22,-71,-25,-89,-80,-4,86,-157
20,39,-12,-5,-9,-28,9,27,41
38,123,-37,-36,-108,-113,11,173,51
24,46,5,8,-37,-71,8,68,51
173,200,20,-79,-31,-111,71,279,522
25,103,-130,-63,-170,-259,-28,208,-314
98,169,4,-10,-83,-189,-24,159,124
47,89,-7,-18,-21,-57,14,70,117
-42,-20,-38,-27,-63,-74,-45,27,-282
119,210,-25,-65,-24,-148,38,223,328
48,63,-80,-33,-104,-190,-20,129,-187
33,53,-22,-9,-12,-9,34,24,92
116,220,62,3,-15,-99,28,226,541
23,73,-29,-12,-48,-59,11,80,39
11,25,-21,-21,-54,-61,-1,84,-38
89,133,29,-15,-40,-57,18,161,318
-12,8,-30,-42,-31,-28,6,49,-80
4,36,-15,-14,-57,-25,21,82,32
21,69,-34,-41,-32,-87,-26,92,-38
29,40,-6,-11,-20,-31,27,44,72
58,30,-50,-68,-118,-229,-49,240,-186
295,325,-207,54,-343,-351,13,235,21
-24,-8,-63,-19,-69,-49,-15,54,-193
40,87,-29,-83,-164,-205,-41,231,-164
73,86,-9,-17,-84,-50,20,217,236
59,64,1,-7,-19,-48,26,89,165
-11,23,-16,-17,5,0,0,26,10
62,105,15,-30,30,-69,2,90,205
16,31,-18,-29,-21,-63,0,55,-29
13,60,-10,-35,-14,-71,8,80,31
17,45,-2,3,-37,-16,44,60,114
21,47,-52,-30,-60,-158,-26,94,-164
22,42,-79,-30,-128,-237,-58,102,-366
151,158,2,67,-73,-41,72,227,563
16,44,6,-3,12,-2,15,50,138
14,16,-30,-16,-62,-51,15,37,-77
31,47,-36,-67,-94,-69,11,103,-74
36,133,-49,-21,-84,-73,12,76,30
-20,60,-70,-51,-8,-49,20,113,-5
9,33,0,-11,-23,-14,10,25,29
0,10,-21,-7,-8,-11,10,22,-5
-35,123,-38,-49,-94,-248,-90,164,-267
32,118,-11,-49,-76,-189,-46,161,-60
235,226,37,-66,65,-41,90,178,724
9,10,-49,-10,-44,-58,-29,56,-115
10,15,-19,-10,-10,-49,5,44,-14
73,164,-5,-44,-59,-150,18,126,123
23,166,-23,-11,0,9,63,199,426
-45,-2,-51,-26,-104,-81,-41,74,-276
12,23,-39,-51,-22,-41,34,56,-28
26,55,-29,11,-14,-37,27,36,75
0,14,-8,5,-16,-66,-4,55,-20
45,98,12,-2,-2,-43,27,81,216
21,29,-51,-28,-44,-63,-3,31,-108
53,40,-1,-25,-65,-103,-15,100,-16
155,246,11,62,-77,-95,24,198,524
48,26,-26,-31,-44,-108,-5,51,-89
100,146,42,-5,-1,28,52,130,492
-30,-8,-37,-12,-79,-107,-54,57,-270
-21,34,-22,-23,-42,-37,-20,45,-86
33,79,23,4,9,-11,17,84,238
38,52,-17,-26,-16,-82,-2,56,3
3,58,-16,-18,-114,-59,-3,85,-64
-1,56,-52,-65,-93,-158,-33,145,-201
37,76,-42,-2,-23,-12,49,43,126
15,23,-21,5,-16,11,24,30,71
122,118,129,58,58,39,49,179,752
15,52,-12,-9,-67,-78,-1,64,-36
-15,8,-38,-51,-39,-69,-17,25,-196
17,26,-31,1,-62,-73,2,108,-12
42,68,-9,-1,-39,-18,24,60,127
0,26,-34,-15,-121,-65,2,108,-99
23,170,-19,-17,-36,-52,46,136,251
-18,28,-49,-47,-48,-144,-40,89,-229
13,52,-33,-13,-111,-132,-6,148,-82
224,241,-67,3,-20,-116,98,247,610
98,236,12,-46,-18,-146,0,235,371
93,79,-58,-60,-101,-103,26,74,-50
78,113,-21,-22,-35,-77,39,164,239
20,14,-9,-3,1,-28,1,12,8
-7,14,-16,-12,-40,-10,17,27,-27
35,46,-13,-2,1,9,40,20,136
12,61,-47,-43,-83,-92,-28,83,-137
2,28,-21,-24,-31,-62,-2,27,-83
12,27,-6,-16,18,1,18,9,63
19,60,-26,-14,-24,-12,38,81,122
-35,3,-29,-16,-40,-96,-54,32,-235
36,41,-26,-3,-56,-58,1,26,-39
47,38,-48,-39,-97,-67,13,91,-62
25,30,-1,-1,-11,-47,13,49,57
-2,27,-22,13,-20,-39,-5,42,-6
8,62,5,-20,-68,-48,2,49,-10
-40,18,-42,-2,-67,-105,-47,74,-211
52,149,-39,-14,-104,-113,26,145,102
10,53,-24,-28,-32,-94,-33,27,-121
14,17,2,-7,2,-17,4,6,21
21,-4,-48,-79,-37,-103,-22,65,-207
0,111,-47,-35,24,-7,38,129,213
7,81,-54,-22,-13,-10,23,97,109
13,-1,-27,-24,-40,-39,7,51,-60
-17,10,-26,-40,-70,-59,-27,79,-150
-37,1,-72,-46,-101,-139,-73,96,-371
8,-5,-29,2,-54,-54,-6,47,-91
16,21,-36,-15,-139,-192,-78,90,-333
-44,16,-79,-58,-114,-198,-66,99,-444
-8,16,-23,-39,-52,-42,-14,32,-130
25,150,-64,-73,-81,-150,10,131,-52
37,94,3,-24,18,-10,27,92,237
-16,31,-9,-32,-41,-5,2,52,-18
13,70,-4,-33,-27,-88,3,61,-5
86,54,-6,8,-32,-78,-1,137,168
16,37,-2,-23,-60,-53,0,78,-7
8,8,-12,-9,-13,-9,14,12,-1
43,19,-30,-1,-67,-75,-5,50,-66
57,84,-23,-66,-51,-28,42,130,145
-25,-14,-41,-37,-38,-42,-14,32,-179
-2,87,-20,-31,-5,-2,56,115,198
9,64,5,0,-23,-34,9,65,95
2,16,-19,-32,-26,-41,-2,45,-57
21,36,-27,-2,-59,-52,12,88,17
11,21,-20,-27,-47,-81,-24,47,-120
58,99,-37,-32,-55,-116,18,116,51
-10,50,-27,-57,-57,-113,-38,61,-191
12,42,-149,-77,-220,-307,-55,117,-637
57,177,-29,-34,-39,-62,57,150,277
42,86,-12,9,-35,-25,48,95,208
83,246,-46,-98,-126,-269,-21,266,35
-9,-1,-28,5,-38,-69,-20,24,-136
4,104,-49,-33,-42,-7,46,157,180
-30,-3,-32,-5,-104,-45,-3,71,-151
47,60,-57,-39,-138,-182,-32,107,-234
73,28,-57,-22,-94,-120,-2,65,-129
-13,34,-17,-43,-33,-60,1,42,-89
-8,-12,-34,0,-60,-86,-30,43,-187
29,80,-41,-24,-77,-93,0,108,-18
-47,-5,-57,-43,-60,-89,-47,39,-309
57,113,-10,-43,-43,-134,3,106,49
19,38,-36,-29,-43,-94,-18,110,-53
35,28,-6,-8,-44,-52,4,55,12
48,78,-32,2,-61,-68,16,71,54
47,104,-21,11,-34,-89,-2,68,84
44,99,-22,-53,-16,-90,-4,126,84
13,9,-20,7,-33,-17,15,9,-17
1,2,-13,3,-43,-30,-8,59,-29
-34,101,-24,-51,-51,-149,-65,112,-161
29,70,-31,6,-42,-49,1,57,41
-3,44,-19,-41,-61,-67,-2,86,-63
-19,48,-26,-34,-58,-151,-32,100,-172
11,23,-19,-1,-20,-12,12,26,20
87,141,-21,26,-61,-60,27,114,253
6,54,-12,-18,-35,-44,14,56,21
21,55,7,-45,-49,-119,-59,116,-73
20,63,-4,-23,1,-25,16,60,108
56,89,-10,-2,-17,-37,17,90,186
17,26,2,3,4,-30,1,33,56
19,-11,-34,-17,-32,-62,-19,43,-113
-13,9,-28,-24,-45,-21,-8,27,-103
30,61,29,0,5,-67,-16,67,109
28,-4,-55,10,-133,-132,-24,51,-259
74,102,42,-1,21,-51,11,118,316
10,65,-50,-102,-60,-62,14,110,-75
82,161,-77,21,-114,-73,52,38,90
25,44,6,26,-18,-44,-6,48,81
238,210,-6,0,-16,-32,48,257,699
623,683,-87,-28,21,-66,406,625,2177
42,58,-65,-38,-105,-115,12,111,-100
-5,21,-19,-10,-24,-20,5,32,-20
1,24,-30,-56,-61,-109,-32,72,-191
85,103,-10,-2,-36,-74,74,135,275
11,46,-23,-13,-39,-40,0,50,-8
-7,27,-7,-35,-36,-2,2,57,-1
51,66,-43,-54,-92,-189,-35,154,-142
17,55,-38,-48,-72,-66,-8,88,-72
15,23,-33,-11,-26,-51,1,30,-52
12,59,-97,-51,-110,-107,-2,80,-216
4,15,0,-1,-2,2,17,14,49
47,109,-12,-12,3,-21,48,89,251
34,15,21,0,14,-10,3,31,108
48,61,-7,-2,-15,-48,32,73,142
14,14,-22,1,-38,-17,8,31,-9
-6,11,-4,-2,-12,-26,-15,32,-22
96,95,-11,-23,-110,-190,-17,164,4
8,44,10,2,-10,-21,25,30,88
4,30,-25,-8,-40,-43,-2,54,-30
46,96,10,9,9,-70,-8,86,178
12,19,-15,-17,-17,-37,-3,15,-43
49,98,1,-31,-71,-188,-71,113,-100
69,42,-34,-51,-67,-101,32,92,-18
4,8,-53,-40,-63,-108,-22,90,-184
53,42,-35,-5,-73,-99,5,100,-12
20,59,-14,-31,-34,-108,-9,92,-25
67,114,-12,-31,-4,-83,24,159,234
25,86,-173,-118,-261,-384,-73,169,-729
-31,-6,-84,-71,-131,-186,-62,178,-393
-7,5,-26,5,-27,-56,-16,32,-90
10,49,-35,-52,-72,-92,-37,63,-166
-4,17,-26,-28,-40,-110,-60,71,-180
67,69,-49,13,-88,-155,24,57,-62
-11,7,-48,-35,-96,-50,-2,61,-174
11,35,-24,-12,-50,-53,-3,26,-70
82,175,-19,-11,32,-52,56,195,458
7,20,-33,-36,-43,-59,9,59,-76
-10,57,-61,-36,-120,-238,-42,149,-301
8,101,-1,-51,5,24,17,102,205
18,29,6,-8,-39,-36,5,51,26
18,40,-37,-15,-53,-84,-16,68,-79
16,11,-4,-10,4,-4,12,24,49
44,97,-40,-31,-50,-52,41,118,127
29,87,-23,10,9,10,64,72,258
-24,-9,-28,-32,-30,-48,-31,20,-182
36,7,-52,-10,-111,-97,12,8,-207
91,127,5,-37,27,-39,49,123,346
25,28,-23,-18,-32,-53,14,43,-16
54,79,-37,-21,-93,-40,22,155,119
58,64,-58,-22,-74,-74,22,109,25
1,8,-32,-16,-45,-60,-11,53,-102
55,36,-7,1,-50,-75,15,98,73
11,13,-6,-21,-19,-54,-9,37,-48
12,35,-17,-10,-30,-6,3,33,20
28,18,4,-14,-87,-87,0,117,-21
8,36,-18,0,-17,-36,-3,31,1
63,140,-28,-40,-7,-27,60,158,319
28,41,-8,-5,-27,-54,11,32,18
127,161,-10,29,-44,-107,28,147,331
31,54,-61,-55,-114,-126,-21,108,-184
-4,45,-1,-11,-30,-104,-18,83,-40
148,122,69,-5,-42,-47,33,252,530
17,6,0,-13,-8,-16,1,13,0
34,108,-10,-23,-63,-139,-35,126,-2
85,143,-14,-43,57,-4,56,139,419
18,-11,-42,-25,-58,-65,-7,25,-165
41,46,4,10,-12,-15,27,83,184
-53,-20,-51,-8,-70,-123,-55,57,-323
66,105,11,-18,-32,-50,8,113,203
32,67,14,16,-3,-19,11,67,185
-50,-31,-18,-25,-39,-82,-48,29,-264
43,61,-43,25,-36,-52,18,26,42
24,47,-14,-8,-34,-49,-6,61,21
73,217,-119,-125,-93,-44,87,93,89
52,109,29,11,-44,-108,8,141,198
1,24,-27,-10,-26,-41,-8,47,-40
5,1,-49,-13,-94,-39,7,31,-151
30,39,21,-5,3,0,18,55,161
40,41,-23,-20,-67,-118,-35,71,-111
58,120,-10,-13,-35,7,62,122,311
-20,8,-23,-10,-20,-43,-26,16,-118
23,21,-3,10,-13,-20,1,20,39
21,22,-17,1,-27,-52,8,46,2
-18,71,-58,-40,-40,-16,18,112,29
6,12,-25,-28,-17,-33,1,16,-68
17,92,-3,-49,2,-67,22,107,121
-49,-8,-70,-52,-119,-207,-70,97,-478
23,23,-40,-21,-41,-60,5,37,-74
10,13,-63,-27,-160,-90,-14,43,-288
0,11,-27,-42,-60,-85,-27,85,-145
49,29,-29,0,-33,-47,27,36,32
4,46,-29,-38,-127,-106,-23,73,-200
100,154,-13,-11,-69,-97,65,166,295
3,77,-9,-33,-81,-95,-21,119,-40
-3,-1,-19,-12,-30,-22,-14,22,-79
37,28,-58,-53,-101,-87,-2,112,-124
1,13,-13,-11,-30,-63,-16,44,-75
17,11,-18,-33,-13,-36,-4,2,-74
37,74,18,-31,5,-35,29,84,181
468,736,-261,134,-628,-640,77,371,257
29,38,-21,-4,-105,-68,16,82,-33
-26,-15,-28,-9,-35,-44,-31,19,-169
-5,13,-9,-38,-50,-45,-13,36,-111
4,76,-2,-42,-54,-147,-55,86,-134
-3,6,-13,-20,-29,-21,-5,23,-62
10,19,-33,-44,-97,-172,-48,85,-280
14,60,6,-8,-3,-3,25,53,144
16,72,-1,6,-42,-85,-25,57,-2
71,102,-40,-54,-123,-122,31,171,36
32,29,7,-11,-74,-73,-4,119,25
5,12,-72,-69,-106,-141,0,61,-310
28,68,-29,-27,-40,-109,-24,67,-66
23,15,-1,-19,-97,-49,11,66,-51
64,69,-9,-9,-15,-42,21,67,146
-4,28,-42,2,-80,-76,-22,63,-131
34,42,-75,-46,-95,-118,-22,66,-214
27,30,-35,-3,-45,-28,23,27,-4
110,193,-57,-35,-167,-160,31,211,126
-41,-13,-57,-69,-45,-137,-53,54,-361
36,62,5,-40,-1,-56,-6,95,95
125,281,-85,-80,-5,-91,77,251,473
9,34,-58,-25,-56,-182,-56,106,-228
115,190,-92,-29,-93,-140,101,187,239
2,17,0,-19,-16,-46,-9,28,-43
-100,-21,-118,-65,-97,-232,-97,73,-657
-21,12,-37,-23,-49,-35,-10,54,-109
-47,-49,-68,-23,-79,-88,-41,29,-366
67,126,-11,138,-141,-88,-21,202,272
20,28,-21,-11,-35,-46,11,27,-27
16,16,-9,-18,-16,-40,-2,42,-11
191,286,63,7,-1,-139,41,302,750
58,117,-89,2,-78,-48,47,126,135
66,161,-67,-65,-175,-184,7,192,-65
20,174,-83,-92,-185,-312,-38,247,-269
65,67,-54,-51,-80,-101,28,138,12
31,82,-18,-24,-35,-63,32,126,131
20,46,8,-17,2,-62,-26,71,42
31,41,-28,-29,-48,-100,-7,43,-97
302,423,-93,-139,-172,-194,147,482,756
-22,34,-30,-44,-45,2,10,54,-41
18,29,4,10,-2,-36,-4,47,66
67,55,1,-32,-14,-79,11,69,78
2,13,-7,-11,-20,-11,9,16,-9
-20,20,-42,-51,-71,-51,-12,66,-161
160,239,15,15,1,-55,95,253,723
29,81,-15,4,-37,-39,18,47,88
87,186,8,-6,-71,-79,36,188,349
-7,48,-72,-64,-144,-225,-82,128,-418
31,18,-42,1,-47,-15,17,27,-10
-44,-37,-29,-28,-63,-84,-43,59,-269
26,16,-12,-11,-16,-15,13,29,30
67,74,-43,-63,-91,-76,44,61,-27
8,29,-22,-15,-30,-71,-27,29,-99
131,217,-11,-7,-35,5,138,176,614
-2,-2,-24,-11,-23,-7,22,30,-17
16,6,-25,3,-33,-45,-5,33,-50
69,75,-43,-19,-13,-66,22,71,96
49,47,-13,-4,-43,-17,7,82,108
39,93,-53,-57,-121,-201,-32,111,-221
40,70,-24,-8,-38,-38,38,61,101
4,21,-50,-15,-167,-48,25,89,-141
18,10,-10,-23,-5,-35,-5,6,-44
55,125,6,-51,54,-39,89,149,388
43,109,-56,-33,-62,-73,5,91,24
59,2,-32,23,-119,-71,19,67,-52
103,100,93,77,3,4,47,160,587
50,65,14,-16,3,-36,31,54,165
-2,19,-24,13,-47,-25,4,40,-22
96,264,-98,-88,-231,-484,-39,342,-238
18,24,0,1,0,-12,14,26,71
1,3,6,-1,-7,-18,-10,14,-12
29,44,-13,3,-29,-18,29,51,96
13,23,-14,-20,-55,-54,-8,72,-43
-30,117,-44,-60,-9,2,45,137,158
-4,-6,-54,-27,-91,-62,8,57,-179
134,234,55,-86,87,-57,61,228,656
19,43,17,26,-30,8,-5,89,167
-20,12,-38,-25,-66,-124,-36,77,-220
-13,-8,-50,-25,-57,-110,-40,59,-244
17,42,-33,-48,-49,-107,-32,83,-127
63,114,29,-31,9,-20,39,117,320
78,110,-64,-108,-88,-113,16,203,34
28,38,-33,-10,-50,-33,22,18,-20
104,281,-39,-49,-192,-213,45,221,158
120,238,-22,-20,-5,-87,49,187,460
82,82,4,2,-24,-84,5,117,184
82,182,-26,-93,-140,-64,71,349,361
14,29,-40,-31,-55,-42,8,64,-53
41,79,-29,-15,-87,-51,31,101,70
38,75,-57,-68,-52,-146,-16,133,-93
97,92,132,75,35,15,9,167,622
53,64,-4,83,-61,-36,29,83,211
34,43,-66,5,-88,-98,-20,49,-141
38,83,-63,9,-49,-85,30,120,83
16,71,-14,-37,-5,-19,34,81,127
95,93,20,60,-26,-31,51,153,415
-16,78,-56,-57,-152,-90,-17,151,-159
184,330,-156,-123,-215,-196,65,411,300
97,83,6,0,-37,-25,51,136,311
45,-44,-54,31,-103,-51,34,32,-110
9,-2,-39,-17,-60,-40,3,56,-90
5,53,-49,-17,-135,-106,-2,106,-145
94,155,-124,-107,-227,-218,-20,289,-158
297,380,-39,-124,-47,-146,149,362,832
16,28,-26,-44,-50,-33,-15,67,-57
15,12,-26,-4,-43,-31,6,46,-25
123,247,-27,-29,-54,-138,75,270,467
49,18,-69,27,-154,-111,22,123,-95
-22,14,-2,7,-45,-55,-28,39,-92
-17,8,-14,-1,-52,-26,-15,40,-77
-37,70,-72,-24,-131,-254,-102,172,-378
-26,66,-80,-43,-13,-20,65,125,74
23,207,-233,-170,-316,-441,-66,442,-554
-1,23,5,0,-17,-37,-7,39,5
-38,10,-47,-78,-63,-108,-46,71,-299
42,79,-46,-2,-102,-113,-12,57,-97
-60,-58,-57,-59,-75,-139,-77,74,-451
11,39,-24,-33,-55,-57,7,49,-63
28,63,-38,-33,-30,-57,9,70,12
312,338,-60,39,-73,-176,163,483,1026
-19,57,-75,-18,-158,-322,-112,240,-407
42,92,-71,-22,-130,-100,27,197,35
46,143,-48,1,-137,-96,33,227,169
50,29,-71,-36,-116,-126,10,76,-184
-48,-29,-64,-70,-73,-114,-44,64,-378
-66,-41,-66,-66,-67,-132,-81,47,-472
25,30,-68,-61,-177,-163,-36,176,-274
2,11,-52,-3,-88,-82,-28,50,-190
-54,24,-29,-44,-55,-95,-74,96,-231
315,427,206,40,109,-49,185,474,1707
97,215,-30,21,-82,-60,67,207,435
84,39,-67,-45,-121,-146,-39,58,-237
66,99,-58,-1,-75,-85,-1,115,60
41,59,-15,5,-21,-21,35,46,129
-18,7,-59,15,-86,-63,-26,46,-184
50,28,-55,-9,-84,-74,35,88,-21
44,115,-59,-11,-54,-92,51,108,102
6,18,-7,-7,-30,-27,-13,80,20
27,53,42,11,17,10,7,89,256
8,36,9,5,-19,-20,-6,85,98
-3,47,30,-17,-10,6,-17,96,132
43,46,-16,29,-42,-63,-8,90,79
8,33,37,35,8,-3,-6,90,202
22,46,40,25,11,33,-8,93,262
42,65,-31,0,-99,-120,18,108,-17
-31,5,-25,-12,-16,-116,-61,58,-198
29,21,-161,-48,-185,-274,-55,63,-610
69,66,-16,7,-27,-32,32,98,197
18,133,-63,-7,-107,-122,12,160,24
73,102,-70,-59,-10,-20,81,119,216
63,223,-72,-65,-195,-263,-13,212,-110
80,260,-55,-117,-145,-240,5,224,12
26,53,17,5,-12,-45,-12,65,97
233,472,-138,-43,-135,-132,519,416,1192
17,96,-26,12,-123,-148,27,137,-8
54,66,-47,-45,-89,-103,9,128,-27
31,30,-15,-39,-6,-124,-21,88,-56
3,26,-19,-37,-43,-56,-23,74,-75
20,21,-7,-3,-6,-6,14,29,62
-63,53,-64,0,-219,-292,-130,221,-494
130,200,22,-76,25,-62,61,183,483
85,248,23,-151,-150,-188,-23,439,283
30,110,1,78,-119,-105,-49,187,133
15,35,-44,-23,-84,-92,-3,73,-123
40,23,-134,-108,-201,-178,-16,178,-396
-12,-3,-50,-113,-88,-304,-103,200,-473
16,64,-10,-54,-37,4,26,144,153
97,275,267,105,161,221,64,319,1509
-1,6,-21,-41,-47,-77,-23,42,-162
9,42,-28,2,-55,-103,-19,62,-90
1,27,-58,-69,-59,-67,5,99,-121
79,120,-45,0,-31,-1,57,139,318
-35,85,-125,-68,-192,-238,-50,189,-434
-14,34,-37,-14,-29,-71,-23,58,-96
68,148,-131,-84,-243,-214,5,303,-148
387,510,-256,-221,-457,-495,-36,798,230
32,152,-108,-133,-214,-192,-3,301,-165
53,183,-196,-224,-316,-358,-12,311,-559
17,19,-7,-1,-23,-38,-10,28,-15
67,154,-92,-78,-207,-261,-30,203,-244
1,23,-31,19,-83,-76,2,73,-72
85,50,-27,1,-50,-69,42,65,97
83,169,-79,-31,-68,-181,-20,211,84
3,2,-14,-10,-17,-65,-12,18,-95
-4,11,-13,-21,-51,-53,-11,48,-94
27,21,-2,-4,1,-19,4,22,50
-9,3,-9,-8,-7,-18,-9,11,-46
10,8,-15,-18,-21,-32,8,21,-39
67,92,-111,-78,-141,-219,-8,167,-231
32,43,-3,-6,-66,-81,3,96,18
40,193,-153,-124,-288,-406,-133,362,-509
180,245,-9,-26,-82,-102,-9,276,473
185,278,-182,-34,-188,-261,61,264,123
193,286,-209,-47,-214,-248,100,267,128
44,58,-50,-36,-43,-44,-4,58,-17
10,67,-12,-1,-8,20,16,65,157
52,56,-61,-71,-70,-104,-6,112,-92
21,32,4,-16,3,-21,11,25,59
-66,78,-118,-97,-154,-200,-61,256,-362
-27,-8,-30,-2,-48,-83,-47,29,-216
-43,29,-63,-21,-150,-136,-51,108,-327
73,71,-38,13,-64,-68,20,38,45
178,204,-173,-70,-308,-229,51,297,-50
-27,30,-25,-15,-49,-36,-23,49,-96
-16,50,-79,-4,-162,-134,-83,161,-267
-18,5,-24,-15,-73,-28,-14,84,-83
-72,-34,-71,-86,-78,-105,-71,82,-435
26,34,-29,-1,-57,-70,-5,20,-82
-51,102,-115,-122,3,-22,12,233,40
5,24,-25,-7,-22,-34,-4,35,-28
-22,-1,-34,-12,-86,-63,-24,70,-172
27,54,-37,-21,-53,-35,19,55,9
30,51,-24,-7,-40,-49,14,44,19
78,61,-56,-10,-79,-101,16,145,54
-8,11,-38,-3,-96,-32,-1,80,-87
-1,4,-36,-31,-35,-30,-13,37,-105
3,10,-16,-19,4,-26,6,7,-31
-18,-22,-82,-67,-93,-142,-36,84,-376
13,24,1,-2,-2,-34,3,14,17
87,210,-154,-119,-256,-376,-2,276,-334
28,38,-82,-81,-114,-85,-23,91,-228
3,27,-30,-33,-58,-92,-17,47,-153
46,85,-11,-3,-48,-87,18,104,104
89,92,-41,-24,-66,-61,42,113,144
-39,49,-46,-40,-114,-173,-94,80,-377
26,104,44,7,-29,-113,-26,181,194
78,181,-31,-3,-82,-95,15,208,271
463,612,-14,-85,44,-105,292,539,1746
361,428,40,-50,-53,-250,115,536,1127
9,44,-12,-24,-68,-61,6,68,-38
7,36,-29,-25,-136,-72,10,102,-107
0,33,-51,-72,-114,-126,-38,72,-296
22,27,-22,-18,-17,-10,16,45,43
3,-6,-28,-17,-32,-31,-6,29,-88
4,9,-16,-17,-18,-37,-3,40,-38
15,35,-35,-20,-34,-45,11,59,-14
27,44,-2,-16,-38,-64,11,66,28
-12,10,-4,-8,-24,-19,-16,1,-72
33,34,-55,-17,-60,-64,21,64,-44
0,6,-56,-35,-100,-76,-9,74,-196
66,71,11,-24,17,-59,5,51,138
46,84,-24,-4,-90,-46,21,145,132
10,47,41,21,3,23,20,50,215
21,36,14,-27,26,-5,21,16,102
-4,85,-54,-62,-28,-64,-18,80,-65
132,123,-122,-114,-374,-316,-76,359,-388
56,3,-86,-48,-144,-202,-41,153,-309
14,-35,-49,-51,-62,-101,-39,67,-256
17,68,-31,-31,-13,-30,23,73,76
40,80,4,-40,-48,-56,0,119,99
21,56,-15,-49,-60,-53,7,136,43
0,16,-36,-15,-27,-52,-7,48,-73
17,93,-40,-40,-84,-123,-39,128,-88
53,156,-75,-108,-118,-171,-24,275,-12
133,139,7,35,-93,-92,33,243,405
28,123,-26,2,-95,-67,12,187,164
20,44,-14,15,1,-23,7,48,98
17,45,-42,-67,-107,-192,-44,123,-267
-9,63,-36,-41,-94,-86,-7,75,-135
136,120,57,81,-1,20,46,216,675
153,360,-178,-214,-493,-616,49,527,-412
22,50,-14,-12,-12,-40,4,53,51
24,69,-9,-43,-80,-84,16,78,-29
-1,23,16,1,-30,-15,0,34,28
86,165,-24,-31,21,-85,84,293,509
42,26,-24,-5,-55,-35,16,14,-21
246,413,-130,-83,-304,-167,154,552,681
-15,36,34,39,-54,46,-6,8,88
-37,32,1,-28,-42,30,-44,4,-84
-37,36,4,-29,-40,40,-44,12,-58
-33,26,5,-31,-41,34,-43,4,-79
-39,32,1,-33,-43,37,-46,9,-82
-41,36,3,-33,-48,40,-50,5,-88
-55,70,18,-45,-68,44,-45,8,-73
-47,69,26,-44,-69,55,-38,14,-34
-27,45,10,-35,-47,25,-34,-2,-65
-47,73,22,-41,-65,53,-44,4,-45
-43,61,17,-31,-66,46,-33,3,-46
-55,69,24,-40,-68,50,-48,4,-64
-47,52,13,-42,-61,43,-45,-2,-89
-50,44,7,-42,-49,34,-40,-15,-111
-47,70,21,-48,-75,33,-43,5,-84
-45,48,5,-27,-47,23,-31,-4,-78
-14,28,6,-24,-4,-6,-14,18,-10
-14,28,9,-26,-3,-6,-12,18,-6
-12,26,-1,-19,-4,2,-14,10,-12
-22,40,11,-40,-24,36,-14,13,0
-17,76,29,0,-54,46,-16,37,101
9,56,-18,-33,-49,-105,-30,57,-113
-43,16,-55,-13,-124,-140,-63,91,-331
57,81,-77,-23,-106,-68,31,117,12
-22,34,11,-38,-26,35,-11,13,-4
37,59,-65,-43,-89,-183,-12,70,-226
-31,-12,-157,-107,-178,-237,-75,148,-649
46,44,-10,2,-50,-51,23,94,98
-23,38,11,-40,-23,37,-13,13,0
-28,30,-21,-35,-86,-82,1,123,-98
-1,73,-39,-39,-68,-67,6,85,-50
57,89,-53,-20,-87,-64,29,144,95
13,2,-42,-55,-69,-80,-14,140,-105
59,74,-20,-10,-26,-60,13,93,123
165,214,24,-14,-39,-101,61,238,548
-85,25,-76,-31,-143,-155,-62,89,-438
563,801,-66,-166,-84,-233,229,712,1756
3,18,-22,-5,-23,-16,8,16,-21
129,137,-108,-39,-154,-246,-2,185,-98
69,85,-140,-91,-240,-242,-24,174,-409
1,15,-59,-30,-79,-57,5,54,-150
-16,37,-53,-41,-101,-54,-9,99,-138
30,62,-61,-94,-129,-206,-13,143,-268
-2,13,7,22,-20,-27,-14,45,24
69,168,82,11,-13,-92,-18,193,400
16,47,-12,-16,-86,-67,7,57,-54
12,79,-9,-21,-94,-90,-8,122,-9
135,110,-219,-188,-354,-537,-73,431,-695
25,92,-20,-10,-66,-95,22,124,72
3,53,-11,-15,-63,-99,-12,67,-77
106,204,-30,-69,-136,-163,56,297,265
100,198,-41,-84,-214,-190,31,414,214
56,144,0,19,-186,-190,-72,344,115
11,21,-27,-18,-62,-58,-14,55,-92
154,312,-95,-87,-104,-33,182,339,668
0,18,14,-1,-5,-28,-16,16,-2
-8,-1,-6,-10,0,-16,-4,18,-27
19,17,-5,-3,6,-9,7,15,47
31,40,-4,0,-10,-29,15,32,75
173,164,-170,-193,-285,-229,50,362,-128
154,144,-145,-194,-297,-245,21,386,-176
82,103,18,-26,-17,-123,-8,168,197
106,44,-6,71,-63,-103,45,106,200
65,172,-178,-160,-500,-626,-144,551,-820
-50,9,-68,-54,-142,-178,-89,115,-457
86,110,-15,-22,-34,-56,41,96,206
32,69,-65,-19,-83,-100,-18,90,-94
-7,26,-20,-29,-27,-60,-13,50,-80
13,40,-26,-17,-51,-35,12,68,4
56,150,59,-11,35,-74,5,182,402
6,29,-29,-48,-34,-108,-17,75,-126
48,25,-49,-38,-65,-82,4,96,-61
75,94,14,0,-20,-65,14,108,220
45,77,-93,-106,-99,-132,1,81,-226
20,39,-30,-22,-42,-20,31,20,-4
66,156,-30,-25,-30,-89,60,137,245
89,184,-116,-72,-97,-147,15,196,52
96,164,1,-51,-71,-131,30,215,253
124,133,-49,-91,-124,-162,27,271,129
221,328,-155,8,-301,-308,-4,212,1
10,-10,-54,-29,-72,-69,-7,35,-196
13,65,-29,-16,-43,-140,-5,75,-80
28,41,-30,-47,-107,-104,9,73,-137
69,109,-115,-110,-296,-337,-44,287,-437
127,70,12,56,-64,-76,11,112,248
82,185,-49,-26,-13,-9,64,40,274
48,30,-131,-75,-202,-187,20,97,-400
6,28,29,-16,-39,-38,-2,63,31
-4,19,-51,-24,-100,-100,-22,49,-233
-57,-56,-92,-73,-98,-149,-74,81,-518
15,43,-54,2,-90,-132,-24,98,-142
-27,38,-52,-23,-80,-115,-10,139,-130
46,32,-39,-6,-72,-34,33,63,23
65,15,-52,-19,-144,-104,2,125,-112
6,14,-6,-6,5,-18,-4,18,9
-2,-11,-14,-14,-16,-16,-14,1,-86
-17,-12,-21,-19,-27,-21,-14,9,-122
206,217,-20,24,-99,-126,84,180,466
70,136,-20,-54,-100,-152,21,245,146
6,27,6,-9,-15,-40,-28,26,-27
-11,15,6,-8,-20,-18,-21,29,-28
47,60,17,25,-36,-16,37,132,266
5,26,-32,-27,-24,-71,-9,33,-99
-9,29,-28,-16,-38,-51,-9,43,-79
7,4,-30,-5,-6,-71,-13,35,-79
8,-1,-12,-9,-29,-18,-3,17,-47
31,-15,-20,17,-69,-66,-45,112,-55
44,74,-84,-62,-175,-123,-23,172,-177
-16,12,-19,-67,-74,-40,-31,60,-175
96,69,-121,-67,-178,-251,-35,166,-321
100,180,-66,-47,-141,-164,63,259,184
49,82,46,21,-35,-102,-23,129,167
25,55,-47,-13,-66,-50,19,88,11
68,114,16,-1,-69,-55,21,161,255
64,78,-37,-11,-25,-105,24,116,104
-7,2,-7,-6,-8,-9,-8,3,-40
47,81,-48,-11,-71,-93,26,88,19
-55,-40,-117,-50,-154,-158,-81,116,-539
119,215,-105,-115,-209,-261,5,343,-8
-80,-21,-138,-78,-157,-196,-64,104,-630
-49,-59,-73,-42,-68,-161,-57,46,-463
-66,-62,-78,-30,-105,-110,-64,46,-469
129,135,-69,-37,-189,-188,-18,77,-160
14,64,-24,-23,-51,-57,-5,123,41
12,27,-26,-29,-64,-34,-10,58,-66
-11,-13,-39,-31,-54,-71,-10,21,-208
53,84,-56,-23,-49,-73,-12,112,36
104,215,-70,-32,-395,-420,-53,494,-157
23,64,-43,-36,-95,-128,-38,101,-152
11,250,-81,-103,-148,-369,-21,317,-144
0,-1,-14,-8,-15,-17,-2,10,-47
37,75,-9,-32,-20,-41,10,69,89
25,18,-1,3,-17,-17,11,21,43
108,84,-5,31,-32,-63,46,117,286
32,29,-7,7,-11,-11,10,18,67
-5,84,-49,-43,-71,-92,-5,83,-98
84,102,-36,-51,-93,-152,17,175,46
42,104,-25,12,-81,-93,52,94,105
12,84,-35,-54,-75,-72,-13,101,-52
14,71,-48,-42,-94,-76,-3,88,-90
28,47,-10,-30,-59,-96,12,102,-6
21,101,-81,-53,-159,-79,5,232,-13
46,52,-10,21,-37,-33,21,62,122
64,149,21,-1,11,-63,49,158,388
43,79,-17,8,-67,-60,-1,96,81
45,120,9,14,-18,-20,44,112,306
122,378,-75,-143,-283,-384,-53,548,110
174,278,-248,-160,-259,-469,5,315,-364
39,148,-57,-61,-59,-64,73,101,120
122,211,-132,-40,-225,-254,-78,168,-228
66,140,23,33,-193,-208,-80,381,162
478,739,97,-5,134,-449,116,786,1896
296,420,31,-5,-110,-120,142,561,1215
134,199,3,47,-52,-87,11,267,522
47,40,-27,-46,-75,-139,0,77,-123
84,278,-194,-202,-231,-270,28,364,-143
81,170,14,-58,-11,-65,38,265,434
38,74,-29,-49,-125,-195,-54,181,-159
33,168,-141,-85,-255,-350,-81,220,-491
229,298,82,41,-99,-75,70,420,966
460,677,164,154,19,-52,293,608,2323
18,99,-33,-17,-124,-172,-23,192,-60
90,138,-23,9,-42,-57,40,148,303
198,286,46,-24,-136,-186,43,455,682
172,282,-116,-111,-125,-127,111,346,432
81,167,-21,-63,-38,-57,40,163,272
416,762,-187,-133,-405,-482,194,777,942
12,56,-84,-53,-151,-251,-72,160,-383
149,243,-70,-54,-146,-91,84,370,485
253,406,-137,-35,-317,-343,-1,545,371
228,375,-11,-37,-34,-141,77,401,858
151,211,0,-44,-28,-105,31,243,459
14,91,-144,-83,-316,-409,-134,238,-743
87,272,-19,-120,-102,-128,33,315,338
42,84,-11,-33,-45,-78,-3,116,72
431,689,-113,-43,-274,-274,319,811,1546
50,65,-48,-38,-90,-83,12,80,-52
7,96,-29,-36,1,4,47,117,207
206,450,-150,-86,-337,-238,166,675,686
113,142,-501,-436,-867,-1126,-264,667,-2272
14,73,-55,-22,-146,-171,-54,105,-256
156,206,-28,-28,-66,-172,82,286,436
49,70,-22,8,-137,-144,-30,162,-44
247,340,20,10,-146,-133,113,355,806
9,103,-43,-75,-68,-167,-30,155,-116
136,280,-11,-29,-71,-122,63,336,582
15,320,54,-61,-80,-26,92,395,709
71,133,-52,-49,-65,-117,43,134,98
24,45,-1,-25,-22,-110,-5,97,3
287,357,387,162,265,148,167,422,2195
99,71,-56,42,-72,-123,38,108,107
124,263,79,-4,20,-82,62,282,744
-43,1,-78,-9,-94,-147,-73,108,-335
-10,5,-40,-49,-55,-36,9,39,-137
8,79,0,-41,-43,-98,-24,117,-2
-19,5,-54,-12,-75,-55,-2,33,-179
-6,28,-2,-33,-43,-40,3,59,-34
-49,-18,-64,-66,-90,-131,-69,79,-408
-51,11,-46,-63,-83,-113,-57,68,-334
-62,3,-60,-59,-72,-132,-78,54,-406
-69,-34,-81,-66,-96,-138,-80,48,-516
33,57,-39,-31,-83,-70,-12,110,-35
2,20,28,-5,18,-28,-12,34,57
1,6,-14,-11,-1,-37,-19,17,-58
-33,-5,-62,-14,-97,-120,-35,60,-306
-68,-16,-60,-60,-91,-110,-71,71,-405
14,45,51,-3,-21,-37,-13,85,121
84,84,-17,18,-71,-61,-3,87,121
9,38,-44,22,-112,-159,-37,108,-175
-6,-11,-50,-80,-89,-83,4,76,-239
42,67,-4,-17,2,-48,4,81,127
-7,36,-12,-3,-70,-38,11,87,4
-103,-4,-125,-103,-199,-227,-62,154,-669
25,22,-42,-13,-55,-100,-32,70,-125
6,27,-23,-24,-28,-31,15,48,-10
39,29,-3,-60,-46,-56,-17,77,-37
5,43,-10,-5,-40,-54,-15,43,-33
6,15,-1,-23,-21,-30,2,47,-5
-40,-8,-47,-29,-54,-121,-68,92,-275
31,53,2,20,12,21,30,46,215
-43,-28,-28,-35,-10,-93,-44,41,-240
22,51,-17,-6,-37,-77,-5,42,-27
-43,-14,-45,-63,-81,-107,-47,123,-277
-20,-2,-43,-73,-88,-127,-26,127,-252
0,21,-7,-15,-16,-14,1,27,-3
121,165,-97,-118,-117,-137,36,321,174
82,106,-49,-15,-57,-6,72,105,238
-40,-38,-55,-12,-66,-103,-43,47,-310
73,152,-138,-47,-118,-149,67,183,23
18,54,-52,-42,-97,-103,31,113,-78
41,40,-27,-33,-83,-110,-6,97,-81
13,38,-42,-17,-96,-52,-15,63,-108
12,29,-34,-56,-93,-121,-24,108,-179
18,17,-7,-4,-21,-12,25,33,49
-3,16,-69,-30,-133,-54,-1,73,-201
24,58,22,-25,-18,-55,10,101,117
15,10,-39,-31,-50,-64,-19,16,-162
13,34,-1,-35,-65,-90,-35,102,-77
66,54,-36,-1,-44,-27,30,67,109
9,43,-37,-26,-17,-44,9,57,-6
-47,12,-31,-75,-100,-167,-102,135,-375
199,306,-80,-98,-135,-126,165,428,659
-32,9,-43,-42,-70,-158,-75,117,-294
18,81,-13,-13,-107,-162,-48,141,-103
24,32,-30,-45,-47,-68,-2,56,-80
30,79,-34,-11,-27,-23,15,56,85
34,50,-50,-24,-75,-77,1,43,-98
-68,-50,-123,-28,-206,-171,-99,104,-641
-1,20,-21,-13,-31,-10,2,20,-34
100,88,16,1,13,-88,23,126,279
-11,34,10,-17,-44,-59,-5,64,-28
45,116,-13,-48,39,-61,29,161,268
15,13,26,-11,-13,-41,-5,79,63
53,93,-5,-18,-27,-14,45,97,224
0,46,-26,-15,-74,-66,-15,82,-68
8,19,-24,-36,-110,-131,-23,112,-185
10,76,-65,-33,-67,-38,39,140,62
14,25,-15,-5,-20,-51,-7,51,-8
0,-13,-10,-32,-12,-56,-25,23,-125
6,16,-15,-22,-25,-31,-25,55,-41
86,80,-47,-28,-67,-114,-2,132,40
-10,29,-15,-17,-6,-33,-12,44,-20
1,18,-21,-3,-23,-24,-2,35,-19
37,61,-5,11,-18,-21,13,80,158
65,75,-16,-44,-70,-66,23,101,68
51,46,-23,47,-54,-59,34,105,147
5,9,-21,-20,-34,-34,-7,34,-68
12,39,-21,-27,-82,-170,-44,83,-210
35,52,10,9,-29,-39,22,75,135
31,35,-20,18,-27,-19,8,34,60
10,38,-23,-17,-86,-69,21,95,-31
39,71,-16,-18,-39,-30,24,101,132
12,24,-37,7,-77,-57,2,53,-73
39,27,-42,9,-80,-36,37,60,14
87,198,99,12,-15,-63,24,266,608
-69,-16,-100,-80,-147,-201,-60,102,-571
48,64,-21,-33,-54,-65,17,74,30
102,79,0,-4,-60,-55,22,171,255
-2,9,-22,-21,-53,-47,-15,42,-109
23,49,-9,-12,-20,-48,-7,70,46
38,57,-34,-63,-94,-179,-71,90,-256
81,94,8,-15,-26,-105,-9,108,136
36,46,-52,-34,-163,-170,4,107,-226
28,48,-34,-12,-29,-60,-22,87,6
8,25,-23,-34,-14,-65,-11,24,-90
17,25,-28,-19,-50,-48,2,50,-51
82,116,-19,-52,-56,-95,1,157,134
32,142,32,-55,-21,-137,43,190,226
51,144,-17,-33,-39,-83,37,186,246
83,144,-38,-51,-28,-151,8,158,125
48,78,-73,-50,-60,-69,15,59,-52
38,44,-10,0,-8,-11,13,29,95
24,99,-108,-64,-190,-279,-54,216,-356
1,-5,-25,-28,-35,-64,-10,40,-126
6,60,-39,-29,-32,-77,-6,88,-29
16,50,-24,5,-41,-63,-3,65,5
47,95,-12,-15,-22,-95,-12,86,72
181,210,-66,-43,-152,-50,154,319,553
78,105,-28,26,-114,-119,11,130,89
17,55,-29,-37,-50,-23,-1,124,56
-14,-17,-59,-16,-105,-134,-53,63,-335
-12,3,-60,-7,-71,-45,3,56,-133
-26,-24,-72,-98,-46,-136,-67,100,-369
19,49,-56,-4,-120,-90,-15,104,-113
40,45,-43,-10,-78,-55,17,75,-9
237,401,-6,-46,35,-105,149,468,1133
114,91,-18,-117,-28,-163,65,181,125
26,21,-13,-18,-56,-35,19,55,-1
244,227,-89,-81,-181,-75,166,373,584
10,101,-39,-41,-117,-137,-22,165,-80
173,262,-103,-71,-177,-194,101,335,326
95,127,81,-75,54,-74,54,196,458
76,89,-5,8,-46,-84,27,112,177
10,20,-23,-24,-30,-46,-23,42,-74
135,190,-96,-36,-8,-23,111,91,364
-9,111,-132,-114,-333,-387,-95,270,-689
10,7,-32,-18,-135,-136,-17,115,-206
63,128,-57,-76,-98,-86,17,140,31
-8,22,3,5,-9,-3,6,29,45
57,99,3,-15,-27,-35,13,70,165
56,78,-43,-19,-90,-73,-2,64,-29
18,-27,-95,-50,-211,-113,-13,128,-363
275,565,153,-41,-88,-59,161,574,1540
46,72,-30,-21,-115,-111,-8,183,16
158,239,21,-62,-42,-202,45,292,449
79,115,-11,-20,-39,-131,80,178,251
15,54,-69,-91,-100,-153,-23,144,-223
69,168,146,68,12,58,59,199,779
92,105,-40,-74,-95,-136,11,227,90
69,202,-37,-20,-34,-34,106,196,448
-19,80,-93,-38,1,38,111,148,228
22,23,-27,-39,-58,-45,-8,39,-93
18,1,-18,8,-28,-35,-1,31,-24
14,17,-66,-39,-87,-76,-30,55,-212
2,25,6,7,-23,-44,-19,49,3
10,1,-43,-35,-51,-99,-22,57,-182
4,7,-6,5,-8,-21,-11,29,-1
7,61,-54,-44,-62,-87,-29,119,-89
-1,-4,-4,-6,-25,-48,-14,38,-64
7,7,-51,-26,-54,-71,-10,28,-170
22,108,-95,-21,-106,-143,-16,107,-144
44,46,-42,19,-121,-121,7,122,-46
4,6,-20,-22,4,-23,5,6,-40
7,30,-82,-55,-112,-95,6,88,-213
19,18,-35,1,-50,-54,6,55,-40
2,-20,-45,-27,-73,-71,-24,84,-174
7,6,-36,-14,-65,-33,-7,24,-118
8,5,-20,-24,-44,-31,18,43,-45
24,44,-29,-44,-72,-64,57,84,0
-133,-36,-82,-115,-138,-255,-145,107,-797
7,44,-11,-14,-30,-53,-13,88,18
185,105,-1,21,-107,-8,131,145,471
11,34,-27,-14,-23,-44,1,67,5
63,111,3,-32,1,-77,19,162,250
-1,32,-29,-13,-25,-44,23,72,15
32,77,-22,-30,-89,-133,-2,165,-2
18,70,-18,-17,-23,-36,29,83,106
72,179,-55,-58,-77,-168,16,218,127
5,12,-16,-23,-25,-34,3,33,-45
39,1,-36,2,-55,-50,19,48,-32
-1,21,-6,-21,-15,-32,2,55,3
7,-5,-22,-10,-16,-33,-8,27,-60
8,22,-6,-5,-26,-34,-23,43,-21
26,-29,-50,17,-98,-94,-16,26,-218
52,169,-64,-46,-28,-74,57,189,255
30,54,-36,-14,-51,-57,26,35,-13
38,107,-12,-56,-76,-212,-70,242,-39
96,140,-58,-87,-171,-185,10,312,57
19,62,-96,-116,-168,-142,-44,207,-278
49,88,-14,-8,-14,-23,24,54,156
104,83,11,40,-45,-27,54,131,351
115,275,16,-47,32,-93,66,289,653
36,34,-25,-2,-20,-38,13,25,23
70,92,11,-1,-30,-5,62,117,316
-70,16,-89,-62,-114,-186,-65,129,-441
33,73,-48,10,-94,-155,-34,92,-123
85,140,-15,-31,-75,-86,48,169,235
13,60,-26,-30,-63,-37,19,80,16
148,307,-177,-219,-186,-155,-59,356,15
-16,9,-18,-27,-51,-84,-37,59,-165
73,262,-92,-121,-291,-501,-88,543,-215
3,4,-13,-10,-1,-37,-19,17,-56
45,42,-24,-25,-44,-111,-15,74,-58
97,113,-42,-75,-69,-184,-4,195,31
220,218,3,67,-79,-106,122,275,720
4,39,-37,-48,-105,-152,-50,91,-258
2,1,-29,-54,-55,-102,-39,79,-197
-34,14,-82,-25,-106,-191,-52,114,-362
13,7,31,1,6,3,-9,15,67
-30,37,-90,-103,-143,-232,-74,114,-521
24,25,-27,-30,-74,-58,1,74,-65
8,21,-19,-11,-10,-16,11,47,31
96,126,-31,-9,23,12,75,88,380
16,55,-46,-2,-46,-60,23,90,30
-4,16,-4,-2,-16,-7,-8,9,-16
30,18,-11,-15,-7,-11,27,39,70
173,267,-142,-148,-400,-329,49,456,-74
100,88,-67,-69,-101,-211,-33,134,-159
74,142,-49,-9,-39,1,87,81,288
14,22,-14,22,-86,-34,1,72,-3
22,51,-14,5,-81,-47,9,77,22
124,212,-21,-39,-52,-126,12,191,301
25,21,-10,9,-35,-26,14,41,39
-5,8,-52,6,-106,-72,-20,46,-195
36,63,-48,5,-116,-74,14,90,-30
17,27,-7,9,-26,-18,14,35,51
11,27,-24,-16,-49,-50,-33,45,-89
21,42,-11,-13,-35,-37,-5,58,20
-6,3,-14,-15,-10,-23,-12,13,-64
-47,-3,-85,-45,-122,-117,-57,97,-379
33,57,-47,-66,-47,-81,9,77,-65
8,19,1,-13,1,-20,10,24,30
42,81,70,-59,21,-105,-19,132,163
0,30,-24,-44,-44,-48,1,66,-63
104,100,-72,-8,-55,-89,50,140,170
72,130,-24,-25,-56,-10,-22,169,234
-31,8,-51,-34,-39,-95,-38,52,-228
-69,-35,-101,-61,-186,-203,-67,160,-562
7,33,-7,-24,-31,-63,-15,72,-28
-8,20,-58,-23,-79,-68,-23,32,-207
1,8,-44,-45,-11,-77,-2,29,-141
-74,5,-52,-68,-126,-110,-75,81,-419
61,64,-26,-49,-105,-94,37,128,16
15,19,-8,-3,-9,-30,0,16,0
14,75,-22,25,-78,-90,-19,84,-11
120,198,-9,-14,-17,-124,22,152,328
32,51,-14,-13,-28,-38,15,58,63
-48,1,-45,-28,-93,-137,-76,44,-382
-42,-19,-63,-46,-69,-118,-55,66,-346
-43,-29,-53,-40,-60,-116,-58,61,-338
-49,-38,-54,-28,-76,-123,-64,66,-366
-51,-13,-66,-54,-102,-115,-61,73,-389
133,132,-68,-40,-58,-109,65,125,180
56,42,-31,-9,-34,-17,20,73,100
-26,39,-59,-77,-132,-206,-61,145,-377
-47,34,-85,-85,-153,-169,-66,175,-396
47,63,-57,-37,-89,-115,-6,101,-93
16,-13,-48,-18,-70,-100,-16,66,-183
-1,39,-41,-7,-110,-146,-59,102,-223
-63,-5,-75,-51,-102,-173,-65,95,-439
44,34,-6,-1,-47,-114,8,89,7
-48,-28,-82,-72,-73,-101,-70,70,-404
32,10,-5,2,-27,-5,21,24,52
177,72,-402,-592,-884,-828,-247,746,-1958
27,100,-48,-84,-137,-229,-70,256,-185
405,447,-274,-32,-708,-702,-9,319,-554
-73,-36,-78,-58,-120,-122,-51,72,-466
51,143,-62,-31,-116,-128,6,53,-84
26,53,-38,-52,-97,-156,-18,113,-169
46,47,-95,-52,-211,-253,-35,129,-424
13,74,-99,-88,-139,-232,-67,187,-351
12,37,25,-19,12,-24,0,37,80
-76,16,-84,-65,-89,-154,-76,91,-437
12,8,1,-6,-25,-10,3,20,3
5,29,-67,-38,-140,-94,16,105,-184
55,63,7,19,-43,-41,1,82,143
9,51,-4,-19,-27,-53,-15,79,21
43,41,-5,-56,-20,-90,6,118,37
10,42,-64,-65,-41,-76,-6,109,-91
-17,72,-74,-35,-194,-214,-54,149,-367
-3,35,-56,-42,-132,-126,-25,94,-255
80,87,27,10,-24,-47,6,113,252
-19,-26,-64,-25,-85,-82,-47,39,-309
-97,-63,-79,-63,-98,-118,-59,57,-520
-94,-24,-52,-65,-79,-127,-78,74,-445
-36,-37,-47,-19,-98,-78,-37,53,-299
784,871,142,-30,137,-110,243,710,2747
123,172,-54,-91,-115,-170,-6,285,144
-24,2,-30,-14,-91,-80,-28,54,-211
190,174,-66,-35,-127,-167,43,268,280
23,79,-54,-4,-78,-74,-20,77,-51
174,290,-198,-85,-210,-202,59,257,85
138,126,-12,-98,-15,-95,-2,213,255
41,76,-42,-28,-90,-94,3,102,-32
24,44,-15,2,-29,-20,23,64,93
5,2,-9,-7,-7,-15,-13,33,-11
-81,2,-98,-74,-130,-158,-101,111,-529
34,40,-4,-9,-27,-59,-10,47,12
31,60,25,7,0,-9,13,75,202
14,38,-22,-27,-30,-55,-9,45,-46
-66,-24,-111,-101,-179,-214,-63,157,-601
27,34,-32,-8,-42,-49,-7,67,-10
120,88,-67,0,-252,-315,-24,232,-218
92,167,-124,-37,-141,-180,21,170,-32
-23,-17,-41,-12,-27,-64,-30,21,-193
16,82,13,-23,-14,-32,10,80,132
-4,27,-25,-21,-104,-65,4,50,-138
75,156,-161,-54,-283,-411,-69,298,-449
205,226,-72,-22,-67,-173,73,332,502
-1,17,-39,-31,-77,-65,-11,47,-160
9,57,6,-15,-33,-8,-1,71,86
-10,21,-43,-26,-172,-102,-40,163,-209
27,80,-17,-38,-43,-59,21,87,58
-13,-10,-50,-50,-31,-27,15,42,-124
57,183,46,-39,32,-24,27,214,496
-22,30,-144,-126,-219,-391,-147,215,-804
-17,83,-87,-100,-227,-153,-21,208,-314
18,10,-36,-31,-51,-53,7,66,-70
6,18,-6,-14,3,-10,9,4,10
2,87,-34,-101,-58,-57,-40,173,-28
-36,33,-55,-65,-133,-156,-67,136,-343
-16,23,-33,-21,-73,-84,-47,73,-178
60,76,0,2,-10,-41,12,76,175
33,51,-21,0,-39,-80,-1,63,6
51,260,57,-49,-48,-88,30,241,454
48,95,-42,26,-38,-77,-18,86,80
203,184,-60,-66,-249,-171,57,382,280
21,27,-31,34,-48,-24,24,45,48
-68,63,-116,-91,-229,-240,-82,250,-513
306,532,-14,-34,-168,-149,128,693,1294
-29,79,-66,-36,-165,-128,-44,223,-166
75,38,7,59,-67,-49,37,99,199
-42,-2,-47,-20,-84,-62,-8,65,-200
18,26,34,-24,4,-10,-1,56,103
-7,-12,-54,-61,-54,-120,-19,88,-239
189,340,-19,-20,-34,-8,135,268,851
-42,12,-59,3,-99,-154,-78,118,-299
-2,59,-21,-7,-88,-197,-76,103,-229
79,127,7,32,20,-2,91,131,485
92,165,17,50,26,3,110,164,627
51,70,-13,8,8,0,53,72,249
87,177,19,-55,-93,-79,35,267,358
99,160,-56,-35,-74,-164,49,242,221
-84,19,-150,-108,-243,-326,-175,187,-880
133,180,-76,-25,-116,-125,38,208,217
26,4,-12,-23,-81,-22,1,100,-7
-91,-52,-71,-74,-83,-135,-90,65,-531
-90,-40,-62,-68,-80,-116,-62,56,-462
-79,-30,-69,-68,-88,-118,-53,71,-434
-64,-5,-45,-33,-94,-105,-47,68,-325
-74,-41,-59,-65,-77,-131,-48,62,-433
-62,-31,-59,-52,-90,-128,-49,59,-412
-72,-42,-66,-53,-98,-140,-75,67,-479
115,156,20,-18,7,-129,-9,191,333
-15,3,-17,-27,-17,-20,-1,32,-62
103,54,-55,-11,-128,-110,80,121,54
-7,3,-8,-2,-21,-7,2,13,-27
32,134,-78,-56,-62,-66,-24,139,19
112,124,-3,-100,-22,-95,26,182,224
50,90,-68,-82,-147,-230,-67,128,-326
6,31,-56,-23,-81,-65,-17,35,-170
-3,-15,-40,-37,-82,-102,-46,62,-263
27,68,-43,-44,-80,-67,-2,100,-41
35,24,-23,10,-62,-49,23,61,19
-89,-17,-58,-65,-66,-153,-98,79,-467
59,75,-12,2,18,14,57,51,264
7,35,-5,-3,-16,-18,16,44,60
-22,3,-64,-5,-103,-89,-17,68,-229
8,20,-2,4,-11,-18,1,21,23
9,19,-14,-23,-57,-54,-6,64,-62
-43,17,-69,-56,-100,-137,-51,91,-348
14,48,-35,-59,-57,-32,2,101,-18
26,55,-49,-32,-45,-70,-4,84,-35
-14,39,-23,-31,-31,-60,8,76,-36
-38,8,-67,-51,-105,-135,-52,107,-333
129,124,-42,-26,-31,-103,15,145,211
79,116,-46,-15,-89,-77,49,122,139
99,106,15,18,-25,-35,51,122,351
10,32,-31,-52,-62,-145,-43,76,-215
107,116,-100,-97,-161,-128,97,236,70
-16,18,-70,-104,-82,-228,-98,187,-393
81,81,-58,-55,-91,-80,-50,151,-21
32,56,-21,14,-54,-58,8,56,33
34,78,-45,-31,-125,-175,-7,173,-98
20,74,-8,10,-77,-85,-13,117,38
-31,-7,-19,-33,-46,-68,-30,26,-208
-75,-55,-85,-64,-92,-200,-103,37,-637
342,366,48,-85,-105,-319,74,426,747
105,215,40,-9,-46,-158,26,277,450
96,154,33,-28,-75,-132,12,269,329
56,95,-134,-20,-319,-283,-59,136,-528
-82,-50,-82,-33,-130,-164,-78,68,-551
70,111,-14,-3,-30,-17,50,87,254
-44,0,-45,-30,-51,-72,-44,47,-239
21,31,-50,-87,-117,-214,-52,186,-282
22,9,-8,13,-37,-52,4,54,5
18,50,-21,-37,-46,-112,8,100,-40
27,34,-8,-3,-6,-12,12,50,94
13,14,-36,-18,-31,-46,-25,15,-114
13,38,-15,-35,-94,-123,-2,88,-130
49,54,-23,-13,-52,-75,17,73,30
55,104,-16,5,-46,-53,21,100,170
156,152,-46,-78,-185,-171,19,397,244
81,109,-14,-10,-10,-23,78,92,303
17,54,-21,13,-58,-33,1,68,41
-15,29,-27,-11,-63,-98,-20,82,-123
39,46,-34,8,-52,-58,9,40,-2
25,44,-32,-22,-34,-80,1,50,-48
-27,46,17,75,-142,-96,-21,156,8
50,46,-25,-1,-39,-53,37,64,79
15,70,-9,-27,-61,-108,2,77,-41
11,13,-61,-6,-113,-76,-28,86,-174
16,26,0,2,-2,-4,15,16,69
17,32,3,-11,-32,-64,0,58,3
13,45,-22,-27,-12,-95,6,78,-14
43,29,-32,-16,-52,-66,40,50,-4
-104,-101,-126,-86,-144,-211,-107,66,-813
7,18,-21,-24,-14,-22,9,23,-24
11,4,8,-17,10,-47,-10,16,-25
-13,54,-12,-38,-28,-117,-33,61,-126
478,788,-95,-74,-328,-99,303,936,1909
19,7,-30,-29,-100,-161,-32,133,-193
15,47,-29,-32,-35,-80,-10,38,-86
30,36,-10,-17,-77,-98,-25,35,-126
29,64,-24,-39,-108,-116,-31,123,-102
-27,30,-59,-41,-100,-105,-23,73,-252
41,92,-44,-41,-66,-166,8,151,-25
86,46,19,-13,-6,-57,25,80,180
12,7,-16,-22,-106,-75,-9,138,-71
17,90,-32,-45,-95,-132,-37,136,-98
13,45,-66,-113,-171,-152,26,255,-163
55,78,9,-30,-30,-90,20,155,167
-3,16,-26,-14,-38,-38,-17,26,-94
108,156,-51,-3,-61,-106,26,122,191
-10,31,-11,-35,-45,-51,-25,72,-74
49,103,-6,-35,-10,-3,12,88,198
118,175,-89,-87,-70,-113,58,191,183
-14,-7,-19,-15,-4,-49,-26,27,-107
25,15,-9,13,-22,-14,19,47,74
1,3,-8,-14,-6,-3,1,17,-9
75,95,-40,-26,-112,-119,1,142,16
49,85,-17,-25,-73,-137,-12,150,20
148,169,-81,-11,-159,-126,107,261,308
26,78,-27,-51,-61,-82,14,70,-33
-1,32,-11,-12,-61,-86,-38,88,-89
6,17,-23,-11,-26,-27,-2,41,-25
69,67,-54,-33,-81,-70,15,46,-41
19,63,9,33,-75,-41,-4,130,134
38,124,44,-56,7,-90,24,179,270
92,145,-21,-41,-113,-152,14,254,178
98,159,-69,-71,-135,-219,-4,249,8
20,17,-9,-30,-24,-59,-5,27,-63
146,309,97,-42,93,-64,54,263,856
51,67,-38,-43,-64,-98,-10,98,-37
32,49,-33,-39,-63,-64,15,88,-15
80,131,10,3,-67,-74,45,196,324
32,30,-42,-3,-70,-60,39,114,40
21,26,4,-10,8,-3,8,34,88
40,60,19,25,-18,-46,15,93,188
16,89,-33,-35,10,-32,19,50,84
70,71,-8,-12,-93,-53,18,215,208
48,33,-26,12,-34,-51,12,34,28
-19,-3,-14,-41,-34,-90,-31,23,-209
213,320,-55,-30,-90,-168,126,408,724
82,128,-28,-74,-41,-125,57,193,192
122,221,-137,-56,-63,-112,94,147,216
-5,-8,-9,-2,-23,-15,-7,10,-59
26,34,-14,11,-165,-133,-46,142,-145
24,22,-5,14,-6,-15,3,16,53
-8,35,-29,-47,-82,-110,-18,69,-190
7,1,-25,-33,-66,-80,-34,61,-169
11,48,-4,-31,-33,-81,15,75,0
-15,55,-58,-59,-90,-137,-59,120,-243
219,272,-100,-50,-133,-181,71,393,491
-63,172,-389,-185,-508,-731,-259,429,-1534
11,9,-19,-22,-43,-48,-5,52,-65
-72,-21,-87,-52,-149,-139,-73,122,-471
21,15,17,-1,10,-19,-18,39,64
43,207,75,-2,78,42,68,211,722
39,27,-49,-44,-65,-64,-6,73,-89
-174,92,-448,-412,-584,-731,-204,586,-1875
99,129,18,-27,-12,-95,30,188,330
-36,-37,-37,4,-44,-81,-42,47,-226
48,62,-10,-24,-2,-22,22,78,152
23,53,4,-30,-20,-113,-31,73,-41
-9,63,-79,-73,-167,-264,-71,235,-365
11,28,-25,-1,-30,-25,8,35,1
102,183,-33,24,-143,-143,50,121,161
141,320,-2,-79,-79,-94,102,345,654
-9,14,-32,-61,-27,-102,-13,59,-171
22,55,-16,-57,-21,-63,15,122,57
81,116,8,-29,15,-39,17,134,303
28,130,-55,-88,-68,-111,28,267,131
11,37,-24,-30,-25,-2,26,43,36
-13,28,-12,-21,-36,-32,5,41,-40
30,138,-30,-82,-62,-260,-90,256,-100
-4,-5,-119,-107,-195,-136,-12,120,-458
37,117,23,-5,-7,-81,15,162,261
19,77,26,3,18,-35,13,65,186
48,99,5,-24,30,-19,15,76,230
18,33,-5,-14,8,-8,15,44,91
47,111,-30,-44,-137,-129,32,160,10
-5,19,-31,-17,-31,-41,-12,47,-71
21,34,10,-8,-20,-26,2,39,52
0,54,-24,-24,-56,-79,-18,69,-78
26,95,25,-10,-3,-71,-34,105,133
3,36,-45,-47,-88,-82,-21,76,-168
3,24,-24,-28,-68,-100,-29,53,-169
11,38,-8,8,-19,-12,18,40,76
147,199,-70,-5,-176,-148,35,324,306
-7,51,-54,-37,-44,-87,22,114,-42
144,346,-4,-51,-203,-483,-68,562,243
81,49,-55,-10,-61,-62,35,113,90
20,77,-36,-32,-74,-44,10,117,38
-38,25,-4,-30,-23,-118,-53,93,-148
-71,15,-36,-13,-71,-184,-88,57,-391
21,73,-48,-3,-98,-132,-37,44,-180
5,50,-15,-40,-33,-35,-1,84,15
5,30,-12,-25,-20,-58,-9,38,-51
116,214,3,-5,-99,-171,47,250,355
-38,26,-23,15,-36,-73,-22,92,-59
93,182,11,-6,55,24,90,151,600
16,17,-48,-27,-48,-58,9,51,-88
89,116,50,33,12,-42,36,99,393
24,24,-3,-19,-40,-95,-17,75,-51
55,30,11,-5,-26,-33,15,80,127
7,2,-33,-2,-58,-53,5,27,-105
602,590,131,2,119,-287,144,574,1875
-14,-1,-34,-32,-58,-89,-19,73,-174
22,18,-9,5,-42,-68,-10,61,-23
62,103,-53,-18,-82,-141,-11,111,-29
174,236,-153,32,-256,-258,-9,128,-106
37,61,-32,24,-112,-46,21,116,69
1,53,3,-12,-40,-64,9,84,34
19,53,-39,-15,-93,-98,20,100,-53
29,72,-67,-87,-153,-134,2,148,-190
-5,35,-71,-44,-173,-80,-10,146,-202
50,190,-49,-124,-146,-329,-44,240,-212
-34,-26,-56,-53,-68,-82,-22,65,-276
11,129,-58,-132,-142,-158,-30,197,-183
95,179,-99,-109,-251,-286,23,346,-102
65,90,-33,-19,-57,-101,-20,88,13
95,145,-31,-39,-63,-94,59,196,268
70,98,-74,-78,-135,-200,-3,113,-209
119,76,-103,-30,-118,-126,19,126,-37
31,176,4,-80,-81,-98,28,318,298
-55,-35,-78,-54,-126,-202,-62,97,-515
-20,15,-44,-60,-35,-84,-17,32,-213
84,97,-30,-53,-122,-170,14,144,-36
29,85,-23,-68,-66,-104,-8,129,-26
4,26,-7,-19,-29,-48,-12,62,-23
172,149,-54,20,-148,-137,65,209,276
30,55,-28,-32,-59,-59,22,67,-4
62,96,5,-21,-38,-29,33,95,203
24,39,-26,-61,-41,-80,-3,94,-54
173,148,-18,33,-90,-80,60,185,411
-5,-5,-12,-12,-35,-34,-21,32,-92
116,180,-17,-94,-18,-103,14,259,337
-6,94,-26,-5,-15,-12,34,125,189
41,88,-79,-46,-125,-106,5,177,-45
-51,20,-80,-77,-145,-221,-84,150,-488
16,18,-9,-18,-17,-37,-16,51,-12
-2,29,-27,-45,-65,-131,-67,114,-194
13,18,-29,-21,-92,-99,-23,64,-169
8,27,-11,-16,-4,-17,5,54,46
22,33,-6,-7,-40,-42,12,32,4
-7,43,-30,-40,-64,-52,-3,75,-78
40,114,-42,-3,-71,-85,0,72,25
7,38,-48,-28,-72,-98,-16,70,-147
320,406,-89,-130,-125,-163,121,535,875
203,552,-218,-243,-355,-639,46,866,212
27,60,-23,-28,-8,-50,6,66,50
0,55,-44,-41,-56,-87,-6,67,-112
-8,-1,-9,-26,3,-25,-9,11,-64
83,132,-59,10,-109,-96,30,103,94
1,22,-17,-7,-34,-1,11,25,0
59,187,-217,-235,-256,-447,-90,385,-614
36,97,9,7,-157,-126,-24,178,20
139,137,34,-13,-17,-9,68,204,543
58,45,-23,11,-25,-21,41,63,149
-102,10,-198,-194,-341,-296,-105,247,-979
-75,-37,-73,-86,-75,-147,-61,43,-511
18,81,-21,-28,-26,-105,26,111,56
52,58,-1,-8,-30,-32,47,73,159
-10,44,-2,-6,-43,-44,-11,113,41
70,100,-42,-4,-21,-54,20,58,127
28,109,-63,-71,-194,-302,-54,170,-377
18,60,-18,-26,-56,-83,11,81,-13
369,496,33,-108,40,-54,207,518,1501
54,54,-13,-42,-27,-56,15,82,67
214,424,70,-85,14,-216,109,468,998
-35,108,-63,-61,33,29,59,108,178
1,59,-68,-60,-11,-1,59,156,135
143,178,67,125,-42,-44,24,239,690
-56,33,-128,-155,-144,-259,-76,302,-483
80,104,28,18,-16,53,50,101,418
79,91,-4,-5,-4,-55,24,101,227
192,244,32,-10,-11,-97,28,290,668
17,44,-26,-15,-52,-61,-11,73,-31
-28,-3,-26,-48,-53,-71,-38,43,-224
11,15,-19,4,-30,-16,10,45,20
32,73,13,26,-1,22,70,137,372
6,32,-8,-9,-14,-25,0,39,21
36,65,-26,-50,-69,-117,-29,85,-105
72,195,-92,-35,-123,-246,7,226,4
18,44,-65,-49,-67,-66,4,87,-94
19,8,-68,-10,-124,-105,15,50,-215
80,129,-1,-27,-44,-67,37,165,272
7,21,-39,-20,-69,-63,-1,95,-69
92,100,-19,-7,-54,-46,24,112,202
7,82,-25,-47,-53,-126,12,136,-14
18,29,-35,-9,-32,-77,-11,51,-66
32,22,-17,-30,-34,-55,4,65,-13
18,32,-3,-6,-34,-29,-10,84,52
10,5,-5,-14,-31,-26,17,18,-26
-52,-43,-79,-46,-112,-119,-76,89,-438
-2,36,-98,-55,-170,-145,-26,118,-342
10,24,-8,-30,-27,-66,-30,52,-75
6,3,-50,-64,-82,-157,-40,45,-339
-7,27,-23,-22,-42,-60,-14,49,-92
105,182,-54,-59,-49,-131,102,248,344
21,35,-31,-21,-80,-98,-8,79,-103
35,72,-21,7,-10,-6,51,48,176
53,71,-69,-2,-228,-243,-53,118,-353
32,29,-15,-9,-24,-41,-5,43,10
62,153,-62,-90,-81,-131,17,170,38
-12,34,-79,-49,-30,-34,8,84,-78
60,125,-1,40,-70,-23,33,112,276
-8,83,-73,-61,-147,-181,-63,175,-275
78,186,-15,-64,-95,-102,64,260,312
-24,-19,-33,-26,-56,-75,-29,55,-207
48,93,-51,-29,-69,-102,-35,124,-21
27,106,5,-16,-48,-83,-17,128,102
142,164,-59,35,-174,-235,-7,195,61
-6,16,-29,-36,-30,-50,9,42,-84
112,172,-54,-40,-49,-109,61,128,221
23,76,-52,-66,-177,-167,-40,203,-200
-16,70,-52,-38,-85,-118,-29,85,-183
10,18,-10,-21,-28,-26,-4,45,-16
134,147,-8,16,-18,-48,85,173,481
-56,-26,-37,-23,-64,-123,-72,70,-331
-5,14,0,-12,-6,-29,-2,36,-4
13,72,-6,-13,-66,-113,-16,69,-60
6,2,-38,-13,-24,-51,-9,54,-73
29,34,-30,-34,-11,-43,26,78,49
48,95,6,-23,24,-7,13,64,220
46,138,-122,-137,-124,-179,23,213,-142
27,30,-10,1,-25,-19,24,28,56
22,62,9,-14,13,11,36,51,190
33,57,-14,-3,-15,-28,45,59,134
33,48,-41,-31,-42,-33,-6,60,-12
-30,91,-34,-52,-92,-54,-13,111,-73
20,68,-32,-49,-39,-106,-18,95,-61
15,31,9,0,-2,-19,9,37,80
-10,25,-20,-40,-88,-95,-37,105,-160
56,107,-56,-17,-109,-177,50,172,26
89,150,-95,-30,-99,-147,63,131,62
79,112,20,-38,-28,-65,14,187,281
-1,79,-66,-55,-108,-165,-38,142,-212
-1,11,-42,-17,-48,-43,-11,39,-112
-2,38,-53,-41,-105,-19,6,88,-88
55,67,16,-5,12,9,44,84,282
-44,-26,-72,-57,-76,-86,-35,28,-368
51,102,-34,-31,-10,-60,52,129,199
4,26,-45,8,-107,-82,-11,57,-150
47,35,-33,-11,-77,-77,-7,46,-77
1,19,-30,4,-48,-8,1,35,-26
-6,21,-18,-9,5,-1,9,23,24
63,108,-39,-53,-94,-84,30,174,105
74,142,-14,-21,-58,-92,35,166,232
-3,74,-29,-24,-59,-91,-10,94,-48
-5,13,-16,-12,-106,-62,-2,83,-107
26,84,-35,-39,-97,-91,13,120,-19
308,305,75,-35,36,-45,123,387,1154
169,227,49,-4,-100,-88,22,310,585
-10,14,-62,-44,-64,-139,-39,72,-272
-11,9,-31,-14,-75,-82,-23,66,-161
78,51,-71,9,-162,-178,-22,204,-91
40,111,1,-14,-95,-213,-73,156,-87
96,116,-23,-37,-101,-171,-25,212,67
239,219,-42,-18,-176,-188,115,329,478
-8,-24,-44,-15,-78,-79,-7,67,-188
68,73,-56,-51,-69,-139,-40,106,-108
89,245,16,-23,52,-67,83,242,637
21,23,-28,-19,-69,-69,3,85,-53
41,60,-85,-54,-194,-211,-67,96,-414
51,71,-47,-16,-116,-152,-5,125,-89
20,54,-60,-111,-113,-89,33,173,-93
71,97,14,-9,8,-69,20,90,222
46,39,12,6,-19,0,23,66,173
10,44,-39,-17,-48,-89,-1,72,-68
312,382,-34,-43,8,-79,157,410,1113
23,45,-10,-7,-100,-141,-79,156,-113
71,93,-22,-14,-18,-24,34,130,250
37,127,-25,-34,-53,-90,4,124,90
41,55,5,-15,-7,-24,12,61,128
0,28,9,-10,-19,-28,-30,61,11
135,176,44,14,-27,-67,32,206,513
-8,34,-36,-15,-116,-43,6,103,-75
32,41,-36,-1,-73,-70,-15,53,-69
29,63,-8,11,-45,-76,-4,86,56
24,39,6,-2,-8,-21,14,48,100
75,86,13,19,-5,-38,12,110,272
-87,-24,-105,-59,-173,-113,-83,85,-559
18,24,-62,-29,-43,-94,-36,56,-166
80,37,-74,-40,-142,-168,2,79,-226
-11,43,-52,-84,-108,-89,-12,72,-241
-13,10,-5,-14,-16,-30,-18,24,-62
37,25,-2,-31,-66,-100,8,96,-33
26,28,-53,-43,-18,-50,35,79,4
-3,1,-40,-14,-80,-119,-36,40,-251
22,49,-82,-126,-144,-245,-35,235,-326
19,48,-5,25,-16,-3,35,67,170
70,68,14,12,-11,-28,41,82,248
15,23,-23,-53,-42,-31,-10,53,-68
19,43,7,24,-58,-38,8,60,65
45,120,-5,-70,-38,-172,-58,170,-8
3,-13,-54,-7,-81,-112,-40,76,-228
17,38,-61,-1,-139,-116,-12,89,-185
-2,14,-27,-32,-16,-150,-51,66,-198
104,140,-40,-14,-148,-143,13,90,2
34,57,-8,13,-95,-121,8,101,-11
7,23,5,-1,-20,-17,7,40,44
-31,45,-67,-9,-103,-178,-42,129,-256
27,8,-61,-7,-90,-93,10,67,-139
8,24,-26,-17,-95,-48,-17,112,-59
27,53,-4,-20,4,-50,13,38,61
7,50,-30,-56,-110,-114,-39,106,-186
18,25,-20,-24,3,-64,-23,32,-53
52,44,-3,6,-1,-19,14,71,164
12,101,-37,-19,-9,26,64,141,279
116,85,-5,16,47,-84,54,129,358
38,43,-8,-20,-74,-50,9,100,38
32,42,-9,-18,-5,-16,22,50,98
77,95,-11,-7,-93,-57,21,205,230
11,20,-44,-20,-64,-51,-10,70,-88
192,205,-18,-105,25,-128,18,305,494
28,35,-26,-9,-53,-20,12,47,14
59,110,-76,-82,-139,-134,-1,177,-86
70,46,-103,-118,-283,-358,-163,321,-588
30,57,-23,4,-52,-81,-17,102,20
-75,-12,-121,-70,-180,-187,-73,179,-539
-8,-11,-35,-25,-55,-67,-5,24,-182
16,98,0,10,-33,-128,-1,142,104
8,27,-43,-35,-101,-101,-49,119,-175
15,50,-28,-6,-68,5,21,105,94
181,239,-82,-104,-143,-116,94,245,314
7,64,-8,-96,-72,-133,-29,152,-115
169,242,-94,-81,-101,-272,-10,249,102
-1,20,-29,-25,-34,-31,-12,31,-81
62,81,-76,-54,-146,-227,-38,143,-255
40,24,10,-1,-100,-60,-16,71,-32
34,101,-133,-100,-224,-383,-131,211,-625
19,50,-4,-3,-21,-29,0,82,94
21,52,-32,-8,-36,-48,-1,40,-12
28,76,-18,-37,-87,-80,13,96,-9
245,420,-113,-5,-104,-236,119,405,731
-23,-3,-82,-61,-84,-159,-66,92,-386
-14,1,-63,-57,-92,-157,-55,96,-341
-16,-1,-82,-59,-96,-159,-62,98,-377
30,33,-47,-22,-56,-60,33,49,-40
22,-20,-70,-77,-105,-127,-28,98,-307
3,80,-30,-99,-20,-80,4,94,-48
222,270,10,-60,-1,-181,117,362,739
-55,-41,-60,-38,-52,-77,-47,51,-319
5,60,-11,-31,-39,-92,1,71,-36
19,95,6,-46,-16,-68,13,83,86
-15,21,-34,-20,-115,-91,-38,84,-208
0,27,-37,-26,-128,-117,-40,100,-221
36,77,-18,-32,-25,-33,5,126,136
26,57,-14,-30,-41,-60,10,74,22
78,67,-24,-30,-36,-33,27,122,171
-30,26,-70,-116,-116,-99,-33,105,-333
18,60,13,-5,-10,-22,18,66,138
4,26,-30,9,-97,-110,-30,90,-138
-28,1,-85,-71,-48,-151,-33,63,-352
70,162,-33,-63,-13,-56,46,186,299
45,66,-11,-26,-27,-27,-15,115,120
50,91,-9,-4,-52,-49,31,127,185
32,42,-47,-23,-43,-16,10,42,-3
51,188,-64,-62,-150,-316,-65,192,-226
-36,32,-16,-36,-110,-148,-50,92,-272
26,18,-26,-28,-97,-95,-29,94,-137
56,162,-39,17,-67,-166,6,99,68
-12,3,-114,-91,-120,-226,-105,159,-506
22,-6,-28,-46,-70,-82,-9,90,-129
150,191,35,0,-35,-88,8,261,522
209,254,-31,-65,-190,-172,19,351,375
77,144,1,21,-66,-86,29,189,309
13,31,-9,-19,-12,-24,1,55,36
25,113,24,-9,-13,-109,-32,139,138
14,56,-63,-85,-110,-109,5,150,-142
-10,0,-18,-13,-11,-22,-5,6,-73
-50,-44,-96,-98,-190,-245,-122,174,-671
-15,53,-139,-121,-285,-268,-64,189,-650
59,120,-38,-58,-100,-52,4,209,144
4,13,-31,-17,-41,-36,-3,36,-75
15,44,-25,-19,-45,-54,16,50,-18
3,24,-43,-27,-80,-81,-20,90,-134
27,34,1,-13,6,-18,20,25,82
43,59,-46,-28,-71,-79,7,116,1
11,38,-42,-14,-43,-126,-40,65,-151
14,59,-55,-54,-31,-112,-28,75,-132
14,18,-5,4,-20,-32,-2,34,11
-22,12,-60,-79,-49,-155,-50,66,-337
2,11,-16,-26,-25,-27,15,70,4
88,138,-75,-42,-115,-214,-40,250,-10
9,-16,-31,-34,-50,-69,-31,56,-166
-10,7,-60,-32,-104,-67,-9,56,-219
393,439,77,56,-103,-152,128,623,1461
11,78,-5,-25,-49,-112,-35,88,-49
-9,10,-27,-2,-22,-44,-7,1,-100
14,36,-22,-9,-57,-80,-13,50,-81
38,121,-92,-52,-124,-233,-36,182,-196
25,10,-38,-9,-36,-68,-17,38,-95
63,42,-30,-34,-24,-26,12,59,62
15,49,18,15,-5,20,24,51,187
120,258,-68,-21,-125,-119,125,271,441
72,50,-88,-108,-159,-168,-21,180,-242
-20,99,-92,-69,-44,-67,42,149,-2
28,103,-49,-34,-15,-41,39,138,169
46,69,-24,21,-10,-33,49,77,195
11,-14,-56,-57,-93,-113,-30,91,-261
-5,45,-26,-20,-34,-100,-34,84,-90
-37,-24,-34,-46,-59,-87,-32,59,-260
-11,14,-32,-31,-80,-38,-12,82,-108
-52,6,-54,-71,-120,-130,-54,79,-396
17,12,-62,-50,-121,-180,-37,170,-251
-68,-28,-92,-74,-206,-180,-148,153,-643
-22,2,-10,-29,0,-33,-18,38,-72
-1,103,-24,1,-139,-321,-85,257,-209
-91,-13,-96,-99,-132,-207,-118,195,-561
-68,-34,-88,-56,-132,-164,-74,96,-520
33,68,-4,-39,-9,-96,-18,82,17
105,169,-6,-5,-65,-27,74,242,487
-31,3,-82,-36,-103,-80,-22,62,-289
146,225,-165,-228,-232,-374,12,418,-198
6,-14,-18,-64,2,-90,-23,44,-157
-14,-3,-45,2,-74,-79,-10,64,-159
-14,26,-1,-16,-3,-16,-1,39,14
-48,-21,-63,-29,-55,-124,-80,35,-385
13,91,-70,-12,-210,-397,-71,205,-451
88,172,-91,-87,-143,-111,17,245,90
67,76,-51,-36,-66,-69,43,82,46
33,40,-31,2,-49,-72,13,60,-4
106,147,12,18,17,-33,44,175,486
-22,-12,-11,-15,-21,-37,-30,23,-125
61,126,-16,-12,-25,-38,51,65,212
173,171,-106,-127,-168,-200,-1,370,112
31,43,-4,-4,-19,-18,27,59,115
-24,3,-80,-86,-163,-161,-80,162,-429
26,117,-1,-51,-35,-54,2,158,162
3,18,-26,-16,-45,-71,-27,80,-84
251,415,-113,-97,-80,-135,118,284,643
82,158,-10,-20,-81,-57,56,258,386
793,987,-483,-160,-540,-324,-461,1362,1174
21,75,-10,-36,-77,-137,6,149,-9
-40,-16,-57,-22,-112,-148,-67,44,-418
21,26,-10,-30,-33,-63,-8,69,-28
45,121,-23,-63,-72,-54,85,151,190
19,-1,-47,-18,-161,-67,5,120,-150
46,59,-28,-1,-56,-48,25,51,48
-20,31,-46,-69,-61,-199,-72,115,-321
118,164,-69,-15,-164,-171,24,173,60
142,156,13,-52,-20,-55,52,122,358
277,472,-55,-96,-278,-350,52,615,637
33,281,-275,-149,-488,-792,-179,563,-1006
-19,116,-38,-133,-72,-220,-17,201,-182
222,348,-169,-58,-161,-131,132,430,613
27,66,-20,-39,-46,-61,5,93,25
97,254,-92,-102,-203,-252,35,345,82
10,97,17,-77,-49,-138,-30,190,20
68,225,-51,-43,-133,-235,56,287,174
49,154,-167,-222,-283,-393,-21,347,-536
-25,97,-63,-83,-2,3,81,203,211
39,50,3,-5,-133,-162,-36,134,-110
143,214,-58,-89,-70,-135,28,241,274
327,520,206,57,171,-36,74,518,1837
38,24,-58,-67,-85,-104,-6,119,-139
199,277,-29,-38,-65,-101,96,309,648
175,212,-6,-73,-47,-47,44,297,555
35,14,-112,-97,-197,-193,-54,179,-425
49,142,-44,-85,-97,-70,-10,162,47
446,489,225,312,-42,-37,27,718,2138
-59,-20,-117,-62,-148,-169,-53,92,-536
4,33,-49,-73,-104,-166,-60,192,-223
70,113,-7,47,-146,-148,15,200,144
41,61,-105,-21,-300,-285,-44,269,-384
21,35,-52,-22,-104,-60,11,66,-105
45,67,-24,-37,-18,-71,-4,131,89
454,631,-163,-209,-279,-240,252,772,1218
198,265,-19,-118,-151,-99,43,411,530
33,60,-38,-100,-118,-73,24,200,-12
362,553,-145,-221,-229,-388,131,670,733
99,156,-54,-163,-193,-201,-14,338,-32
0,61,-88,-100,-170,-212,-53,178,-384
-65,62,-67,-68,-14,-17,55,73,-41
415,519,-129,-51,-174,-155,191,553,1169
38,166,-155,-208,-310,-291,-53,410,-403
318,488,-67,-209,-215,-322,107,700,800
69,119,-61,-27,-117,-180,12,191,6
302,339,70,0,59,-121,136,369,1154
11,82,-99,-68,-74,-120,-9,86,-191
17,35,6,7,-18,-6,16,47,104
4,60,-57,-51,-172,-230,-53,187,-312
26,20,-54,-36,-107,-97,-12,76,-184
33,88,-12,-16,-23,-53,0,97,114
4,40,10,-1,-31,-11,4,79,94
18,44,-36,-44,-34,-59,7,75,-29
-37,-31,-86,-34,-121,-202,-69,61,-519
38,29,-25,-65,-130,-111,-7,118,-153
31,38,-3,-3,-6,-33,4,61,89
59,62,-86,-53,-187,-226,-43,182,-292
-21,-3,-51,-79,-48,-154,-49,85,-320
137,163,29,10,-15,-70,80,209,543
78,111,-28,-47,-57,-52,62,192,259
59,25,-105,-89,-216,-248,-14,86,-502
1,24,7,-22,1,-14,4,48,49
120,157,24,-12,-15,-95,25,177,381
214,445,55,-124,-386,-499,-89,762,378
12,74,-36,-10,-80,-102,-26,90,-78
6,27,-2,-11,-1,-12,12,12,31
30,88,-8,0,-31,-39,12,47,99
-20,107,-48,-39,-37,-29,39,186,159
15,-1,-136,-85,-185,-232,-82,143,-563
12,12,0,-5,-18,-14,9,22,18
1,71,-82,-67,5,-2,31,170,127
56,68,5,0,-33,-30,41,60,167
-26,85,-185,-120,-282,-323,-38,255,-634
14,71,-13,-34,-101,-149,-45,110,-147
43,93,-25,21,-88,-69,2,90,67
26,44,-26,-8,-17,-63,5,58,19
18,0,-9,-11,-29,-10,0,25,-16
6,2,-12,-24,-28,-71,-19,29,-117
12,45,-45,-40,-128,-102,-15,114,-159
53,42,-24,14,-58,-43,22,52,58
105,126,20,-11,-250,-103,-40,318,165
-78,-72,-128,-75,-116,-138,-61,90,-578
22,29,-10,-18,-26,-52,-2,32,-25
2,26,-14,3,-8,9,13,28,59
142,230,-157,-101,-356,-396,-66,449,-255
-13,-4,-22,-14,-20,-37,-26,8,-128
-7,18,2,11,-32,-9,-6,18,-5
42,105,13,-12,3,-46,10,122,237
63,123,-63,-60,-104,-66,-19,189,63
14,34,-7,-39,-5,-24,18,62,53
89,92,-41,-21,-93,-53,61,150,184
137,160,-4,47,-72,7,75,192,542
24,77,0,-53,-31,-82,-1,91,25
-2,-18,-21,-24,-43,-35,-7,36,-114
-1,83,-40,-74,-64,-194,-72,173,-189
-6,87,-32,-70,-58,-214,-63,159,-197
-35,126,-8,-94,-215,-192,-21,301,-138
61,83,-67,-36,-104,-94,4,70,-83
51,104,-40,20,-44,-70,8,83,112
73,115,7,30,20,6,79,116,446
44,54,-6,-17,3,-50,12,70,110
7,59,16,25,1,2,23,52,185
85,58,-16,40,-72,-75,48,99,167
60,93,17,-21,5,-45,34,123,266
30,50,-27,-5,-9,-8,23,71,125
-37,43,-11,-27,-58,-103,-49,64,-178
11,39,-8,-36,-40,-137,-39,94,-116
-53,-10,-101,-65,-244,-253,-101,146,-681
-74,15,-82,-52,-178,-152,-85,141,-467
-3,87,-66,-75,-114,-155,-37,148,-215
123,125,-38,5,-93,-64,33,136,227
96,97,27,-4,0,-76,-3,122,259
15,65,-39,-21,-10,8,35,58,111
61,73,-30,-27,-44,-59,17,66,57
107,110,45,29,49,-85,38,154,447
174,234,91,-103,55,-167,39,294,617
5,12,-16,-13,-52,-41,-16,30,-91
137,156,50,-34,-94,-151,3,338,405
52,122,-15,-26,-35,-34,68,156,288
6,23,-10,-23,-14,-33,-15,45,-21
-40,17,-121,-85,-241,-222,-76,207,-561
59,13,-28,-1,-26,-44,0,63,36
8,104,-114,-66,-165,-137,-15,164,-221
14,74,-6,-42,-67,-103,15,121,6
-2,26,-11,-10,-15,-32,-16,35,-25
2,59,-34,-39,-85,-74,14,103,-54
11,27,-19,-16,-17,-42,7,-8,-57
46,110,-46,-30,-71,-94,28,111,54
12,9,-17,-21,-25,-56,-11,29,-80
-75,-40,-121,-32,-191,-206,-112,109,-668
39,0,-70,-51,-77,-127,-14,65,-235
-42,31,-47,7,-83,-102,-36,77,-195
-2,42,0,-8,-20,-39,-9,54,18
4,5,-6,-15,-22,-11,-8,19,-34
34,75,47,63,-15,5,13,110,332
6,32,-24,-38,-27,-34,-17,53,-49
12,34,-29,-33,-41,-29,24,76,14
-15,0,-29,-42,-23,-71,-28,44,-164
93,94,55,-43,29,-100,17,137,282
23,25,12,4,-6,-31,-17,61,71
10,14,-21,-10,-28,-20,6,8,-41
26,30,-28,17,-41,-42,11,45,18
3,12,-27,-31,-22,-58,-3,36,-90
13,40,-4,-14,-21,-42,-4,28,-4
51,88,24,-34,-39,-70,10,126,156
2,93,-58,-85,-85,-137,-36,167,-139
-61,-42,-87,-83,-118,-100,-40,58,-473
-27,39,-52,-7,-101,-127,-42,71,-246
-31,14,-57,-26,-75,-79,-25,85,-194
24,37,-8,-13,-32,-33,0,65,40
-7,-7,-19,-33,-14,-110,-30,55,-165
62,32,-7,-25,-4,-34,26,72,122
67,111,-71,-43,-81,-75,16,179,103
46,58,15,-11,1,-59,11,100,161
31,27,-32,1,-82,-56,-3,34,-80
-53,43,-96,-40,-137,-147,-91,194,-327
-4,-3,-22,-3,-34,-46,-31,23,-120
28,19,-7,-18,2,-48,15,34,25
32,89,-5,-15,-18,-43,13,99,152
1,5,-4,-10,8,-5,4,9,8
48,92,13,-19,-31,-61,11,144,197
29,81,11,11,-14,-52,-16,73,123
-1,4,-36,-51,-34,-91,-22,70,-161
-19,10,-28,-30,-110,-48,-3,58,-170
80,68,-78,-23,-52,-80,38,43,-4
2,32,10,-2,-5,-44,-19,59,33
24,27,-29,-33,-34,-82,9,46,-72
-43,10,-50,-99,-115,-173,-28,118,-380
4,17,-10,-6,-28,-49,-12,22,-62
202,369,-103,68,-97,-73,139,336,841
139,233,-95,-89,-171,-311,-6,312,12
-76,-24,-43,-56,-56,-141,-90,70,-416
23,40,-27,-27,-41,-120,-2,77,-77
17,60,-28,-38,-113,-125,-15,130,-112
-16,37,-73,-112,-120,-114,-26,103,-321
-51,-11,-42,-69,-75,-167,-74,134,-355
-1,27,-22,-15,-1,-29,2,19,-20
-9,18,-33,-11,-27,-33,-16,40,-71
-33,-22,-30,-24,-35,-73,-52,40,-229
81,164,-48,-45,-48,-88,44,112,172
29,42,16,-14,-28,-48,1,44,42
109,139,-62,-21,-76,-147,35,185,162
22,75,-21,-25,5,1,37,58,152
27,59,4,-18,-45,-118,-9,85,-15
-16,-5,-57,-81,-109,-91,-34,92,-301
-58,80,-50,-48,-132,-158,-73,141,-298
-1,6,-28,-10,-43,-25,-3,30,-74
55,39,5,14,0,-6,24,56,187
53,72,3,12,-29,-56,3,78,136
18,-7,-18,-20,-30,-41,-23,30,-91
14,-11,-36,-8,-69,-56,-4,55,-115
11,81,-118,-77,-158,-344,-131,213,-523
23,87,-37,-54,-94,-182,-14,95,-176
22,152,-32,-77,-63,-169,-8,239,64
-46,41,-79,-50,-103,-125,-34,136,-260
1,-5,-13,-7,-22,-24,-13,28,-55
52,140,34,83,-9,-5,-11,206,490
35,29,-4,-31,-33,-41,3,83,41
53,61,-1,45,1,-17,31,76,249
-39,127,-158,-128,-300,-324,-29,264,-587
-16,43,-32,-44,-77,-56,-8,87,-103
71,123,-17,-55,-36,-24,48,67,177
9,36,4,-5,-13,-5,1,37,64
26,41,-11,3,-43,-16,24,43,67
32,108,-18,-34,-35,-82,30,106,107
29,38,7,-21,-3,-43,9,52,68
2,23,-1,-18,-27,-52,-24,43,-54
30,49,-18,-10,-33,-59,-8,53,4
30,186,30,-3,-70,-20,-29,219,343
115,189,-70,-38,-107,-66,53,139,215
15,25,-11,-21,2,-20,22,35,47
-71,27,-61,-39,-118,-205,-86,116,-437
40,59,-32,17,-68,-85,-28,59,-38
14,42,-20,-17,-4,-35,13,24,17
65,97,-35,-26,-44,-53,74,141,219
52,39,-39,-29,-65,-69,-21,77,-55
144,224,-145,-106,-179,-246,19,248,-41
56,49,-15,-11,-44,-57,14,85,77
131,174,-28,-76,-71,-123,23,229,259
134,119,29,-5,-13,-3,58,207,526
96,52,-22,-14,-157,-87,24,202,94
-17,-19,-91,-43,-108,-135,-52,95,-370
34,105,-42,-56,-68,-125,-14,143,-23
66,98,18,3,-26,-32,34,113,274
11,41,-32,-16,-33,-60,7,48,-34
31,81,-21,-49,-90,-152,-22,119,-103
5,54,-101,-83,-178,-219,-56,225,-353
54,49,18,-4,18,-23,15,50,177
29,7,-66,-20,-155,-119,22,108,-194
85,111,-15,-22,-18,-55,59,135,280
-46,28,-95,-96,-164,-243,-98,126,-588
119,175,56,-30,15,-91,35,209,488
109,209,-17,-29,-21,-132,20,204,343
205,262,-153,-86,-185,-285,69,327,154
39,164,-52,-56,-88,-164,-6,240,77
59,58,-34,-39,-9,-94,-15,66,-8
29,68,-4,45,-121,-120,-27,151,21
9,23,-24,-28,-26,-47,-6,50,-49
-7,17,1,-4,-41,-54,-22,57,-53
11,12,-15,-6,-12,-16,13,22,9
37,95,-45,0,-68,-75,-13,77,8
49,66,-33,-36,-89,-139,-39,85,-136
88,128,-26,-22,-92,-176,16,186,102
45,57,-22,-48,-76,-98,15,110,-17
62,95,17,4,-92,-58,11,192,231
37,18,-36,-64,-73,-114,-32,83,-181
118,135,3,-39,-42,-102,35,145,253
28,23,-9,-10,-33,-40,6,47,12
-45,-19,-78,-56,-86,-116,-46,64,-382
24,19,-21,-5,-33,-29,5,34,-6
-67,17,-64,-17,-81,-166,-82,74,-386
76,49,-55,7,-70,-13,60,76,130
6,0,-36,-16,-74,-49,5,31,-133
185,213,-115,-11,-235,-51,150,115,251
-63,-30,-48,-50,-57,-120,-73,84,-357
67,112,45,45,-5,14,43,139,460
13,44,-62,-82,-90,-103,-22,128,-174
-34,4,-60,-39,-124,-114,-23,96,-294
224,336,-75,-3,-39,-48,176,256,827
7,26,-20,-5,-63,-54,-2,55,-56
6,43,-11,-5,-65,9,2,101,80
-42,30,9,-48,-63,-102,-38,113,-141
221,347,-128,-98,-327,-286,86,480,295
85,179,-3,-52,-38,-88,26,193,302
46,97,-27,-42,-49,-49,49,95,120
125,250,-52,-124,-53,-150,83,294,373
33,207,5,-54,15,-16,105,258,553
74,152,41,108,-105,-55,39,213,467
139,279,7,-15,-67,-213,53,371,554
67,70,1,12,-53,-32,66,131,262
211,298,-117,-46,-162,-149,101,318,454
31,18,-84,-67,-145,-134,6,75,-300
33,65,-113,-96,-106,-156,12,150,-211
84,100,24,38,-43,-59,42,194,380
31,132,-63,-48,-17,-60,63,124,162
55,115,-70,-107,-159,-124,20,183,-87
83,155,-243,-137,-397,-453,-69,341,-720
50,84,10,-5,-1,-61,18,98,193
-18,47,-62,-35,0,11,46,93,82
6,-2,-27,-39,-66,-43,-12,73,-110
26,52,-53,-22,-39,-62,12,19,-67
87,101,-63,-30,-77,-76,50,118,110
143,52,38,-18,-83,60,80,260,532
29,35,-10,-31,-64,-74,30,79,-6
47,63,-19,1,-23,-42,10,32,69
11,17,-20,-32,-101,-165,-37,131,-196
-14,105,-27,-29,-7,51,55,131,265
17,8,-17,-8,-12,-18,9,18,-3
332,830,-366,-231,-1016,-1366,-185,1312,-690
-10,102,-70,-15,-37,-41,32,154,115
70,59,-22,-14,-3,-34,31,109,196
-12,189,58,3,-264,-121,-38,336,151
-25,3,-48,-80,-111,-80,-13,141,-213
19,52,-63,-37,-59,-125,2,105,-106
22,-14,-16,-21,-33,-63,-8,73,-60
20,11,-47,-75,-42,-73,-5,72,-139
22,13,-24,-23,-32,-115,-18,80,-97
5,16,-28,1,-74,-52,0,43,-89
28,160,-85,-12,-116,-14,100,205,266
-9,10,-27,-29,-37,-53,-28,31,-142
29,10,-30,8,-42,-24,18,30,-1
39,47,-31,3,-90,-127,-4,139,-24
3,26,-49,-38,-65,-52,11,62,-102
61,43,-51,-16,-91,-119,-4,65,-112
361,792,-202,-224,-196,-286,213,920,1378
-2,66,-64,-46,-112,-77,-17,90,-162
32,48,-1,-2,-1,-23,17,37,107
82,-1,-56,21,-93,-112,39,50,-70
42,135,94,52,-17,-3,-58,196,441
-23,64,-23,-67,-84,-129,-22,110,-174
53,126,-10,37,-115,-148,-53,196,86
12,23,-56,-45,-187,-102,-49,215,-189
1,-15,-31,5,-39,-84,-18,27,-154
57,106,-51,-46,-98,-139,2,124,-45
74,123,-18,-33,-61,-120,-19,135,81
35,142,-116,-68,-200,-157,-1,229,-136
94,113,5,-6,4,-56,45,101,300
108,-20,47,25,-48,41,53,145,351
12,144,26,-54,-89,-428,-130,288,-231
46,65,-33,-95,-110,-385,-165,279,-398
297,514,-143,-301,-333,-312,97,807,626
71,169,36,-26,-28,-178,6,179,229
-7,46,2,-54,-26,-40,-1,94,14
-66,-7,-88,-32,-154,-153,-66,91,-475
214,319,9,-59,18,-138,101,316,780
41,30,-32,-43,-31,-116,-24,84,-91
7,-21,-91,-48,-103,-198,-29,79,-404
508,717,-543,34,-1024,-1128,-57,551,-942
21,89,-17,-29,-81,-64,19,74,12
7,1,-20,-9,-27,-10,3,24,-31
7,6,-25,-23,-47,-94,-35,65,-146
39,3,-6,-21,-33,-69,2,37,-48
16,24,-66,-34,-107,-98,-20,52,-233
4,89,-78,-123,-197,-411,-134,328,-522
-26,100,-67,-188,-203,-414,-117,315,-600
1,6,13,-19,-6,-47,-25,62,-15
188,306,-66,-13,-64,-142,92,335,636
114,198,56,16,-48,-77,75,276,610
-17,6,-42,-82,-104,-89,-35,124,-239
48,29,-22,14,-26,-27,21,24,61
15,26,-17,-3,-26,-20,-3,36,8
7,12,-32,-50,-57,-56,-32,26,-182
-3,25,-63,-45,-70,-91,10,59,-178
2,20,-19,17,-70,-67,-18,87,-48
-2,87,0,-67,-70,-123,-12,139,-48
27,31,-18,-7,-50,-57,-22,58,-38
75,144,-33,-22,-99,-114,7,192,150
28,52,-20,-66,-95,-105,-27,114,-119
115,236,9,44,-130,-157,10,205,332
0,4,-9,-1,-1,-13,-5,10,-15
-2,1,1,4,-5,-10,-8,8,-11
-5,13,-10,-10,-14,-24,5,12,-33
13,46,-10,-5,-5,-36,3,49,55
1,10,-12,-15,-37,-12,17,46,-2
259,335,55,-97,-92,-203,65,471,793
26,85,-71,-77,-130,-164,-16,141,-206
21,118,-58,-100,-154,-193,-10,219,-157
20,71,-69,-22,-198,-182,-29,161,-248
185,376,-110,-136,-143,-240,88,384,404
114,114,-19,8,-108,-116,18,206,217
-72,4,-74,-45,-134,-150,-80,104,-447
327,236,246,-1,249,23,92,440,1612
28,47,-26,-64,-46,-103,-31,93,-102
2,52,-46,-56,-75,-48,-26,131,-66
186,170,7,-26,-35,-149,60,266,479
44,38,-11,-13,-49,-80,3,47,-21
18,12,-25,-37,-25,-67,9,46,-69
6,7,-18,-20,-39,-52,-13,38,-91
-26,2,-14,-17,-25,-46,-25,41,-110
3,11,2,-8,7,-22,-2,9,0
23,28,-9,-3,-13,-32,14,33,41
10,224,-104,-43,-201,-447,-91,331,-321
31,29,17,-46,1,-21,5,90,106
-13,5,-20,-14,-15,-12,-2,5,-66
11,13,-11,-27,-13,-42,-6,21,-54
-5,62,43,5,-37,-20,-2,105,151
3,15,18,4,-13,5,11,38,81
180,207,36,-200,27,-292,15,330,303
135,132,22,65,-61,-100,50,190,433
120,177,9,-69,-21,-107,20,205,334
1,23,8,-3,-1,8,5,25,66
-2,30,-41,-37,-82,-69,-16,86,-131
36,57,-15,-22,-10,-79,25,43,35
64,141,-41,-55,-139,-209,-45,223,-61
18,8,-14,-3,-36,-21,15,28,-5
6,15,-28,-27,-50,-34,-1,31,-88
12,1,-16,-22,-15,-34,-9,28,-55
5,11,-22,-9,-32,-43,-3,40,-53
14,38,-80,-63,-142,-136,-41,120,-290
20,7,-38,-30,-56,-36,13,60,-60
15,25,-12,-11,-23,-45,-5,30,-26
6,6,-11,-5,-7,-20,-1,10,-22
11,-2,-20,-7,-37,-16,4,18,-49
-76,-24,-86,-56,-137,-144,-82,96,-509
-23,-22,-29,-14,-22,-30,-23,5,-158
27,12,-13,4,-26,-38,5,34,5
114,186,-147,-201,-184,-326,-33,326,-265
36,98,-75,-6,-124,-102,-7,136,-44
17,51,11,-35,-13,-41,16,63,69
-8,37,-12,-59,-34,-15,-18,67,-42
-34,9,-59,-51,-49,-118,-48,70,-280
-40,9,-72,-47,-53,-125,-30,50,-308
50,126,-84,-87,-129,-172,12,136,-148
22,5,-18,-23,-38,-88,-41,45,-136
108,352,184,14,3,108,25,346,1140
17,7,-25,7,-42,-30,-5,41,-30
22,41,-24,-25,-55,-56,-1,54,-44
32,27,-1,-8,4,-4,15,36,101
23,19,-5,-3,-2,-5,15,28,70
17,40,-17,-22,-16,-35,1,42,10
84,107,15,51,-56,-62,32,104,275
51,129,-21,-30,-98,-121,32,223,165
56,137,-109,-176,-207,-260,-49,274,-334
219,291,-4,-99,-53,-78,87,365,728
26,50,-16,-30,-6,-68,-8,41,-11
78,187,-14,-55,-32,-124,60,240,340
-3,-1,-21,-13,-36,-30,-17,15,-106
-30,-58,-68,-8,-107,-130,-32,51,-382
-11,-1,-45,14,-123,-140,-32,65,-273
21,75,10,-7,-53,-52,-10,105,89
9,31,-18,-4,-21,-49,7,35,-10
22,-2,-6,18,-29,-37,-20,51,-3
41,44,-22,-21,-61,-44,11,77,25
-67,-26,-56,-53,-80,-121,-58,87,-374
-87,10,-78,-53,-126,-153,-66,137,-416
53,55,-41,-39,-118,-137,-1,78,-150
-12,-10,-11,-26,-65,-66,-16,105,-101
-8,35,-33,-17,-64,-98,-17,64,-138
191,327,-142,23,-242,-286,-43,310,138
58,121,-53,-19,-72,-59,27,135,138
-68,-5,-88,-92,-92,-162,-84,122,-469
35,112,-7,-38,-64,-119,0,201,120
-33,43,-81,-25,-130,-166,-66,111,-347
29,60,12,-7,4,-54,1,59,104
6,83,-92,-72,-140,-138,-39,182,-210
13,14,-2,-6,-11,-6,7,20,29
46,91,15,53,-199,-57,-23,162,88
12,88,-8,-2,-154,-67,-4,108,-27
70,65,-63,-6,-93,-46,5,63,-5
248,364,-40,3,-105,-178,81,531,904
65,41,-52,36,-119,-64,32,63,2
69,82,-21,-16,-33,-113,12,133,113
24,90,-11,-31,38,-25,70,110,265
-105,-40,-123,-58,-133,-188,-88,92,-643
-7,7,-60,-21,-122,-146,-49,105,-293
-3,2,-117,-101,-155,-132,-21,79,-448
41,54,-18,-44,-20,-76,13,59,9
28,82,-80,-80,-179,-200,-16,209,-236
-25,60,-111,-73,-177,-326,-124,174,-602
37,68,-40,-18,-47,-37,38,44,45
22,101,-8,-43,-60,-40,-2,116,86
337,479,-94,-197,-296,-269,128,684,772
86,117,3,11,-11,-22,-4,120,300
-21,65,-75,-41,-24,10,58,54,26
53,97,-54,-8,-158,-147,9,128,-80
0,22,-16,18,-44,-41,-10,13,-58
6,17,-59,-51,-99,-105,-52,108,-235
2,31,-5,-15,-39,-68,-21,46,-69
27,30,-4,2,-9,-2,22,15,81
3,74,-27,-49,-58,-110,-20,116,-71
40,74,-26,-23,-47,-107,-16,70,-35
112,242,-84,-85,-111,-283,-13,274,52
29,43,-38,-55,-70,-137,2,74,-152
223,300,-58,-59,-87,-163,100,401,657
2,18,-11,-30,-15,-20,9,53,6
87,201,-5,14,-151,-137,-10,180,179
0,-5,-42,-28,-58,-77,-6,20,-196
191,338,-51,-199,-437,-382,-52,672,80
14,39,6,26,-112,-121,-32,211,31
-84,117,-284,-279,-430,-575,-203,546,-1192
29,70,12,-37,-46,-69,-7,101,53
-12,20,-155,-139,-310,-290,-138,203,-821
127,193,-205,-139,-222,-314,2,313,-245
45,104,36,-2,38,6,45,91,363
83,155,-230,-87,-303,-235,-28,242,-403
15,77,-39,-37,-135,-275,-27,203,-218
10,8,-84,-78,-117,-172,-56,121,-368
46,86,27,-6,27,-13,22,79,268
1,13,-71,-59,-70,-71,0,61,-196
11,32,-30,-28,-76,-38,1,63,-65
-38,-13,-95,-16,-99,-118,-61,71,-369
54,120,-11,-38,-103,-154,-41,227,54
-15,-2,-37,-51,-45,-65,-25,41,-199
31,66,14,13,-7,-29,13,62,163
0,11,-36,-21,-50,-37,-3,69,-67
43,143,-76,-84,-32,-61,51,144,128
-1,48,-34,7,-61,-71,-9,68,-53
76,75,-10,-19,-66,-47,31,94,134
74,117,-16,3,-33,-20,52,129,306
147,184,179,-3,-30,-42,62,347,844
57,-7,-124,-47,-178,-177,10,107,-359
38,41,-39,-69,-47,-135,-12,104,-119
285,830,-487,-373,-912,-1429,-296,1176,-1206
14,22,-6,-3,-17,-14,4,16,16
76,82,22,3,-1,-47,48,155,338
-8,60,-40,-59,-66,-71,-15,81,-118
16,107,-7,-45,-3,-31,23,124,184
60,219,-152,-75,-183,-255,41,265,-80
15,6,-80,-33,-206,-78,6,126,-244
-5,46,13,-9,6,-47,-14,39,29
72,52,-4,16,-31,-36,17,94,180
28,56,-29,0,-61,-19,45,74,94
32,85,-44,-42,-48,-79,-3,85,-14
-77,-24,-66,-51,-57,-227,-88,93,-497
1,59,-11,-30,-40,-55,-18,114,20
69,91,53,48,-62,-85,-11,131,234
15,30,-5,-5,-10,-30,-3,22,14
-22,3,-19,12,-29,-34,-2,24,-67
-6,1,-40,-22,-92,-75,-12,49,-197
0,25,-45,-34,-66,-64,-12,68,-128
12,57,-63,-41,-116,-153,-30,106,-228
-8,17,-1,-33,-51,-96,-24,73,-123
68,16,-10,-17,-35,-67,15,83,53
119,108,-25,12,-52,-63,49,184,332
51,95,23,-16,9,-12,26,88,264
33,115,-34,-69,-107,-121,20,165,2
-24,15,-55,-16,-105,-107,-43,85,-250
9,15,-20,-47,-62,-37,-9,71,-80
-74,-29,-127,-76,-148,-196,-119,103,-666
-69,-31,-40,-61,-47,-101,-59,36,-372
36,38,-24,-4,-57,-45,25,42,11
24,64,-51,-42,-75,-96,-19,77,-118
22,22,-27,-12,-50,-15,24,48,12
-25,7,-61,-41,-73,-114,-29,26,-310
78,113,-73,13,-95,-89,22,84,53
136,146,-33,6,-67,-42,78,170,394
-12,-5,-30,-54,-72,-88,-36,95,-202
40,99,-63,-29,-142,-174,1,152,-116
18,6,-45,-28,-58,-107,-31,48,-197
22,64,-1,-9,-21,-37,9,77,104
11,41,-11,-13,-18,-74,-18,34,-48
-24,76,-81,-56,-163,-199,-68,175,-340
-8,-7,-54,-40,-63,-88,-24,53,-231
26,25,-68,-39,-104,-86,16,77,-153
7,17,-51,-29,-134,-114,-38,118,-224
27,50,-50,-20,-81,-36,2,45,-63
63,64,-49,-31,-72,-111,25,146,35
2,64,-76,-104,-118,-144,-53,166,-263
26,68,-60,-41,-155,-149,-52,157,-206
24,10,-67,-6,-113,-130,-25,82,-225
29,13,-42,-53,-60,-62,24,76,-75
-23,11,-17,-2,-35,-79,-31,44,-132
3,21,-5,-26,-35,-61,-6,65,-44
-18,7,-35,-12,-46,-19,-8,43,-88
18,23,-26,-41,-22,-53,-11,27,-85
5,27,-1,-15,-14,-24,-4,49,23
32,34,7,-15,3,-19,27,61,130
-2,15,-2,9,-14,-22,-7,36,13
35,59,-10,-14,-26,-15,39,56,124
62,149,-56,-15,-197,-53,55,270,215
-34,-17,-23,-44,-99,-175,-83,112,-363
3,32,-105,-45,-116,-115,13,144,-189
66,101,-112,-55,-197,-212,-34,207,-236
9,95,-43,-50,-10,-26,25,153,153
-3,49,-29,-38,-66,-72,-1,77,-83
6,86,-34,-80,-91,-161,-29,172,-131
50,23,-20,9,-62,-60,-5,80,15
20,-5,-29,-61,-38,-77,-26,80,-136
-17,24,-34,-35,-41,-49,-6,47,-111
23,68,-62,-19,-72,-88,19,73,-58
-48,-10,-85,-86,-121,-130,-57,64,-473
-80,-31,-136,-56,-185,-140,-69,58,-639
70,101,-41,-16,-130,-115,17,189,75
-4,49,-47,-33,-67,-108,-37,97,-150
24,58,-44,-45,-48,-124,-23,89,-113
67,196,-48,-56,-33,-252,-3,224,95
73,196,-78,-88,-146,-295,-32,254,-116
16,34,-71,-47,-177,-212,-57,120,-394
71,90,-10,-11,-68,-62,25,120,155
8,-15,-64,-39,-70,-127,-3,57,-253
16,21,-24,-46,-69,-138,-44,50,-234
52,168,-3,-58,-51,-135,-9,156,120
2,61,-85,-38,-131,-123,-17,99,-232
42,96,-130,-53,-286,-306,-76,264,-449
6,7,-31,-56,-41,-129,-43,69,-218
33,230,-159,-65,-293,-372,-103,338,-391
73,69,-76,-13,-170,-161,13,67,-198
6,3,-18,-23,-39,-28,-7,37,-69
31,48,-38,-20,-62,-60,-1,34,-68
17,34,7,3,-21,-34,-7,44,43
41,67,-21,-26,-17,-57,16,75,78
1,41,-6,-21,-11,-58,-27,32,-49
3,34,-72,-93,-99,-152,7,122,-250
48,76,-53,4,-83,-67,27,33,-15
45,87,-58,-72,-115,-123,0,140,-96
13,51,-70,-50,-88,-178,-36,69,-289
50,91,-50,-45,-113,-103,11,110,-49
40,140,-67,-2,-84,-105,24,201,147
13,1,12,-30,-15,-39,-6,68,4
50,132,-47,-41,-102,-96,28,186,110
-1,-2,-44,-27,-48,-19,-3,12,-132
2,15,-28,-36,-157,-133,-1,150,-188
20,10,-51,-65,-153,-195,-58,101,-391
154,189,11,-1,-89,-98,76,247,489
-16,48,-54,-63,-82,-130,-34,147,-184
13,37,-4,-24,-7,-25,12,43,45
20,36,-19,-17,-9,-40,13,55,39
38,29,-18,-16,-64,-69,0,64,-36
80,112,-70,-49,-134,-157,41,147,-30
70,82,-116,-33,-114,-181,1,147,-144
-23,-7,-48,-21,-59,-77,-23,58,-200
22,56,15,-8,14,-20,17,46,142
45,82,-35,-49,-61,-133,-10,168,7
-51,-24,-48,-34,-54,-73,-56,40,-300
15,58,-25,-36,-3,-49,-1,36,-5
146,196,50,0,-62,-24,82,279,667
12,-2,-41,-25,-64,-79,-19,45,-173
35,61,-33,-40,-134,-105,16,93,-107
1,10,-62,-56,-137,-139,-67,109,-341
38,39,12,-5,-27,-16,26,62,129
148,197,54,-17,61,-70,56,218,647
40,80,-93,-129,-219,-194,-22,219,-318
123,208,-114,-29,-71,-74,116,183,342
-28,-17,-123,-61,-144,-215,-84,113,-559
-2,19,-37,-45,-42,-96,-26,48,-181
0,11,-13,-8,-25,-22,11,25,-21
73,54,-4,-47,-14,-52,34,77,121
60,93,-52,-26,-37,-76,34,108,104
99,161,42,-16,4,-9,70,195,546
18,42,-5,-7,-36,-64,-1,38,-15
49,147,-38,-65,-75,-41,68,149,194
26,70,-18,-1,-25,-55,26,69,92
42,50,4,-16,11,-24,27,42,136
107,13,-5,14,-66,-53,7,99,116
62,118,-33,-14,-13,21,68,58,267
27,51,-47,-25,-87,-114,3,88,-104
-50,-9,-30,-29,-44,-95,-73,57,-273
-4,-1,-31,-46,-59,-97,-37,63,-212
20,17,0,-3,1,-2,15,33,81
-46,44,-56,-16,-105,-179,-52,128,-282
112,160,-7,-63,-19,-133,61,183,294
5,9,-30,12,-38,-31,5,36,-32
51,93,3,-54,-5,-64,15,133,172
221,375,-34,-24,-70,30,168,257,923
38,85,-64,-29,-61,-26,57,72,72
29,72,-48,-41,-145,-149,-24,178,-128
8,60,-14,-44,-76,-78,9,146,11
89,67,51,19,-16,-45,12,123,300
-6,19,-29,-28,-6,-45,-17,40,-72
110,168,-21,-19,-89,-46,103,221,427
104,136,-21,-40,-26,-53,63,150,313
98,112,-23,-14,-49,-67,27,132,216
19,30,-16,-12,-13,-38,1,33,4
7,38,-52,-26,-44,-93,-17,71,-116
30,45,-8,2,-25,-53,22,72,85
65,57,-49,-55,-107,-128,-44,161,-100
25,46,-35,-26,-66,-93,-25,54,-120
18,33,-47,-42,-61,-124,-43,109,-157
61,137,28,-23,22,-18,31,125,363
18,58,-79,-44,-62,-47,15,90,-51
28,11,5,-25,-30,-63,-4,72,-6
3,68,-5,-5,-4,-5,25,54,131
9,4,-57,17,-138,-81,1,108,-137
19,17,-22,-2,-54,-72,-3,28,-89
-6,7,-16,-23,-30,-31,3,48,-48
17,7,-21,5,-28,-23,13,24,-6
28,66,-15,-27,-31,-56,34,96,95
19,45,12,-7,5,-39,7,34,76
-47,-8,-45,-38,-50,-125,-48,63,-298
5,15,-19,-17,-24,-48,-4,30,-62
22,92,-79,-51,-107,-71,9,139,-46
6,6,-24,5,-53,-29,-10,42,-57
8,42,-30,-44,-70,-149,-33,63,-213
13,-17,-31,-48,-46,-73,-22,44,-180
19,28,-32,-21,-41,-53,-29,53,-76
20,47,-69,-37,-79,-104,-5,98,-129
24,39,-54,-93,-117,-136,-16,88,-265
38,10,-16,-10,-41,-66,12,38,-35
5,28,4,31,-42,-47,-5,43,17
7,9,-23,-26,-27,-35,-15,27,-83
10,135,-91,-84,-167,-327,-99,148,-475
23,35,-19,-12,-45,-67,-14,30,-69
139,210,23,-21,-70,-195,57,353,496
36,22,-10,2,-48,-42,5,48,13
16,22,-21,-9,-37,-47,-5,37,-44
31,105,5,1,-14,-72,-15,80,121
30,19,-13,-15,-19,-44,4,35,-3
15,32,-9,-16,-1,-60,-8,28,-19
11,24,-20,-19,-12,-25,22,43,24
18,24,-17,-15,-38,-13,28,25,12
63,106,-11,-3,-24,-12,43,93,255
12,9,-60,-58,-74,-67,-2,72,-168
-5,20,-32,-25,-38,-24,5,40,-59
34,50,-8,-24,-15,-28,33,55,97
5,57,-46,-26,-122,-103,-27,102,-160
26,31,-24,34,-94,-86,-11,73,-51
-19,-5,-39,-36,-75,-66,-6,33,-213
-51,-23,-58,-26,-76,-96,-29,31,-328
14,27,-21,-13,-17,-11,15,15,9
25,32,-14,-15,-42,-56,2,40,-28
77,93,-56,-17,-34,-1,65,94,221
-54,34,-65,-35,-88,-200,-70,79,-399
5,16,-59,-14,-106,-57,9,62,-144
26,39,-42,-6,-69,-44,16,26,-54
84,171,-24,-4,-52,-32,98,204,445
45,40,-16,21,-34,-37,4,52,75
28,52,-53,-51,-127,-106,1,72,-184
-16,-4,-35,-25,-35,-60,-34,26,-183
-2,2,-62,-63,-86,-134,-42,95,-292
-38,-17,-93,-28,-131,-226,-61,150,-444
47,81,25,-25,2,-45,-13,100,172
109,219,-7,-16,-70,-86,46,232,427
9,12,-23,-33,-50,-32,21,66,-30
7,70,-42,-72,-88,-112,23,111,-103
-28,-11,-37,-32,-40,-105,-51,50,-254
-8,25,-44,-46,-95,-92,-36,62,-234
63,86,-51,-66,-139,-200,-28,145,-190
17,99,-58,-54,-77,-147,-42,184,-78
22,66,-96,-87,-103,-276,-55,171,-358
62,171,-17,6,-40,-14,80,106,354
-11,115,-106,-69,-182,-299,-132,238,-446
16,49,-3,-16,-6,-47,-1,56,48
-30,24,-43,-55,-40,-75,-13,60,-172
245,374,-180,-15,-300,-258,36,333,235
60,54,-47,-8,-85,-44,20,89,39
46,50,-19,-17,-70,-89,4,95,0
31,57,-5,-7,-7,-18,15,42,108
56,62,-29,-49,-85,-112,7,100,-50
47,86,-54,-31,-151,-115,33,126,-59
-23,30,-21,-32,-49,-67,-18,46,-134
-7,19,-27,-11,-86,-40,-9,115,-46
3,11,-5,-33,-53,-34,-5,33,-83
-32,-13,-50,-36,-85,-133,-48,55,-342
-25,53,-5,-47,-51,-115,-28,57,-161
73,127,-84,-40,-133,-207,-57,157,-164
-17,-21,-117,-88,-175,-236,-89,188,-555
100,243,-80,-116,-122,-180,35,350,230
31,25,-61,-69,-103,-129,-28,93,-241
6,53,-68,-73,-97,-94,-27,119,-181
75,80,-16,9,-62,-54,-7,61,86
53,75,4,11,-92,-71,-7,132,105
2,9,-23,-34,-31,-124,-16,76,-141
132,109,-36,14,-88,-51,14,109,203
4,52,5,-43,-23,-124,-18,92,-55
-12,10,-72,-37,-135,-132,-48,119,-307
-10,88,-19,-31,-2,7,30,119,182
13,23,-15,-3,-35,-55,-19,38,-53
9,39,-8,4,-45,-37,-18,60,4
158,191,-48,38,-174,-68,77,235,409
57,44,12,17,-64,-51,-1,84,98
8,37,-18,-31,-51,-55,17,72,-21
45,49,-13,-79,-41,-75,22,94,2
155,131,-16,-36,-174,-154,45,272,223
26,75,-68,-80,-124,-78,1,130,-118
-33,37,82,58,-28,56,11,96,279
58,457,199,89,-274,-182,-95,630,882
1,-12,-29,-22,-31,-28,-28,44,-105
-21,51,-46,8,-67,-125,-60,64,-196
104,141,-6,-23,-16,-26,48,127,349
8,39,-61,-58,-106,-182,-53,94,-319
11,18,-17,-26,-29,-16,10,44,-5
26,37,-83,-38,-159,-192,-16,118,-307
-25,-21,-42,-28,-54,-86,-41,40,-257
-11,30,-61,-72,-82,-94,-29,135,-184
99,113,1,-5,-9,-64,51,131,317
-17,34,-304,-242,-363,-465,-186,499,-1044
101,78,-84,-80,-185,-273,-66,257,-252
4,28,-20,-9,-7,-28,5,25,-2
3,32,-21,-55,-43,-93,-19,70,-126
58,56,-25,4,-89,-101,-8,149,44
111,136,-31,-37,-34,-109,38,143,217
-53,10,-93,0,-134,-165,-49,74,-410
5,-4,-48,-46,-95,-83,-9,94,-186
-3,-4,-36,-30,-47,-50,5,41,-124
198,218,-80,-50,-152,-117,43,293,353
9,2,-57,-57,-80,-121,-21,103,-222
22,22,-9,-3,-9,-7,17,29,62
-118,-22,-122,-70,-219,-177,-107,104,-731
21,98,-36,-48,-74,-163,12,114,-76
11,33,-20,-30,-38,-89,-35,78,-90
39,45,-26,-18,-93,-98,-19,131,-39
-11,62,-30,-27,-59,-100,-8,84,-89
121,224,-68,25,-100,-101,55,158,314
130,209,-25,-102,-92,-201,14,317,250
61,79,-53,-26,-66,-80,33,78,26
-71,32,-110,-65,-167,-127,-65,179,-394
146,84,35,-19,-28,-39,29,186,394
163,208,-567,-391,-838,-1276,-248,634,-2315
62,67,-1,14,-39,-47,47,92,195
160,281,-15,31,-110,-64,82,260,625
99,170,66,-8,54,-34,38,164,549
113,230,-65,-54,-133,-168,8,266,197
228,358,24,-11,64,70,162,310,1205
-34,5,-52,-49,-44,-71,-23,54,-214
-7,4,-3,-8,0,-6,3,8,-9
23,65,-32,-24,-46,-99,-42,95,-60
7,19,-109,-36,-141,-155,-17,62,-370
120,214,-69,2,-133,-153,43,272,296
19,21,-5,8,-11,-6,16,9,51
39,159,75,11,-50,-37,11,154,362
140,175,32,9,-67,-35,22,292,568
34,91,-67,-72,-78,-342,-122,293,-263
17,21,-33,-39,-56,-62,14,62,-76
36,64,-13,-8,-36,-76,-6,88,49
98,129,-23,-69,-74,-113,18,216,182
4,30,-23,-6,-29,-54,-13,43,-48
-21,20,-63,-39,-72,-138,-46,90,-269
49,24,-36,-9,-37,-112,-12,73,-60
-34,-37,-63,-57,-86,-164,-64,104,-401
21,15,-12,-7,-20,-28,-1,17,-15
19,33,-34,-18,-42,-75,0,56,-61
66,103,-42,-17,-68,-137,27,149,81
-38,-32,-40,-38,-44,-90,-63,52,-293
0,-3,-18,-27,-38,-77,-30,45,-148
24,66,1,2,-47,-44,2,41,45
-4,2,-33,-53,-103,-77,-36,58,-246
224,363,-43,-222,-494,-533,-52,750,-7
344,571,72,-75,-519,-590,-41,938,700
244,398,-372,-549,-874,-785,-51,1139,-850
-7,22,-28,-35,-89,-88,-18,87,-156
9,41,-18,-22,-40,-15,9,34,-2
5,35,-18,-13,-39,-39,6,34,-29
4,76,-9,-36,-52,-94,-10,85,-36
9,49,-27,-29,-55,-55,3,91,-14
24,175,-34,-48,-9,29,89,224,450
68,10,-236,-168,-292,-442,-134,261,-933
97,39,-183,-142,-282,-387,-87,299,-646
347,573,30,-57,27,-156,117,505,1386
17,21,-65,-95,-133,-196,-36,121,-366
-82,-30,-58,-71,-80,-126,-95,60,-482
-62,-16,-78,-61,-95,-108,-65,81,-404
-73,-44,-70,-58,-96,-126,-83,84,-466
-70,-48,-78,-73,-99,-103,-99,78,-492
-82,-18,-66,-82,-86,-100,-72,72,-434
-86,-70,-96,-90,-97,-116,-101,46,-610
-52,-32,-66,-50,-81,-126,-81,65,-423
-59,-21,-39,-36,-59,-121,-67,72,-330
-60,-16,-68,-45,-90,-116,-63,68,-390
-65,-4,-54,-53,-73,-116,-71,69,-367
-73,-32,-63,-47,-80,-102,-81,90,-388
-6,82,-69,-51,-5,-31,24,187,131
32,19,-39,0,-34,-51,22,12,-39
-13,24,-23,-13,-36,-59,-24,38,-106
21,74,-59,-78,-80,-143,-1,125,-141
11,29,-64,-84,-149,-260,-80,137,-460
-8,-8,-35,-29,-46,-54,-21,48,-153
13,-7,-27,16,-89,-76,-5,80,-95
198,253,-22,2,-53,-84,116,242,652
50,109,-13,-1,-44,-54,-9,157,195
-32,-23,-45,-45,-30,-99,-30,34,-270
6,32,-122,-81,-139,-241,-30,196,-379
89,133,-20,-16,-54,-123,26,125,160
55,100,27,-1,-21,-65,15,130,240
-29,26,-55,-56,-93,-102,-34,77,-266
15,27,-8,-11,-6,-26,21,55,67
-19,-18,-23,-18,-18,-41,-20,6,-151
37,43,-37,4,-49,-78,-7,54,-33
7,-15,-23,-7,-25,-18,-3,14,-70
137,182,-35,-57,-55,-182,-17,219,192
89,204,12,-15,-49,-112,10,218,357
356,620,267,-181,2,-285,195,663,1637
60,61,-28,-19,-9,-34,44,49,124
137,200,-85,-40,-158,-197,77,305,239
31,45,-15,8,-21,-18,10,26,66
46,55,43,-6,20,-1,30,62,249
77,48,-20,-48,-100,-178,-39,197,-63
59,32,-46,-28,-57,-112,-12,76,-88
131,125,40,31,-135,-134,21,321,400
34,78,-46,-54,-130,-135,33,152,-68
0,24,-16,-16,-31,-63,-25,70,-57
-9,3,-35,-34,-40,-108,-38,41,-220
33,35,-10,-20,-24,-71,-14,48,-23
30,-10,-35,-31,-84,-101,-23,81,-173
136,158,-129,-38,-126,-199,36,253,91
-60,-9,-62,-37,-88,-118,-65,53,-386
11,-10,-35,-15,-60,-70,-18,10,-187
20,15,-9,-9,-5,-36,-9,23,-10
6,-10,-29,-35,-56,-94,-17,45,-190
14,30,-23,-22,-33,-31,-5,47,-23
-7,15,6,0,-20,1,-10,14,-1
5,-7,-19,-12,-46,-54,-26,42,-117
-53,14,-55,-50,-94,-150,-71,64,-395
16,65,-14,-12,-4,-52,24,52,75
23,55,-27,-11,-8,-41,24,44,59
24,35,-19,-11,-21,-27,20,65,66
7,37,-18,-9,-16,-20,3,38,22
-3,15,-31,-16,-37,-27,2,27,-70
21,6,-27,-30,-29,-53,-11,28,-95
71,68,-71,-79,-84,-82,43,148,14
24,45,-8,-40,-69,-68,-8,122,-2
53,71,-33,-38,-74,-79,-16,141,25
56,50,-95,-22,-165,-70,36,142,-68
129,182,-39,-19,-52,-59,60,263,465
155,351,-484,-465,-711,-1173,-276,943,-1660
110,172,-100,-114,-162,-215,11,271,-27
-18,9,-38,-19,-77,-77,-18,87,-151
5,38,-46,7,-63,-91,-19,93,-76
12,26,-8,-16,-26,-25,0,39,2
-20,-9,-72,-81,-77,-130,-29,65,-353
-19,16,-8,0,-12,-16,-16,9,-46
3,125,-35,-51,49,4,82,170,347
11,78,-20,14,-78,-99,-26,70,-50
99,123,-57,-65,-111,-155,-5,217,46
32,10,-23,-22,-52,-73,-3,70,-61
113,127,-191,-279,-257,-372,-30,385,-504
250,419,-117,5,-208,-272,68,387,532
487,533,58,17,-23,-254,145,634,1597
83,137,-66,-11,-52,-76,62,112,189
-49,-51,-113,-49,-135,-189,-114,114,-586
-13,44,-71,-99,-115,-133,-47,102,-332
50,56,-49,-59,-68,-116,-5,83,-108
41,76,-60,-37,-63,-120,9,87,-67
186,336,-92,-126,-197,-222,68,376,329
132,107,46,-7,2,-62,5,206,429
19,52,-23,-28,-48,-84,-19,88,-43
-52,-40,-79,-64,-85,-124,-77,61,-460
-64,-27,-85,-75,-94,-121,-65,58,-473
-79,-44,-77,-61,-81,-130,-86,42,-516
246,347,52,-42,-3,-89,117,448,1076
22,86,16,-4,-64,-63,10,134,137
11,2,-42,-29,-66,-28,11,49,-92
101,112,-72,-30,-159,-195,4,141,-98
-8,16,-39,-44,-57,-65,-18,67,-148
-20,102,-139,-102,-229,-349,-65,205,-597
59,43,-14,-23,-57,-95,16,66,-5
40,23,-44,-5,-46,-91,7,60,-56
242,381,-13,-459,-560,-404,-339,801,-351
64,119,20,2,-21,-27,32,124,313
9,28,-16,-16,-56,-39,-24,53,-61
-27,-15,-46,-51,-81,-154,-49,64,-359
34,15,-15,7,-43,-46,18,10,-20
170,207,94,24,42,29,96,252,914
44,49,-37,-83,-100,-178,-33,167,-171
43,48,-39,-35,-153,-208,-46,127,-263
4,64,-23,-22,-40,-35,12,58,18
79,106,14,-13,-6,-54,39,78,243
-18,197,-3,-152,-57,15,-34,191,139
89,105,17,-64,-3,-96,9,125,182
5,32,-106,-89,-160,-113,-12,157,-286
927,783,51,287,114,-116,-210,761,2597
35,41,-60,-57,-110,-121,-36,113,-195
5,42,6,-3,9,-18,1,20,62
65,47,-36,-12,-53,-52,10,28,-3
26,44,-18,-1,-46,-62,-10,56,-11
-36,-18,-19,-25,-30,-61,-47,24,-212
57,45,-33,-18,-17,-42,20,23,35
13,43,-22,-25,-12,-45,13,58,23
35,48,-9,4,-13,-31,34,50,118
8,19,-16,-2,-10,0,0,7,6
42,63,-33,2,-7,0,55,70,192
16,25,-21,-21,-23,-37,13,36,-12
-50,-44,-62,-59,-69,-112,-60,44,-412
-73,-10,-70,-44,-76,-115,-66,39,-415
25,15,-7,2,-41,-21,1,16,-10
6,25,-11,5,-12,-25,-9,16,-5
2,45,2,-5,-59,-14,5,57,33
9,6,-25,-21,-33,-70,-17,47,-104
-11,10,-2,-14,-22,-36,-3,19,-59
33,23,-27,-29,-84,-147,-35,93,-173
-5,14,-21,-14,-6,-20,0,24,-28
69,97,-26,-2,-63,-70,1,96,102
28,139,-14,-60,-102,-47,-29,223,138
174,274,-110,9,-204,-229,13,232,159
180,136,84,38,31,-26,23,211,677
38,12,-13,14,-46,-50,8,49,12
32,58,-17,-40,-18,-45,13,50,33
24,191,-41,-12,-13,-27,50,223,395
126,157,-55,-63,-111,-76,56,227,261
-25,19,-62,-47,-185,-201,-98,141,-458
28,52,-24,-16,-54,-57,-1,79,7
9,27,5,-12,-13,-48,-6,51,13
44,77,-65,10,-76,-38,31,95,78
-8,8,-27,-12,-33,-7,13,39,-27
-28,6,-19,-6,-26,-71,-39,24,-159
-30,35,-32,-31,-41,-56,-29,33,-151
7,32,-36,-27,-45,-91,-5,49,-116
13,26,-17,-23,9,-50,1,28,-13
10,55,-23,-9,-12,-55,-2,55,19
28,10,-11,-7,-29,-44,-10,19,-44
5,19,-3,-14,1,-14,7,14,15
-20,-7,-25,-22,-30,-58,-22,32,-152
-20,5,-20,3,-37,-34,-7,23,-87
7,66,-1,-15,30,-3,24,64,172
-2,12,-9,-13,-45,-42,-2,32,-69
-6,10,-8,-8,2,-12,-3,18,-7
64,133,-56,-39,-63,-108,-6,169,94
50,162,-56,-101,-33,-62,78,95,133
86,135,-76,-87,-142,-191,-39,204,-110
8,39,-32,-26,-51,-81,3,66,-74
31,61,-45,-39,-87,-82,10,89,-62
-9,11,-32,-25,-30,-64,-24,32,-141
18,64,-34,-9,-43,-39,36,57,50
85,149,-51,-28,-83,-132,48,190,178
70,273,-91,-158,-307,-542,-204,604,-355
-11,50,-20,-43,-71,-67,-12,85,-89
13,25,-19,-26,-54,-77,17,48,-73
150,244,-19,-76,-68,-176,21,249,325
-4,-16,-58,-63,-82,-118,-32,72,-301
-5,36,-25,-26,-94,-12,2,104,-20
-3,6,-33,-10,-47,-43,-21,38,-113
81,131,13,-4,3,13,44,143,424
43,65,-26,-33,-34,-99,-5,87,-2
229,289,7,-28,-41,-137,89,305,713
-7,3,-6,-2,-1,-12,-5,8,-22
1,17,9,-10,0,-2,8,19,42
13,8,-6,-1,-9,-21,-13,24,-5
12,24,3,-21,12,-17,5,31,49
5,6,-1,3,-11,-8,1,15,10
-60,-40,-56,-55,-56,-107,-55,67,-362
-68,-48,-57,-49,-74,-105,-59,69,-391
67,111,-110,-120,-161,-265,-99,198,-379
-44,-25,-48,-43,-93,-101,-48,64,-338
8,61,13,6,-49,-2,6,68,111
6,23,-2,-18,-10,0,11,23,33
-22,12,-67,-96,-110,-70,-9,70,-292
95,232,-61,-32,36,-88,123,142,447
-89,-56,-120,-138,-149,-249,-116,143,-774
23,53,-28,-42,-66,-70,6,102,-22
6,48,3,-52,-16,-74,-17,65,-37
278,298,-73,-27,-106,-242,138,327,593
392,616,15,-109,-59,-55,304,647,1751
158,212,63,34,-78,-4,121,362,868
127,162,-65,10,-105,-148,23,142,146
38,107,-45,-80,-100,-170,-6,205,-51
145,366,-159,-91,-277,-377,-17,397,-13
117,232,47,-9,-122,-99,-17,288,437
134,193,-51,-86,-141,-273,44,245,65
327,449,130,-2,99,-56,123,480,1550
116,207,-10,1,-70,-150,28,172,294
243,379,-164,-166,-331,-387,22,623,219
61,79,-16,-58,-75,-115,22,134,32
53,141,-56,-58,-275,-328,-50,253,-320
105,297,-6,-37,-194,-127,65,432,535
400,643,-129,32,-270,-442,-12,495,717
81,127,-496,-489,-915,-1228,-342,730,-2532
328,398,22,-101,-81,-192,140,463,977
55,96,-83,-92,-232,-52,66,296,54
-7,87,-153,-139,-306,-350,-88,323,-633
173,251,42,-38,30,-60,62,249,709
63,208,-168,-83,-179,-174,74,312,53
83,87,-19,-40,-185,-182,-19,201,-74
76,173,-52,-66,-98,-124,32,184,125
32,45,-137,-48,-206,-290,-27,115,-516
-21,57,-102,-34,-15,0,25,83,-7
26,72,-8,35,-110,-4,34,128,173
45,195,-85,-87,-196,-356,-67,264,-287
57,199,-163,-148,-370,-254,15,407,-257
354,455,149,30,52,-14,225,511,1762
355,406,135,3,-55,-140,102,649,1455
191,229,72,19,-12,-31,77,263,808
44,83,12,-38,-49,-35,33,138,188
148,291,-114,-209,-518,-369,-70,626,-215
221,301,-33,-31,-42,-68,87,379,814
164,212,-41,-40,-172,-188,16,305,256
521,720,39,36,-144,-277,305,818,2018
75,204,70,7,-75,-112,-8,331,492
109,178,-9,-49,-30,-109,26,193,309
47,57,-42,-23,-33,-82,-13,77,-12
35,29,-73,-48,-86,-79,1,89,-132
34,26,-58,-3,-106,-63,-15,123,-62
-11,6,-58,-17,-120,-129,-31,59,-301
-4,-9,-18,-11,-27,-16,3,18,-64
21,24,-27,-7,-34,-49,-6,38,-40
83,103,3,-37,-27,-76,5,108,162
89,91,-85,-111,-193,-162,-1,212,-160
157,214,-24,36,-47,-84,46,181,479
122,196,-45,-45,-23,-55,43,161,354
-9,22,-65,-61,-82,-182,-71,136,-312
74,194,-120,-104,-225,-235,-14,348,-82
562,625,-12,-73,-107,-347,240,859,1747
76,151,-283,-64,-636,-713,-178,424,-1223
135,272,-131,-142,-229,-366,-54,437,-78
159,292,-403,-461,-784,-1176,-266,757,-1882
126,312,-159,-226,-385,-729,-127,615,-573
172,235,-90,-59,-173,-163,103,259,284
41,268,-100,-184,-249,-265,-14,397,-106
45,98,-4,-37,-114,-223,-2,140,-97
107,134,-27,-51,-179,-157,5,308,140
27,73,1,-25,-15,-69,-12,82,62
360,372,-241,182,-352,-56,240,282,787
185,294,10,-40,-27,-77,97,281,723
209,295,-38,-34,-98,-192,37,378,557
229,328,-61,-78,-190,-219,63,507,579
41,149,-78,-16,48,-76,72,137,277
139,144,-70,-49,-124,-261,4,235,18
24,50,8,-16,-85,-149,-50,156,-62
162,249,-20,-60,-113,-131,62,279,428
23,23,-38,8,-143,-101,-14,162,-80
204,270,-87,-52,-160,-149,61,373,460
-11,-9,-108,-79,-224,-160,-24,138,-477
43,197,-65,-81,-166,-238,-1,204,-107
50,103,-67,-86,-118,-156,3,131,-140
116,256,43,-94,-106,-198,50,402,469
31,4,-34,-5,-112,-135,-50,121,-180
46,98,-153,-118,-164,-231,8,169,-345
-13,129,-104,-74,-23,-20,70,168,133
26,27,-12,-6,-111,-182,-51,74,-235
166,188,-108,-213,-145,-304,92,388,64
-18,20,-146,-81,-193,-261,-47,155,-571
116,96,-21,-21,-22,-78,40,148,258
55,118,79,99,-70,26,55,201,563
31,52,5,-9,-95,-120,-24,120,-40
96,223,-172,-172,-260,-358,-70,336,-377
-17,93,-124,-84,-282,-326,-65,370,-435
7,26,-151,-80,-306,-239,-72,178,-637
19,-27,-56,7,-71,-101,-14,15,-228
46,103,-62,-35,-91,-183,-5,142,-85
271,427,-83,25,-241,-209,69,188,447
96,104,-74,-42,-125,-131,30,178,36
147,310,58,-63,-111,4,74,433,852
174,336,23,-34,-8,-92,77,380,856
114,220,-76,-64,-170,-128,46,313,255
20,19,-51,-14,-113,-139,-33,127,-184
130,329,-116,-60,-211,-435,53,465,155
244,293,-54,-96,-168,-240,47,479,505
850,1343,-32,-127,-444,-661,330,1513,2772
140,263,-12,-2,-130,-153,13,311,430
106,71,-85,-12,-292,-381,-61,252,-402
467,464,113,-77,92,-193,155,440,1461
19,2,-61,-26,-157,-72,16,90,-189
173,248,42,-55,-204,-303,-32,426,295
-29,23,-33,-33,-96,-124,-15,59,-248
25,155,-15,-59,-96,-220,-37,179,-68
56,111,-18,-43,-12,-54,56,93,189
7,30,-52,-17,-96,-40,7,57,-104
-66,28,-42,-36,-125,-82,6,135,-182
-78,-5,-68,-38,-158,-84,3,115,-313
20,114,-38,-30,-124,-128,4,160,-22
43,43,-48,-7,-49,-43,20,19,-22
11,7,-2,2,-1,-14,0,-4,-1
25,40,10,-8,10,-11,16,41,123
21,18,-19,-68,-39,-78,-17,69,-113
4,46,-48,-49,-77,-65,-2,57,-134
-6,1,-15,8,-27,-35,-16,10,-80
20,26,-29,-30,-54,-62,-5,52,-82
2,7,-14,5,-19,-11,6,11,-13
2,22,-1,0,-4,-21,-8,19,9
129,243,52,28,64,-28,117,285,890
66,117,-32,-16,-126,-139,-11,194,53
48,48,-7,-14,-37,-13,21,69,115
7,15,-121,-95,-165,-189,-27,164,-411
3,36,-10,-20,-38,-31,15,65,20
15,50,-68,-59,-123,-154,-38,86,-291
43,110,72,59,-54,50,67,148,495
31,67,-104,-7,-185,-252,-42,106,-386
76,90,-64,-62,-96,-144,14,149,-37
63,121,22,-14,-1,-70,26,169,316
62,100,-17,-23,-35,-67,59,77,156
220,216,-1,-9,7,-176,8,252,517
105,112,-45,-44,-86,-93,45,211,205
14,60,-125,-68,-221,-214,-52,215,-391
10,28,-6,-1,1,-36,-8,32,20
23,89,11,-28,64,39,42,55,295
98,96,13,-15,15,-50,32,128,317
-1,15,-19,-20,-35,-20,-10,30,-60
4,63,-97,-55,-131,-224,-83,151,-372
-49,-31,-52,-35,-107,-152,-72,113,-385
31,17,9,-4,-8,-87,-42,36,-48
19,37,-37,-27,-66,-77,-3,69,-85
41,54,-53,-32,-78,-134,15,154,-33
36,60,-38,-26,-89,-88,-8,104,-49
39,28,-139,-95,-223,-238,-34,166,-496
9,12,-14,1,-28,-6,3,29,6
46,139,-49,-80,-155,-176,-11,227,-59
123,99,-25,-26,-54,-57,46,146,252
103,153,39,25,-62,-204,-92,355,317
97,160,39,66,-103,70,73,178,580
14,65,-2,-34,-67,-67,3,142,54
-2,16,-7,-2,-18,-32,-7,37,-15
-19,-42,-129,-104,-136,-226,-85,108,-633
27,20,-9,-2,-24,-62,-12,44,-18
22,76,-9,-21,-59,-93,-2,96,10
5,3,-14,-4,-24,-14,0,14,-34
61,53,-32,48,-78,-84,17,137,122
-38,2,-132,-77,-195,-179,-47,100,-566
185,244,13,-52,-9,-139,-14,238,466
-1,16,-2,-2,-16,-29,-13,35,-12
25,4,-30,-23,-43,-53,1,38,-81
20,93,-52,-44,-132,-165,-48,154,-174
10,27,-24,-18,-29,-48,-16,20,-78
200,297,58,26,-31,17,110,312,989
85,87,-20,0,-60,-73,18,124,161
19,36,-53,-51,-143,-133,-4,107,-222
12,33,-54,-55,-77,-47,1,120,-67
-22,-14,-31,-23,-44,-89,-30,40,-213
25,74,6,-41,-9,-105,-16,96,30
-66,-61,-64,-28,-95,-145,-74,54,-479
-6,-14,-48,-60,-72,-111,-44,103,-252
-8,8,-31,-24,-61,-68,-43,91,-136
43,30,-107,-129,-209,-283,-93,204,-544
22,83,-40,-46,-78,-39,28,95,25
81,134,-91,25,-258,-263,-19,281,-110
91,114,-54,-16,-120,-137,0,140,18
44,70,-12,-18,-40,-49,-7,75,63
58,57,-46,-6,-92,-99,27,92,-9
13,18,-24,-34,-22,-76,13,51,-61
29,21,-1,-4,1,-12,17,28,79
26,43,-13,-39,-1,-32,12,57,53
-5,1,-21,-25,-37,-34,-18,44,-95
3,11,-32,-11,-52,-72,-17,28,-142
10,6,-17,-28,-60,-77,-23,97,-92
12,28,-38,-38,-85,-85,-8,62,-152
23,-11,-20,-6,-85,-82,-11,74,-118
14,-5,7,9,-47,-38,-22,46,-36
50,79,1,-11,-37,-62,17,85,122
-36,-8,-39,-39,-35,-50,-30,26,-211
43,78,-17,-47,-19,-101,11,126,74
14,2,-1,6,-13,-38,-11,50,9
23,54,-8,-45,-24,-30,10,115,95
-12,69,-78,-73,-154,-223,-25,193,-303
42,75,-24,-38,-40,-114,-15,78,-36
176,276,-80,-105,-226,-181,50,403,313
86,49,-79,-59,-127,-124,6,137,-111
10,39,2,-24,-20,-9,0,46,44
109,160,-93,-82,-133,-158,56,211,70
34,92,-114,-2,-207,-210,-66,142,-331
16,60,5,4,-22,17,20,81,181
16,31,-11,10,-10,-25,7,29,47
31,44,-42,-25,-93,-65,14,89,-47
54,180,-58,-59,-31,-99,5,179,171
35,35,-27,-17,-24,-64,6,66,10
86,89,-13,-46,-36,-124,2,163,121
62,48,-45,42,-185,-206,-19,152,-151
-5,54,-20,-1,-63,-36,4,63,-4
-7,35,-19,-39,-19,-83,-8,70,-70
54,49,35,55,-42,-17,3,77,214
148,183,-35,8,-76,-62,56,208,430
190,260,-32,-85,-60,-134,6,363,508
37,36,-50,2,-87,-63,3,66,-56
27,39,19,-10,-6,-24,15,49,109
43,58,-28,13,-85,-105,11,122,29
120,106,24,61,4,-30,77,123,485
-7,13,-46,-4,-73,-67,-19,51,-152
27,57,32,-31,-51,4,-14,77,101
1,49,-10,-22,-59,-27,1,62,-5
11,5,-11,-49,-11,-91,-37,83,-100
-44,41,-131,-111,-164,-217,-72,189,-509
-43,-9,-60,-65,-95,-113,-55,72,-368
-42,-28,-38,-15,-53,-129,-59,42,-322
39,28,-13,-22,-23,-26,8,54,45
50,87,-11,-17,-51,-81,3,137,117
171,234,-96,-19,-190,-180,55,337,312
-2,100,-42,-18,23,4,37,118,220
0,78,-40,-40,7,34,81,108,228
61,55,7,24,-39,-36,39,105,216
32,75,-6,-17,9,-10,37,77,197
-10,81,-111,-87,-214,-209,0,156,-394
182,306,-118,25,-235,-144,42,177,235
40,151,-7,-5,-25,-62,40,144,276
86,185,66,-1,53,-28,78,196,635
-3,-6,-17,-7,-9,-17,-9,13,-55
19,36,9,-22,-3,-47,-2,31,21
21,48,-33,-26,-56,-95,-3,62,-82
16,35,-35,-41,-34,-95,-15,42,-127
-13,-3,-43,-28,-67,-47,-9,20,-190
226,256,-48,-116,-102,-107,108,280,497
7,36,-13,-19,-16,-6,28,70,87
-16,71,-63,-83,-87,-89,-10,87,-190
45,112,-30,-30,-105,-196,-37,170,-71
6,51,-45,-36,-83,-87,9,88,-97
67,115,-19,15,-16,-7,69,79,303
16,-5,-55,-77,-117,-304,-67,180,-429
30,240,-14,-57,77,-34,67,252,561
153,219,-9,-12,-88,-125,48,258,444
20,40,-19,-36,-50,-63,-3,81,-30
8,49,-21,-9,-34,-48,-13,51,-17
34,43,4,-3,19,22,41,26,186
67,175,119,95,7,101,56,242,862
64,48,-113,-17,-142,-121,44,106,-131
52,105,-49,-70,-114,-117,19,162,-12
-18,10,-32,-36,-50,-79,-25,53,-177
14,22,-8,-25,-41,-41,4,41,-34
11,79,-33,0,-136,-148,-32,127,-132
-13,39,-140,-146,-185,-167,-14,198,-428
4,11,-28,-14,-27,-42,-26,22,-100
72,138,-8,-11,-104,-88,27,176,202
267,312,15,-58,33,-31,80,273,891
52,181,-23,-22,23,-64,91,221,459
28,74,-68,-37,-146,-159,-16,152,-172
259,439,-54,-46,-240,-254,120,401,625
116,240,-130,-31,-213,-200,-28,164,-82
6,19,-22,-17,-49,-77,-24,58,-106
32,19,-20,0,-25,-29,26,31,34
121,51,-680,-490,-991,-1303,-331,617,-3006
12,3,-26,2,-43,-65,-4,52,-69
63,122,23,-50,-34,-127,20,139,156
2,45,2,-8,-23,-24,-6,39,27
0,23,-7,-13,1,-26,0,51,29
25,25,-10,-13,-23,-33,3,41,15
52,-28,-283,-97,-546,-454,-88,219,-1225
-1,38,-26,-21,-62,-73,-45,55,-135
5,50,-14,-20,-7,-73,-11,107,37
31,80,-60,-60,-87,-148,-16,109,-151
9,4,0,-15,4,-18,-8,7,-17
26,18,-10,-39,6,-77,-15,18,-73
16,31,-13,-8,-27,-28,-2,48,17
9,51,-13,-27,-61,-68,-9,94,-24
-55,-32,-68,-48,-86,-128,-48,62,-403
-69,-36,-55,-67,-95,-121,-71,63,-451
-60,-25,-62,-37,-76,-134,-80,61,-413
-79,6,-117,-52,-166,-165,-66,143,-496
43,57,-41,-59,-136,-146,-39,128,-193
56,124,-59,-89,-114,-173,-19,228,-46
40,56,-40,-36,-34,-26,29,49,38
2,62,-42,-55,-95,-128,-16,117,-155
60,80,-38,-44,-46,-105,19,188,114
0,66,-25,-48,-105,-219,-69,161,-239
42,104,-10,-28,9,-59,2,96,156
26,87,-8,26,-82,-43,6,125,137
115,243,-104,-132,-202,-378,11,251,-196
21,56,30,35,-21,38,15,50,224
16,-16,-89,-74,-128,-118,-60,66,-403
264,435,231,215,-331,-162,-90,746,1308
53,64,-32,-6,-36,-78,-1,93,57
16,31,-55,-34,-102,-73,-7,70,-154
23,38,-24,-14,-56,-60,7,70,-16
70,91,-23,-15,-74,-105,-9,127,62
106,197,62,17,-2,-53,11,205,543
49,85,-25,-21,-98,-99,27,152,70
63,96,-104,-76,-114,-150,2,129,-154
-15,-13,-39,-5,-69,-44,-22,26,-181
-30,35,-94,-30,-136,-206,-51,74,-438
124,178,-58,-57,-48,-182,-8,186,135
51,79,38,-4,-79,-167,-96,219,41
498,661,120,170,48,36,287,792,2612
90,232,-87,27,-56,-42,65,182,411
28,29,-17,-29,-59,-90,-15,112,-41
37,76,-15,-22,2,-17,32,51,144
0,45,-46,-52,-44,-49,11,72,-63
-5,-54,-27,-58,-54,-122,-45,22,-343
21,26,-48,-49,-68,-77,-14,77,-132
47,25,-45,-8,-88,-103,-15,97,-90
15,17,2,-10,-11,-7,16,22,44
58,106,-87,13,-59,-122,11,78,-2
67,62,-31,-23,-116,-51,24,215,147
32,26,-45,-2,-181,-105,-22,110,-187
23,123,-43,-43,-73,-118,36,186,91
39,47,-36,-26,-73,-28,18,77,18
74,120,-21,-2,-149,-165,-7,159,9
7,-1,-14,-6,-31,-19,-8,14,-58
12,12,-17,-17,-13,-8,17,28,14
5,3,-20,-10,-32,-37,-19,35,-75
0,19,-15,-16,-22,-36,1,30,-39
23,86,-16,-57,-75,-139,-12,142,-48
191,208,-22,15,-66,-46,116,241,637
428,508,10,71,52,-5,123,472,1659
44,66,-48,17,-139,-134,4,126,-64
139,302,-88,-78,-216,-240,32,383,234
39,56,5,-44,-64,-129,-21,113,-45
107,121,-19,12,-221,-148,-34,358,176
28,69,-23,10,-74,-31,19,122,120
-19,73,-190,-66,-345,-488,-146,302,-879
-9,-4,-29,-26,-35,-53,-17,37,-136
27,52,-45,-33,-32,-19,22,71,43
-14,55,-116,-96,-168,-181,-62,116,-466
11,52,-9,-10,-14,-63,-26,53,-6
98,123,-54,-50,-91,-45,91,162,234
143,153,22,77,-72,-85,42,206,486
-22,20,-36,-27,-58,-68,-27,42,-176
-50,-26,-69,-50,-68,-115,-38,56,-360
16,37,-9,-5,3,-21,-3,36,54
6,68,22,16,-28,-14,4,69,143
-15,23,-28,-22,-55,-65,-31,42,-151
28,111,-40,-47,-56,-109,-8,137,16
15,47,16,-25,5,-23,15,49,99
228,309,14,-32,-55,-72,99,381,872
102,113,-14,-14,-64,-19,64,146,314
74,59,-34,-14,-52,-77,31,48,35
-17,19,-77,-34,-113,-127,-41,90,-300
11,61,-45,-39,-61,-74,8,92,-47
-98,-34,-96,-55,-145,-140,-54,123,-499
104,127,-60,-49,-144,-153,32,230,87
-92,-14,-113,-87,-150,-153,-61,116,-554
83,168,-23,-3,-70,-50,1,224,330
39,116,-53,-90,-101,-154,26,182,-35
39,47,-34,0,-137,-110,20,130,-45
-41,-30,-40,-28,-49,-96,-44,48,-280
105,116,-22,-31,17,-76,44,129,282
23,57,-40,-16,-59,-82,-2,85,-34
-11,29,-53,-61,-115,-99,-15,113,-212
41,88,-23,0,-36,-48,42,81,145
40,0,-21,-3,-83,-134,-17,69,-149
112,176,-58,-133,-98,-138,34,201,96
-21,13,-71,-34,-118,-131,-22,103,-281
2,67,6,-32,-45,-115,-31,120,-28
81,134,-94,-88,-199,-163,-19,318,-30
90,120,-102,-84,-151,-293,-34,177,-277
6,17,-44,-28,-109,-121,-16,76,-219
12,-2,-20,-19,-37,-38,-11,35,-80
19,20,-2,1,-7,9,31,35,106
30,64,-70,-28,-96,-86,12,74,-100
3,34,-34,-6,-43,-67,-16,43,-86
15,30,-12,-13,3,-11,14,22,48
-6,31,-24,-40,-25,-66,-22,67,-85
50,69,-70,-40,-75,-92,15,130,-13
52,48,-65,-27,-66,-41,15,55,-29
48,38,-29,11,-102,-118,3,65,-84
-17,-16,-18,-24,-12,-18,-15,9,-111
5,-1,-8,-4,-14,-7,-3,9,-23
38,84,-13,8,-16,-78,-4,77,96
10,114,-8,-20,-54,-122,-27,194,87
370,460,-23,-94,-162,-351,40,651,891
-16,-5,-10,-40,-19,-17,2,29,-76
21,32,-19,10,-46,-21,12,36,25
5,30,-27,-26,-45,-78,-4,50,-95
-60,11,-160,-115,-298,-298,-83,266,-737
45,46,-100,-32,-140,-111,59,115,-118
-27,133,-8,-17,-157,-182,-111,211,-158
22,69,-59,-37,-106,-102,13,158,-42
8,4,-58,-36,-93,-76,-4,39,-216
26,80,-36,-27,-56,-92,-5,89,-21
111,117,20,22,-50,-36,67,145,396
12,-12,-18,-18,6,-13,-8,19,-32
28,87,-71,-41,-118,-99,50,109,-55
24,18,-82,-30,-125,-117,-5,82,-235
-4,4,-35,-11,-45,-47,-14,35,-117
29,24,-14,-3,-32,-27,13,33,23
20,79,-49,-49,-162,-112,3,167,-103
4,29,6,3,2,-8,7,27,70
-51,23,-138,-129,-175,-360,-119,147,-802
-2,21,4,-3,-7,-22,11,45,47
23,37,-42,-5,-102,-129,-6,124,-100
-139,-4,-306,-297,-349,-481,-225,377,-1424
149,224,24,50,-72,-57,56,287,661
15,31,-35,-24,-61,-63,-10,78,-69
-43,30,-103,-104,-161,-176,-52,142,-467
48,13,-20,-11,-89,-85,-7,105,-46
10,41,-15,-31,-35,-59,5,65,-19
97,56,-79,-38,-114,-105,44,131,-8
75,67,-148,-85,-278,-247,-25,147,-494
-13,-5,-15,-13,-12,-18,-6,13,-69
4,8,5,-2,-3,-11,4,8,13
-7,14,-29,-47,-44,-68,-24,36,-169
24,4,-50,-55,-47,-99,-22,51,-194
31,67,-115,-91,-214,-405,-148,232,-643
20,17,-57,-48,-83,-54,-15,78,-142
2,25,-23,-21,-67,-81,-25,45,-145
74,92,-84,-37,-206,-226,-31,123,-295
30,67,-38,-52,-42,-115,-15,116,-49
-37,75,-26,-48,2,-15,9,114,74
81,68,-49,-30,-102,-151,-30,41,-172
65,86,-52,-22,-129,-91,37,134,28
428,652,-195,-33,-235,-229,151,644,1183
317,523,-55,-121,-105,-266,182,611,1086
149,335,-206,-115,-155,-248,78,293,131
50,61,54,-28,51,-25,1,45,209
24,48,3,-4,5,-39,2,42,81
-52,22,-61,-11,-155,-169,-90,140,-376
62,119,60,24,15,-2,60,164,502
16,20,-14,9,-16,-7,13,12,33
20,90,-79,-73,-138,-239,-62,224,-257
3,72,-146,-44,-8,29,42,130,78
17,6,-22,-10,-47,-58,-6,41,-79
-16,15,-44,-33,-49,-109,-21,67,-190
8,8,-26,-26,-60,-50,3,22,-121
24,32,-35,-61,-58,-89,15,87,-85
4,35,-21,-25,-77,-19,-36,65,-74
29,54,-1,0,-20,-26,4,45,85
32,92,-30,-8,-107,-73,9,85,0
31,52,-36,-21,-38,-55,11,67,11
39,74,-16,-4,-44,-68,8,69,58
21,52,-110,-70,-206,-290,-89,243,-449
9,53,-20,-44,-74,-52,6,103,-19
97,175,-15,-53,16,-10,103,158,471
163,180,-47,7,-187,-126,51,286,327
4,13,-23,-10,-43,-66,-22,54,-93
9,43,-61,-17,-59,-96,9,92,-80
55,93,15,19,-33,-38,14,83,208
95,221,-81,-160,-326,-376,-25,424,-228
-28,62,-44,-71,-117,-142,-57,108,-289
-6,44,-21,-26,-18,-67,-4,74,-24
54,69,-13,3,-63,-35,66,86,167
62,98,-57,-29,-131,-211,-5,169,-104
1,10,-12,-3,-42,-98,-42,83,-103
40,61,-54,-46,-84,-80,18,56,-89
-82,-68,-75,-71,-92,-137,-89,58,-556
387,304,52,-36,34,-166,249,443,1267
4,24,12,15,-27,-14,13,73,100
-12,2,-35,-2,-98,-70,-31,55,-191
39,21,-24,-6,-73,-60,-26,94,-35
12,-18,-48,-24,-76,-93,-27,30,-244
107,159,-48,-19,-69,-86,28,208,280
2,-5,-54,-27,-169,-113,12,139,-215
15,24,-8,16,-36,-20,9,36,36
-2,33,-4,-2,-13,-39,-10,46,9
20,71,-54,-30,-143,-146,-26,73,-235
82,203,-50,-85,-136,-363,-88,290,-147
92,84,-70,-69,-164,-154,-7,227,-61
3,-24,-57,-3,-106,-103,-28,46,-272
38,103,-78,-65,-175,-154,-11,186,-156
38,113,-39,-12,-68,-78,27,101,82
12,-27,-56,-63,-66,-134,-57,83,-308
81,134,-77,4,-174,-187,-42,123,-138
6,3,-11,-11,-10,-3,-3,28,-1
9,71,-24,-10,-59,-33,7,87,48
185,265,-94,-90,-178,-175,64,303,280
-13,35,-40,-29,-37,-57,-4,48,-97
5,34,-17,-15,-63,-42,17,73,-8
21,60,-2,-45,-13,-66,2,71,28
27,49,-18,11,-29,-71,-2,69,36
53,51,-17,-16,-46,-36,35,55,79
3,87,-40,-46,-40,-33,37,130,98
104,112,26,-35,13,-48,21,150,343
13,5,-65,-32,-109,-88,-9,55,-230
7,88,-23,-17,4,19,37,104,219
85,67,-6,-25,-118,-162,-11,83,-87
14,13,-49,-27,-71,-67,-2,65,-124
169,253,-33,-10,-114,-59,105,413,724
13,16,-22,-13,-5,-27,12,34,8
-10,7,-121,-39,-169,-161,15,108,-370
-3,53,-22,-32,-97,-128,-39,137,-131
25,34,-27,-1,-82,-92,-12,129,-26
96,180,-23,15,-90,-118,25,130,215
17,74,-31,-71,-105,-112,-6,103,-131
76,91,61,-2,12,3,46,136,423
7,184,20,-47,-26,16,95,303,552
95,70,-5,93,-85,-48,49,163,332
49,51,-39,-14,-95,-26,45,117,88
31,69,-66,-71,-125,-145,-23,187,-143
28,73,16,-9,-37,-4,32,94,193
12,72,-84,-70,-119,-101,38,83,-169
42,80,-50,-38,-45,-76,34,98,45
33,16,-44,-2,-58,-51,-21,86,-41
-4,46,-15,-33,-41,-80,-13,97,-43
1,209,31,-44,25,43,75,238,578
13,133,-63,-35,-50,-13,61,205,251
30,55,1,-14,9,-64,-14,62,65
35,63,-1,-28,-76,-106,-6,119,0
19,-21,-94,-40,-149,-219,-61,54,-511
78,41,-50,2,-169,-172,-23,122,-171
23,29,-88,17,-205,-275,-56,131,-424
18,90,-77,-62,-142,-242,-65,187,-293
35,122,-78,-111,-188,-243,-56,102,-417
39,49,1,-27,11,-16,22,55,134
74,107,-49,-40,-37,-129,28,161,115
113,150,-38,-47,-46,-167,7,181,153
51,32,-50,-8,-112,-81,32,83,-53
15,22,-27,-5,-29,-36,-8,38,-30
42,58,-18,-41,-65,-74,-12,113,3
21,1,-12,-1,-10,-18,9,7,-3
-4,150,-24,-61,53,-11,66,162,331
-14,103,-24,-61,32,-24,17,115,144
-2,81,-17,-41,17,-23,20,99,134
-7,126,-7,-20,39,16,55,161,363
-13,30,-86,-99,-130,-149,-42,172,-317
19,28,2,32,-36,-44,24,55,80
41,100,40,29,-48,-42,-31,137,226
30,74,-30,-14,-27,-77,0,89,45
26,40,-86,-72,-91,-168,-5,114,-242
37,63,24,-13,29,-14,23,64,213
20,49,-8,-46,-38,-125,-12,111,-49
18,13,-18,-32,-45,-58,-13,7,-128
-3,15,-9,-16,-10,-7,-9,4,-35
69,66,7,12,-24,-28,48,119,269
4,36,-59,-57,-23,-131,-12,84,-158
48,139,-42,-54,-73,-50,43,185,196
51,50,-28,-52,-85,-107,13,128,-30
186,294,-99,-115,-216,-335,26,423,164
27,-10,-79,-74,-205,-183,-76,93,-507
44,52,6,1,4,-6,22,71,194
66,142,39,-19,26,-83,32,184,387
19,57,0,-20,-14,-53,0,82,71
31,103,4,-55,-192,-59,-9,331,154
9,21,-40,-54,-63,-98,7,58,-160
-22,16,-39,-60,-69,-73,-8,86,-169
32,94,-54,-37,-102,-186,-44,124,-173
26,63,-31,-43,-93,-202,-73,148,-205
283,415,-146,-71,-274,-384,35,585,443
20,35,-24,-14,-22,-52,16,53,12
67,22,-71,-8,-134,-159,-18,143,-158
2,60,-58,-109,-136,-101,-46,104,-284
35,39,-29,-10,-15,-41,-3,34,10
56,99,-32,-39,-54,-33,26,146,169
-15,67,-15,-54,-96,-116,-62,92,-199
69,72,-89,-54,-146,-127,25,139,-111
35,37,-24,-14,-13,-55,11,44,21
149,275,-76,-94,-123,-119,112,381,505
11,127,7,-26,-89,-93,-21,204,120
-19,116,5,-142,-44,-57,-41,203,21
14,33,-85,-90,-151,-156,-13,132,-316
21,48,-36,-57,-21,-38,27,65,9
77,98,-55,-10,-136,-141,6,184,23
-73,27,-110,-74,-169,-191,-61,168,-483
-3,8,-20,-8,-94,-127,-12,115,-141
31,72,-66,-96,-109,-140,11,156,-141
50,85,7,1,4,-43,12,88,204
9,10,-11,-7,-27,-34,2,26,-32
79,173,-5,-11,-74,-91,18,221,310
87,142,27,-2,1,-52,14,181,398
-10,28,11,-12,-20,-32,-16,82,31
13,57,0,-22,-21,-47,-8,91,63
381,551,17,2,2,-52,218,549,1668
-13,21,-9,-26,-13,-41,-8,37,-52
-22,72,-30,-62,-107,-97,-40,161,-125
119,251,-114,-139,-239,-396,2,407,-109
15,-2,-24,-16,-37,-21,0,37,-48
8,28,-37,-35,-47,-28,5,42,-64
130,50,-76,15,-108,-82,79,142,150
-95,-66,-79,-65,-105,-114,-62,49,-537
383,615,-129,-108,-208,-258,152,581,1028
-29,20,-26,-33,-78,-33,-18,90,-107
19,10,-20,-7,-41,-37,2,25,-49
25,84,-26,-70,-34,-163,-38,131,-91
53,42,7,15,-62,-10,15,87,147
1607,2108,-400,-274,-203,-396,-301,2427,4568
73,154,20,-44,-78,-117,35,288,331
487,580,-8,-175,-226,-719,174,922,1035
17,80,-59,-94,-150,-155,26,181,-154
40,87,9,2,-7,-38,9,100,202
207,393,124,-75,66,-105,69,467,1146
43,108,-9,-49,-96,-98,-27,237,109
0,60,-39,-23,-93,-117,-31,108,-135
40,99,-77,-90,-67,-95,-26,154,-62
7,33,6,4,-25,-39,-21,63,28
-22,51,28,8,-38,-8,-21,90,88
-3,52,15,-6,-20,-12,-18,63,71
-24,3,-23,-16,-32,-59,-38,30,-159
-24,38,-11,-11,-60,-43,-58,67,-102
56,55,-40,9,-85,-69,14,42,-18
60,103,-5,-45,-28,-49,49,146,231
52,121,-34,-27,-62,-66,5,98,87
24,37,-6,-32,-46,-106,-22,100,-51
-9,51,-53,-70,-81,-131,-41,130,-204
7,57,-38,-58,-66,-128,-39,87,-178
-17,41,-42,-33,-89,-145,-65,78,-272
71,85,-7,-32,-21,-65,43,126,200
-26,42,-64,-55,-137,-94,-40,117,-257
19,-7,-90,-98,-230,-297,-101,202,-602
-28,9,-24,6,-134,-64,-2,98,-139
50,45,10,-22,-59,-101,-30,106,-1
166,273,-34,-38,-114,-187,48,331,445
303,576,-71,-122,-69,-55,288,370,1220
10,73,-62,-62,-106,-210,-33,144,-246
19,55,-79,-119,-103,-101,33,190,-105
41,97,-81,-109,-107,-209,-47,132,-283
7,9,-17,-22,-39,-69,-17,34,-114
215,249,-295,-34,-498,-387,4,237,-509
252,340,-213,20,-408,-419,0,318,-110
25,24,-95,-130,-231,-214,-57,313,-365
112,115,-23,28,-45,-24,33,163,359
7,-5,-20,-1,-29,-38,-11,31,-66
143,149,-98,-67,-158,-97,63,245,180
-3,13,-7,13,-47,-85,-26,82,-60
-51,25,-66,-72,-114,-252,-111,165,-476
82,59,2,52,-35,20,38,81,299
36,88,5,3,-62,-120,-17,144,77
79,261,-37,-255,-418,-379,-113,635,-227
30,41,-8,-14,-46,-16,-26,121,82
48,-24,-86,-53,-179,-245,-57,209,-387
100,134,-35,-76,-45,-157,-3,239,157
67,83,-40,-12,-177,-163,-1,161,-82
8,36,-46,-44,-113,-97,-28,86,-198
81,143,-99,-26,-148,-75,79,35,-10
106,71,77,15,27,-28,33,181,482
16,16,-92,-100,-158,-81,33,176,-190
-4,17,-19,-17,-49,-4,2,47,-27
4,18,-26,6,-69,-32,0,36,-63
5,0,-32,-29,-51,-41,-16,29,-135
0,-9,-14,-26,-33,-32,-9,22,-101
157,418,-159,-41,-170,-213,158,592,742
41,53,-34,-1,-38,-35,32,55,73
41,78,-16,-31,-71,-79,32,115,69
23,38,-37,-6,-92,-84,15,66,-77
18,51,-21,2,-23,-36,2,34,27
18,30,-36,-31,-44,-60,-9,43,-89
88,90,-33,35,-120,-81,34,116,129
107,127,-27,-59,-82,-144,19,249,190
-5,21,-51,-41,-102,-66,-8,68,-184
106,328,-76,-38,-139,-253,54,331,313
33,104,-49,-28,-34,-60,20,127,113
-3,104,10,-26,-8,4,36,172,289
15,57,-89,-80,-182,-273,-88,228,-412
48,47,-26,-59,-53,-168,-45,139,-117
278,325,43,-17,-18,-112,60,343,902
6,34,-43,-16,-103,-105,-5,107,-125
86,152,-97,-96,-253,-229,-66,389,-114
82,46,-80,-148,-146,-177,-49,137,-335
94,42,-78,-105,-191,-156,-28,185,-237
18,83,-40,-33,-53,-19,-19,84,21
24,8,-14,-3,-66,-38,-7,53,-43
-12,-3,-29,-23,-18,-35,2,46,-72
-21,39,-94,-55,-139,-130,-50,130,-320
42,91,-34,-68,-57,-96,6,155,39
136,177,65,-23,-10,-82,11,273,547
56,39,-91,-99,-158,-204,-14,239,-232
265,351,-108,-45,-190,-186,88,387,562
120,292,-76,-101,-68,-191,59,322,357
74,233,-16,-53,36,-73,90,276,567
39,203,-66,-75,-128,-187,-43,247,-10
70,215,-47,-37,-159,-221,-49,290,62
375,427,-48,80,-142,-50,152,502,1296
164,271,-55,-69,-208,-234,15,232,116
97,240,-19,-113,-15,-163,58,280,365
216,304,-104,63,-191,-199,77,149,315
28,104,-75,-81,-123,-207,-18,196,-176
8,113,-63,-75,-13,-191,-60,248,-33
150,255,-89,-35,-255,-303,-25,376,74
37,87,-57,-48,-48,-46,29,112,66
87,153,-54,-64,-84,-117,-4,184,101
173,227,-86,-133,-307,-367,-88,418,-163
201,303,-43,-53,-58,-222,-34,329,423
86,150,-2,-51,-129,-213,-43,235,33
288,382,-58,-43,-86,-159,117,422,863
130,260,-55,-116,-208,-234,35,391,203
-28,112,-211,-237,-436,-473,-175,350,-1098
24,46,-25,-30,-89,-73,-16,81,-82
266,413,-40,-58,-224,-203,26,488,668
358,504,79,100,-233,-144,181,583,1428
54,146,-62,22,-119,-151,-51,134,-27
167,310,-43,-96,-47,-149,91,391,624
317,248,202,39,86,-54,61,419,1318
161,189,-90,-11,-351,-349,-11,326,-136
223,293,-83,-15,-130,-126,103,314,579
39,67,-91,-73,-224,-252,-65,225,-374
236,331,-15,-3,-44,-85,82,368,870
-34,36,-142,-157,-238,-442,-124,271,-830
8,50,-81,-53,-109,-144,-26,111,-244
20,5,-42,-67,-106,-77,-14,116,-165
384,568,-77,37,-89,-79,324,665,1733
240,333,-47,-65,-154,-283,6,416,446
83,254,-69,-82,-319,-406,-15,449,-105
466,679,243,80,116,-182,129,717,2248
268,470,84,48,-38,-138,109,552,1355
132,290,-91,-40,-205,-222,60,371,295
-6,95,-71,-49,22,4,74,129,198
126,303,-145,-80,-290,-43,112,498,481
25,63,-14,-25,-64,-159,-35,146,-63
143,161,-66,4,-113,-88,94,131,266
11,30,-30,-36,-72,-60,-8,88,-77
8,36,-63,-62,-119,-147,-23,88,-282
38,115,-55,-50,-84,-230,-13,199,-80
-44,-8,-149,-78,-166,-302,-120,167,-700
20,61,-48,-15,-44,-20,38,32,24
20,43,-21,-41,-78,-101,-15,121,-72
39,35,-8,-2,-4,-34,12,40,78
28,44,-61,-37,-96,-98,-29,100,-149
-19,26,-38,-58,-81,-133,-74,114,-263
14,93,-96,8,-197,-304,-55,128,-409
97,230,63,-26,-63,-68,39,333,605
276,463,-159,-182,-455,-560,-69,646,-40
284,316,-172,-59,-135,-130,149,339,592
108,156,-89,-66,-231,-280,9,276,-117
150,163,-243,-127,-401,-503,-86,343,-704
-54,15,-59,-53,-117,-108,-51,111,-316
222,337,-69,-38,15,-89,148,331,857
19,23,-45,-65,-96,-68,11,94,-127
46,151,-17,-32,-1,-93,15,123,192
28,80,-26,-23,-54,-110,-1,104,-2
81,185,-131,-70,-41,-70,133,167,254
-49,9,-68,-73,-102,-113,-46,98,-344
57,42,-31,-5,-43,-50,44,56,70
30,34,-21,-6,-48,-50,-3,54,-10
12,35,-54,-42,-50,-96,-8,76,-127
20,69,-19,-114,-91,-131,-22,141,-147
37,67,-17,-52,-40,-61,22,99,55
30,121,-5,10,-69,-140,-2,115,60
119,146,33,48,-20,-23,20,152,475
2,44,-10,-5,-45,-84,-39,101,-36
26,44,-23,10,-48,-25,12,39,35
8,9,-19,-4,-44,-50,-14,47,-67
11,28,-5,-13,-10,-8,16,34,53
2,28,24,4,14,-2,-3,37,104
-13,40,-35,-45,-34,-46,12,50,-71
26,33,-17,15,-44,-65,-6,38,-20
116,71,30,6,-1,-144,14,135,227
-16,38,-41,-36,-40,-43,0,54,-84
-93,-46,-118,-73,-169,-174,-73,105,-641
25,103,-30,-77,-48,-101,-5,161,28
56,88,-11,-20,-81,-89,5,132,80
-2,18,-22,-33,-27,-25,7,43,-41
20,11,-35,-14,-18,-49,-2,11,-76
-19,12,-78,-69,-100,-125,-56,123,-312
-1,39,-21,-20,-31,-29,-3,39,-27
26,44,-26,-35,-81,-72,-10,138,-16
300,580,331,133,-21,-6,-28,590,1879
127,132,-155,-80,-223,-253,14,209,-229
48,96,-28,-16,7,-120,4,129,120
61,297,34,11,-163,-185,15,486,556
75,143,-42,-25,-46,-115,-10,115,95
282,527,432,277,-6,158,15,625,2310
65,157,-46,-1,-203,-113,68,245,172
519,838,252,-222,127,-111,303,941,2647
40,96,-10,-5,0,-27,47,101,242
23,60,-58,-38,-98,-161,-48,146,-174
29,26,-67,-36,-102,-93,14,85,-144
38,58,-23,-23,-36,-75,31,144,114
-14,0,-12,-30,-53,-98,-43,68,-182
13,12,-26,-9,-24,-56,-8,55,-43
32,21,-26,-41,-21,-55,24,51,-15
15,56,-68,-46,-136,-98,-9,102,-184
-23,78,-57,-78,-124,-149,-40,213,-180
290,319,36,-26,-70,-3,170,375,1091
2,50,-15,-23,-45,-77,-13,71,-50
126,139,13,84,-69,-102,46,188,425
18,73,19,-35,-31,-96,-1,102,49
12,18,-1,-30,-15,-79,-17,32,-80
-4,6,-44,-29,-82,-70,-1,30,-194
24,23,-30,-16,-26,-39,17,16,-31
22,14,-23,-5,-36,-50,3,15,-60
-75,5,-72,-46,-108,-155,-82,105,-428
57,64,-35,10,-44,-40,35,76,123
16,15,-18,-28,-7,-25,14,30,-3
292,352,-42,58,-138,-194,125,376,829
58,117,-304,-363,-454,-394,-90,586,-844
-4,23,-21,-34,-24,-60,-13,43,-90
32,57,-19,-29,-39,-66,-6,84,14
24,33,-15,-12,-76,-64,-1,110,-1
37,43,-61,-25,-88,-91,16,80,-89
21,15,-32,-58,-43,-61,-7,90,-75
46,125,-60,-62,-175,-206,-18,256,-94
51,62,-64,-57,-190,-210,-32,211,-229
118,126,-59,-66,-185,-221,4,245,-38
110,122,-47,-49,-183,-219,-27,244,-49
68,145,-69,-84,-204,-179,14,287,-22
106,111,-76,-63,-216,-207,8,268,-69
83,144,-76,-59,-213,-172,7,277,-9
92,155,-98,-68,-223,-163,13,296,4
-99,-36,-127,-75,-185,-142,-90,110,-644
149,199,-25,-33,13,-88,63,179,457
39,75,-38,-27,-44,-60,30,49,24
56,139,36,-45,15,7,86,192,486
11,35,-43,-97,-79,-163,-45,157,-224
59,152,-51,-6,-126,-53,0,193,168
64,123,-85,-51,-119,-191,-25,208,-76
-9,5,-4,-40,-28,-110,-29,78,-137
88,174,-31,-39,-83,-125,40,206,230
27,51,-34,-62,-31,-91,-16,60,-96
24,74,-39,-5,-66,-59,-1,103,31
55,103,-8,-33,-24,-21,44,72,188
26,16,-28,-11,-61,-67,14,17,-94
112,67,-53,11,-62,-100,1,54,30
145,98,-110,36,-202,-106,68,137,66
-1,11,-14,-9,-25,-60,-36,52,-82
66,46,-41,-35,-71,-106,-6,180,33
21,7,-45,-46,-55,-106,-27,51,-200
97,42,-46,-29,-58,-108,-16,61,-57
3,23,-5,28,-96,-8,-10,76,11
17,65,-42,-8,-67,-62,9,65,-23
20,27,-40,-31,-61,-56,-13,36,-118
-11,5,8,-2,-7,2,-21,24,-2
38,107,-20,-32,-50,-197,7,155,8
3,-7,-52,-17,-58,-54,-20,53,-152
41,61,-10,-2,-24,-28,16,40,94
14,17,-31,-37,-77,-125,-26,56,-209
67,106,-25,-61,-92,-58,30,164,131
83,75,-33,-48,-111,-133,10,150,-7
-25,9,-13,-6,-57,-60,-34,57,-129
26,55,-48,-47,-44,-100,-3,74,-87
27,23,-23,-14,-30,-23,7,63,30
-50,-10,-94,-45,-162,-163,-62,157,-429
-2,32,-29,-54,-41,-73,-12,74,-105
116,186,-142,-55,-220,-366,-48,277,-252
13,31,-47,-11,-96,-134,-44,75,-213
28,4,-28,-20,-45,-53,3,38,-73
-20,48,-25,-40,7,-160,-55,74,-171
41,59,-41,-24,-74,-143,-42,75,-149
-34,-19,-77,-56,-126,-125,-51,52,-436
39,32,-95,80,-204,-103,14,121,-116
7,30,-12,-19,-15,20,24,43,78
-9,123,-108,-92,-205,-197,-19,203,-304
10,32,-26,-28,-76,-119,-17,97,-127
114,294,-94,-54,-126,-185,28,327,304
12,101,-24,-20,-2,-23,56,110,210
73,55,-45,-11,-71,-53,24,94,66
32,36,-29,14,-21,6,33,28,99
-29,31,-52,-5,-102,-115,-42,121,-193
67,82,-13,-35,-109,-181,-40,190,-39
2,41,-69,-39,-78,-135,-13,87,-204
62,179,-15,-10,-64,-105,9,217,273
41,22,-112,-43,-220,-233,-47,177,-415
-69,2,-131,-125,-275,-317,-128,189,-854
1080,1345,218,253,-16,-69,568,1366,4745
-50,-25,-78,-88,-102,-93,-78,105,-409
17,97,-6,3,-106,-82,-12,161,72
59,96,-1,-7,22,-104,19,136,220
-51,1,-112,-39,-169,-152,-66,142,-446
60,52,-10,-10,-50,-57,20,84,89
33,148,-133,-41,-257,-348,-104,259,-443
4,21,-15,-27,-18,-9,19,45,20
771,1313,-808,-400,-1706,-1827,-267,1316,-1608
214,318,-119,14,-231,-152,98,205,347
266,302,68,-186,7,-44,172,447,1032
161,236,11,-15,-63,-206,-11,282,395
198,244,-17,-8,-129,-108,62,341,583
182,251,-59,-57,-74,-169,74,292,440
232,265,-57,-17,-196,-226,52,327,380
353,423,-58,-35,-143,-101,126,454,1019
199,340,-68,-73,-58,-109,107,281,619
109,142,-52,-18,-194,-137,31,262,143
19,62,-20,-29,-63,-81,4,68,-40
143,222,-70,-93,-158,-235,23,150,-18
-109,-13,-107,-60,-156,-193,-116,125,-629
570,608,279,298,147,48,76,793,2819
63,139,-97,-71,-206,-166,26,288,-24
87,204,-49,-32,-137,-229,-19,266,91
-51,10,-124,-72,-271,-173,-79,180,-580
185,264,12,-10,-66,-92,95,252,640
471,642,153,-170,140,-276,185,700,1845
326,449,-114,13,-274,-371,26,392,447
57,109,-76,-63,-138,-171,-37,157,-162
180,288,-42,-50,-218,-135,23,370,416
339,429,234,79,172,-6,161,489,1897
0,53,-45,-50,-56,-99,-31,120,-108
60,109,-116,-69,-262,-237,-4,273,-246
87,279,-192,-169,-520,-671,-172,595,-763
93,165,-56,-51,-113,-185,-34,190,9
102,165,24,31,-75,-119,19,230,377
248,521,-96,46,-137,-275,145,378,830
56,76,-23,-29,-51,-72,35,75,67
118,236,-31,-50,-133,-209,-16,252,167
169,206,63,12,-23,-72,22,256,633
101,156,-128,-148,-213,-250,-5,314,-173
119,143,-54,-64,-97,-142,64,213,182
176,191,-202,-134,-266,-324,20,325,-214
140,263,29,-87,-83,-136,92,401,619
178,204,-43,-47,-50,-125,59,249,425
384,397,-60,-108,-57,-144,166,493,1071
146,189,-176,-243,-302,-491,-94,388,-583
-118,-34,-105,-80,-151,-147,-86,113,-608
158,101,12,-44,-20,-80,34,139,300
46,28,-22,-17,-13,-52,-8,64,26
28,224,-71,-106,-167,-292,-54,262,-176
91,365,64,-66,-103,66,100,349,866
94,138,-16,-48,-8,-94,-1,179,244
-5,29,-25,-65,-52,-80,8,102,-88
27,193,-15,-96,-133,-241,-75,271,-69
21,63,-44,-50,-42,-65,30,78,-9
14,26,-50,-30,-93,-57,25,62,-103
47,146,3,6,-42,-188,-69,185,88
80,89,-36,-103,-122,-167,-9,200,-68
253,453,-5,-128,-28,-107,139,400,977
1074,1569,217,-124,219,191,764,1490,5400
-2,41,-7,-43,-48,-61,20,76,-24
32,69,-87,-104,-215,-87,9,308,-75
16,57,-58,-66,-46,-149,-32,108,-170
-8,13,-14,-35,-64,-66,-45,89,-130
6,44,-23,-38,-81,-56,-38,104,-82
37,33,-64,-25,-94,-47,39,77,-44
141,197,-71,-48,-115,-113,26,240,257
96,252,-76,-67,-57,-91,123,155,335
32,81,-68,-24,-153,-168,31,175,-94
234,275,-34,-2,-205,-203,45,318,428
135,109,-52,31,-81,-100,30,113,185
7,40,-26,-36,-47,-83,3,36,-106
182,178,56,-15,-12,-48,55,254,650
53,66,-60,-67,-195,-163,-45,273,-138
-101,1,-286,-302,-388,-471,-165,436,-1276
130,196,-171,-62,-256,-225,15,170,-203
-29,59,1,-48,-84,-85,-38,135,-89
153,134,13,-19,-10,-93,32,223,433
10,15,-118,-128,-179,-167,-15,196,-386
29,39,-25,-42,-26,-64,0,69,-20
125,297,-29,7,-151,-163,54,355,495
-11,16,-75,-55,-88,-105,-20,71,-267
51,53,-38,2,-45,-27,22,46,64
87,153,-93,-105,-244,-136,79,250,-9
49,66,-24,-15,-142,-163,-41,183,-87
100,131,-9,-35,1,-113,32,186,293
103,181,-12,-38,-31,-51,49,188,389
168,170,-44,-15,-89,-98,73,250,415
77,61,-46,-14,-66,-29,-1,133,115
38,22,-139,-104,-202,-192,-10,183,-404
14,27,-16,-5,-5,-2,24,12,49
32,35,-124,-78,-190,-239,-72,186,-450
48,145,153,33,86,55,5,172,697
34,56,-55,-74,-83,-144,-37,143,-160
0,37,-85,-49,-96,-172,-42,122,-285
74,194,141,65,-76,27,-58,252,619
-7,1,-23,-24,-43,-37,-6,24,-115
86,95,-87,-127,-180,-173,27,192,-167
-13,44,-62,-96,-217,-184,-50,141,-437
19,-11,-36,-29,-51,-83,-24,8,-207
-18,9,-19,-21,-12,-41,-10,28,-84
-39,30,-87,-56,-103,-200,-66,95,-426
7,-3,-63,-65,-126,-124,-21,132,-263
76,193,-53,-32,-63,-118,27,129,159
-7,24,-84,-68,-162,-67,14,57,-293
-3,-26,-56,-40,-33,-99,-27,74,-210
92,99,-58,-26,-110,-70,45,155,127
-5,23,-114,-80,-167,-190,-23,129,-427
0,13,-47,-33,-70,-102,-28,83,-184
26,6,-36,10,-41,-59,9,51,-34
-1,31,-22,-66,-76,-101,-22,124,-133
8,17,-10,10,-26,-1,15,28,41
61,348,-87,-161,-218,-332,55,524,190
15,84,-61,-26,-133,-319,-82,192,-330
55,58,-2,9,-32,-87,3,40,44
-1,5,-23,8,-27,-11,10,22,-17
31,95,34,-15,26,-10,32,117,310
17,30,-56,-76,-30,-107,-4,34,-192
23,44,5,-3,-4,-38,7,51,85
30,61,-64,-32,-68,-74,21,18,-108
14,10,-10,-16,-16,-57,-8,37,-46
102,220,-43,24,-42,-95,30,158,354
19,79,-27,-30,-57,-181,-29,119,-107
103,168,49,-57,-61,-65,46,246,429
98,167,-77,3,-119,-129,47,185,175
31,16,-29,-6,-47,-48,26,46,-11
-42,41,-29,-14,-53,-130,-47,48,-226
-8,3,-50,-16,-84,-128,-48,71,-260
-8,15,-9,-5,-10,-19,-5,27,-14
7,56,-14,-12,-42,-110,-8,69,-54
87,86,21,82,-55,-66,39,164,358
25,-11,-79,-60,-106,-155,-46,92,-340
45,71,-46,-24,-172,-122,-42,197,-93
67,100,-18,20,-87,-128,-15,129,68
-3,33,-75,-46,-126,-70,11,81,-195
32,82,-23,-2,-24,-37,38,52,118
-45,26,-62,-61,-127,-199,-66,99,-435
-58,-26,-73,-62,-70,-93,-51,70,-363
17,13,-16,-36,-43,-45,9,50,-51
-23,-16,-46,-44,-42,-103,-51,57,-268
18,59,-33,4,-38,-58,-4,64,12
19,21,-19,-34,-62,-110,-11,87,-109
11,11,-31,21,-66,-49,-15,68,-50
4,29,-18,-58,-34,-60,-12,74,-75
-3,38,-43,-35,-77,-49,-13,76,-106
2,19,-38,-25,-39,-27,0,21,-87
0,16,-46,-29,-48,-62,-4,48,-125
157,151,-78,-34,-154,-194,36,269,153
10,15,-7,-6,-12,-37,-14,19,-32
44,71,-39,-24,-52,-100,13,117,30
41,90,8,-13,-61,-60,-9,152,148
6,-25,-59,-42,-63,-81,-10,39,-235
-91,12,-87,-63,-159,-214,-100,142,-560
22,32,-10,0,9,-15,14,12,64
30,13,1,-16,-34,-39,-11,65,9
-11,21,-54,-40,-86,-56,-34,83,-177
-10,4,-32,-5,-47,-70,-26,24,-162
12,59,-62,-96,-128,-109,-35,101,-258
-23,128,-69,-38,38,23,67,154,280
9,34,-153,-118,-274,-385,-107,226,-768
22,38,-8,-31,-20,-116,-25,97,-43
5,11,-16,-17,-39,-39,-13,35,-73
7,23,-40,-30,-61,-84,-19,90,-114
-3,14,-6,-19,-56,-78,-41,62,-127
38,96,4,-21,-5,-9,47,86,236
92,138,-46,-14,-108,-187,1,122,-2
15,24,-7,0,-20,-5,7,15,29
-17,15,3,-65,1,-102,-17,91,-91
-1,21,-31,-30,-7,-81,-12,55,-86
34,36,-31,-3,-57,-63,9,84,9
-51,4,-89,-32,-155,-143,-86,103,-449
-12,34,-80,-106,-90,-266,-90,211,-399
25,32,-5,-32,-6,-62,-1,73,24
99,113,26,-12,29,-77,14,85,277
-47,4,-77,-28,-93,-117,-71,64,-365
54,75,-104,-98,-128,-242,-59,113,-389
192,280,-42,-25,-72,-115,88,261,567
61,145,-52,-36,-112,-130,-13,128,-9
60,154,-46,-76,25,-32,85,193,363
49,192,-122,-182,-298,-271,4,363,-265
79,51,-31,-53,-202,-255,-23,221,-213
68,135,-1,-57,-47,-32,11,190,267
-72,2,-107,-86,-102,-179,-69,122,-491
336,573,-141,-81,-307,-325,108,664,827
53,21,-50,3,-105,-109,-12,119,-80
-7,64,-133,-94,-211,-223,-47,159,-492
216,277,57,-48,-64,-142,45,427,768
10,42,-28,-33,-65,-107,-13,111,-83
-77,6,-205,-173,-273,-311,-142,202,-973
145,134,-66,4,-147,-111,43,168,170
-14,14,-32,-51,-55,-108,-9,40,-215
-56,82,-51,-56,12,-16,48,96,59
1,47,-100,-82,-91,-197,-64,185,-301
178,206,-93,-89,-224,-277,23,331,55
264,318,19,-2,-33,-124,97,345,884
26,39,-44,-74,-42,-100,-4,63,-136
127,191,-118,-73,-165,-200,25,286,73
282,290,38,-60,-31,-73,162,320,928
77,177,-29,-126,-155,-31,53,351,317
38,112,-64,-28,-12,-24,41,171,234
262,426,-49,-114,-113,-191,101,508,830
88,243,-153,-112,-222,-407,-30,381,-212
-18,48,-7,-44,-39,-78,-71,75,-134
247,419,-60,62,-263,-341,37,262,363
243,364,-110,-203,-174,-386,21,528,283
56,91,-24,-48,-110,-70,9,124,28
107,156,-60,-43,-136,-126,27,234,159
146,173,24,11,-17,-32,69,176,550
117,232,-107,-79,-148,-191,73,245,142
176,209,-39,4,-150,-157,69,187,299
-3,68,-75,-100,-71,-135,-7,120,-203
80,98,-45,-52,-61,-116,17,181,102
210,300,27,-29,-112,-283,69,419,601
200,340,-239,57,-438,-495,-81,300,-356
250,325,77,28,-26,-54,102,375,1077
75,119,-27,-59,-147,-146,22,216,53
86,236,6,-141,-81,-154,55,260,267
15,131,-90,-99,-204,-159,2,311,-93
49,85,-81,-90,-186,-208,1,207,-223
64,160,-138,-120,-261,-292,-40,360,-267
131,220,-30,-34,-127,-159,-1,262,262
35,219,-56,-72,-15,-59,93,233,378
23,133,-41,-60,-96,-187,-19,192,-55
80,166,-72,-85,-174,-237,-15,248,-89
-7,45,-13,-22,-52,-22,21,73,23
14,54,-52,-23,-133,-93,-11,111,-133
97,156,-9,-17,-39,-151,-26,212,223
18,104,-14,8,13,0,69,147,345
-36,21,-98,-89,-100,-149,-94,96,-449
-31,57,-51,-45,-141,-183,-32,109,-317
-35,115,-24,-56,1,4,35,206,246
-21,42,-34,-38,-80,-72,-15,90,-128
-12,-13,-147,-116,-322,-301,-114,231,-794
-4,72,-108,-53,-3,-13,39,87,17
-5,7,-28,-6,-31,-78,-4,33,-112
15,1,-15,18,-39,-46,-8,21,-53
8,34,-9,-8,-21,-32,-2,55,25
13,12,-10,0,-33,-25,16,15,-12
138,158,-61,-70,-76,-136,40,207,200
26,75,-85,-55,-111,-83,33,128,-72
-4,15,-25,-19,-41,-27,-7,33,-75
4,8,-32,-16,-37,-50,18,35,-70
-14,30,-43,-25,-79,-69,0,40,-160
10,39,-20,15,1,5,27,3,80
29,21,-35,-44,-50,-72,29,78,-44
91,203,9,-36,-28,-84,55,255,465
-3,22,-52,-73,-79,-65,-2,105,-147
-7,1,-49,-47,-105,-130,-25,90,-272
29,17,-39,-75,-65,-101,-17,94,-157
-73,-6,-47,-84,-92,-112,-67,72,-409
-58,-21,-39,-58,-47,-100,-49,79,-293
96,88,59,-22,43,93,88,151,596
-7,44,-36,12,-77,-131,-37,71,-161
80,103,-3,-75,-32,-96,-14,156,119
129,171,-43,-32,-152,-178,38,255,188
16,15,22,2,-19,-81,-21,111,45
-15,12,-40,-35,-61,-83,-23,50,-195
-1,31,2,-22,-5,6,6,55,72
77,115,40,2,27,-48,41,120,374
34,41,-75,-29,-185,-214,-77,118,-387
266,364,53,25,55,78,180,367,1388
196,216,55,-70,60,-94,82,175,620
-1,135,21,-28,-75,-204,-71,211,-12
25,78,-46,-76,-116,-94,11,127,-91
27,27,-28,-20,-28,-74,-4,38,-62
7,150,-85,-105,-182,-258,-53,156,-370
21,56,-97,-3,-114,-90,9,84,-134
115,144,-34,-37,-87,-174,-3,208,132
14,11,10,-15,5,-25,-12,30,18
131,292,10,43,-93,-37,87,412,845
17,7,-21,-15,-26,-56,-25,25,-94
7,8,-5,-10,-14,-14,7,13,-8
79,158,17,3,3,-54,65,148,419
-14,11,-36,-33,-63,-77,-24,57,-179
18,15,19,22,-30,-33,-11,59,59
67,86,-14,-8,-18,-15,52,90,240
58,35,-56,-6,-81,-75,14,58,-53
0,100,-45,-82,-126,-130,-15,158,-140
6,45,-52,-18,-74,-130,-25,89,-159
30,25,-32,7,-139,-135,-3,117,-130
-3,33,-33,-27,-124,-90,-4,75,-173
-6,39,-27,-35,-41,-100,10,95,-65
3,15,-55,-11,-48,-110,-9,74,-141
32,73,-28,-41,-43,-51,29,38,9
3,-17,-72,-30,-127,-109,-18,19,-351
15,15,-22,2,-58,-59,-14,62,-59
-5,6,-33,-34,-49,-77,-22,44,-170
0,19,-33,-49,-25,-20,3,15,-90
4,2,-43,-18,-26,-31,3,33,-76
2,73,8,-8,-65,-89,-5,148,64
8,12,-12,-11,-12,-26,-4,24,-21
74,146,8,-52,-87,-244,-35,268,78
45,95,11,-17,-54,-33,2,158,207
25,48,11,-5,-21,-15,-16,85,112
-11,-9,-45,-5,-72,-84,-38,42,-222
-1,29,-20,-24,-5,-48,0,41,-28
-75,-29,-128,-57,-199,-176,-46,153,-557
30,34,-21,-20,-46,-62,15,47,-23
22,35,-63,-38,-55,-116,-6,97,-124
54,43,-31,7,-89,-91,-26,75,-58
10,23,-35,-19,-8,-54,16,59,-8
24,14,-53,-28,-51,-110,-29,54,-179
100,154,-21,-48,-28,-14,59,80,282
35,46,-17,-22,-43,-56,3,83,29
48,122,-36,-14,-18,19,65,89,275
-30,30,-38,-30,-82,-79,-45,58,-216
-8,29,-38,-38,-28,-77,-14,92,-82
6,12,-11,-34,-36,-65,-11,68,-71
5,41,-14,-36,-40,-70,-1,25,-90
19,48,-50,-33,-22,-34,26,27,-19
17,1,-27,-33,-31,-57,-2,51,-81
31,66,-33,-27,-38,-28,39,48,58
-13,28,-52,-51,-55,-38,4,27,-150
11,18,-38,-28,-33,-65,-21,47,-109
17,18,-30,-19,-34,-37,13,38,-34
-12,21,-19,-25,-49,-15,5,67,-27
-3,7,-33,-24,-50,-47,-10,47,-113
2,-13,-13,-15,-27,-20,6,8,-72
18,-2,-23,-19,-51,-68,-17,40,-122
18,24,-32,-3,-53,-14,21,45,6
11,28,-19,-5,-34,-39,6,33,-19
76,83,-46,-2,-50,-25,38,58,132
34,41,-5,-23,-33,-28,14,65,65
37,20,-25,-21,-25,-22,31,23,18
-7,6,-24,-20,-48,-38,-5,40,-96
1,27,3,-41,-9,-16,-3,36,-2
2,5,-21,-6,-18,-20,-4,27,-35
14,-6,-20,1,-25,-44,-7,18,-69
5,-2,-28,-33,-18,-36,-5,10,-107
8,14,-9,-15,-42,-31,6,47,-22
5,39,13,13,-1,-4,6,58,129
5,8,-11,-20,-15,-42,-13,21,-67
-7,7,-14,-28,-26,-13,6,28,-47
12,28,-26,10,-45,-32,-13,23,-43
34,18,-17,7,-38,-24,10,31,21
17,4,-6,-19,-36,-40,-25,31,-74
24,29,-17,-15,-18,-27,21,44,41
-41,-13,-32,-20,-18,-40,-26,33,-157
42,55,-19,6,-1,6,35,59,183
-4,19,2,3,-38,-28,4,37,-5
-5,30,-26,-1,-45,-31,-9,31,-56
12,44,-41,-5,-67,-40,21,41,-35
-12,-1,-4,-8,-2,-23,-13,11,-52
4,22,-43,-10,-71,-66,14,55,-95
46,14,-27,-10,-146,-77,7,103,-90
74,119,39,-48,-5,-111,-24,163,207
143,174,-14,-15,-79,-175,52,198,284
5,15,-22,-21,-42,-34,6,22,-71
13,43,2,-9,-15,-28,4,41,51
141,197,-42,-84,-90,-234,-3,311,196
-5,143,-28,-57,24,-4,73,225,371
-60,-12,-69,-60,-77,-120,-64,60,-402
6,109,9,23,-42,-131,-32,103,45
23,36,-4,-5,-34,-35,-1,59,39
77,175,-112,-103,-183,-229,-42,221,-196
29,-8,-76,-66,-144,-149,-38,156,-296
5,5,-32,-30,-43,-39,-4,39,-99
159,265,-12,-41,-132,-163,11,412,499
33,73,-54,-21,-127,-84,-62,167,-75
82,129,27,7,-26,-54,31,136,332
94,238,-82,-86,-214,-157,19,336,148
37,35,-4,3,-42,-81,4,96,48
126,305,-207,-163,-411,-701,-163,564,-650
562,760,5,-128,-102,-213,305,771,1960
39,72,-28,-1,-28,-12,14,71,127
40,113,-5,-12,-13,-74,9,113,171
46,139,-64,-50,-121,-179,2,174,-53
19,15,-17,-12,-10,-4,19,24,34
0,50,-28,-21,-38,-64,-15,68,-48
111,180,55,-5,39,28,116,157,681
27,74,44,46,-38,-6,28,88,263
176,80,83,40,16,-14,-1,167,547
24,30,-51,-95,-95,-110,-9,80,-226
6,27,-34,3,-4,-15,22,5,10
84,156,-75,-24,-114,-107,50,238,208
-5,15,-4,-8,-25,-14,5,48,12
135,163,-24,11,-179,-172,7,233,174
46,88,-16,5,-23,-73,1,58,86
48,99,-97,-74,-133,-86,29,165,-49
51,106,6,-20,-38,-54,42,173,266
37,145,-91,-133,-74,-66,57,145,20
91,132,42,-23,-29,-114,-7,178,270
33,19,-55,-20,-88,-80,16,86,-89
160,310,-9,25,-63,-96,114,413,854
93,185,19,-23,1,-94,47,242,470
22,20,-20,-80,-13,-127,-22,85,-135
4,136,-68,-60,-12,-14,57,178,221
34,44,-17,-34,-6,-62,4,69,32
37,112,-51,-35,-70,-64,10,114,53
5,42,-40,-38,-54,-67,-2,84,-70
252,439,-176,-167,-565,-738,-150,859,-246
-91,2,-132,-88,-155,-274,-97,163,-672
410,153,-544,95,-933,-699,115,415,-988
99,642,3,-117,-82,-69,9,799,1284
74,138,-62,-34,-111,-86,25,108,52
39,38,-56,-51,-98,-103,-9,101,-139
65,138,-510,-341,-851,-1151,-186,713,-2123
137,187,-6,9,-71,-162,-9,198,283
-67,-11,-58,-38,-86,-115,-61,63,-373
191,293,-13,-124,-176,-235,45,406,387
341,597,37,-18,-60,-265,131,501,1264
115,143,-133,-145,-272,-420,-97,339,-470
112,206,-90,-147,-243,-269,-104,386,-149
146,212,-117,-98,-159,-240,50,301,95
-23,54,-101,-82,-187,-205,-34,195,-383
47,167,-69,-76,-177,-345,-94,256,-291
61,67,-26,11,-91,-115,17,130,54
127,219,-113,-32,-110,-148,94,238,275
114,197,-98,-81,-152,-265,-13,216,-82
13,126,-95,-108,-202,-268,-65,245,-354
121,196,-118,-140,-371,-392,-49,453,-300
205,586,-328,-264,-813,-957,-98,947,-722
321,373,-87,7,-88,-180,151,388,885
62,105,-88,-105,-76,-169,-29,249,-51
12,151,-167,-136,-356,-329,-24,336,-513
128,128,-18,-63,-73,-203,-52,183,30
95,146,-108,-92,-86,-203,-17,261,-4
128,354,-152,-93,-249,-354,-4,521,151
193,391,-93,-48,-254,-361,-34,512,306
443,470,40,-46,-5,-147,192,509,1456
105,206,-73,-32,-198,-258,-28,290,12
88,182,-62,-38,-139,-235,-7,265,54
380,149,-525,32,-948,-683,68,440,-1087
255,341,-66,-109,-189,-216,30,436,482
334,396,122,156,-76,-61,115,560,1546
39,71,15,-2,16,-33,12,42,160
86,178,-240,-139,-401,-432,-70,328,-690
55,108,5,9,-39,-78,11,135,206
102,117,-22,-15,-119,-163,-12,178,66
50,78,21,-12,-107,-49,27,182,190
287,450,-33,-75,-128,-140,169,564,1094
9,60,-27,-60,-71,-82,12,107,-52
53,70,-71,-82,-99,-162,22,189,-80
162,144,-120,-23,-184,-205,78,209,61
36,49,8,-23,-6,-44,14,77,111
31,36,14,13,4,-9,16,51,156
2,25,-24,-41,-36,-78,-33,67,-118
49,32,-54,-16,-81,-76,11,83,-52
23,22,-71,-33,-116,-91,-13,112,-167
44,59,0,0,-31,-56,14,63,93
64,99,-69,-93,-62,-176,13,165,-59
48,154,-87,-54,-179,-265,-46,171,-258
30,33,-11,-38,-2,-62,21,60,31
32,125,-60,-44,-119,-170,-21,149,-108
36,86,-37,-51,-125,-115,4,161,-41
-1,64,23,8,-35,-31,-9,109,128
-21,-4,-75,-69,-97,-120,-38,84,-340
-1,35,2,1,4,-35,-5,26,27
71,119,-19,-47,-25,-18,35,161,277
18,37,-5,-21,-87,-63,-8,103,-26
-3,6,-7,-18,-20,-21,-11,25,-49
3,31,15,1,-18,13,11,41,97
23,47,0,-6,-13,-35,13,64,93
24,27,-9,-18,-13,-2,20,53,82
-5,53,16,-19,-71,-68,-29,108,-15
-32,-17,-81,-42,-108,-116,-39,63,-372
902,1071,-20,13,-15,-16,581,1009,3525
4,18,-30,-12,-36,-30,-8,17,-77
9,27,-3,-35,0,-1,27,56,80
-9,14,-21,-34,-30,-39,1,44,-74
-1,10,-14,-3,-24,-12,-10,28,-26
38,56,-11,5,-28,-36,10,40,74
24,84,-27,-12,-44,-104,-18,113,16
-7,-1,-22,-31,-37,-21,-3,40,-82
-17,-21,-71,-47,-79,-103,-35,59,-314
90,104,28,-67,-77,-81,-6,215,206
480,685,324,106,46,-142,166,846,2511
7,57,-15,-19,-51,-49,23,102,55
78,118,30,4,-23,-71,12,169,317
-34,0,-67,-14,-149,-96,-34,127,-267
9,2,-51,-52,-109,-145,-33,73,-306
-6,-3,-58,-27,-148,-186,-56,101,-383
6,45,-9,-33,-52,-81,-10,77,-57
25,105,-19,-22,-41,-70,25,101,104
75,57,7,2,4,-24,10,93,224
10,37,-9,-12,-7,-20,17,59,75
3,10,-21,40,-62,-36,-6,41,-31
-36,-16,-63,-34,-100,-107,-44,67,-333
16,42,-23,-24,-64,-73,-11,77,-60
6,-7,-13,-18,-37,-37,-21,31,-96
105,187,-58,17,-115,-172,-3,106,67
35,140,-43,-38,-179,-78,36,243,116
14,119,-37,-28,4,-29,54,118,215
30,70,-49,-16,-126,-162,-33,106,-180
140,102,21,70,-62,-18,53,218,524
188,292,-28,-52,-38,-96,130,287,683
119,159,-56,-58,-108,-149,29,221,157
12,-12,-30,-30,-77,-85,-13,52,-183
55,118,-182,-102,-216,-166,36,225,-232
21,67,-23,-47,-38,-80,-29,119,-10
44,98,-70,-59,-178,-215,-36,225,-191
51,97,-69,-92,-185,-211,-42,217,-234
46,120,-53,-66,-151,-204,-15,230,-93
29,92,-88,-68,-172,-208,-43,204,-254
17,107,-79,-96,-184,-191,-39,202,-263
42,96,-69,-60,-190,-200,-47,234,-194
37,108,-70,-71,-195,-210,-55,213,-243
57,139,-67,-82,-166,-189,2,206,-100
37,90,-67,-90,-183,-226,-52,204,-287
36,112,-73,-79,-157,-212,-33,234,-172
21,82,-75,-73,-205,-203,-49,238,-264
19,101,-81,-91,-214,-195,-34,227,-268
31,98,-65,-126,-160,-185,-25,243,-189
129,170,-3,-34,-143,-228,-27,264,128
116,165,-21,-50,-114,-211,12,268,165
89,95,-55,-65,-188,-205,-26,243,-112
97,102,-51,-82,-188,-227,-1,227,-123
101,118,-52,-52,-164,-201,-9,239,-20
112,94,-65,-71,-175,-229,-24,242,-116
112,86,-60,-69,-172,-232,-48,237,-146
127,105,-46,-53,-182,-227,-13,249,-40
83,112,-76,-70,-236,-213,-24,253,-171
94,92,-49,-61,-186,-231,-13,276,-78
89,104,-68,-73,-185,-229,-30,256,-136
116,115,-67,-70,-211,-215,-18,282,-68
121,134,-56,-63,-172,-247,-24,249,-58
116,144,-49,-94,-182,-233,-46,275,-69
86,91,-61,-83,-216,-225,-43,258,-193
125,94,-73,-67,-195,-257,-32,252,-153
95,128,-40,-67,-191,-202,-13,292,2
113,109,-63,-56,-204,-242,-30,264,-109
119,112,-50,-60,-169,-228,-4,260,-20
65,171,-87,-78,-204,-179,19,284,-9
96,142,-63,-70,-195,-195,8,282,5
97,136,-77,-81,-218,-168,-3,287,-27
105,161,-54,-65,-210,-160,22,299,98
94,146,-100,-56,-228,-168,27,303,18
77,153,-82,-65,-214,-167,12,295,9
100,151,-62,-48,-194,-177,25,285,80
76,135,-94,-81,-200,-182,16,290,-40
83,137,-93,-72,-242,-204,-17,279,-129
99,132,-77,-63,-208,-172,-2,296,5
-31,-2,-55,-23,-78,-97,-37,28,-295
78,97,-50,-26,-83,-71,59,137,141
37,48,2,-4,-65,-60,1,107,66
-6,17,-9,-3,-24,-18,4,28,-11
17,12,-13,5,-25,-32,7,33,4
4,2,-13,-7,-2,-14,3,10,-17
13,7,-10,0,-12,-18,-2,16,-6
18,28,-43,-55,-77,-91,-24,80,-164
-8,27,-2,10,-58,-23,-34,62,-26
52,61,-35,-59,-46,-74,24,78,1
22,38,-50,-25,-67,-60,-7,69,-80
95,176,-48,-44,-7,-60,64,161,337
16,12,-43,-6,-71,-52,-7,36,-115
-28,28,-130,-107,-238,-340,-113,132,-796
-7,20,2,-3,-2,-23,-14,22,-5
38,58,-33,35,-81,-135,-20,130,-8
8,11,0,9,-25,-15,12,21,21
-13,3,-1,-7,-4,-11,-6,10,-29
3,14,-2,3,-3,-11,12,34,50
-18,-6,-10,-8,-7,-20,-23,9,-83
13,37,-37,-18,-88,-83,-22,61,-137
-8,17,-46,1,-86,-124,-52,123,-175
-4,5,-28,-8,-49,-58,11,34,-97
30,50,-29,1,-57,-51,18,51,13
-73,-47,-50,-63,-95,-110,-65,73,-430
-94,-51,-67,-76,-98,-126,-72,59,-525
24,39,0,-11,15,-3,10,30,104
101,141,0,-27,-27,-73,72,213,400
66,73,-51,-63,-126,-96,19,127,-51
-16,48,-26,-32,-82,-41,3,89,-57
58,53,-32,-55,-58,-130,-21,117,-68
-9,-29,-50,-33,-57,-145,-35,99,-259
79,102,-6,-3,8,-46,28,121,283
37,146,3,-98,-111,-112,-87,243,21
4,29,-8,-1,-14,-15,4,32,31
26,60,-45,-77,-37,-92,33,97,-35
5,74,-110,-69,-189,-274,-49,160,-452
64,29,-22,-45,-25,-75,38,136,100
-15,58,13,-52,-50,-78,-5,80,-49
100,130,19,-38,-16,-73,40,142,304
83,82,11,37,-45,-29,41,145,325
-9,3,-13,-17,-13,-38,-7,17,-77
-25,15,-81,-40,-142,-234,-117,126,-498
177,344,-152,-122,-278,-366,25,323,-49
-74,-25,-87,-77,-111,-150,-74,115,-483
30,37,-5,-14,2,-9,15,29,85
8,11,-26,-3,-54,-21,10,19,-56
84,145,-82,-40,-102,-143,48,198,108
77,104,30,-16,-7,-4,47,147,378
-23,1,-32,-12,-73,-44,-14,59,-138
-16,54,35,11,5,1,-8,67,149
-1,-11,-14,-3,-16,-25,-4,15,-59
-16,0,3,2,-18,-22,-11,36,-26
27,16,-18,11,-2,0,22,18,74
199,2,-27,-13,-84,-165,29,168,109
68,90,58,16,42,-48,-3,111,334
3,53,8,-1,-27,21,2,95,154
-8,99,-130,-135,-128,-301,-74,167,-510
49,25,-120,-127,-167,-290,-61,120,-571
22,65,-2,-18,-24,-32,20,92,123
20,30,-8,-15,-19,-49,4,61,24
72,64,-51,2,-90,-75,14,132,68
54,56,-64,-19,-90,-133,-1,111,-86
44,55,-39,-41,-43,-119,-13,76,-80
59,76,-21,6,-48,-82,20,100,110
-40,-21,-75,-58,-146,-133,-41,123,-391
-5,32,-16,-40,-59,-70,-45,134,-69
-47,18,-95,-41,-146,-153,-60,123,-401
0,36,-27,-18,-59,-47,22,58,-35
-59,-8,-73,-80,-124,-133,-55,77,-455
-18,18,-54,-42,-103,-164,-57,107,-313
-10,68,-14,-31,-47,-109,-21,76,-88
43,92,-4,-32,-79,-83,-35,214,116
24,22,-58,-5,-66,-46,-2,71,-60
-38,30,-283,-230,-352,-508,-189,436,-1134
6,20,-60,-15,-139,-111,-17,124,-192
36,37,-19,-7,-19,-21,29,48,84
-9,-12,-22,-57,-37,-73,-34,72,-172
83,107,-34,-25,-135,-94,2,235,139
-42,17,-50,-23,-73,-129,-58,51,-307
-3,50,-57,-20,-116,-131,-21,68,-230
26,53,-1,-25,-2,-51,4,66,70
29,25,-9,8,-32,-27,5,25,24
31,59,-42,-25,-55,-48,28,95,43
153,192,-53,-7,-153,-136,-4,154,146
150,244,-40,-50,-218,-287,6,322,127
10,63,-28,-37,-78,-70,5,69,-66
2,60,-29,-44,-76,-62,14,86,-49
8,90,-46,-51,-65,-133,-38,129,-106
21,23,-36,-4,-103,-62,-21,79,-103
570,726,-56,-132,-10,-255,316,785,1944
-15,-3,-42,7,-84,-60,-18,50,-165
-22,130,-94,-112,-121,-126,-52,219,-178
201,262,-310,-16,-467,-403,-4,252,-485
6,33,-36,-32,-67,-32,17,85,-26
48,47,-26,-35,-93,-125,5,100,-79
31,32,-27,-32,-113,-59,-2,105,-65
38,48,1,-23,-18,-80,6,94,66
-7,11,-61,-43,-144,-99,-30,87,-286
67,8,-38,49,-64,-61,67,62,90
-34,86,-65,-57,-125,-227,-62,198,-286
27,37,-37,-39,-22,-26,15,45,0
54,59,-18,-35,-20,-84,3,109,68
13,34,-50,-56,-24,-81,-1,66,-99
-6,42,-37,-41,-52,-65,0,65,-94
9,74,-37,-19,-77,-105,-11,113,-53
-29,16,-136,-62,-294,-300,-99,224,-680
-84,-2,-86,-95,-85,-204,-118,98,-576
-2,1,-70,-22,-72,-71,3,46,-187
18,16,7,-4,-9,-2,16,19,61
41,51,20,-22,11,-23,31,65,174
21,29,-129,-105,-233,-240,-30,152,-535
21,81,-25,-41,-49,-125,3,98,-37
1,14,-40,-30,-22,-32,-12,28,-93
-15,-7,-30,-32,-43,-35,-35,25,-172
-18,20,-17,-27,-40,-57,-34,33,-140
28,88,-82,-83,-139,-61,23,176,-50
-46,7,-32,12,-60,-41,-26,13,-173
-26,73,-59,-26,-118,-188,-54,125,-273
20,24,-34,-30,-27,-74,2,52,-67
20,42,-44,-51,-132,-75,34,96,-110
16,9,-48,-27,-87,-67,-26,79,-151
-27,12,-56,-52,-162,-237,-101,156,-467
11,61,-40,-69,-51,-129,-17,83,-151
-2,-4,-19,-35,-28,-44,-16,37,-111
170,264,-9,25,-68,-88,84,221,599
9,33,-19,-2,-13,-36,11,33,16
49,56,14,15,-7,-34,27,56,176
-15,14,-24,-21,-36,-63,-29,25,-149
2,71,-100,-93,-178,-211,-60,127,-442
125,281,74,93,-152,-128,-35,274,532
-19,76,-123,-47,-254,-431,-137,242,-693
-10,3,3,-8,-15,-43,-24,38,-56
-21,15,-26,-31,-65,-67,-28,75,-148
69,113,-233,-150,-416,-445,-109,322,-849
112,136,-220,-177,-422,-445,-122,366,-772
98,231,-85,-6,-175,-164,15,92,6
22,56,-45,-28,-83,-85,-20,86,-97
38,39,-77,-15,-87,-121,-34,61,-196
8,40,-11,-35,-20,-50,6,70,8
56,77,-17,-36,-38,-75,14,131,112
167,267,-33,1,-68,-136,73,277,548
70,51,-81,-38,-106,-98,-23,121,-104
65,48,-83,-41,-108,-95,-20,121,-113
26,63,9,-1,-36,-52,20,93,122
-20,8,-15,-2,-23,-31,-22,19,-86
-3,13,-6,-34,8,-20,-6,28,-20
13,28,-32,14,-49,-57,-14,58,-39
62,96,-41,-27,-76,-59,-10,142,87
39,37,-9,21,-28,-14,28,55,129
28,-1,-4,-24,-33,-55,9,58,-22
179,266,-46,0,-117,-139,38,301,482
2,5,-4,-14,-13,-34,-9,23,-44
34,56,-64,-22,-52,-115,2,108,-53
3,18,-7,-11,-36,-3,25,39,28
150,130,43,33,5,-57,30,130,464
19,52,-35,-18,-75,-99,-31,124,-63
37,40,11,-18,-58,-95,4,88,9
-1,-15,-36,-11,-46,-79,-23,56,-155
-1,57,-30,-22,-28,-64,-8,72,-24
281,415,-147,-88,-221,-457,82,467,332
21,33,-2,-16,4,-17,10,49,82
-2,-6,-25,-17,-45,-36,-9,16,-124
-12,8,-35,-43,-51,-76,-34,61,-182
44,91,2,-21,-81,-137,-6,142,34
-83,-22,-68,-51,-124,-110,-57,98,-417
80,133,-64,-58,-102,-38,87,178,216
52,87,-87,-54,-178,-268,-28,224,-252
19,54,-57,-68,-97,-111,-14,94,-180
70,121,-63,7,-83,-103,32,64,45
-70,33,-115,-36,-155,-124,-108,198,-377
58,84,-43,-43,-98,-109,17,224,90
-4,21,3,16,-50,-53,-29,78,-18
46,68,-63,-44,-134,-81,25,149,-34
50,40,-25,-38,-32,-59,26,78,40
-7,61,-42,-44,-103,-99,-53,137,-150
-40,148,-160,-160,-125,-289,-52,257,-421
17,11,-20,-14,-5,-43,6,1,-47
4,5,-27,-29,-33,-30,25,47,-38
-1,-10,-36,-25,-52,-62,-34,55,-165
27,32,-72,-26,-107,-71,14,76,-127
178,350,76,85,-136,-197,-2,334,688
334,288,10,-63,-178,-92,111,531,941
50,32,-80,-155,-132,-163,-28,167,-309
23,108,-48,-75,-110,-49,19,106,-26
2,10,-30,-17,-66,-129,-38,95,-173
10,24,-42,-93,-65,-136,-36,108,-230
95,154,-26,-80,-24,-112,26,220,253
61,154,-85,-17,-14,22,86,165,372
7,54,-59,-64,-89,-69,1,115,-104
78,167,11,37,-23,-12,33,161,452
362,436,143,80,-66,-118,122,580,1539
180,144,-13,-24,-9,-51,128,187,542
-25,66,-159,-111,-139,-250,-86,206,-498
146,231,-168,-149,-225,-315,17,331,-132
-28,60,-109,-59,6,-35,89,190,114
173,835,175,316,-753,-149,-156,1254,1695
109,147,23,-5,-44,-47,53,146,382
15,139,28,-22,-89,-120,9,153,113
1,85,-39,-92,-51,-92,7,180,-1
43,44,-67,-42,-141,-95,15,163,-80
27,68,-39,-17,-99,-118,-19,82,-115
1122,1784,-334,-365,-171,-240,610,1645,4051
-15,30,-98,-52,-123,-109,2,73,-292
16,20,-84,-81,-137,-152,-28,138,-308
119,136,45,-89,16,-99,24,165,317
44,58,-29,-33,-88,-86,-25,144,-15
-29,-5,-27,-20,-37,-52,-27,42,-155
364,512,7,-33,31,-82,199,614,1612
0,2,-13,-8,-21,-4,-1,22,-23
57,171,2,-70,-2,-86,0,191,263
13,20,-71,-15,-148,-231,-39,134,-337
112,205,-28,-33,-72,-92,69,202,363
19,16,-32,-61,-66,-144,-68,94,-242
238,346,-37,-83,-192,-464,-45,541,304
122,139,-118,-56,-138,-104,69,197,111
105,175,-126,-143,-140,-148,86,222,31
34,40,-14,-7,-137,-138,-42,158,-106
176,367,-77,4,-289,-176,125,552,682
111,169,-14,-42,-92,-158,35,276,285
-9,-3,-27,-28,-20,-32,-15,37,-97
6,16,-1,-7,-4,-10,3,8,11
9,48,13,3,-9,9,21,56,150
-8,53,41,62,-63,22,26,77,210
5,42,-7,-11,-17,13,-14,74,85
87,118,-16,-38,-67,-22,66,172,300
-3,5,2,-4,-1,-5,-3,7,-2
-4,2,-2,-4,-4,-6,-3,7,-14
17,9,-14,-10,-36,-95,11,35,-83
4,22,-46,-9,-65,-94,-5,46,-147
7,38,6,-7,-16,-24,-2,26,28
