protein-water,protein-carbon,hydrogen bond (long-range),pi-pi (long-range),disorder (long),K-Beta similarity,disorder (short),electrostatic (short-range),8-feature sum
23,78,3,7,-72,-4,24,134,193
-4,-16,-41,-41,-58,-47,0,29,-178
15,25,-44,-1,-91,-124,-25,38,-207
0,19,-15,-8,-52,-45,-12,33,-80
-15,4,-30,-27,-41,-58,-38,23,-182
21,-16,-22,-52,-75,-50,2,47,-145
7,17,-68,-17,-102,-43,-5,89,-122
9,-1,-16,-31,-78,-57,-5,54,-125
19,29,-10,12,-66,-14,1,55,26
0,-6,-15,-27,-48,-44,-31,15,-156
20,5,-13,-9,-14,-40,-7,0,-58
-5,21,-27,-19,-46,-25,-9,37,-73
2,2,-23,-19,-23,-57,-39,31,-126
19,0,-17,-36,-60,-41,-12,65,-82
4,-2,-19,-15,-44,-39,-2,33,-84
23,-4,-28,-45,-75,-84,-13,55,-171
9,-15,-16,-29,-58,-78,-6,32,-161
19,5,-2,-11,-28,-48,-31,51,-45
-14,37,-64,-30,-73,-71,2,27,-186
6,7,-11,-28,-24,-34,-10,36,-58
13,-12,-69,-57,-129,-56,-3,65,-248
2,-6,-52,-69,-97,-102,-14,73,-265
12,-1,-29,-26,-81,-96,-21,25,-217
22,19,-48,-42,-78,-39,-1,81,-86
26,4,-27,-4,-51,-49,9,21,-71
17,10,-42,-58,-105,-106,-1,84,-201
35,-6,-22,-3,-35,-64,-9,36,-68
14,39,-19,-41,-62,-86,-27,60,-122
13,-9,-60,-21,-92,-82,-9,42,-218
4,1,-34,5,-57,-84,-3,57,-111
17,16,-32,-9,-57,-37,-11,42,-71
5,22,-45,-43,-27,-83,-23,55,-139
0,5,-78,-65,-66,-61,-25,43,-247
12,-18,-40,-21,-61,-50,15,20,-143
10,-2,-23,-1,-36,-35,-9,22,-74
7,12,-24,2,-70,-26,7,66,-26
14,44,-38,-30,-81,-74,-9,85,-89
30,11,-41,-23,-85,-77,-7,39,-153
27,10,-26,-15,-48,-78,-12,54,-88
4,-7,-17,-12,-57,-79,-31,38,-161
-1,21,-11,-8,-41,-5,-12,51,-6
43,0,-58,-40,-158,-141,9,54,-291
19,-3,-20,-19,-31,-40,1,22,-71
9,9,-26,-33,-35,-57,-8,48,-93
10,-7,-51,-9,-80,-86,-23,42,-204
19,31,-6,-20,-53,-82,-12,60,-63
31,8,-35,-34,-107,-80,7,63,-147
26,-6,-57,-33,-120,-88,-37,95,-220
26,3,-33,-13,-39,-35,18,25,-48
23,7,-55,-4,-89,-86,-6,47,-163
14,15,-14,-16,-18,-34,11,44,2
21,7,-47,-38,-99,-133,-18,66,-241
22,4,-42,0,-66,-74,2,33,-121
74,-20,-75,-20,-162,-129,1,53,-278
-3,29,-56,-37,-100,-81,-23,90,-181
12,-5,-48,-8,-97,-67,-2,57,-158
-6,15,-86,-26,-167,-9,33,113,-133
11,9,-21,-18,-30,-9,-3,30,-31
36,7,-49,-61,-96,-132,-2,62,-235
-23,10,-47,-52,-107,-45,-4,85,-183
-11,-14,-13,-7,-56,-60,-18,45,-134
7,8,-51,-21,-110,-41,2,71,-135
-12,25,-75,-61,-119,-67,-4,60,-253
-7,-25,-32,-22,-38,-23,-20,28,-139
6,-21,-58,15,-168,-61,-19,114,-192
36,12,-71,-31,-163,-128,-27,75,-297
11,59,-127,-142,-155,-235,-43,162,-470
26,-10,-57,-32,-57,-53,4,31,-148
-3,7,-25,-33,-34,-20,-4,9,-103
17,16,-89,-40,-137,-72,-10,85,-230
29,-13,20,-10,-67,-77,-52,49,-121
26,-2,-50,-34,-87,-70,-16,59,-174
0,28,-79,-42,-141,-56,-1,105,-186
14,19,-13,-25,-44,-60,-1,53,-57
76,22,-66,-13,-170,-113,31,107,-126
-4,-1,-32,-37,-71,-60,-22,64,-163
20,3,-10,-16,-48,-92,-9,38,-114
50,49,28,48,-83,-40,-51,105,106
14,8,-20,-16,-49,-93,-21,50,-127
12,10,-10,11,-6,-11,-9,24,21
35,8,-42,-31,-93,-76,-20,94,-125
15,-7,-26,-30,-63,-42,-19,28,-144
42,4,-10,-11,-69,-109,-2,102,-53
-3,0,-36,-13,-51,-23,0,26,-100
-4,-3,-42,-32,-64,-42,-19,7,-199
7,-25,-58,-15,-132,-71,-14,59,-249
8,9,-31,-27,-40,-42,-3,36,-90
-24,-29,-46,-34,-114,-109,-26,57,-325
16,13,-27,-26,-60,-35,10,58,-51
2,-16,-45,-13,-113,-82,17,62,-188
-1,22,-37,-8,-58,-46,1,43,-84
1,3,-42,-17,-34,-48,-16,17,-136
14,3,-37,-32,-57,-17,6,41,-79
15,-8,-48,-4,-82,-65,-29,42,-179
-13,22,-68,-7,-125,-97,-22,63,-247
12,5,-13,-22,-29,-42,4,14,-71
-3,31,6,-14,-10,-15,-10,30,15
36,36,-23,-37,-14,-68,-1,118,47
-5,-18,-75,-54,-122,-53,7,33,-287
42,21,-77,-25,-122,-21,10,70,-102
42,-7,-24,-25,-84,-66,4,57,-103
-5,8,-23,-5,-26,-49,-10,34,-76
15,9,-33,-5,-56,-29,-6,7,-98
20,24,-7,-38,-60,-72,-1,113,-21
9,-11,-13,-44,-37,-76,-17,51,-138
-3,-1,-27,-20,-30,-24,-2,28,-79
-11,7,-46,-41,-59,-12,-7,32,-137
20,11,-7,-6,-10,-25,3,31,17
-1,-11,-47,-32,-57,-81,-37,10,-256
7,25,-31,-32,-42,-37,-14,56,-68
11,1,-59,-5,-76,-55,-24,40,-167
10,8,-33,-16,-49,-56,-10,48,-98
-13,7,-61,-8,-127,-46,-33,66,-215
21,18,-29,-7,-51,-18,6,65,5
31,32,-40,-12,-140,-70,1,82,-116
103,32,-17,20,-176,-89,-25,171,19
19,40,-23,-25,-27,-35,37,57,43
12,18,-12,-22,-6,-25,5,40,10
20,3,-25,-22,-87,-84,-10,92,-113
1,7,-8,-45,-14,-56,-25,33,-107
-3,-3,-59,-24,-110,-22,-6,50,-177
36,51,-19,-8,-55,-57,13,97,58
-18,6,-16,-19,-68,-38,-35,35,-153
13,10,-24,-19,-25,-38,-10,48,-45
28,12,-27,-1,-86,-110,-58,55,-187
2,10,12,3,-54,-19,-9,51,-4
9,21,-49,-47,-39,-35,14,49,-77
6,22,-78,-25,-196,-91,-14,93,-283
18,-14,-21,-11,-47,-67,8,22,-112
24,14,-5,-4,-41,-45,13,45,1
2,4,-30,-25,-72,-2,16,49,-58
10,-14,-26,-27,-16,-35,-8,24,-92
16,-2,1,17,-40,-30,-23,46,-15
26,69,-63,-88,-135,-87,17,147,-114
-7,-2,-32,-38,-66,-56,-7,36,-172
34,-2,-18,28,-47,-40,-13,38,-20
0,37,-43,-70,-94,-59,-8,74,-163
-11,24,-45,-35,-62,-94,-28,54,-197
14,2,-25,-15,-60,-46,11,28,-91
17,-4,-17,-37,-23,-50,-6,52,-68
-7,12,-9,-30,-74,-38,-11,67,-90
19,14,-7,55,-87,-6,7,63,58
21,5,-20,13,-60,-46,-5,28,-64
44,45,3,80,-138,-21,-26,122,109
16,18,-15,-3,-42,-55,-17,34,-64
10,32,-100,-98,-65,-173,-17,61,-350
13,5,-73,-56,-106,-72,8,43,-238
42,55,-55,-44,-120,-88,7,93,-110
16,14,-34,-12,-24,-13,18,27,-8
6,12,-5,-16,-20,-44,4,30,-33
37,3,-56,-14,-122,-67,12,64,-143
-2,62,-140,-79,-251,-164,22,180,-372
0,-26,-64,-38,-149,-48,-3,32,-296
16,10,-14,-8,-60,-30,-3,48,-41
10,17,-53,-30,-117,-42,-10,75,-150
2,11,-21,-30,-42,-35,-9,33,-91
15,-17,-26,-25,-36,-49,-5,3,-140
47,-35,-29,45,-82,-99,-31,83,-101
20,12,-35,-13,-74,-43,24,66,-43
-13,27,-38,-52,-104,-75,-21,65,-211
11,23,-5,10,-57,-26,3,37,-4
15,1,-25,-13,-62,-38,8,23,-91
18,18,-54,-33,-29,-85,-8,39,-134
9,11,-19,-14,-39,-32,18,27,-39
7,17,-8,-17,-21,-18,4,37,1
9,14,-25,-26,-79,-33,-18,92,-66
-9,-2,-22,-13,-58,-27,-11,16,-126
13,-20,-74,-16,-139,-57,0,56,-237
38,-19,-42,-8,-103,-80,-3,50,-167
22,-7,-24,-24,-34,-29,8,16,-72
17,-6,-58,-42,-99,-66,-32,81,-205
10,8,-32,-27,-74,-77,-14,56,-150
-13,1,-62,-27,-114,-68,0,34,-249
-12,2,-52,-23,-46,-27,0,27,-131
16,35,-22,-1,-55,-32,3,33,-23
11,48,-42,-40,-59,-20,39,69,6
1,39,-42,-37,-62,-38,-6,16,-129
13,17,-15,-16,-34,-48,-16,33,-66
1,8,-46,-60,-24,-89,-10,63,-157
12,14,-17,-10,-32,-59,-11,20,-83
43,-17,-23,-30,-137,-165,-77,203,-203
-10,-13,-44,-35,-51,-79,-32,37,-227
52,58,-77,-76,-150,-130,3,86,-234
-4,15,-68,-34,-125,-79,3,69,-223
24,36,-24,-22,-87,-63,4,56,-76
32,29,-22,-1,-38,-54,8,29,-17
7,14,-20,-16,-39,-29,-7,41,-49
25,17,-54,-17,-74,-43,-11,66,-91
-1,10,-24,-53,-54,-78,-56,52,-204
16,26,-12,-34,-63,-71,-7,55,-90
16,15,-20,6,-34,-48,-3,41,-27
-6,-15,-31,-35,-37,-76,-9,36,-173
5,42,-103,-101,-109,-115,18,60,-303
11,16,-12,-34,-13,-28,-1,47,-14
10,23,-13,-10,-26,-54,-10,12,-68
22,11,-23,-17,-12,-71,-24,31,-83
-6,-6,-29,-24,-88,-56,1,58,-150
22,6,-35,-52,-37,-121,-38,64,-191
34,42,-17,16,-23,-52,24,51,75
-4,25,-51,-18,-52,-65,-3,47,-121
16,-49,-42,-96,-39,-153,-45,48,-360
-11,24,-39,-31,-49,-67,-15,43,-145
-14,18,-34,-8,-69,-22,-7,69,-67
15,-2,-26,3,-25,-23,5,17,-36
14,-9,-63,-14,-113,-90,4,50,-221
-3,17,-12,-23,-20,-6,2,27,-18
21,4,-50,-56,-69,-121,5,57,-209
17,4,-16,-14,-35,-59,-10,58,-55
-21,37,-53,-32,-60,-87,-1,74,-143
7,19,-46,-33,-45,-49,-1,33,-115
36,14,-39,-25,-84,-64,24,77,-61
6,-7,-16,-33,-49,-36,2,36,-97
1,13,-31,11,-91,-21,3,59,-56
13,10,-24,-19,-60,-47,-2,41,-88
-79,-77,-53,-10,-173,-203,-117,156,-556
-50,-94,-71,6,-151,-247,-116,155,-568
30,-6,-61,-4,-63,-46,17,55,-78
-7,7,-26,-24,-47,-36,-16,41,-108
15,11,-31,-28,-55,-57,-13,25,-133
25,11,-17,-15,-67,-77,-27,40,-127
15,-2,-24,-16,-37,-21,0,37,-48
13,-7,-46,-31,-125,-102,-18,47,-269
17,-6,-17,10,-38,-29,3,21,-39
2,-8,-6,-12,-38,-50,-15,85,-42
31,19,-59,-14,-111,-105,8,45,-186
9,13,-70,-4,-103,-126,-15,82,-214
26,-20,-31,-39,-53,-115,-45,55,-222
42,17,-43,-13,-157,-91,39,156,-50
18,12,7,-17,-17,-46,-9,61,9
16,-2,-26,8,-51,-40,-15,40,-70
20,12,-48,-31,-56,-114,-13,107,-123
-5,9,-28,-25,-33,-26,9,13,-86
0,-4,-15,2,-35,-50,-20,42,-80
30,29,-30,-10,-13,-41,16,34,15
-3,27,-1,-30,-41,6,14,40,12
-8,13,-22,-47,-40,-38,-4,37,-109
-3,22,-23,-24,-49,-52,-1,57,-73
-6,33,-69,-89,-91,-58,-1,64,-217
73,4,-31,64,-160,-117,-65,122,-110
7,-11,-39,-50,-53,-52,-13,19,-192
23,-23,-44,-57,-108,-78,-31,63,-255
9,-10,-38,-13,-45,-48,-9,25,-129
13,36,14,2,-14,9,-3,22,79
9,30,-9,-19,-6,-30,2,54,31
-12,7,-35,-25,-60,-57,-12,36,-158
25,12,-76,-53,-51,-75,-11,62,-167
7,40,10,5,-25,-27,-4,54,60
14,22,-15,-16,-31,-26,13,59,20
12,-15,-60,-28,-107,-57,8,37,-210
-39,-36,-62,-42,-54,-52,-12,30,-267
11,20,-44,-20,-64,-51,-10,70,-88
-5,1,1,-43,-55,9,13,50,-29
80,-45,-21,39,-115,-138,-48,64,-184
1,35,-22,-13,-33,-52,-22,32,-74
22,-6,-19,-14,-28,-42,-1,29,-59
30,23,-40,-31,-64,-76,-5,33,-130
54,85,-42,-22,-52,-126,-5,77,-31
15,84,-41,-64,-73,-163,5,59,-178
-15,-17,-49,-45,-65,-28,-2,46,-175
6,2,-17,-18,-50,-42,-9,46,-82
33,18,-44,2,-107,-76,-2,43,-133
7,23,-45,-25,-63,-34,-4,13,-128
-6,0,-47,-27,-44,-62,-5,76,-115
4,57,-29,-13,-57,-63,-9,76,-34
-4,2,7,13,-10,1,-9,48,48
30,-44,-68,-3,-147,-89,-20,43,-298
86,-14,-102,-26,-189,-142,-52,79,-360
5,10,-32,-5,-46,-34,2,38,-62
12,5,-17,-16,-43,-22,6,25,-50
20,6,-8,-22,-28,-41,-19,38,-54
66,34,-83,-45,-122,-235,-50,135,-300
35,41,-38,-39,-110,-54,5,104,-56
1,10,-14,-35,-42,-33,9,31,-73
11,13,-29,-28,-14,-79,-3,36,-93
27,8,-43,32,-103,-13,9,45,-38
24,21,-31,-31,-31,-87,-13,88,-60
6,0,-23,-20,-38,-1,17,19,-40
3,9,-19,-17,-89,-30,-27,56,-114
-3,-4,-43,-15,-95,-62,-4,46,-180
6,-4,-3,-13,-53,-35,-20,22,-100
10,22,-16,-11,-15,-23,4,32,3
3,-12,-71,3,-118,-53,-1,51,-198
21,14,-88,-45,-129,-97,0,15,-309
3,9,-33,-18,-35,-33,-1,27,-81
17,4,-58,-39,-67,-86,7,38,-184
3,2,-36,3,-92,-63,-14,60,-137
-24,16,-59,-42,-69,-74,-23,25,-250
17,35,-46,-30,-112,-107,-39,77,-205
16,10,-13,-37,-29,-77,-33,40,-123
47,71,-42,-24,-137,-64,-7,183,27
21,-33,-32,-27,-56,-117,-17,29,-232
42,35,-66,1,-122,-96,11,83,-112
12,11,-23,-24,-74,-53,-11,54,-108
11,-10,-45,-58,-91,-113,-16,60,-262
16,19,-31,-4,-36,-36,7,49,-16
32,40,-129,-86,-201,-150,10,137,-347
22,61,-14,-35,-39,-76,-2,88,5
54,-3,-19,3,-130,-84,3,75,-101
47,-24,-78,-41,-190,-133,32,117,-270
9,-8,-60,-20,-102,-67,-12,22,-238
58,31,-26,-44,-93,-18,-6,111,13
4,92,12,-27,-55,-80,-20,121,47
-2,63,-6,-33,-4,-109,-12,52,-51
22,-19,-85,-50,-147,-87,-9,52,-323
17,14,-48,-42,-105,-70,8,60,-166
-23,23,-92,-98,-98,-95,-12,51,-344
59,22,-64,25,-95,-62,21,67,-27
4,5,-38,-28,-64,-35,0,41,-115
-5,0,-21,-38,-53,-35,-9,37,-124
12,14,-36,-27,-39,-50,-6,28,-104
27,39,-71,-18,-202,-55,26,184,-70
21,11,-35,2,-47,-40,-9,52,-45
20,36,-19,-17,-9,-40,13,55,39
15,-5,-25,-29,-58,-37,-2,35,-106
0,-8,-31,-14,-35,-39,-21,7,-141
9,39,-24,-19,-24,-13,12,40,20
26,20,-61,-33,-130,-63,14,63,-164
15,12,-11,-4,-20,-15,1,41,19
-7,9,-38,-40,-60,-52,-7,30,-165
-1,-22,-85,-43,-123,-62,-25,33,-328
16,19,-21,-40,-56,-138,-9,84,-145
36,21,-11,-17,-115,-57,15,53,-75
-23,41,-66,-40,-80,-85,-26,50,-229
5,-21,-29,-24,-102,-78,-21,44,-226
32,3,-57,-7,-142,-65,18,75,-143
25,-1,-70,-66,-136,-148,-40,79,-357
14,15,-46,-7,-40,-49,-4,40,-77
0,2,-27,-16,-38,-35,-13,41,-86
-2,24,-33,-21,-13,-41,-11,31,-66
16,2,-49,14,-86,-62,14,50,-101
26,34,-32,-18,-31,-72,1,53,-39
38,-5,-51,-12,-95,-38,11,50,-102
30,27,-27,-20,-78,-80,5,39,-104
31,30,-7,-10,-36,-68,11,45,-4
19,51,-27,9,-72,-90,-17,47,-80
57,-9,-44,1,-67,-96,29,31,-98
5,-8,-92,-32,-221,-138,-3,114,-375
2,27,-2,-9,-16,-40,1,59,22
44,1,3,-12,-27,-26,-7,50,26
20,18,-40,-6,-129,-64,10,91,-100
14,20,-53,-28,-49,-50,20,44,-82
4,9,-18,35,-111,0,35,96,50
14,27,8,3,-33,-6,13,56,82
6,-4,-5,-11,-13,-29,-1,24,-33
11,8,-15,-24,-57,-41,7,36,-75
-4,16,1,-4,-42,-13,1,73,28
-2,-30,-63,-12,-90,-45,-7,38,-211
10,4,-58,-12,-102,-56,-3,39,-178
27,25,-55,-44,-84,-30,-3,75,-89
-1,16,-25,-20,-33,-10,11,38,-24
21,1,-20,0,-71,-85,-14,46,-122
-5,-22,-34,-31,-81,-26,9,42,-148
0,-8,-49,15,-115,-45,13,42,-147
34,51,-28,-20,-40,-95,-36,43,-91
51,1,-81,-23,-208,-129,-5,117,-277
16,18,-33,-19,-88,-73,6,49,-124
-6,10,-33,-32,-73,-33,-1,37,-131
54,18,-45,-50,-109,-144,-36,116,-196
3,1,-26,-29,-79,-117,-6,67,-186
-17,-9,-27,-31,-50,-34,-17,38,-147
3,31,-22,-16,-23,-43,6,54,-10
-7,19,-14,-19,-37,11,-7,23,-31
3,7,-32,-23,-71,-70,-8,64,-130
18,11,-28,-24,-37,-38,-1,54,-45
31,26,-52,-40,-91,-85,1,26,-184
68,25,-42,-93,-142,-222,-64,218,-252
-22,-1,-41,-34,-90,-40,-17,41,-204
23,31,-52,-41,-150,-98,-14,69,-232
23,20,-35,-14,-39,-42,-12,26,-73
51,28,-81,-95,-123,-94,11,107,-196
53,3,-69,14,-167,-106,1,117,-154
-80,-42,-59,-52,-73,-163,-104,52,-521
-3,30,-9,50,-95,-8,-5,89,49
8,28,-53,-61,-200,-134,-16,148,-280
30,8,-2,-35,-11,-53,-2,44,-21
4,21,-21,-41,-26,-21,9,35,-40
-82,-51,-71,-5,-108,-128,-63,63,-445
35,10,9,1,-76,-29,-4,101,47
32,24,-15,-17,-51,-39,-10,56,-20
53,26,-54,-15,-114,-120,6,72,-146
5,18,-7,-13,-26,-44,-10,36,-41
11,37,-59,-5,-81,-38,21,67,-47
5,18,-17,-13,-18,-15,-3,29,-14
-11,-32,-45,-23,-30,-62,-20,29,-194
42,21,-12,-3,-46,-45,-22,68,3
-2,-9,-45,-31,-41,-44,-5,21,-156
0,3,-32,-36,-31,-38,3,21,-110
32,-3,-37,-24,-98,-97,-30,39,-218
16,26,-29,-9,-57,18,22,59,46
-12,-19,-74,-34,-141,-125,-13,94,-324
17,5,-35,-5,-50,-62,5,23,-102
14,-8,-37,-6,-61,-43,13,16,-112
15,5,-45,-22,-82,-47,-10,72,-114
23,8,-23,-2,-35,-22,-4,31,-24
66,26,-68,20,-165,-21,-9,120,-31
4,14,-6,-5,-24,3,-1,41,26
-8,-3,-48,-3,-114,-57,-16,67,-182
6,-4,-38,-22,-95,-66,7,43,-169
25,-15,-62,-6,-91,-96,-8,20,-233
12,-1,-42,8,-82,-84,-17,47,-159
22,-2,-35,-41,-58,-56,5,35,-130
15,38,-20,-37,-35,-3,13,56,27
49,67,-71,-32,-89,-69,-21,88,-78
-1,-5,-31,-17,-18,-32,-7,12,-99
17,7,-21,-3,-63,-19,-11,62,-31
36,-2,-52,11,-126,-49,11,43,-128
-10,0,-45,-41,-56,-45,0,38,-159
53,47,-38,-20,-108,-148,-37,56,-195
23,48,-37,-17,-67,-14,18,92,46
5,-12,-57,-7,-109,-78,-5,56,-207
-7,8,-45,-37,-61,-71,-4,44,-173
0,18,-4,4,-39,-17,12,35,9
11,8,-37,-35,-35,-42,-6,24,-112
63,32,-26,23,-64,-51,10,33,20
-8,21,-13,-17,-34,3,12,48,12
43,-5,-67,-27,-211,-135,-41,151,-292
-21,-3,-39,-25,-46,-44,-22,17,-183
42,45,-68,-8,-138,-162,-26,59,-256
22,15,-67,-51,-109,-71,-11,87,-185
77,-14,-86,-31,-224,-189,18,77,-372
14,18,-10,-18,-36,-21,7,31,-15
9,-24,-56,-31,-84,-73,15,25,-219
16,47,-42,-9,-72,-47,-7,44,-70
5,7,-28,-35,-44,-65,-18,19,-159
-2,40,-37,-23,-35,17,29,48,37
28,-11,-62,-7,-143,-94,-19,38,-270
18,0,-20,-8,-153,-46,-2,97,-114
73,31,8,72,-110,4,-14,155,219
-5,-20,-34,-7,-75,-26,-14,23,-158
5,19,-25,-20,-25,-48,-7,23,-78
0,7,-14,-21,-42,-55,-26,47,-104
10,-5,-36,3,-87,-40,-32,28,-159
-39,-52,-29,9,-69,-103,-51,45,-289
19,13,-30,1,-39,-35,-8,41,-38
12,15,-13,-15,-21,-25,10,43,6
8,-12,-29,-10,-106,-59,-1,71,-138
-6,22,-25,-8,-20,-12,7,23,-19
12,4,-177,-143,-208,-214,-37,104,-659
19,6,-17,-24,-20,-47,-8,20,-71
41,4,-45,-18,-99,-96,-4,41,-176
16,-20,-26,-2,-51,-49,-9,33,-108
31,14,-23,4,-56,-19,-9,36,-22
14,-2,-19,-12,-61,-43,-14,44,-93
21,13,-32,-50,-86,-91,-37,90,-172
16,11,-20,-1,-25,-86,-15,25,-95
9,-11,-49,-34,-92,-64,-33,46,-228
39,17,-58,1,-120,-113,-13,97,-150
4,5,-18,-21,-43,-43,-1,36,-81
28,78,-42,-24,-75,-95,0,150,20
6,2,-62,-13,-134,-100,-16,64,-253
2,16,-25,-19,-37,-39,-2,55,-49
13,4,-31,3,-81,-82,-15,53,-136
1,15,-27,-14,-55,-31,-8,39,-80
-25,17,-10,-30,-43,-12,-15,61,-57
13,25,-36,-25,-116,-87,-9,70,-165
9,7,-11,-33,-16,-35,1,6,-72
21,29,-89,-59,-169,-78,-2,103,-244
0,-15,-39,-29,-46,-58,-15,26,-176
56,53,-43,-9,-92,-103,-1,80,-59
71,11,-7,-11,-95,-96,-30,113,-44
-1,21,-84,-40,-207,-121,12,106,-314
12,16,-37,-22,-64,-79,-29,27,-176
10,10,-66,-15,-90,-106,-23,49,-231
41,19,-29,-39,-83,-92,-28,73,-138
1,-3,-74,-45,-72,-72,-23,68,-220
-7,-3,-36,-22,-57,-84,-21,24,-206
-10,3,-22,-31,-28,-36,-12,0,-136
16,12,-118,-70,-277,-148,-15,160,-440
10,2,-31,-13,-42,-18,2,15,-75
28,-23,-59,-25,-102,-62,-1,46,-198
8,22,-12,-16,-13,-36,-15,25,-37
19,7,-14,15,-80,-13,-19,60,-25
-10,2,-18,-26,-47,-63,-11,68,-105
12,4,-1,-10,-46,-54,-10,42,-63
50,92,5,-22,-13,-45,42,104,213
-5,24,-27,-29,-53,-58,-20,34,-134
114,38,-28,55,-228,-123,-80,274,22
13,6,-28,-33,-59,-100,-25,69,-157
18,-4,0,-3,-35,-39,-1,31,-33
0,-2,-29,-34,-60,-77,-25,38,-189
-4,15,-38,-22,-31,-31,-8,23,-96
1,-4,-34,-36,-78,-56,-10,40,-177
50,7,-48,-21,-150,-100,25,66,-171
10,44,-28,-7,-111,-33,2,78,-45
8,-1,-28,-33,-35,-39,-6,27,-107
5,0,-33,-21,-40,-48,0,4,-133
8,-1,-32,-12,-34,-72,-20,45,-118
11,8,-33,-22,-31,-36,-14,42,-75
10,11,-23,-24,-25,-33,-8,11,-81
-8,-5,-40,-52,-66,-50,-25,44,-202
22,-19,-54,-13,-121,-133,4,63,-251
10,36,1,-20,-25,-55,4,44,-5
20,14,10,-5,-52,-70,-14,63,-34
22,5,-6,-7,-44,-38,0,32,-36
8,21,-23,-13,-45,-68,-16,25,-111
-7,3,-6,-30,-27,-26,-8,31,-70
34,27,-27,-2,-72,-59,-3,66,-36
6,5,-10,-28,-8,-40,3,35,-37
1,22,-25,-15,-39,-44,-13,58,-55
32,-18,-56,-34,-135,-79,-21,52,-259
21,30,-62,-1,-111,-62,6,68,-111
20,8,-14,-17,-41,-41,8,37,-40
2,-33,-82,-43,-110,-75,-29,37,-333
12,39,-15,-27,-29,-102,-17,70,-69
46,24,-76,-40,-164,-182,-10,120,-282
51,5,-27,37,-98,-50,-9,78,-13
8,15,-43,-5,-82,-70,3,35,-139
11,9,-48,0,-83,-87,2,50,-146
98,-22,-42,-25,-99,-146,-34,93,-177
-6,-13,-73,-12,-134,-115,-11,24,-340
39,39,-42,-48,-92,-112,-24,43,-197
12,-10,-45,-34,-112,-109,-28,100,-226
0,3,-30,-40,-47,-33,4,5,-138
14,40,-44,4,-92,-112,-28,55,-163
-4,-9,-45,-68,-56,-93,-3,26,-252
-1,13,-31,-10,-55,-44,14,19,-95
12,46,-48,-14,-87,-76,-7,36,-138
2,-4,-14,-20,-79,-76,-11,53,-149
-5,-19,-92,-20,-135,-74,20,60,-265
6,-3,-24,-31,-51,-31,-9,23,-120
23,19,-52,-10,-145,-92,15,47,-195
36,25,-67,11,-205,-147,-33,143,-237
21,-4,-28,0,-27,-70,-1,45,-64
41,14,-38,-25,-55,-110,-12,50,-135
46,-8,-34,44,-102,-71,-11,62,-74
47,8,-30,-4,-55,-61,-14,44,-65
65,-16,-5,1,-64,-65,-5,69,-20
21,19,-11,-22,-34,-2,16,41,28
9,11,-12,-17,-29,-42,-3,48,-35
84,15,7,-29,25,-69,-18,71,86
27,32,-20,56,-98,-36,-1,71,31
11,28,-62,-44,-126,-132,20,72,-233
17,17,-35,-29,-115,-140,-41,75,-251
2,21,-36,-22,-58,-90,-42,30,-195
-9,5,-34,-33,-26,-25,-8,27,-103
26,4,-46,-3,-103,-93,-10,46,-179
-14,0,-27,-30,-43,-29,-13,16,-140
11,-23,-34,-5,-81,-41,-20,41,-152
-5,-15,-31,-24,-52,-58,-30,4,-211
56,52,-50,1,-41,-95,-4,59,-22
10,24,-13,-28,-49,-38,-3,37,-60
38,33,-51,-21,-96,-121,-7,32,-193
26,-1,-13,-10,-34,-4,2,40,6
17,22,-57,-21,-127,-131,8,85,-204
23,29,-7,-8,-37,-28,-2,44,14
43,-14,-16,-43,-57,-55,-36,100,-78
11,44,-35,-6,-56,-82,-11,45,-90
-6,22,-26,-27,-34,-26,5,39,-53
0,38,-66,-91,-117,-86,6,84,-232
24,14,-13,-19,-41,-36,9,40,-22
-11,0,-37,-43,-46,-48,-8,24,-169
19,22,-20,-46,-40,-65,-27,66,-91
-13,24,-18,-14,-25,-10,1,44,-11
13,6,-15,5,-51,-42,-11,28,-67
-9,-9,-43,-32,-83,-56,-20,46,-206
3,7,-27,-24,-49,-44,-20,43,-111
-12,36,-69,-45,-77,-46,-11,89,-135
-2,5,-29,-8,-32,-39,-4,29,-80
20,1,-40,-23,-89,-79,0,39,-171
-8,33,-37,-27,-58,-44,-24,51,-114
17,24,-41,13,-80,-86,-13,41,-125
-2,18,-20,-14,-48,-27,-4,46,-51
11,7,-39,-15,-26,-53,-2,40,-77
-16,-9,-19,-59,-6,-72,-25,57,-149
-7,33,-49,-51,-72,-73,0,61,-158
29,23,-52,-67,-100,-108,-15,137,-153
17,-2,-57,-27,-38,-64,-3,45,-129
-14,14,-53,-16,-76,-65,6,35,-169
-9,33,-46,-51,-77,-85,-11,57,-189
44,17,-47,-10,-61,-93,2,58,-90
4,9,-22,-31,-14,-23,-9,21,-65
-8,1,-50,-62,-56,-18,8,55,-130
-9,-10,-25,-44,1,-61,1,34,-113
21,21,-10,-39,-10,-28,-9,43,-11
-2,-3,-68,-33,-66,-54,-7,15,-218
5,9,-25,10,-51,-22,3,50,-21
64,69,16,-25,-10,27,28,102,271
15,26,-8,-27,-32,-25,18,38,5
12,9,-26,-27,-35,-17,-2,22,-64
42,25,-2,-4,-42,-11,15,16,39
121,73,-105,-28,-123,-110,-3,103,-72
58,12,-62,47,-129,-78,17,63,-72
12,19,-31,-36,-44,-47,-21,49,-99
-6,11,-10,-20,-32,-24,0,49,-32
72,-27,40,11,-77,-78,-17,117,41
55,-2,-74,7,-185,-154,-28,108,-273
15,26,-61,-73,-142,-127,6,47,-309
1,22,-34,-7,-33,-39,-22,26,-86
8,22,-56,-23,-90,-86,-16,42,-199
3,2,-26,-24,-33,-25,0,33,-70
20,44,-8,-40,-40,-105,-22,62,-89
13,16,-75,-37,-73,-116,-28,50,-250
1,39,-45,-41,-78,-36,15,84,-61
68,8,-9,12,-84,-83,-47,70,-65
0,2,-54,-18,-95,-34,-7,75,-131
4,-6,-14,-3,-20,-21,-14,61,-13
8,35,1,-16,-22,-48,-14,50,-6
9,7,-48,-8,-76,-51,3,28,-136
8,-18,-53,-39,-81,-117,-24,74,-250
63,35,-101,-65,-224,-221,-38,96,-455
-12,20,-16,-63,-52,-55,-38,67,-149
36,24,-32,-5,-14,-31,21,9,8
22,8,-49,-10,-50,-65,3,14,-127
15,2,-35,-27,-55,-38,5,48,-85
31,22,-58,-15,-62,-91,-21,51,-143
33,-10,-33,9,-63,-64,-2,43,-87
-12,14,-15,6,-45,-48,-10,53,-57
-20,-37,-169,-155,-177,-151,-17,55,-671
22,14,-40,-23,-36,-67,-14,40,-104
-1,5,-13,-27,-65,-81,-15,47,-150
7,-12,-67,-39,-132,-58,-15,51,-265
-9,34,-33,-24,-49,-40,-17,51,-87
11,-11,-40,-24,-64,-61,-30,42,-177
20,-12,-51,-57,-97,-83,-31,86,-225
-3,19,-35,-60,-109,-78,2,78,-186
24,7,-30,-13,-45,-28,23,43,-19
-4,25,-39,-49,-58,-87,-1,88,-125
1,-2,-34,-5,-41,-86,-27,9,-185
-1,16,-36,-16,-29,-8,-8,23,-59
17,-9,-75,-37,-101,-134,-14,31,-322
-17,-4,-41,-30,-40,-37,-10,43,-136
18,19,-57,0,-92,-150,4,58,-200
22,49,-52,-15,-60,-132,-6,52,-142
8,5,-11,-17,-26,-31,-7,19,-60
1,13,-47,3,-113,-98,-22,42,-221
-31,5,-94,-60,-156,-66,-37,60,-379
9,-3,-18,-4,-50,-44,5,38,-67
16,25,-33,-30,-55,-65,3,85,-54
25,-12,-37,-3,-53,-52,-19,29,-122
3,27,-36,-26,-28,-56,0,43,-73
52,86,-94,-65,-125,-155,20,120,-161
-1,34,-29,-11,-26,-42,24,74,23
12,26,-25,-17,-19,-12,21,68,54
23,-4,-42,-29,-65,-122,-19,51,-207
9,11,-14,-11,-36,-57,-17,11,-104
21,20,-57,-30,-149,-99,-2,66,-230
9,12,-8,4,-35,-35,-18,42,-29
-20,2,-42,-28,-64,-33,-7,54,-138
6,19,-9,-12,-28,-44,-11,45,-34
-1,-18,-27,-42,-6,-40,-23,7,-150
36,1,-64,-14,-91,-60,-8,47,-153
3,17,-29,-33,-35,-33,13,63,-34
9,-6,-63,-33,-138,-149,-55,88,-347
-3,-12,-11,-32,-62,-16,-12,71,-77
26,3,-35,-11,-84,-52,5,58,-90
-9,-10,-58,-51,-82,-56,-30,19,-277
9,11,-19,-27,-81,-63,24,66,-80
27,-9,-28,-27,-63,-75,-23,21,-177
-6,18,-35,-22,-46,-55,-34,26,-154
21,0,-32,-25,-48,-57,4,43,-94
17,21,16,29,-55,0,-7,75,96
45,-29,-11,-41,-64,-51,-21,66,-106
19,32,-19,-12,-33,-49,-14,77,1
24,11,-31,-29,-43,-49,-16,72,-61
29,21,-36,-10,-27,-40,-2,24,-41
-2,-4,-77,-54,-100,-58,-2,43,-254
19,37,-90,-35,-239,-202,-52,167,-395
14,3,-15,-12,-72,-29,-6,42,-75
-5,20,-28,-12,-44,-26,-4,30,-69
4,21,-13,-30,-14,-7,-1,24,-16
-9,-7,-46,-32,-128,-24,-19,75,-190
36,-9,-33,-3,-86,-65,11,58,-91
22,44,-21,-17,-42,-78,-9,38,-63
6,22,-35,-11,-66,-46,-13,44,-99
46,4,-56,-25,-117,-75,6,28,-189
-3,-2,-29,-18,-97,-65,-2,75,-141
-1,19,-35,-41,-156,-111,11,154,-160
-2,5,-22,-31,-64,-26,4,34,-102
0,16,-59,-25,-72,-71,-17,76,-152
20,11,-17,-12,-49,-54,-1,38,-64
20,8,-29,-14,-105,-67,0,54,-133
-15,17,-41,-44,-36,-19,-5,24,-119
-3,61,-76,-21,-78,-65,8,91,-83
5,18,-30,-37,-22,-68,-39,49,-124
22,14,11,-12,-9,-39,9,44,40
17,10,-29,-6,-53,-44,-14,28,-91
-3,-9,-30,-27,-28,-28,-6,25,-106
16,-12,-38,6,-76,-56,10,32,-118
44,20,-50,-46,-91,-100,11,54,-158
47,44,-40,-23,-65,-99,-5,59,-82
0,6,-23,-16,-44,-33,-20,39,-91
-13,-10,-19,-27,-41,-27,0,27,-110
6,20,-22,-18,-15,-54,-12,26,-69
14,14,-30,-22,-33,-62,-8,26,-101
-13,25,-29,-11,-96,-31,-1,75,-81
3,6,-26,-7,-97,-38,12,48,-99
20,-3,-14,-22,-26,-49,-15,15,-94
2,27,-4,-11,-2,-40,3,45,20
-2,23,-38,-34,-34,-110,-6,59,-142
-4,14,-12,-36,-40,-26,6,49,-49
24,25,-61,-29,-92,-58,3,45,-143
-3,10,-34,-19,-30,-22,-12,25,-85
72,60,-55,21,-114,-42,58,114,114
-6,4,-22,-28,-38,-36,-15,43,-98
-9,22,-46,5,-122,-34,21,69,-94
-25,27,-60,-47,-87,-66,-2,55,-205
14,45,2,5,-90,-30,10,74,30
-33,-33,-52,-8,-103,-63,-35,59,-268
18,3,-40,-27,-99,-52,-13,41,-169
13,11,-37,-3,-71,-63,1,43,-106
-4,-1,-45,-49,-77,-60,-21,46,-211
39,-4,-42,-39,-95,-104,3,35,-207
23,18,-29,-50,-41,-68,-5,41,-111
13,28,-46,-21,-55,-57,1,61,-76
3,-10,-17,-43,-30,-16,-8,26,-95
17,1,-21,4,-106,-46,8,54,-89
6,27,-54,-55,-101,-16,7,72,-114
47,87,9,-19,-51,-291,-108,222,-104
17,16,-60,-37,-95,-86,6,58,-181
-25,-5,-89,-74,-144,-66,-15,65,-353
-4,64,-118,-102,-138,-99,16,74,-307
10,18,1,-11,-23,-34,-14,43,-10
-13,-7,-50,-60,-89,-134,-19,102,-270
27,65,-25,-2,-39,-47,14,28,21
12,14,-25,-15,-51,-36,20,46,-35
-14,33,-55,-25,-55,-52,-3,52,-119
7,-4,-27,-18,-103,-58,-25,62,-166
26,24,-24,-14,-32,-47,1,34,-32
25,47,-52,-8,-56,-142,-7,66,-127
4,23,-27,-16,-65,-86,-10,34,-143
13,-24,-45,0,-50,-89,-34,14,-215
9,19,-31,-16,-65,-25,11,64,-34
35,5,-39,-34,-71,-76,-22,71,-131
26,39,-9,-2,-15,-15,20,32,76
17,21,-43,-26,-122,-56,-1,57,-153
4,7,-37,-22,-27,-60,-6,36,-105
-3,1,-102,-25,-150,-89,-20,81,-307
-19,-7,-27,-45,-55,-53,-24,69,-161
-1,22,-37,-32,-58,-59,-6,64,-107
0,36,-39,-37,-91,-126,-29,91,-195
13,2,-21,7,-17,-33,0,31,-18
-6,-8,-43,-19,-52,-66,-26,23,-197
39,-8,-45,-8,-89,-63,-12,23,-163
-7,4,-56,-50,-81,-53,-28,57,-214
20,21,-56,-33,-71,-84,-19,60,-162
5,10,-31,-23,-67,-26,2,39,-91
-18,-21,-91,-42,-112,-91,-16,63,-328
7,-1,-52,-60,-45,-80,-14,26,-219
-21,37,-85,-67,-71,-57,-7,45,-226
3,21,-15,11,-110,-27,-27,98,-46
1,40,-49,-39,-80,-111,-20,97,-161
26,10,-31,-27,-43,12,-5,66,8
3,-6,-35,-15,-42,-51,4,17,-125
14,19,-17,-37,-12,-30,6,35,-22
15,35,-45,-11,-92,-5,57,87,41
28,0,-70,-26,-122,-99,5,31,-253
-7,-13,-23,-7,-45,-32,-3,24,-106
6,16,-7,2,-24,-20,3,24,0
128,10,-108,-36,-227,-200,-16,114,-335
1,-3,-23,-27,-39,-35,-5,19,-112
32,31,17,-7,-40,-83,-23,77,4
17,16,-31,-14,-40,-49,-28,60,-69
51,10,-46,12,-83,-93,4,78,-67
0,3,-25,-30,-43,-48,10,31,-102
11,41,-14,-14,-5,-5,28,41,83
7,-1,-23,-18,-29,-30,-23,48,-69
22,-14,-55,-7,-82,-106,-40,106,-176
7,6,-11,-19,-29,-84,-8,43,-95
-17,9,-48,-55,-62,-6,-2,49,-132
18,-4,-40,-30,-108,-57,5,115,-101
0,-10,-16,-41,-13,-60,-3,43,-100
61,9,-16,0,-88,-105,-24,122,-41
24,14,-47,-51,-55,-104,-22,75,-166
21,21,-11,-44,-62,-58,-9,105,-37
5,3,-39,-49,-72,-37,-22,19,-192
44,29,-44,-48,-95,-43,-15,89,-83
12,0,-48,-63,-90,-98,-12,70,-229
7,2,-21,2,-53,-53,-14,44,-86
24,-33,-10,-21,-70,-59,-20,49,-140
69,47,-71,-7,-80,-84,-37,76,-87
-13,20,-38,-13,-92,-42,5,43,-130
35,24,-41,-8,-38,-37,18,30,-17
14,4,-27,-14,-26,-58,-17,20,-104
24,47,-14,-8,-34,-49,-6,61,21
64,19,-84,-31,-158,-146,21,100,-215
22,1,-24,3,-31,-70,-26,51,-74
23,17,-3,-23,-41,-53,-13,69,-24
17,13,-18,-6,-37,-35,0,10,-56
-28,-7,-53,6,-59,-45,-25,36,-175
-6,12,-3,-4,-12,-17,0,61,31
26,16,-22,-9,-32,-40,0,38,-23
-7,-2,-62,-41,-85,-29,-2,47,-181
2,51,15,-19,-2,-43,-13,84,75
16,-11,-26,-24,-58,-89,-25,37,-180
16,23,-31,-36,-42,-42,7,52,-53
10,13,-7,-12,-31,-37,-8,22,-50
34,52,-57,-52,-111,-125,-46,133,-172
-15,15,-24,-22,-44,-43,-10,8,-135
9,9,-9,0,-41,-60,-8,30,-70
17,30,-42,-13,-46,-60,2,36,-76
30,-2,-44,-32,-103,-105,-1,36,-221
46,17,-18,-2,-39,-57,-13,69,3
13,21,-31,-29,-58,-56,-25,44,-121
27,11,-25,-12,-52,-63,-7,37,-84
55,-1,-75,-8,-186,-93,21,106,-181
13,22,-34,-22,-42,-90,-15,26,-142
8,4,-15,-11,-34,-21,-10,18,-61
10,7,-29,-28,-17,-79,-20,16,-140
7,-6,-11,1,-57,-39,-7,44,-68
16,18,-37,-2,-64,-51,4,71,-45
9,16,-22,-32,-51,-30,5,55,-50
36,-26,-54,-37,-73,-106,-18,27,-251
-4,20,-50,-63,-109,-86,-5,98,-199
23,-2,-21,-34,-42,-55,-17,55,-93
28,12,-20,-26,-48,-60,-2,25,-91
37,4,33,-36,-21,-56,-15,100,46
1,-13,-31,-12,-73,-66,-3,29,-168
2,15,-24,-17,-78,-48,-3,29,-124
10,-21,-38,-14,-49,-49,9,37,-115
36,11,-77,-30,-104,-163,-8,56,-279
-11,3,-35,-2,-95,-71,-29,53,-187
86,-9,-83,-51,-130,-144,10,122,-199
47,-3,-16,-11,-30,-91,-15,77,-42
14,33,-5,-12,-25,-34,-3,38,6
-3,32,-15,-35,-27,-55,-3,65,-41
9,-12,-36,-23,-40,-65,-16,25,-158
12,39,-53,-26,-90,-97,-10,15,-210
10,5,-30,-8,-57,-56,8,32,-96
8,8,-38,-1,-99,-44,23,67,-76
-2,38,-63,-61,-67,-79,-9,13,-230
-8,6,-48,-36,-91,-79,2,42,-212
20,28,-36,-19,-58,-47,-4,40,-76
3,25,-81,-74,-136,-73,-6,116,-226
11,33,-4,-12,-16,-55,-11,11,-43
-1,15,-8,-9,-15,-32,3,19,-28
108,61,-44,-4,-155,-109,-35,118,-60
66,90,18,-30,-29,4,41,174,334
-3,6,-30,-22,-28,-63,-29,37,-132
42,-40,-68,-37,-117,-95,14,70,-231
24,-7,-52,-19,-77,-55,-1,11,-176
-29,5,-64,-48,-107,-25,11,62,-195
17,87,-25,5,-76,-126,7,61,-50
25,4,-22,2,-56,-35,-15,38,-59
14,14,-13,-18,-104,-81,-21,55,-154
22,6,-42,-58,-40,-70,2,64,-116
52,16,-55,1,-94,-82,15,44,-103
22,15,-32,-35,-54,-67,-5,13,-143
-9,6,-41,-33,-56,-45,-2,42,-138
87,5,-46,27,-95,-70,6,54,-32
-3,4,-51,0,-120,-60,-12,51,-191
-8,0,-47,-38,-57,-52,5,8,-189
9,35,-39,-15,-88,-135,-29,47,-215
11,27,-34,-32,-46,-24,3,46,-49
-10,13,-15,-11,-47,-36,-2,43,-65
-17,17,-31,-24,-31,-30,-6,33,-89
35,-1,-35,-15,-81,-30,20,51,-56
-28,-7,-41,-38,-95,-60,-12,66,-215
17,39,-31,-44,-42,-52,10,47,-56
-37,-20,-65,-79,-160,-77,3,74,-361
15,12,-18,-6,-30,-74,-29,46,-84
2,12,-15,-5,-27,-43,-15,36,-55
29,-9,-26,-28,-58,-82,-6,33,-147
-10,7,-53,-53,-66,-117,-33,80,-245
8,-7,-36,-29,-45,-14,10,23,-90
26,32,-30,-12,-37,-86,-19,50,-76
19,15,-7,-11,-44,-48,-28,48,-56
30,33,-31,-22,-21,-41,17,49,14
-2,12,-43,-44,-70,-90,-23,84,-176
19,30,-20,-15,-54,-76,-4,79,-41
47,27,-64,-14,-103,-149,16,132,-108
-17,6,-74,-76,-119,-90,-12,27,-355
1,13,-35,-17,-39,-47,-15,31,-108
-1,8,-44,-41,-56,-38,-10,41,-141
8,12,-20,-40,-52,-117,-66,88,-187
16,-13,-48,-18,-70,-100,-16,66,-183
40,39,-23,-43,-93,-48,51,112,35
12,7,-11,-10,-26,-45,-10,14,-69
14,10,-10,-16,-16,-57,-8,37,-46
131,31,-70,99,-211,-120,-48,221,33
0,31,0,-9,-8,-68,4,40,-10
26,11,-32,-36,-16,-54,-18,25,-94
-23,22,-50,-25,-78,-73,-15,75,-167
9,23,-45,-17,-97,-56,21,79,-83
8,33,-68,-52,-99,-47,-5,87,-143
20,36,-52,-14,-107,-82,53,88,-58
19,21,-20,-23,-45,-43,-8,40,-59
1,16,-21,-34,-49,-28,5,40,-70
2,-24,-28,-29,-52,-53,-8,50,-142
45,-22,-101,-7,-205,-106,-44,104,-336
18,17,-15,-10,-13,-40,3,28,-12
14,38,-125,-57,-109,-142,-19,94,-306
22,40,-12,-26,-41,-74,-2,43,-50
9,3,-32,2,-49,-42,-6,38,-77
-1,21,-33,-35,-56,-30,-9,41,-102
-66,-33,-46,-8,-117,-69,-48,46,-341
-7,5,-35,-37,-47,-99,-49,36,-233
1,20,-7,6,-44,-26,1,53,4
12,38,-20,-7,-53,-87,-28,17,-128
30,24,-41,-1,-63,-38,7,70,-12
-23,14,-45,-42,-67,-50,-30,58,-185
-6,11,-32,-28,-18,-15,6,34,-48
3,10,-19,-24,-28,-15,12,50,-11
19,20,-31,-75,-114,-84,14,121,-130
7,-2,-22,-24,-25,-23,4,50,-35
-2,9,-33,-12,-51,-41,-11,13,-128
1,-2,-14,-14,-28,-36,-2,14,-81
16,7,-13,30,-28,-34,-23,39,-6
28,1,-39,4,-70,-61,-6,29,-114
20,39,-40,1,-68,-96,-6,42,-108
25,17,-34,7,-48,-67,-9,27,-82
-6,2,-22,-22,-53,-79,-36,35,-181
11,-4,-46,-30,-62,-56,-7,29,-165
-4,29,-99,-81,-165,-88,-33,97,-344
23,5,-63,-14,-115,-42,19,71,-116
16,0,-41,-40,-67,-131,-26,59,-230
7,9,-18,-15,-37,-36,2,13,-75
-3,17,-5,-32,-25,-86,-3,77,-60
28,11,-34,14,-123,-52,22,63,-71
16,35,38,31,-48,5,2,65,144
-14,10,-34,-5,-34,-44,-2,-8,-131
-6,4,-25,-25,-48,-40,-2,27,-115
-5,-18,-49,-13,-73,-57,-19,28,-206
-22,27,-54,-7,-97,-132,-84,56,-313
9,15,-62,-34,-88,-78,-7,42,-203
6,19,-51,-28,-63,-81,-8,55,-151
-18,0,-91,-107,-112,-117,-18,98,-365
12,22,-29,-7,-14,-60,-12,27,-61
10,9,-41,-51,-76,-56,0,39,-166
12,3,-25,-4,-61,-58,-4,49,-88
11,1,-35,-9,-51,-58,-12,24,-129
11,10,-54,-4,-114,-62,4,50,-159
16,2,-30,3,-73,-66,-11,32,-127
13,87,-122,-96,-124,-57,35,97,-167
13,-31,-38,-43,-63,-77,-25,65,-199
20,-2,13,-10,-87,-55,-9,102,-28
4,-3,12,13,-20,-36,-7,17,-20
12,30,-38,-37,-85,-85,-7,64,-146
12,-15,-21,-23,-53,-52,-8,17,-143
13,11,-34,-13,-77,-53,-11,15,-149
12,31,-11,-3,-21,-30,5,44,27
-10,26,-29,-30,-66,-51,-20,46,-134
14,-8,-73,-28,-97,-88,0,54,-226
12,21,-85,-23,-145,-69,31,85,-173
30,12,-13,-21,-44,-47,13,42,-28
11,-11,-39,-7,-47,-74,-28,49,-146
9,6,-35,-23,-63,-38,3,24,-117
37,24,-3,-3,10,5,12,42,124
0,28,-21,-67,-46,-118,-38,95,-167
7,1,-17,-21,-53,-61,-24,50,-118
29,15,-72,-42,-102,-98,0,73,-197
-3,19,-37,-29,-68,-96,-36,40,-210
6,23,-33,-31,-45,-62,-18,10,-150
14,30,-32,-18,-65,-25,-1,61,-36
10,28,-3,-22,-20,-49,-11,21,-46
46,28,-56,-26,-156,-106,-5,65,-210
0,25,-61,-6,-103,-63,15,72,-121
20,15,-8,-12,11,-11,4,38,57
119,68,-48,-80,-133,-104,-3,136,-45
-103,-61,-81,-39,-108,-173,-78,106,-537
66,27,-16,-2,-74,-86,20,79,14
0,-29,-76,-59,-88,-110,-28,90,-300
14,-14,-50,-36,-68,-85,-28,49,-218
65,-29,-60,-60,-120,-119,-10,104,-229
19,27,-41,-40,-51,-126,10,56,-146
-4,-10,-25,-26,-58,-87,6,58,-146
-1,26,-14,-40,-10,-19,15,57,14
-2,-6,-40,-39,-71,-71,-21,53,-197
-8,22,-12,-21,-42,-61,-21,39,-104
9,12,-37,-10,-52,-49,-11,40,-98
29,-34,-68,-19,-132,-121,1,62,-282
21,14,1,-16,-24,-63,-5,10,-62
13,40,-41,5,-60,-86,-17,74,-72
16,15,-47,-45,-43,-40,-17,79,-82
23,19,-56,-64,-106,-113,-12,70,-239
25,23,-34,4,-90,-68,-10,33,-117
-18,11,-28,-7,-14,-36,-18,36,-74
-16,6,-33,-5,-36,-47,-4,38,-97
-1,10,-29,-8,-55,-29,-3,54,-61
37,21,-60,-58,-61,-117,-14,55,-197
11,10,-25,-27,-74,-68,-30,31,-172
128,59,-14,-22,-110,-70,-17,145,99
5,17,-31,-39,-21,-75,-11,47,-108
19,34,-49,-28,-84,-76,-5,91,-98
20,34,-36,-5,-92,-39,-2,83,-37
-5,-9,-36,-60,-73,-78,6,62,-193
3,-7,-21,-15,-32,-24,-7,25,-78
31,-23,-63,-13,-132,-54,2,32,-220
4,12,-31,-14,-78,-49,-14,61,-109
8,34,-9,-7,-3,-28,2,48,45
1,-15,-29,-12,-51,-36,-17,39,-120
-3,6,-31,-41,-69,-75,-25,45,-193
30,26,-13,8,-48,-60,4,48,-5
11,6,-54,-30,-54,-84,-18,28,-195
-9,23,-65,-38,-95,-78,-8,74,-196
24,21,-36,-19,-107,-74,-17,88,-120
4,10,-28,-11,-61,-62,-26,48,-126
1,-12,-28,-32,-41,-25,8,37,-92
12,7,-26,-26,-21,-22,7,23,-46
29,-1,-45,-1,-87,-70,-10,23,-162
24,-9,-40,-44,-84,-94,-1,85,-163
36,4,43,22,-1,-11,-17,58,134
20,-32,-40,-52,-60,-95,-17,68,-208
41,-22,-33,-33,-117,-96,-14,92,-182
14,21,-21,1,-55,-72,-33,38,-107
-8,-7,-88,-36,-131,-48,2,35,-281
17,2,-31,-17,-14,-52,-14,18,-91
19,3,-34,-41,-63,-70,-10,40,-156
-6,-6,-20,-7,-82,-37,-3,53,-108
-2,33,-28,-25,-42,-55,21,77,-21
5,11,-36,-28,-79,-95,-2,35,-189
31,6,-23,-17,-24,-77,-7,14,-97
-15,29,5,-16,-35,-24,-11,35,-32
10,14,-31,-35,-37,-54,1,35,-97
-1,17,-61,-54,-87,-93,-34,94,-219
7,26,-46,-40,-108,-90,-13,40,-224
8,8,-12,6,-22,-43,-7,32,-30
-2,25,-56,-36,-81,-64,-10,21,-203
28,-8,-51,-9,-74,-52,10,44,-112
-7,-28,-76,-32,-112,-125,-7,40,-347
7,13,-42,-5,-55,-44,-1,29,-98
23,-6,-19,3,-66,-53,-10,21,-107
7,15,-12,-10,-47,-47,2,60,-32
-11,32,-63,-45,-64,-116,5,63,-199
5,50,-21,-25,-73,-72,7,52,-77
6,18,-20,-14,-54,-59,-13,72,-64
-11,21,-70,-55,-115,-70,13,63,-224
6,12,-20,-31,-39,-60,-17,55,-94
23,-16,-17,5,-50,-40,-4,40,-59
-20,-9,-64,-50,-82,-101,-24,21,-329
-2,1,-29,-29,-44,-67,-17,33,-154
4,-7,-38,-37,-73,-37,-4,36,-156
41,4,-44,-39,-41,-68,-10,54,-103
29,27,-63,-44,-40,-84,16,54,-105
13,42,-11,1,-12,-63,-2,48,16
23,27,-5,-12,-4,-29,5,49,54
37,25,-53,-28,-94,-90,1,52,-150
7,35,-16,-21,-27,-48,-6,25,-51
7,6,-59,-26,-106,-48,2,49,-175
8,-14,-25,-14,-38,-56,-37,50,-126
42,44,-52,-47,-134,-128,8,95,-172
-2,16,3,-24,-20,-27,13,56,15
4,39,-52,5,-128,-75,-8,94,-121
8,46,-62,-35,-88,-62,13,44,-136
-4,22,-89,-80,-115,-119,-36,114,-307
-7,26,-14,-26,-23,-10,-16,66,-4
25,21,-53,-44,-135,-106,-30,70,-252
19,35,-62,-64,-95,-93,-35,89,-206
11,7,-21,-30,-48,-82,-27,61,-129
30,43,-49,-32,-64,-41,-4,69,-48
-6,0,-22,-23,-31,-47,-13,21,-121
-10,-10,-39,-45,-75,-44,-29,23,-229
40,44,3,7,-20,-45,-1,47,75
26,23,-32,-25,-122,-112,-24,73,-193
2,1,-32,-28,-36,-45,-22,20,-140
13,46,-28,-8,-92,-49,-5,105,-18
10,30,-84,-61,-157,-74,-6,101,-241
33,16,-54,-23,-85,-44,-1,64,-94
27,30,-43,-36,-75,-56,-10,54,-109
-1,20,-46,-53,-77,-24,-8,56,-133
10,4,-60,-31,-92,-98,-13,43,-237
79,40,-97,-71,-194,-212,4,181,-270
6,14,-15,-19,-32,-54,-20,48,-72
23,58,-48,-37,-117,-114,14,71,-150
12,18,-8,-18,-24,-58,-18,37,-59
-5,-14,-49,-14,-38,-45,-11,25,-151
-1,0,-12,-27,-72,-48,-5,89,-76
3,-21,-48,-6,-99,-71,-3,61,-184
21,21,-53,-80,-73,-78,24,41,-177
15,-25,-25,-10,-50,-30,-15,46,-94
26,27,16,14,-65,-4,0,63,77
36,31,-37,-19,-111,-77,30,103,-44
2,-6,-51,-34,-97,-43,-1,64,-166
15,31,-40,-37,-58,-58,-3,39,-111
-12,47,-36,-41,-80,-55,-2,71,-108
32,42,-15,13,-67,-60,19,60,24
5,48,-18,-12,-63,7,0,110,77
19,19,-9,2,-41,-35,-4,13,-36
-12,-10,-25,-23,-54,-35,-10,22,-147
6,21,-51,-24,-53,-68,-15,50,-134
-3,-7,-46,-22,-52,-67,-42,48,-191
49,12,-46,-7,-112,-92,-21,46,-171
1,32,-7,-1,-24,-15,19,41,46
5,44,-20,-17,-22,-39,-3,22,-30
-9,26,-25,-31,-23,-42,-14,30,-88
9,-9,-45,-14,-73,-28,12,55,-93
-3,-8,-49,-3,-121,-68,-18,47,-223
15,44,-40,-50,-90,-136,-8,169,-96
8,23,-37,-37,-69,-85,-22,46,-173
82,3,-81,-12,-186,-164,24,54,-280
1,11,6,3,-23,-11,-4,33,16
5,14,-24,-15,-24,-37,15,42,-24
12,38,-10,-28,-27,-49,2,55,-7
6,11,-38,-36,-49,-52,2,19,-137
7,4,-12,19,-29,-11,23,19,20
5,8,-35,1,-103,-54,4,26,-148
27,40,-49,6,-102,-108,6,51,-129
10,-21,-85,-38,-188,-96,-18,109,-327
37,12,-25,-13,-33,4,-5,40,17
0,31,-31,-15,-22,-51,-7,45,-50
10,13,-59,-29,-133,-76,12,47,-215
-9,9,-28,-32,-116,-77,-31,76,-208
15,12,-29,-21,-63,-76,-22,48,-136
1,-3,-19,-31,-49,-52,-13,65,-101
-14,-3,-23,-17,-40,-28,-5,23,-107
33,-3,-38,3,-106,-107,13,72,-133
-17,-6,-15,-24,-56,-32,-8,61,-97
-16,-9,-41,-32,-52,-23,-6,-1,-180
-18,-10,-43,-41,-93,-42,-11,58,-200
30,23,-48,-48,-80,-110,-30,45,-218
-2,17,-58,-50,-59,-90,-36,56,-222
17,-14,-15,-5,-37,-27,-6,41,-46
9,29,-35,-40,-67,-102,-20,21,-205
-3,6,-24,-15,-63,-62,-18,27,-152
2,3,-47,-11,-33,-44,4,5,-121
12,-14,-53,-13,-80,-79,-8,20,-215
-7,5,-25,-34,-38,-72,-27,53,-145
7,33,-20,-17,-33,-47,8,78,9
2,16,-27,-18,-72,-80,-20,12,-187
-9,-2,-36,-33,-75,-44,21,86,-92
26,-7,-31,-5,-47,-70,-12,29,-117
1,23,-7,-22,-19,-6,2,40,12
41,-4,-36,-27,-95,-98,-36,52,-203
8,6,-2,-7,-7,-13,-9,28,4
34,23,-25,-53,-61,-111,7,95,-91
10,13,-7,-8,-24,-37,-18,41,-30
14,-1,-48,-43,-89,-85,-27,39,-240
-7,-23,-50,-54,-32,-97,-24,23,-264
8,25,-3,-35,-42,3,25,89,70
0,76,-65,-58,-104,-166,-33,114,-236
28,19,-32,-19,-19,-55,-13,30,-61
28,20,-28,-13,-47,-32,18,6,-48
-9,2,-29,-25,-32,-38,-25,28,-128
42,56,-40,-14,-45,-68,-1,59,-11
-4,49,-31,-15,-59,-64,-14,72,-66
2,1,-34,-25,-55,-54,-9,22,-152
15,-16,-33,-35,-53,-67,-17,32,-174
13,9,-18,-1,-40,-57,-24,39,-79
24,13,-15,-38,-10,-45,-13,63,-21
10,11,-14,-22,-41,-53,-13,23,-99
11,15,-91,-16,-163,-121,-11,93,-283
20,-9,-58,-25,-140,-71,2,81,-200
-28,2,-47,-49,-48,-15,2,25,-158
0,22,-26,-27,-55,-50,-18,52,-102
-9,14,-27,-27,-56,-31,7,15,-114
-9,26,-31,-17,-50,-50,-29,24,-136
-5,5,-39,-36,-36,-29,0,54,-86
5,12,-24,-11,-6,-49,-7,-12,-92
4,33,-20,-12,-27,-40,-11,62,-11
42,70,-71,-63,-117,-136,-40,102,-213
-4,24,-47,-1,-89,-116,-13,37,-209
19,32,-18,-27,-51,-132,-19,76,-120
33,15,-29,-25,-76,-84,2,74,-90
9,-2,-54,-25,-69,-64,-15,42,-178
16,11,-31,-18,-73,-47,-28,58,-112
11,12,-12,-20,-34,-35,17,34,-27
-1,0,-35,-20,-54,-6,-4,31,-89
4,13,-32,-12,-53,-57,-13,28,-122
36,16,-41,-28,-52,-68,-22,39,-120
29,20,-47,-24,-103,-91,-7,119,-104
-19,9,-26,-21,-97,-41,-16,71,-140
-5,9,-23,7,-62,15,4,43,-12
21,28,12,-6,-26,-59,0,58,28
12,24,-16,6,-44,-26,10,10,-24
20,10,-42,-16,-53,-52,6,26,-101
4,10,-33,-36,-53,-52,-11,37,-134
24,5,-15,-6,-44,-42,-3,16,-65
25,0,-31,3,-56,-61,8,31,-81
26,-2,-57,3,-143,-74,25,95,-127
13,11,-5,-24,-34,-68,-12,50,-69
20,-23,-34,-60,-88,-96,-31,66,-246
52,13,-8,10,-128,-46,-26,88,-45
63,-15,-52,-45,-72,-174,7,50,-238
-12,-15,-24,-27,-39,-52,-4,18,-155
37,4,-31,-3,-79,-73,2,9,-134
-26,16,-119,-82,-186,-102,3,109,-387
13,12,-32,2,-37,-42,-1,28,-57
27,18,-45,-47,-71,-100,-27,55,-190
11,5,-40,-21,-58,-32,-3,50,-88
-7,-8,-42,-23,-61,-52,-7,35,-165
2,9,-37,-54,-71,-71,-4,39,-187
18,38,-25,-12,-51,-61,14,56,-23
17,17,-28,-35,-74,-72,5,53,-117
1,22,-38,-34,-40,-27,-1,39,-78
31,27,-23,-30,-50,-61,-29,40,-95
11,20,-55,-41,-99,-130,-10,80,-224
16,8,-82,-66,-119,-109,-15,57,-310
-9,-20,-73,-59,-111,-92,-7,44,-327
1,-15,-24,-48,-31,-29,-7,24,-129
20,12,-68,-42,-106,-109,-21,60,-254
5,11,-17,-21,-46,-35,-7,24,-86
-31,17,-56,-41,-94,-86,-36,94,-233
18,19,-54,-22,-84,-91,-3,58,-159
52,18,-73,-11,-157,-78,37,68,-144
13,1,-30,-35,-79,-47,-10,55,-132
2,7,-45,-45,-114,-40,-8,67,-176
19,13,-39,-1,-108,-54,11,39,-120
9,2,-35,-41,-78,-86,-15,58,-186
18,-24,-54,-67,-82,-91,-21,56,-265
27,34,-47,-8,-64,-79,-22,32,-127
-1,11,-31,-37,-45,-39,3,42,-97
-8,-8,-48,-6,-107,-32,-13,66,-156
66,13,-83,-5,-146,-159,-38,76,-276
27,6,-17,-23,0,-49,2,35,-19
8,-16,-55,-22,-80,-82,1,49,-197
3,31,-28,-30,-24,-41,-4,31,-62
61,8,-61,-19,-128,-113,-48,89,-211
9,5,-25,-9,-27,-24,9,23,-39
25,27,-22,-20,-46,-47,16,67,0
2,3,-47,-45,-96,-103,-32,54,-264
29,35,-71,-80,-80,-66,35,97,-101
49,-2,-79,-54,-203,-171,6,131,-323
25,5,-32,-25,-46,-72,-28,27,-146
10,-2,-39,-37,-60,-70,-2,21,-179
3,3,-24,-11,-33,-49,-13,40,-84
17,7,-53,-29,-95,-48,3,23,-175
12,5,-7,-18,-15,2,9,27,15
9,10,-27,-15,-26,-28,11,36,-30
-10,-17,-18,-18,-34,-25,3,26,-93
5,-4,-26,-20,-56,-38,-10,52,-97
12,17,-22,-15,-40,13,-1,39,3
32,9,-30,-13,-63,-74,-5,34,-110
8,3,-27,-20,-42,-46,-36,32,-128
-3,8,-23,-10,-55,-82,-25,41,-149
11,36,-21,-26,-11,-22,6,43,16
-11,5,-15,-15,-31,-35,-1,12,-91
-3,16,-17,-28,-18,-38,-17,53,-52
30,12,-32,-20,-86,-65,-14,15,-160
54,25,-79,-46,-159,-108,-3,87,-229
36,28,-47,-36,-74,-95,0,46,-142
-2,8,-6,-19,-33,15,13,42,18
-32,2,-67,-49,-111,-45,-11,68,-245
56,7,-77,14,-179,-158,6,87,-244
35,13,-23,-3,-49,-29,8,27,-21
31,59,-38,-38,-55,-79,-3,77,-46
-6,3,-51,-40,-56,-29,17,24,-138
-4,-13,-33,-20,-33,-48,-5,22,-134
1,-29,-59,-42,-77,-35,14,28,-199
19,35,-17,-32,-37,-73,-17,56,-66
9,6,-50,-26,-64,-36,0,46,-115
37,22,-37,7,-79,-73,-5,28,-100
20,17,-7,-10,-12,-40,0,33,1
39,16,-31,-24,-5,-43,1,54,7
40,14,-39,-21,-133,-47,15,70,-101
9,20,-12,-12,-40,-48,-8,16,-75
12,-5,-16,-10,-66,-76,-34,37,-158
23,39,-51,-29,-106,-58,17,83,-82
39,3,-12,-9,-20,-45,-10,15,-39
24,-8,-7,-16,-44,-39,-15,55,-50
16,-21,-82,-32,-119,-79,-14,25,-306
28,-6,-45,-17,-143,-143,-50,93,-283
22,7,-38,-19,-87,-94,-1,72,-138
7,10,-14,-10,-42,-19,10,27,-31
32,9,-66,-9,-75,-53,-1,35,-128
39,28,-89,-73,-127,-193,-43,158,-300
56,-19,-43,13,-121,-71,-12,55,-142
-11,30,-96,-41,-116,-76,-6,53,-263
63,17,-70,-35,-99,-138,9,106,-147
17,3,-9,-14,-41,-27,-5,46,-30
1,-10,-49,-4,-94,-56,10,29,-173
30,36,-50,-28,-116,-60,-14,121,-81
2,-6,-42,-35,-85,-52,-35,81,-172
66,18,-18,11,-79,-102,-10,123,9
21,0,-39,-48,-15,-49,-11,20,-121
31,34,-19,-6,-20,-54,-10,54,10
4,12,-52,-51,-103,-58,-19,57,-210
8,54,-15,-46,-15,-137,-35,78,-108
-12,26,-19,-10,-21,-41,-13,43,-47
37,15,-66,-17,-146,-110,2,72,-213
53,29,-50,-33,-130,-170,-90,131,-260
0,15,-9,-7,-92,-25,-15,74,-59
24,4,-37,-10,-58,-63,0,64,-76
6,-23,-63,-68,-144,-62,0,61,-293
-2,22,-1,-26,-14,11,8,45,43
4,-12,-60,-49,-76,-77,-13,45,-238
-10,16,-20,2,-43,-45,-13,53,-60
21,29,-20,-10,-69,-50,-2,63,-38
-11,24,-34,-26,-36,-43,-16,46,-96
8,6,-30,-25,-56,-55,-17,56,-113
77,21,-8,27,-73,-113,3,139,73
44,33,-48,-24,-95,-60,-3,95,-58
17,25,-28,-37,-40,-61,-9,35,-98
-13,-15,-21,-2,-55,-34,-3,32,-111
79,12,-41,-20,-150,-128,-45,157,-136
-2,33,-46,-39,-86,-92,-8,71,-169
22,5,-18,-24,-57,-48,7,39,-74
10,19,-27,-16,-64,-57,-4,37,-102
22,27,-19,-13,-3,-46,-2,52,18
34,-35,8,37,-47,-23,-27,80,27
21,11,-12,-22,-13,-43,3,35,-20
24,7,-2,-22,-48,-31,19,67,14
70,-8,-87,-13,-240,-199,12,116,-349
19,-12,-46,-13,-61,-49,-8,58,-112
10,-24,-21,10,-62,-20,-3,47,-63
5,-5,-18,-4,-28,-44,-12,21,-85
10,3,-17,-15,-33,-45,-3,22,-78
15,-2,-74,3,-105,-77,-39,87,-192
58,42,-89,-33,-187,-205,-36,69,-381
33,26,-8,-35,-59,-79,-15,88,-49
32,10,-32,-5,-51,-69,1,39,-75
28,28,-13,0,-55,-57,-21,80,-10
36,18,-30,-10,-59,-87,12,74,-46
-7,26,-24,-35,-1,-49,-6,21,-75
3,12,-42,-47,-112,-72,1,92,-165
71,34,-25,-39,-67,-104,14,51,-65
1,-9,-23,-19,-41,-41,-14,22,-124
22,3,-12,-12,-28,-31,1,43,-14
11,4,-58,-68,-138,-169,-21,58,-381
35,20,-64,-16,-67,-71,14,58,-91
34,-24,-6,1,-32,-48,-16,27,-64
26,4,9,-19,-39,-69,-11,43,-56
62,67,-31,4,-81,-91,17,62,9
13,37,-23,-12,-56,-76,-12,51,-78
30,-4,-40,-68,-97,-126,-18,57,-266
49,-15,-56,-35,-105,-130,-43,135,-200
38,22,-15,-21,-28,-57,-9,39,-31
24,4,-10,29,-37,-49,-17,37,-19
10,4,-20,-26,-26,-23,7,14,-60
17,23,-43,-3,-59,-45,-12,81,-41
54,-14,-82,-46,-199,-131,-27,115,-330
-5,-9,-37,-31,-64,-12,-3,40,-121
1,16,-16,-24,-33,-26,7,46,-29
13,29,-39,-4,-39,-28,11,45,-12
13,-7,-31,-47,-36,-50,-13,47,-124
12,3,-18,-5,-49,-21,5,45,-28
3,8,-11,-28,-34,-32,-15,26,-83
28,35,-37,-20,-81,-128,0,70,-133
18,15,-36,-25,-55,-42,0,48,-77
5,49,-35,-37,-79,-57,-11,62,-103
3,19,-18,-31,-34,-8,-2,61,-10
10,-9,-51,-19,-118,-87,-2,38,-238
17,6,-48,-46,-91,-56,26,60,-132
-4,4,-10,-28,-38,-25,-4,15,-90
35,-22,-65,-76,-87,-105,-29,61,-288
21,22,-40,2,-80,-31,18,63,-25
3,15,-81,-21,-91,-43,1,43,-174
31,1,-49,-46,-59,-97,-24,96,-147
22,31,-98,-52,-253,-157,47,136,-324
-3,50,-87,-89,-173,-154,-20,127,-349
4,22,-21,14,-54,-58,-8,36,-65
13,-3,-27,-23,-43,-25,-5,40,-73
1,4,-37,-15,-51,-45,0,22,-121
27,11,-42,-44,-147,-101,-5,39,-262
45,52,-56,-56,-118,-207,-51,143,-248
31,26,-25,4,-61,-42,-3,96,26
17,11,-42,-22,-81,-62,-4,89,-94
34,26,-3,-27,0,-81,-12,41,-22
34,11,-27,-23,-82,-69,11,57,-88
33,50,-88,-103,-139,-174,-9,154,-276
26,20,-14,-13,-44,-53,-17,74,-21
17,15,-16,-6,-9,-36,-1,33,-3
25,12,-25,-19,-68,-72,-10,18,-139
-1,-10,-22,-27,-32,-53,-10,31,-124
-7,4,-22,-20,-29,-32,-17,33,-90
4,-7,-46,-59,-80,-125,-28,67,-274
23,-43,-91,-54,-114,-148,-74,87,-414
31,30,9,-24,-27,-89,-29,45,-54
10,-8,-17,-58,-40,-63,-29,12,-193
23,27,-36,-40,-80,-95,15,52,-134
54,16,-102,-36,-224,-135,-4,74,-357
68,38,-24,-52,-77,-147,-10,47,-157
17,-14,-7,-16,-27,-48,-5,41,-59
9,44,-9,-23,-21,-51,7,20,-24
24,-12,-36,-21,-88,-100,-3,48,-188
24,45,1,-22,-19,-40,-3,54,40
2,13,-22,-10,-26,-7,20,45,15
38,50,-3,-6,-34,-123,-34,115,3
38,0,-68,-74,-80,-165,-54,128,-275
51,-15,-24,-45,-32,-78,-1,100,-44
5,17,-56,-57,-68,-98,3,89,-165
87,-3,-32,94,-222,-138,-24,137,-101
59,26,-49,-30,-67,-74,-50,83,-102
21,66,-133,-94,-220,-344,-88,182,-610
49,-10,-67,4,-77,-93,-2,35,-161
13,-4,-31,-20,-64,-22,5,41,-82
1,9,-30,-32,-34,-33,0,38,-81
5,36,-11,-34,1,-16,17,28,26
-9,30,-26,-36,-43,-46,-10,54,-86
60,9,-72,-16,-232,-162,-5,113,-305
23,68,-45,-47,-105,-100,5,45,-156
-10,30,-35,-43,-46,-62,-23,26,-163
16,-4,-20,-48,-60,-98,-25,107,-132
6,-8,-13,-28,-33,-34,-18,32,-96
7,0,-38,-32,-52,-50,-3,59,-109
27,-8,-28,2,-81,-67,-7,31,-131
-59,-58,-90,-42,-122,-121,-57,75,-474
83,-1,-26,-19,-83,-92,13,125,0
53,37,-54,-40,-77,-29,-4,89,-25
47,50,-34,-20,-68,-28,4,86,37
70,53,-107,-10,-164,-107,26,131,-108
56,67,-86,-92,-166,-167,-9,159,-238
38,24,-41,-47,-56,-61,-9,74,-78
20,-4,-44,-38,-41,-103,-18,50,-178
20,-22,-43,-17,-77,-65,-12,26,-190
6,4,-15,-29,-46,-39,-6,24,-101
23,9,-44,-48,-106,-31,-8,88,-117
19,34,-13,0,-43,-30,3,18,-12
26,40,-69,-28,-102,-91,-30,118,-136
1,6,-77,-19,-156,-71,10,59,-247
-7,-5,-59,-50,-106,-63,-3,19,-274
21,40,-19,-16,-35,-8,19,71,73
16,13,-43,19,-72,-73,-5,32,-113
17,-2,-54,-27,-106,-79,20,52,-179
0,8,-32,-40,-40,-68,-17,29,-160
-4,9,-38,-24,-29,-54,-16,44,-112
14,0,-121,-97,-174,-100,-2,60,-420
-2,16,-43,-23,-48,-20,2,21,-97
4,12,-43,-15,-68,-29,1,45,-93
16,16,-37,-17,-56,-80,-20,19,-159
-9,-20,-48,-26,-74,-17,-20,22,-192
9,25,-36,-5,-63,-93,-11,28,-146
14,-16,-51,-28,-88,-90,-17,37,-239
-10,-1,-26,-22,-54,-99,-52,67,-197
21,26,-15,15,-61,-97,7,18,-86
6,3,-45,-50,-41,-54,-15,10,-186
40,35,-70,4,-101,-179,-8,58,-221
29,21,-51,17,-91,-76,3,64,-84
10,8,-23,-32,-50,-5,3,72,-17
-13,21,-49,-56,-60,-52,-22,30,-201
32,38,-50,-57,-95,-115,-6,62,-191
-2,8,-64,-51,-125,-109,-5,104,-244
24,5,-30,-10,-78,-69,-25,56,-127
11,6,-14,3,-12,-53,1,49,-9
6,10,-84,-15,-137,-50,-9,51,-228
-23,-20,-48,-46,-89,-74,-25,36,-289
5,-43,-42,-37,-117,-105,-9,69,-279
-3,10,-11,-3,-16,-31,9,32,-13
-14,37,26,8,0,-23,-7,46,73
67,47,-14,-12,-153,-51,-4,217,97
29,30,-80,-22,-134,-39,9,113,-94
39,-8,-61,-16,-133,-108,-7,53,-241
-3,14,-51,-55,-105,-55,6,43,-206
24,12,-44,-19,-113,-42,-17,104,-95
6,5,-32,-14,-42,-36,-3,35,-81
-4,-9,-58,-16,-108,-54,23,36,-190
23,1,-20,-2,-41,-45,19,3,-62
22,17,-50,-15,-84,-79,0,33,-156
41,-3,-31,-16,-104,-107,-21,15,-226
-11,20,-21,-42,-49,-59,-11,31,-142
16,-6,-81,-56,-143,-118,2,38,-348
11,11,-26,-34,-35,-77,-25,20,-155
-12,47,-12,-19,-31,-97,-19,17,-126
26,13,-21,-11,-67,-53,-20,44,-89
31,12,-37,-16,-70,-28,15,60,-33
15,-2,-67,-14,-104,-69,-12,57,-196
80,-6,-72,-48,-120,-129,0,117,-178
20,5,-3,-6,-45,-42,-11,33,-49
-23,-14,-65,-34,-67,-46,-26,13,-262
20,22,-54,-38,-60,-89,-13,96,-116
-48,-17,-54,-47,-67,-46,-28,37,-270
37,30,-45,-24,-83,-85,16,37,-117
9,45,-62,-61,-116,-134,-49,193,-175
-9,9,-185,-126,-263,-199,-62,193,-642
55,9,-66,-33,-128,-171,-30,91,-273
26,-19,-4,18,-34,-21,-5,58,19
-15,13,-62,-53,-83,-77,3,75,-199
-26,-33,-89,-52,-114,-60,-3,27,-350
-1,2,-63,-26,-90,-67,-4,38,-211
62,19,-31,69,-224,-50,-26,119,-62
-31,-10,-57,-57,-72,-45,-20,31,-261
58,25,-63,15,-178,-111,24,84,-146
25,9,-19,-10,-32,-18,3,48,6
13,13,-30,17,-109,-110,-32,90,-148
1,21,-30,-23,-40,-33,6,23,-75
49,-39,-68,-30,-132,-93,-7,62,-258
-6,5,-40,-13,-83,-78,-17,50,-182
49,12,-21,-22,-61,-65,-6,40,-74
21,9,-47,0,-101,-101,-12,39,-192
33,31,-59,-67,-104,-120,4,41,-241
27,-2,-43,-31,-160,-101,-20,66,-264
-11,30,-29,-35,-56,-49,-37,36,-151
21,3,-34,-14,-51,-39,8,35,-71
38,1,-7,22,-55,-65,-19,71,-14
-40,8,-87,-152,-151,-101,-8,105,-426
0,41,-63,-69,-40,-96,-31,48,-210
12,-19,-35,17,-93,-54,-2,44,-130
-6,-1,-61,-53,-95,-59,-9,52,-232
51,19,-30,-60,-26,-142,-10,88,-110
36,18,-13,4,-37,-36,4,10,-14
-9,-12,-19,-8,-36,-68,-19,44,-127
24,-7,-34,-22,-50,-58,-33,14,-166
-11,14,-70,-84,-98,-79,15,51,-262
15,22,-53,-40,-37,-84,12,50,-115
64,26,-62,-19,-130,-96,21,44,-152
-2,20,-15,-20,-41,-41,-14,20,-93
11,23,-37,-25,-56,-65,-16,52,-113
10,27,-33,-42,-70,-71,-2,56,-125
-5,19,-2,-11,-38,-8,-13,44,-14
3,11,7,-16,-41,-46,-13,61,-34
17,-18,-15,-13,-79,-46,-11,56,-109
-1,-29,-109,-70,-142,-108,-57,111,-405
3,74,-38,-37,-96,-56,23,106,-21
-34,-5,-67,-43,-56,-73,-8,41,-245
48,22,-42,5,-58,-38,12,31,-20
64,52,-41,-14,-153,-137,37,58,-134
45,55,-49,-32,-125,-178,-6,42,-248
23,-16,-51,-28,-94,-71,-13,50,-200
9,20,-16,-3,-38,-39,2,59,-6
11,29,-23,-22,-2,-35,17,17,-8
8,22,-43,-25,-113,-61,-3,46,-169
20,27,-75,-48,-99,-84,-41,99,-201
66,49,-21,-23,-51,-49,12,125,108
-9,9,-93,-89,-196,-155,-59,129,-463
13,28,-30,-13,-53,-45,-4,45,-59
-7,-7,-29,-22,-39,-45,-15,41,-123
-8,26,-53,-29,-96,-63,-31,53,-201
-23,-1,-41,-38,-35,-42,-33,7,-206
5,16,-32,-18,-77,-66,8,49,-115
0,-6,-39,-32,-73,-62,-28,51,-189
36,-26,-16,-32,-70,-70,0,50,-128
14,-42,-58,-6,-156,-117,-17,52,-330
3,6,-34,-14,-43,-80,-32,25,-169
-10,11,-35,-20,-65,-17,-8,46,-98
12,51,-34,-38,-37,-34,12,61,-7
12,16,-35,-59,-71,-51,4,69,-115
-1,16,-23,-29,-12,-57,-18,29,-95
16,15,-47,-12,-59,-63,-19,17,-152
18,14,-35,-29,-106,-54,34,84,-74
18,16,-29,-4,-101,-28,6,75,-47
34,25,-36,-7,-86,-56,2,50,-74
12,34,-13,-44,-40,-97,-21,56,-113
19,14,-31,-3,-41,-34,17,33,-26
61,12,-41,-20,-41,-105,-2,71,-65
3,49,3,-32,-5,-33,6,45,36
4,-11,-41,-17,-47,-34,-20,34,-132
19,10,-24,4,-44,-19,5,37,-12
21,18,-24,-27,-15,-27,6,34,-14
19,20,-15,-14,-23,-40,-4,34,-23
30,7,-28,-4,-30,-37,5,16,-41
3,23,-39,-31,-68,4,-12,55,-65
33,12,-19,-25,-53,-49,-14,40,-75
11,4,-38,-41,-58,-69,-6,57,-140
-2,25,-27,-2,-101,-110,-27,72,-172
11,-29,-33,-3,-106,-67,-11,46,-192
40,32,-10,-35,-60,-78,2,69,-40
49,42,-44,-32,-107,-127,-13,70,-162
-56,-10,-47,-33,-60,-85,-65,53,-303
21,12,-37,-21,-81,-85,-8,53,-146
19,5,-31,-23,-57,-34,11,9,-101
11,-19,-49,-48,-93,-68,9,28,-229
6,1,-23,-49,-54,-40,-2,44,-117
6,-18,-15,-59,-70,-97,-1,69,-185
16,26,-35,-1,-43,-53,8,46,-36
5,12,-47,-25,-87,-76,-8,69,-157
14,2,-14,-38,-73,-62,-11,37,-145
11,-5,-53,-23,-48,-67,-3,42,-146
-5,-1,-61,-36,-35,-70,-28,22,-214
18,-27,22,56,-114,-16,-15,134,58
19,19,-23,2,-78,-82,-16,34,-125
24,12,-40,-12,-126,-108,1,44,-205
8,-32,-17,-45,-72,-66,-19,42,-201
34,11,-54,-15,-171,-100,-12,96,-211
0,-14,-37,-11,-67,-53,-9,39,-152
29,54,-24,-72,-90,-117,-23,124,-119
21,36,-55,-42,-88,-115,-54,75,-222
-5,11,-20,-39,-40,-22,-6,22,-99
34,-8,-20,-4,-65,-87,-25,58,-117
11,-2,-86,-19,-104,-198,-74,138,-334
16,-22,-53,-26,-91,-50,20,62,-144
6,-22,-40,-10,-33,-66,-15,27,-153
20,24,-36,-66,-111,-55,1,72,-151
10,-4,-40,-12,-52,-51,-21,34,-136
51,33,-86,-90,-150,-159,-25,153,-273
1,11,-25,-16,-41,-46,-5,17,-104
2,3,-56,-52,-71,-57,-6,49,-188
7,-26,-46,-47,-52,-83,-22,21,-248
35,14,-16,-18,-34,-84,0,15,-88
14,-3,-49,-36,-52,-71,-6,37,-166
27,10,-85,-43,-98,-136,-30,90,-265
1,4,-21,-22,-29,-50,-1,22,-96
-6,0,-13,-23,-31,-36,-7,30,-86
46,4,-45,-8,-118,-100,-10,48,-183
10,4,-45,-50,-23,-67,-5,42,-134
17,0,-43,-26,-80,-53,-39,53,-171
2,0,-32,-30,-26,-48,-13,22,-125
-15,-2,-22,-36,-34,-29,5,30,-103
-8,16,-32,-13,-52,-46,-9,35,-109
14,7,-33,-22,-61,-54,-26,45,-130
43,42,-32,-19,-83,-56,-7,97,-15
30,16,-17,13,-135,-37,20,123,13
7,16,-60,-39,-111,-47,6,48,-180
2,10,-28,-18,-31,-42,-17,50,-74
28,4,26,16,-5,-14,-8,54,101
11,28,-19,17,-63,-45,-15,34,-52
50,-12,-55,-11,-111,-110,-9,14,-244
-4,26,-20,-30,-9,-45,2,46,-34
137,72,12,56,-165,-175,-71,197,63
30,37,-24,-40,-74,-58,-4,76,-57
6,2,-44,0,-101,-43,-8,46,-142
22,17,-26,-3,-43,-52,8,14,-63
14,53,-11,-20,-8,-46,-2,66,46
7,5,-15,-12,-42,-41,-16,38,-76
13,9,-24,-27,-31,-36,-8,28,-76
30,11,-4,-13,-20,-31,-24,52,1
-7,-7,-22,-18,-45,-42,-24,41,-124
56,-8,-52,15,-103,-62,10,50,-94
0,24,-30,-4,-48,-67,-21,36,-110
21,-9,-98,-61,-117,-140,0,63,-341
26,10,-4,-11,-42,-37,13,29,-16
14,5,-36,-30,-16,-43,-11,17,-100
-4,6,-42,-34,-82,-94,-25,23,-252
9,14,-18,-31,-17,-33,-2,32,-46
-5,4,-33,-34,-58,-32,5,30,-123
-27,35,-15,-12,-39,-37,-17,14,-98
11,3,-13,-8,-30,-44,-17,21,-77
20,14,-16,4,-25,-21,15,36,27
9,6,-2,-18,-64,-28,-24,72,-49
15,41,-37,-40,-73,-78,-12,73,-111
39,18,-14,-5,-40,-58,8,62,10
3,43,-7,-29,-48,-67,1,58,-46
8,37,-16,-30,-52,-68,-11,37,-95
1,13,-3,-19,-14,-12,-1,34,-1
3,-6,-17,-14,-34,-26,-3,19,-78
-2,37,-27,-1,-64,-68,-18,77,-66
26,34,-2,-1,-43,-27,3,67,57
18,22,0,-18,-24,-86,-11,34,-65
-5,0,-17,-23,-27,-11,10,28,-45
9,15,-24,-11,-26,-53,-4,41,-53
-1,-7,-37,-37,-70,-63,-18,-3,-236
13,40,-32,-16,-36,-61,5,51,-36
4,10,-28,-29,-26,-32,-5,17,-89
7,2,-26,-13,-42,-21,12,30,-51
-5,14,-19,-25,-58,-32,-20,40,-105
-2,27,-39,-39,-44,-63,-7,56,-111
45,14,-30,-50,-58,-80,2,48,-109
32,17,-13,-4,-33,-38,25,28,14
16,3,-23,-24,-75,-65,-10,37,-141
47,5,-57,-51,-107,-138,-32,31,-302
-6,18,-52,-29,-91,-51,-18,61,-168
-10,17,-34,-34,-45,-50,-31,21,-166
20,22,-57,-70,-109,-91,7,103,-175
-20,26,-52,-42,-59,-82,-15,48,-196
13,15,-58,-13,-132,-98,-4,73,-204
14,52,-36,-6,-85,-112,11,78,-84
9,23,-40,-43,-41,-70,-10,29,-143
82,24,-85,-107,-227,-300,-36,158,-491
-37,8,-56,-43,-96,-28,-5,64,-193
15,11,-29,-10,-36,-31,5,13,-62
11,-1,-22,-17,-11,-59,-17,38,-78
17,4,-20,-66,-21,-64,-15,48,-117
24,-8,-34,-42,-60,-115,-58,56,-237
-12,18,-48,-50,-35,-63,4,58,-128
-7,35,-65,-49,-73,-115,-10,79,-205
6,19,-43,-22,-40,-60,-4,24,-120
31,28,-37,-47,-63,-91,4,47,-128
10,-2,-33,-32,-89,-54,-1,50,-151
-3,5,-25,-31,-55,-53,-33,38,-157
26,13,-32,-31,-71,-86,5,71,-105
7,25,-4,18,-38,-50,2,52,12
10,5,-28,-10,-54,-79,-12,39,-129
5,23,-29,-13,-49,-70,-21,60,-94
32,-15,-71,-23,-92,-68,-4,56,-185
23,3,-55,-36,-89,-91,-5,96,-154
33,13,18,31,-47,-5,-3,57,97
-12,27,-36,-46,-36,-29,0,43,-89
-5,8,-19,-5,-26,-34,-3,28,-56
4,8,-25,-20,-57,-49,-3,28,-114
9,-6,-21,-24,-63,-84,-13,47,-155
7,-8,-15,-11,-30,-54,-4,38,-77
-15,13,-20,-22,-17,-38,-13,50,-62
19,20,-43,-36,-87,-85,-7,55,-164
23,45,-7,-12,-23,-54,8,53,33
-24,-20,-48,-4,-71,-121,-38,52,-274
9,12,-53,-14,-36,-66,-21,33,-136
-2,-12,-66,-37,-96,-88,-16,41,-276
18,-21,-20,-33,-39,-43,-19,15,-142
14,32,-22,-30,-74,-69,-17,66,-100
17,0,-49,-24,-122,-100,-18,46,-250
12,7,-44,-4,-74,-70,-17,77,-113
33,35,-4,-16,-13,-73,-9,64,17
17,-22,-74,-20,-134,-97,1,27,-302
9,7,-14,-22,-28,-25,-11,32,-52
28,21,-40,-17,-47,-44,8,54,-37
10,21,-1,-22,-20,-44,-12,23,-45
21,33,-51,-39,-29,-61,-5,61,-70
80,2,40,-5,-87,-132,12,108,18
11,-1,-19,22,-65,-35,7,47,-33
3,-8,-39,-14,-47,-64,-24,18,-175
11,24,-23,-8,-18,-12,20,16,10
39,66,-89,-72,-152,-201,-27,145,-291
25,45,-39,-40,-73,-54,13,53,-70
163,50,-152,-49,-213,-169,8,123,-239
30,16,-20,-37,-51,-76,-6,58,-86
-7,-8,-32,-23,-45,-30,-10,26,-129
3,21,-22,-11,-26,-32,17,27,-23
41,-36,-46,-29,-103,-100,-19,64,-228
5,4,-27,-12,-92,-60,-17,35,-164
9,37,-7,-7,-35,-28,14,40,23
0,14,-4,-30,-66,-67,1,60,-92
8,30,-3,-3,2,-21,10,35,58
-29,-4,-26,-28,-40,-40,-22,48,-141
6,15,-25,-36,-65,-32,4,47,-86
7,-9,-58,-49,-112,-144,-53,84,-334
20,7,-47,-19,-51,-58,-13,34,-127
13,6,-28,-20,-32,-66,0,40,-87
1,-8,-56,-43,-81,-67,-14,39,-229
13,44,-29,-23,-36,-55,4,90,8
14,3,-56,-21,-109,-114,-29,61,-251
22,24,-35,-6,-57,-85,-25,42,-120
-12,12,-14,-29,-45,-25,-9,39,-83
-2,-1,-31,-21,-40,-47,-18,35,-125
0,2,-17,-21,-25,-27,16,39,-33
18,-16,-58,-8,-99,-93,-13,46,-223
40,9,-38,-63,-128,-143,-31,54,-300
24,38,-22,-16,-97,-99,14,68,-90
17,-25,-52,-45,-115,-87,-22,74,-255
-3,14,-21,-7,-58,-18,-3,22,-74
-4,1,-29,-14,-47,-30,-20,39,-104
32,18,4,-21,-17,-37,17,29,25
-4,23,-9,-19,-26,-29,1,34,-29
1,13,-24,-39,-37,-8,-9,45,-58
25,-28,-81,-52,-103,-102,-1,30,-312
7,10,-13,-19,-33,-57,-22,60,-67
1,22,-16,-26,-28,-47,-14,23,-85
25,13,-52,-35,-107,-119,-13,97,-191
0,37,-54,-64,-66,-70,-15,56,-176
13,15,-17,-26,-43,-44,4,28,-70
5,-9,-39,-19,-53,-68,-17,24,-176
13,16,-19,-11,-37,-32,-13,39,-44
19,-14,-43,-22,-81,-82,-8,13,-218
28,10,-34,-46,-31,-42,4,19,-92
21,19,-6,-29,-27,-30,17,58,23
2,60,-74,-103,-127,-164,-20,63,-363
5,69,-53,-47,-89,-76,20,90,-81
12,7,-16,-5,-29,-18,7,22,-20
23,-4,-18,-27,-31,-40,1,28,-68
5,10,-45,-38,-82,-68,-15,89,-144
11,37,-76,-54,-100,-82,9,83,-172
11,0,-25,0,-48,-28,7,36,-47
8,1,-78,-25,-113,-103,-44,69,-285
-1,-1,-9,-22,-29,-51,-12,36,-89
21,17,-42,-24,-58,-58,13,102,-29
-5,-7,-64,-61,-51,-134,-37,72,-287
19,19,-12,4,-28,-73,-13,38,-46
33,-12,-8,-36,-48,-88,-20,73,-106
-9,17,-52,-32,-46,-49,-23,28,-166
58,39,-18,13,-125,-94,-32,148,-11
9,24,-42,-39,-31,-91,-3,45,-128
12,20,-55,-43,-81,-75,7,75,-140
71,11,-8,-12,-113,-104,-12,154,-13
17,10,-15,2,-30,-41,2,24,-31
22,46,-23,-62,-66,-81,-12,141,-35
-4,-17,-46,-34,-126,-60,-8,68,-227
15,26,-37,-31,-66,-71,-25,65,-124
12,-13,-36,-38,-85,-80,-27,39,-228
19,-17,-58,-36,-58,-78,-24,53,-199
-14,10,-31,-13,-52,-26,-11,35,-102
-3,18,-39,-25,-64,-29,-11,54,-99
3,20,-7,-33,-68,-7,12,88,8
23,11,-41,15,-91,-36,24,43,-52
15,9,-54,-4,-123,-62,6,72,-141
16,18,16,-10,-14,-1,-5,55,75
36,2,-57,-21,-103,-72,-8,61,-162
50,35,-48,-39,-69,-87,-17,83,-92
5,8,-10,-32,-46,-77,-40,76,-116
26,1,-38,-32,-59,-76,5,64,-109
-16,22,-20,-45,-55,-51,-7,59,-113
-4,26,-32,-41,-37,-38,-12,28,-110
72,16,-79,-104,-112,-113,-16,127,-209
31,15,-5,-32,-73,-102,-7,70,-103
23,21,-24,0,-29,-17,4,33,11
26,38,-59,-53,-56,-110,12,71,-131
30,-21,-34,-16,-63,-67,8,2,-161
38,-14,-24,-1,-48,-35,-3,37,-50
-2,27,-27,-32,-23,-106,-6,68,-101
19,6,-13,-29,-38,-27,4,32,-46
8,41,2,-19,4,-64,-1,61,32
18,16,-23,2,-27,-35,5,24,-20
25,38,-33,-19,-72,-93,-21,37,-138
10,24,-6,-8,-29,-53,-17,40,-39
2,25,-38,-24,-49,-46,-18,28,-120
30,17,-48,-38,-67,-45,5,34,-112
74,13,2,21,-81,-27,1,114,117
-13,34,-33,-18,-87,-100,-57,81,-193
10,1,-32,-27,-43,-42,9,34,-90
-14,11,3,8,-33,7,-6,40,16
10,20,-49,-30,-94,-66,-20,72,-157
18,2,-22,-27,-12,-55,-2,46,-52
12,54,-36,-36,-78,-47,1,116,-14
16,11,-36,-23,-23,-57,-18,54,-76
-4,13,-30,-18,-83,-21,4,64,-75
0,19,-42,-46,-52,-61,7,65,-110
34,16,-32,-19,-53,-58,-3,16,-99
27,24,-36,-31,-63,-58,34,75,-28
44,21,8,4,-54,-54,2,102,73
14,5,-26,-21,-73,-44,-22,23,-144
15,33,-72,-46,-182,-126,-35,74,-339
11,9,-28,-1,-25,-38,-7,46,-33
27,-15,-37,-10,-149,-79,-10,121,-152
14,32,-45,-48,-96,-123,-11,66,-211
9,20,-42,-39,-93,-65,-15,87,-138
-1,0,-41,-28,-46,-78,-4,40,-158
15,29,-19,-25,-25,-28,17,31,-5
5,1,-44,-36,-55,-67,-13,36,-173
-10,2,-39,-19,-35,-36,-10,48,-99
22,0,-38,-33,-93,-77,10,25,-184
31,9,-58,-10,-107,-88,-4,45,-182
30,29,-16,-22,-29,-44,-11,44,-19
45,5,-50,-24,-73,-92,-8,14,-183
8,8,-1,21,-19,-19,6,25,29
23,5,-18,-4,-19,-35,7,27,-14
5,-10,-20,-12,-45,-46,3,44,-81
45,16,-16,14,-43,-28,3,47,38
27,24,-28,9,-136,-88,28,58,-106
1,26,-33,-26,-17,-23,-1,34,-39
10,16,-16,-24,-22,-33,6,23,-40
19,28,-28,-23,-69,-83,-5,51,-110
7,26,-31,-7,-27,-18,18,29,-3
14,20,-26,-15,-28,-54,-10,34,-65
-32,39,-55,-92,-124,-76,-34,131,-243
10,2,-53,-29,-85,-51,-2,34,-174
9,5,-50,-8,-102,-43,-15,61,-143
-16,15,-48,-56,-70,-47,14,69,-139
64,59,-54,23,-125,-117,19,87,-44
21,17,-25,-33,-32,-47,-25,56,-68
28,-39,-72,-6,-176,-119,-2,65,-321
24,19,-33,-18,-42,-70,9,38,-73
73,-29,-45,28,-145,-118,-5,74,-167
13,-4,-19,-24,-49,-58,-1,29,-113
0,19,-11,-22,-44,-32,-5,13,-82
7,25,-26,-28,-36,-63,21,81,-19
74,49,-47,1,-84,-68,34,23,-18
-30,23,-68,-75,-55,-131,-22,32,-326
25,23,-4,-11,-22,-40,2,61,34
4,17,-38,-7,-60,-52,-14,31,-119
49,4,-34,5,-63,-94,-6,46,-93
-14,1,-45,-22,-53,-33,-8,25,-149
44,17,-67,-17,-129,-104,9,52,-195
11,32,0,-27,-19,-58,-30,54,-37
47,11,-47,-37,-101,-154,-12,29,-264
13,-14,-34,-22,-63,-47,2,23,-142
12,12,-31,-23,-60,-43,7,24,-102
17,14,-6,-6,-11,-28,-1,35,14
20,8,-29,-9,-30,-5,12,38,5
1,0,-24,-29,-53,-41,-12,24,-134
6,-1,-18,-33,-35,-39,-2,26,-96
-6,-7,-51,-58,-86,-98,-15,47,-274
7,-13,-21,-3,-44,-24,-1,25,-74
7,-1,-38,-14,-31,-40,-26,6,-137
47,3,2,-35,-61,-81,-3,62,-66
35,-28,-53,-28,-142,-133,-54,78,-325
46,-8,-31,1,-61,-72,-11,22,-114
12,-1,-43,-14,-93,-98,-31,56,-212
-13,1,-42,-59,-44,-104,-40,45,-256
0,23,-57,-6,-105,-48,6,76,-111
75,-2,-3,-91,-60,-139,45,134,-41
6,2,-21,-29,-35,-47,1,7,-116
14,-26,-47,-14,-91,-69,3,23,-207
18,1,-45,-21,-100,-64,-9,46,-174
15,9,-63,-74,-91,-120,-26,93,-257
5,17,-17,-24,-16,-21,16,28,-12
12,-9,-17,-7,-42,-7,-10,26,-54
5,-32,-45,-13,-158,-104,-6,89,-264
-2,-11,-66,-38,-76,-76,-4,29,-244
-4,16,-54,-35,-81,-80,-26,26,-238
29,11,3,-44,-21,-40,-2,68,4
-4,-2,-37,-46,-36,-64,-19,40,-168
7,14,-9,-8,-27,-24,10,40,3
2,-3,-44,-32,-69,-65,-6,71,-146
-1,33,-46,-24,-64,-46,9,48,-91
69,63,-61,-27,-67,-79,26,106,30
6,5,-36,-25,-89,-59,-7,46,-159
-1,7,-22,-7,-56,-29,1,25,-82
2,5,-26,-18,-38,-76,-37,55,-133
5,33,-32,-21,-28,-72,-28,25,-118
16,6,-40,-60,-87,-81,-21,48,-219
4,-3,-45,-50,-86,-76,-27,73,-210
19,11,-46,-63,-82,-86,-36,67,-216
56,59,-35,-10,-85,-98,6,88,-19
-5,10,9,12,-25,-10,-8,39,22
-4,-12,-60,-42,-80,-32,-2,42,-190
7,20,-24,-25,-50,-56,-32,41,-119
14,32,-62,-24,-114,-166,-60,78,-302
-5,5,-38,-44,-52,-20,-6,57,-103
40,1,-7,-3,-50,-41,-4,61,-3
-2,-13,-36,-42,-59,-59,-17,92,-136
-8,27,-10,-25,-16,-39,-16,40,-47
21,23,-11,-38,-73,-26,6,66,-32
32,4,-35,-48,-71,-67,-10,52,-143
19,19,-63,-34,-139,-70,-25,109,-184
2,-3,-30,-36,-46,-39,5,12,-135
37,23,-7,-4,4,-39,18,20,52
7,12,-34,-9,-45,-70,-25,44,-120
-10,7,-22,-17,-39,-30,6,20,-85
18,14,-57,-36,-84,-94,-24,59,-204
28,17,-26,-19,-63,-94,6,56,-95
-1,1,-22,-13,-43,-65,-29,27,-145
31,15,6,-4,-33,-61,-15,90,29
24,19,-68,-41,-115,-52,-3,76,-160
44,28,-44,-10,-76,-63,-2,46,-77
2,65,-26,-50,-52,-113,-17,80,-111
-26,16,-63,-61,-68,-68,-13,48,-235
24,-23,-66,-51,-113,-136,-38,81,-322
18,50,-42,-16,-70,-103,-16,76,-103
22,4,-35,-25,-77,-78,-20,46,-163
9,7,-24,-19,-50,-41,-12,15,-115
24,16,-30,-9,-53,-59,8,27,-76
8,5,-44,-21,-26,-69,-23,40,-130
-27,0,-32,-61,-73,-27,-3,62,-161
3,19,-3,-24,-23,-35,11,29,-23
13,7,-60,-38,-84,-85,-5,39,-213
23,-6,-86,0,-152,-126,1,55,-291
17,-10,-12,-11,-21,-35,-8,36,-44
16,6,-25,-3,-66,-62,-19,48,-105
12,8,-6,-26,-37,-49,-13,40,-71
9,16,-26,-12,-36,-34,-19,33,-69
29,2,-59,-17,-124,-73,6,39,-197
49,7,7,-11,-12,-93,-28,74,-7
0,-4,-50,-3,-100,-58,-7,39,-183
44,18,-62,20,-147,-103,1,59,-170
43,45,-65,-45,-75,-100,11,66,-120
-5,30,-57,-27,-76,-77,-28,53,-187
33,25,-35,-43,-78,-123,1,88,-132
14,15,-52,-45,-50,-82,-7,36,-171
18,28,-12,-21,-33,-53,1,47,-25
-8,8,-61,-61,-154,-78,13,37,-304
8,-22,-65,-46,-79,-85,-15,44,-260
12,18,-32,-41,-27,-38,-31,61,-78
11,43,-73,-57,-139,-136,-20,120,-251
17,-18,-35,-44,-50,-127,-46,38,-265
16,16,-4,-26,-17,-43,-12,24,-46
87,8,-66,-14,-157,-147,-10,85,-214
41,-27,-61,-38,-172,-133,-3,69,-324
9,36,-33,-30,-75,-36,4,73,-52
-11,12,-41,-31,-46,-37,-11,35,-130
-4,13,-29,-30,-9,-35,-13,34,-73
5,6,-41,-14,-113,-73,-2,31,-201
29,30,-31,-21,-57,-57,-1,73,-35
34,31,-7,-2,-81,-35,-6,60,-6
0,-33,-57,-7,-101,-58,-6,21,-241
0,4,-36,-30,-41,-37,-6,35,-111
30,2,-31,9,-59,-54,10,7,-86
30,19,-48,-50,-102,-122,-7,107,-173
23,20,-70,5,-177,-120,-10,99,-230
-6,19,-1,-38,-16,-22,10,40,-14
-1,28,-118,-115,-193,-169,-34,98,-504
1,-27,-47,-33,-54,-77,-22,17,-242
8,8,-49,-3,-121,-61,0,61,-157
11,-16,-57,-21,-155,-102,13,38,-289
17,19,-2,-6,-24,-36,16,47,31
9,17,-19,-22,-8,-38,5,22,-34
19,-12,-31,-17,-104,-62,-20,66,-161
61,5,-19,-38,-106,-189,-10,123,-173
32,-23,-50,-45,-57,-57,-3,54,-149
20,-7,-15,-56,-46,-78,-29,51,-160
2,-3,-45,2,-128,-52,14,93,-117
21,63,-39,2,-27,-16,20,8,32
38,8,-37,-26,-79,-64,3,28,-129
-1,10,-31,-10,-50,-51,-14,19,-128
8,1,-80,-40,-155,-71,-8,99,-246
-12,10,-34,-22,-45,-45,0,29,-119
-6,17,-42,-30,-78,-75,-14,63,-165
4,19,-41,-20,-31,-75,-12,39,-117
-1,8,-27,-26,-10,-55,-9,31,-89
-13,13,-31,-27,-37,1,10,22,-62
19,6,-3,-15,-41,-55,-22,34,-77
-3,5,-38,-32,-60,-54,6,29,-147
31,26,-43,-2,-79,-106,-8,50,-131
20,8,-21,-38,-39,-51,-6,50,-77
30,25,-68,-43,-134,-172,-53,23,-392
15,40,-28,-49,-48,-24,-21,64,-51
-4,6,-46,-35,-110,-106,-9,108,-196
0,17,-22,-24,-29,-4,12,35,-15
7,18,-22,-24,-57,-53,-8,72,-67
2,32,-31,-50,-66,-101,-56,51,-219
-4,8,-25,-26,-25,-32,4,29,-71
13,1,-36,-17,-124,-41,1,69,-134
13,23,-47,-51,-125,-122,-30,98,-241
-5,9,-31,-24,-40,-45,-14,25,-125
-13,14,-49,-49,-81,-86,-37,30,-271
12,7,-26,-42,-51,-82,-33,50,-165
10,-5,-65,-32,-121,-100,-8,21,-300
35,13,-10,-2,-35,-41,-2,25,-17
30,41,-23,3,-16,-60,-8,35,2
-16,28,-25,-23,-32,-36,-19,35,-88
53,12,-75,-22,-108,-116,-45,78,-223
55,40,-52,20,-114,-181,6,80,-146
10,5,-40,-29,-80,-73,-13,83,-137
24,38,-1,-10,-25,-53,2,13,-12
7,24,-47,-13,-66,-67,4,57,-101
12,11,-27,-28,-39,-33,-10,34,-80
31,38,-36,-25,-26,-82,2,42,-56
67,27,-77,-26,-120,-119,-53,84,-217
12,-3,-29,-43,-48,-47,-3,21,-140
18,23,-89,-48,-121,-59,-36,76,-236
17,-1,-53,-22,-59,-32,2,36,-112
11,7,-26,-3,-59,-53,-8,25,-106
15,12,-32,-10,-47,-22,-9,37,-56
16,17,-132,-51,-239,-100,-29,54,-464
1,18,-13,-23,-28,-56,-8,43,-66
9,18,-19,-12,-42,-23,-6,29,-46
-6,3,-15,-13,0,-25,5,33,-18
2,-2,-33,-20,-32,-44,-7,7,-129
5,22,-43,-13,-62,-73,1,38,-125
8,8,-26,17,-62,-31,-1,45,-42
36,9,-35,-11,-130,-88,-16,68,-167
5,24,-33,-52,-37,-91,8,46,-130
-22,-23,-56,-89,-80,-116,-21,97,-310
-4,19,-11,-4,-12,-69,-5,56,-30
17,0,-33,3,-51,-43,11,16,-80
0,3,-31,-24,-32,-14,9,30,-59
22,23,-44,-10,-55,-60,-15,30,-109
-4,-6,-41,2,-79,-57,-21,63,-143
22,3,-27,-12,-56,-75,-18,30,-133
15,16,-26,0,-53,-43,-5,30,-66
4,5,-52,-25,-73,-57,-19,73,-144
38,30,-14,-21,-59,-73,-12,56,-55
12,14,-42,-27,-56,-38,-6,17,-126
-67,-51,-135,-10,-193,-142,-51,91,-558
17,37,-42,-35,-52,-63,-34,63,-109
48,50,-68,-66,-93,-127,-3,76,-183
-2,18,-47,-38,-22,-63,-29,32,-151
-11,7,-28,-16,-55,-16,-2,30,-91
-2,-13,-48,-28,-66,-57,-26,29,-211
81,13,-19,-44,-94,-203,-66,194,-138
3,-10,-24,-22,-44,-40,-5,35,-107
11,-20,-70,-11,-101,-100,-10,53,-248
36,-1,-49,-2,-66,-50,9,41,-82
19,26,-22,-6,-30,-38,-2,40,-13
14,8,-111,-72,-264,-131,11,144,-401
4,14,-26,-15,-63,-54,-3,32,-111
27,3,-64,13,-117,-176,-26,138,-202
13,28,-27,-2,-41,-22,3,34,-14
0,27,-9,-19,-3,-28,-1,32,-1
28,12,-10,57,-110,-10,-6,77,38
12,67,-11,-35,-84,-44,-2,125,28
4,-7,-29,-35,-50,-53,-13,21,-162
16,-3,-50,0,-105,-76,3,54,-161
30,17,-78,-14,-122,-34,7,65,-129
55,39,-49,-16,-58,-59,15,41,-32
30,12,-24,10,-51,-68,-35,55,-71
46,31,-54,16,-154,-111,10,164,-52
65,3,-73,-28,-100,-175,-51,99,-260
-3,23,-29,-13,-63,-85,-26,48,-148
0,18,-55,-55,-95,-110,-12,77,-232
18,12,-31,-13,-44,-34,-5,19,-78
1,5,-38,1,-45,-134,-79,74,-215
12,32,-19,-20,-22,-73,7,58,-25
35,23,-80,-63,-184,-147,15,62,-339
35,29,-61,-57,-157,-204,-50,141,-324
8,-22,-73,-45,-107,-69,-18,70,-256
33,30,-77,-39,-157,-85,-3,59,-239
5,-8,-27,-32,-27,-48,-7,33,-111
28,2,-24,-56,-81,-43,-14,47,-141
32,3,-59,7,-112,-110,-22,35,-226
43,6,-14,-14,-20,-45,-19,52,-11
4,9,-34,1,-47,-33,2,17,-81
13,35,-36,-30,-119,-80,6,77,-134
14,-4,-3,-16,-21,-69,-18,56,-61
37,10,-39,-18,-83,-78,7,27,-137
9,32,-27,-25,-35,-76,-1,33,-90
25,-13,-94,-69,-160,-177,-57,36,-509
18,12,-39,-10,-99,-77,0,40,-155
-3,-23,-27,-21,-67,-15,-2,21,-137
15,5,-42,0,-44,-28,2,24,-68
19,7,-21,-15,-47,-52,1,37,-71
23,19,-34,-31,-40,-55,-14,35,-97
-30,23,-43,-49,-122,-24,13,78,-154
8,10,-7,-17,-35,-36,2,28,-47
17,-11,-42,-29,-35,-78,-17,50,-145
26,32,-36,-50,-38,-67,-11,36,-108
6,11,-11,-4,-36,-26,-15,40,-35
4,3,-60,-32,-111,-56,-18,69,-201
12,2,-43,-11,-63,-90,-9,30,-172
25,47,0,-8,-45,-29,15,68,73
2,10,-24,-31,-31,-39,-12,21,-104
46,42,-61,-43,-147,-105,-6,37,-237
16,20,-34,-24,-16,-35,-8,53,-28
45,50,-9,-39,-31,-14,28,102,132
22,8,-43,-15,-97,-103,-22,70,-180
47,-2,-42,4,-97,-111,15,45,-141
-2,10,-12,-13,-26,-32,-19,50,-44
21,-2,-90,-29,-86,-62,-4,43,-209
24,28,-27,-83,-101,-120,-28,84,-223
15,2,-31,-26,-68,-49,-6,21,-142
-18,13,-39,-62,-65,-50,-4,66,-159
12,48,-33,-28,-77,-102,-29,82,-127
-87,-107,-108,-19,-171,-167,-83,74,-668
6,21,2,2,-21,-36,9,26,9
-3,8,-38,-36,-70,-89,-10,33,-205
13,9,-23,0,-41,-33,-5,33,-47
31,11,-33,-45,-131,-149,-18,114,-220
35,24,-12,-5,-58,-36,6,66,20
-2,18,-38,-17,-42,-42,-14,39,-98
2,26,-28,-13,-33,-27,5,50,-18
23,5,-56,-17,-95,-77,-6,15,-208
-96,-14,-113,-98,-134,-125,-59,61,-578
9,-23,-64,-31,-100,-85,-25,45,-274
19,77,-38,-30,-64,-123,-18,100,-77
-1,28,2,0,-28,-20,12,30,23
-7,8,0,8,-15,10,-21,37,20
18,9,-13,-20,-60,-34,12,15,-73
40,3,-34,6,-145,-63,-12,65,-140
1,-23,-52,-16,-107,-39,13,42,-181
12,12,-17,-36,-73,-69,-10,64,-117
21,-8,-43,-12,-48,-78,-34,34,-168
26,-9,-63,-34,-125,-85,4,62,-224
2,20,-58,-37,-82,-79,-13,76,-171
26,57,-25,-18,-37,-64,-2,55,-8
7,17,-21,-5,-39,-44,-11,45,-51
1,3,-39,-46,-62,-63,-23,52,-177
34,-16,-72,-30,-179,-64,-7,101,-233
11,38,-22,-3,-50,-44,-1,61,-10
6,-6,-41,-10,-54,-47,-5,23,-134
27,19,-57,-23,-109,-75,-12,88,-142
44,-11,-92,-8,-118,-92,9,27,-241
-6,5,-21,-18,-33,-41,-13,26,-101
26,32,-47,-45,-165,-176,-35,136,-274
6,14,-17,-3,-42,-76,-22,47,-93
32,-2,-30,-5,-114,-26,23,93,-29
6,27,-11,-15,-9,-44,-22,42,-26
16,16,-24,-18,-57,-73,4,42,-94
15,21,-12,51,-133,9,-32,104,23
37,4,-35,-51,-90,-65,-20,81,-139
-21,6,-90,-67,-90,-112,-11,40,-345
9,-22,-57,-69,-66,-145,-26,74,-302
24,53,-22,12,-53,-41,-8,50,15
-17,32,-35,-41,-102,-71,-16,61,-189
6,10,-46,-27,-67,-68,-22,37,-177
-12,-47,-63,-52,-66,-71,-18,47,-282
31,34,-52,-15,-69,-94,1,81,-83
7,14,-41,-31,-111,-85,2,48,-197
34,-32,-45,-7,-104,-73,-10,65,-172
44,7,-88,-35,-119,-97,15,55,-218
15,12,-29,5,-53,-19,-7,24,-52
25,13,-54,2,-130,-66,0,53,-157
13,29,-41,-31,-46,-65,-5,59,-87
64,27,-44,-41,-86,-80,-6,16,-150
-4,10,-16,-41,-23,-27,9,59,-33
16,11,-13,-26,-51,-84,-13,68,-92
-8,30,-38,-74,-100,-123,-23,86,-250
0,9,-33,-11,-34,-10,1,10,-68
8,-6,-43,-42,-70,-70,-12,4,-231
3,9,-62,-35,-65,-44,22,69,-103
-6,16,-24,-25,-31,-39,-19,38,-90
7,-9,-19,-34,-38,-22,-8,31,-92
-1,4,-21,-25,-39,-80,-25,16,-171
15,18,-29,5,-43,-39,19,26,-28
22,13,-26,-25,-39,-46,-5,24,-82
19,19,-17,5,-54,-29,-8,51,-14
19,-1,-30,-27,-53,-74,-21,16,-171
14,12,-31,-13,-33,-65,-18,32,-102
9,11,-50,-42,-79,-39,16,51,-123
30,7,10,36,-78,-30,-30,99,44
57,42,-42,11,-73,-67,28,74,30
36,25,-7,-49,-53,-67,-4,26,-93
51,45,0,-53,-41,-48,20,153,127
8,30,-3,-19,-34,-19,5,38,6
12,10,-60,27,-94,-84,-20,84,-125
12,18,-70,-21,-130,-65,-4,74,-186
-16,-15,-31,-63,-75,-82,-47,73,-256
14,17,5,-12,-55,-1,4,46,18
26,21,-97,-49,-116,-181,-94,110,-380
-15,11,-83,-54,-135,-74,-5,103,-252
56,34,-84,-30,-173,-143,0,98,-242
24,-9,-23,-8,-31,-42,3,22,-64
1,17,-46,-21,-98,-78,-19,65,-179
37,48,-40,-38,-95,-103,-28,88,-131
8,75,-29,-51,-151,-82,20,128,-82
-16,8,-34,-57,-48,-70,-10,56,-171
26,3,-57,-16,-51,-70,-4,42,-127
-6,1,-27,-30,-60,-45,-16,34,-149
23,60,-29,-27,-49,-100,-36,69,-89
-2,2,-25,-41,-43,-61,-24,55,-139
-11,23,-29,-13,-27,-22,6,47,-26
-6,9,-14,-45,-40,-34,4,78,-48
10,11,-32,-43,-27,-62,-16,50,-109
34,102,-22,-44,-28,-126,20,113,49
14,29,-24,-13,-39,-42,-17,44,-48
3,-5,-51,-38,-80,-65,-43,46,-233
23,51,-20,-18,-5,-51,-12,48,16
88,126,-61,-56,-86,-195,8,191,15
11,0,-28,-9,-29,-29,8,31,-45
19,37,-35,-27,-47,-57,3,44,-63
-12,-19,-52,-30,-87,-50,-26,29,-247
29,29,-64,-40,-125,-84,16,79,-160
25,22,-40,-68,-45,-102,-17,56,-169
86,36,-85,-10,-118,-115,-7,77,-136
18,26,-87,-39,-175,-127,-13,148,-249
31,-4,-39,10,-86,-69,1,34,-122
13,14,-75,-33,-113,-88,5,72,-205
10,-5,-17,-24,-42,-29,-6,7,-106
7,10,-5,-21,-17,-12,-4,27,-15
4,-19,-35,-23,-57,-72,-25,45,-182
-4,9,-39,-61,-71,-59,-39,53,-211
17,8,-46,-10,-112,-50,-7,49,-151
32,38,-36,-45,-36,-80,-6,68,-65
22,30,-68,-61,-116,-95,16,71,-201
19,6,-30,-49,-128,-150,-104,167,-269
11,43,-44,-20,-90,-59,-14,75,-98
33,-1,-81,9,-150,-112,-9,51,-260
13,-8,-46,-22,-54,-28,0,29,-116
13,10,-55,-26,-140,-51,4,61,-184
3,15,-19,-21,-64,-81,-2,41,-128
-12,4,-27,-47,-26,-51,-24,49,-134
40,-9,-60,-31,-109,-153,-42,67,-297
-2,35,-83,-80,-132,-124,-53,95,-344
33,-5,-48,-15,-123,-96,4,57,-193
16,17,-30,0,-65,-47,15,52,-42
2,34,-40,-22,-89,-45,-11,72,-99
22,34,-88,-41,-150,-93,16,74,-226
-5,11,-31,-41,-26,-28,-8,67,-61
36,-9,-35,-42,-68,-82,1,36,-163
-5,-5,-34,-43,-59,-27,-19,37,-155
18,20,-5,-33,-18,-26,-3,34,-13
25,8,-18,-20,-45,-42,-11,29,-74
-5,4,-40,-25,-42,0,6,40,-62
13,7,-91,-72,-180,-112,-12,70,-377
22,9,-24,-17,-34,-35,11,14,-54
8,4,-29,-7,-32,-40,-3,41,-58
-1,2,3,16,-17,-9,-10,35,19
5,37,-80,-50,-142,-81,13,103,-195
38,50,-77,-99,-224,-148,-1,139,-322
-11,14,-53,-43,-87,-32,-17,48,-181
17,7,-86,-11,-154,-119,-41,84,-303
10,24,-27,-15,-83,-3,-7,74,-27
85,0,-69,20,-158,-125,-21,68,-200
54,19,-84,-41,-55,-59,-5,35,-136
28,-12,-60,5,-148,-60,30,47,-170
30,19,-45,-43,-104,-118,-8,81,-188
19,-2,-59,-2,-98,-105,-26,52,-221
-4,34,-41,-49,-93,-68,13,90,-118
51,4,-49,-3,-122,-101,12,41,-167
21,2,-19,-20,-64,-95,-12,73,-114
31,15,-24,-7,-69,-88,-12,74,-80
-7,23,-37,-2,-16,-79,-29,57,-90
20,-7,-45,5,-91,-66,-38,82,-140
14,4,-23,-17,-23,-30,-9,19,-65
18,9,-28,-24,-68,-87,-11,57,-134
0,21,-25,-20,-43,-74,-21,26,-136
33,3,-70,-38,-143,-100,-32,103,-244
26,-4,-46,-21,-59,-50,-7,18,-143
68,4,-63,-6,-140,-112,-35,75,-209
36,40,17,21,-107,-80,2,130,59
8,33,-30,-43,-62,-70,1,37,-126
43,2,-31,-13,-125,-112,12,78,-146
33,27,-25,5,-51,-27,20,35,17
5,43,-53,-31,-71,-63,6,89,-75
36,-8,-60,-30,-88,-97,-18,33,-232
20,40,-64,-88,-108,-139,-10,83,-266
17,33,-58,-66,-53,-95,-5,65,-162
29,25,20,-13,-32,-34,12,92,99
-2,23,-18,-7,-17,-46,-10,35,-42
-6,6,-23,-24,-27,-32,-11,20,-97
18,17,-52,-45,-71,-94,-13,68,-172
20,-7,-58,-50,-73,-90,-22,24,-256
43,-1,-21,13,-98,-70,0,61,-73
17,16,-42,13,-121,-93,-9,49,-170
41,-13,-44,-33,-84,-96,-17,110,-136
11,21,-14,-18,-58,-21,-5,41,-43
5,29,-14,-7,-29,-5,3,51,33
18,24,-42,-40,-82,-85,-15,33,-189
15,2,-20,-26,-50,-37,4,39,-73
30,14,-21,6,-42,-67,-26,68,-38
28,22,0,-26,-39,-68,0,95,12
15,-20,-83,-64,-145,-192,-47,140,-396
5,25,-31,-24,-36,-41,3,40,-59
-11,17,-62,-34,-126,-40,-22,63,-215
29,-1,-60,-44,-54,-47,2,47,-128
-1,23,-19,-17,-28,-39,-12,37,-56
3,26,-14,-20,-36,-62,-7,40,-70
11,45,-27,-15,-35,-60,0,62,-19
37,19,-58,-11,-103,-115,4,41,-186
9,16,-40,-32,-85,-49,-12,46,-147
34,38,-21,-49,-87,-46,51,101,21
23,16,-21,-23,-35,-82,-18,27,-113
5,15,-6,-32,-8,-27,2,33,-18
9,-21,-44,-35,-115,-71,-7,13,-271
35,8,-45,-34,-116,-30,-9,95,-96
-91,-25,-125,-51,-153,-144,-78,81,-586
19,-36,-50,-32,-53,-51,0,36,-167
18,4,-72,-13,-156,-105,-15,58,-281
-2,19,-5,-26,-21,-43,-13,41,-50
13,-15,-47,-8,-130,-83,-15,42,-243
-3,13,-37,-45,-46,-94,-59,43,-228
27,14,-60,57,-125,-36,3,56,-64
27,25,-61,-36,-104,-77,6,43,-177
4,0,-40,1,-100,-56,-6,37,-160
25,12,-17,39,-79,-54,1,56,-17
19,26,-3,-8,-11,-21,18,45,65
21,5,-24,4,-29,-66,-21,29,-81
19,2,-24,-31,2,-63,-23,42,-76
40,3,-63,-13,-103,-117,-15,66,-202
47,19,-16,-26,-30,-82,-3,34,-57
78,37,-85,3,-219,-172,9,80,-269
-1,34,-54,-20,-69,-64,-28,64,-138
46,8,-134,-54,-161,-195,-29,127,-392
26,15,-40,-33,-50,-71,1,29,-123
23,18,-58,13,-151,-99,5,75,-174
15,20,-22,-21,-47,-44,-5,25,-79
36,16,-21,3,-49,-65,-6,75,-11
-1,13,-21,-29,-71,-66,-34,64,-145
-1,-4,-87,-34,-101,-106,-13,52,-294
31,-3,-41,5,-96,-66,-8,47,-131
2,54,-43,-43,-58,-88,-8,66,-118
-26,7,-55,-46,-52,-100,-19,22,-269
35,-2,-43,-5,-106,-75,3,28,-165
4,23,-41,-13,-37,-106,-30,71,-129
8,-15,-34,-47,-64,-88,-5,34,-211
11,-7,-46,-23,-120,-59,3,37,-204
8,-10,-41,-24,-44,-54,-14,19,-160
14,-28,-94,-32,-140,-107,-18,57,-348
51,17,-45,-20,-122,-59,9,36,-133
30,39,-14,-6,-30,-49,-8,7,-31
-4,20,3,-36,-46,2,-14,60,-15
10,16,-48,-12,-107,-42,13,60,-110
-12,-10,-46,-21,-68,-65,-43,60,-205
32,13,-66,-21,-62,-60,-19,58,-125
7,-1,-36,-64,-101,-64,-13,68,-204
0,3,-5,-13,-52,-22,2,29,-58
13,15,-21,-15,-35,-28,9,16,-46
-7,15,-24,-15,-21,-34,4,40,-42
20,19,-44,-7,-49,-64,3,29,-93
13,7,-47,-12,-79,-49,-20,31,-156
19,10,-49,-57,-96,-105,-33,76,-235
11,2,-43,-15,-79,-37,-3,41,-123
1,-11,-45,-28,-77,-68,-8,32,-204
-12,-2,-37,-25,-19,-45,5,52,-83
34,8,-45,-49,-78,-90,-1,54,-167
-70,-109,-173,-92,-167,-290,-136,104,-933
15,-18,-63,-24,-117,-98,10,51,-244
11,22,-1,-11,-36,-53,-18,25,-61
1,13,-12,-7,-11,-28,13,27,-4
26,22,-26,-41,-47,-95,-10,46,-125
9,9,-43,-21,-51,-41,-4,27,-115
25,20,-8,-10,-34,-68,-13,36,-52
10,32,-16,-28,-42,-28,13,69,10
13,-4,-43,-4,-106,-76,-10,59,-171
11,-3,-29,-4,-69,-74,-15,42,-141
1,11,-37,-37,-44,-47,-18,43,-128
-8,77,-21,-45,-99,-222,-71,166,-223
27,32,-38,2,-94,-55,2,96,-28
0,13,-31,-33,-62,-94,-45,69,-183
-26,-8,-31,-10,-50,-42,-20,41,-146
-90,-40,-151,-12,-202,-261,-123,116,-763
-92,-31,-110,-17,-142,-194,-123,122,-587
2,-2,-29,-42,-14,-42,-6,22,-111
23,-2,-48,-39,-63,-78,5,22,-180
2,8,-13,6,-74,-35,-6,37,-75
-22,1,-18,-19,-51,-32,4,41,-96
16,-17,-54,-19,-100,-75,-19,62,-206
39,3,-89,-38,-148,-120,-16,101,-268
3,-16,-45,-65,-63,-66,-17,55,-214
9,-2,-28,-1,-21,-40,-11,29,-65
-5,-7,-41,-44,-77,-33,0,35,-172
82,-22,-51,-22,-190,-117,-16,154,-182
4,12,-22,-19,-18,-33,-9,28,-57
18,23,-35,-43,-22,-36,12,67,-16
24,20,-22,-29,-115,-57,0,49,-130
50,-24,-51,-67,-73,-137,-28,46,-284
21,-9,-41,-30,-64,-85,-10,25,-193
67,12,-26,12,-118,-126,-2,105,-76
48,8,-31,-42,-123,-120,-4,64,-200
11,-10,-35,-15,-60,-70,-18,10,-187
-42,-25,-41,-50,-68,-62,-43,50,-281
-1,23,-29,-14,-97,-5,5,73,-45
5,24,-62,-8,-132,-115,-16,53,-251
-1,4,-15,-21,-21,-18,-5,11,-66
15,8,3,2,-31,-16,10,42,33
-14,-5,-54,-39,-57,-62,-32,26,-237
-1,-5,-11,-3,-38,-34,-21,28,-85
3,3,-30,-28,-64,-55,-17,26,-162
13,-17,-49,-12,-55,-61,-24,29,-176
8,1,-13,-13,-31,-51,-8,18,-89
24,-4,-22,-18,-30,-15,-5,55,-15
-41,-2,-68,-66,-103,-114,-38,68,-364
9,-1,-19,-32,-16,-37,13,26,-57
12,20,-9,-14,-28,-47,-14,26,-54
26,-4,-33,-29,-26,-54,3,94,-23
40,6,-27,-22,-19,-54,-18,25,-69
-5,14,-29,-28,-40,-18,-4,51,-59
18,11,-29,-43,-27,-114,-10,73,-121
-8,18,-46,-59,-34,-80,-39,56,-192
52,13,-38,-32,-132,-91,-40,96,-172
72,-28,-50,55,-126,-98,-9,84,-100
22,23,-14,2,-32,-40,1,23,-15
25,27,6,-26,-46,-53,9,53,-5
22,3,-43,-13,-42,-64,-8,29,-116
24,53,-13,-12,-73,-50,7,70,6
5,24,-8,-32,-9,-62,-27,42,-67
15,45,-32,23,-116,-88,9,65,-79
14,51,-34,-6,-103,-59,-8,106,-39
9,34,-16,-5,-57,-6,9,56,24
9,34,-54,-56,-95,-132,-26,107,-213
49,7,15,52,-83,-64,-5,119,90
171,110,8,-10,-168,-85,-23,302,305
48,16,-25,25,-64,-29,24,29,24
-12,7,-33,-29,-34,-58,-21,50,-130
60,47,32,40,-54,-110,-29,94,80
17,40,-108,-90,-227,-68,10,150,-276
9,9,-32,-11,-60,-42,-13,42,-98
1,-13,-29,-23,-48,-48,-3,32,-131
52,28,-21,0,-61,-72,-23,78,-19
0,29,-27,-6,-75,-97,-17,71,-122
30,30,-43,-47,-106,-80,7,125,-84
32,61,-27,-12,-83,-101,-24,69,-85
1,9,-36,-47,-61,-107,-45,51,-235
-2,-2,-36,-22,-41,-65,-27,46,-149
8,-6,-67,-2,-123,-91,-14,44,-251
8,10,-45,-35,-49,-53,-19,59,-124
2,-5,-38,-35,-70,-65,-31,74,-168
3,-27,-34,-50,-90,-58,-25,54,-227
12,-3,-42,-53,-117,-70,5,41,-227
3,8,-23,-27,-30,-2,4,27,-40
27,58,-24,-62,-46,-137,-2,86,-100
2,45,-48,-14,-55,-43,-3,27,-89
6,41,-21,-42,-39,-55,-17,105,-22
25,8,-59,-12,-81,-74,-7,66,-134
18,14,-63,-23,-80,-46,7,60,-113
13,20,-9,-9,-27,-52,-14,67,-11
25,11,-24,-18,-57,-61,1,44,-79
-9,4,-35,-21,-46,-105,-38,61,-189
12,6,-17,-45,-52,-14,-14,26,-98
34,11,-45,-21,-81,-106,-14,59,-163
66,77,-129,-37,-252,-214,-21,191,-319
15,16,-32,-24,-45,-46,-4,39,-81
10,0,-55,-29,-114,-106,-18,63,-249
33,5,-81,-39,-121,-99,-20,53,-269
31,-4,-25,-25,-38,-35,8,19,-69
23,37,-10,-27,-13,-65,-20,24,-51
34,25,-20,-18,-58,-59,8,53,-35
17,8,-12,-35,-28,-61,-12,32,-91
-6,-6,-62,34,-115,-93,-10,66,-192
21,3,-10,7,-30,-8,-8,35,10
-10,1,-42,-21,-76,-60,-7,16,-199
10,11,-30,-22,-30,-32,6,28,-59
4,9,-32,-15,-44,-40,-19,17,-120
6,-4,-27,-11,-46,-52,-11,36,-109
43,18,-34,7,-74,-83,-13,35,-101
51,42,-41,-4,-64,-22,22,23,7
73,66,-38,-2,-71,-25,24,62,89
39,18,-32,31,-53,-46,2,19,-22
-3,42,-34,-29,-93,-54,9,112,-50
2,13,-25,-38,-56,7,1,53,-43
-1,-1,-27,-13,-67,-43,-26,36,-142
3,-1,-21,-37,-47,-50,-20,30,-143
29,-7,-4,-13,-26,-36,9,21,-27
42,20,-38,14,-69,-61,-5,63,-34
8,-9,-29,-17,-51,-16,-14,28,-100
-17,16,-62,-47,-72,-34,0,76,-140
-40,-26,-53,-43,-48,-96,-53,39,-320
13,37,-59,-54,-127,-66,20,55,-181
34,22,-7,-2,-21,-39,-6,61,42
12,-12,-42,-27,-122,-72,-20,55,-228
21,-9,-25,-38,-32,-111,-51,30,-215
-3,8,-48,-9,-102,-69,14,52,-157
20,56,-56,-44,-95,-135,-38,88,-204
21,4,-19,-27,-45,-38,6,3,-95
-5,19,-14,-12,-74,-17,-12,53,-62
35,-36,-67,-7,-69,-71,-7,15,-207
1,-1,-58,-57,-105,-66,-25,46,-265
37,-5,-33,-11,-100,-65,-8,67,-118
25,4,-3,-5,-31,-31,14,34,7
26,5,-17,-8,-2,-54,-7,27,-30
68,12,-41,23,-63,-41,0,54,12
11,3,-35,-32,-49,-58,-20,69,-111
10,40,-13,-12,-46,-34,11,43,-1
83,16,-45,-68,-129,-229,-42,71,-343
46,14,-111,-16,-202,-151,15,130,-275
75,75,-56,-27,-129,-105,23,129,-15
23,4,-17,-12,-43,-54,-23,21,-101
9,13,-33,-7,-44,-42,0,55,-49
13,-3,-80,-22,-118,-84,-26,61,-259
-5,-17,-73,-58,-124,-77,-16,89,-281
30,12,-63,-22,-123,-55,16,45,-160
19,24,-30,-49,-73,-62,8,58,-105
-48,1,-59,-46,-60,-83,-43,59,-279
7,32,-21,-24,-53,-64,-28,33,-118
16,17,-90,-19,-141,-89,-7,50,-263
-3,2,-30,-12,-63,-59,-10,40,-135
43,20,-43,-25,-50,-56,16,28,-67
40,14,-58,-30,-99,-132,13,66,-186
13,14,-86,-64,-119,-115,-53,98,-312
-9,-4,-75,-91,-113,-72,-16,75,-305
46,7,-60,-51,-53,-135,-19,64,-201
22,25,-20,-4,-23,-36,0,33,-3
6,24,-13,-10,-22,-106,-37,52,-106
8,27,-23,-3,-20,-27,3,15,-20
18,31,-26,-46,-56,-73,5,65,-82
19,10,-35,-60,-46,-52,9,70,-85
-4,-4,-40,-42,-126,-79,-34,121,-208
1,41,-1,-41,0,-18,-6,42,18
46,27,-24,-6,-54,-102,-13,82,-44
88,17,-88,-3,-189,-64,-8,110,-137
17,125,0,-10,-75,-96,-1,128,88
13,-8,-9,-44,-63,-81,-5,64,-133
-3,27,-54,-35,-52,-54,1,40,-130
48,28,-30,21,-65,-45,15,33,5
29,1,-49,-16,-71,-127,5,80,-148
7,-3,-22,-21,-36,-42,-7,11,-113
16,1,-40,-29,-82,-85,-4,50,-173
25,40,-70,-68,-104,-105,19,94,-169
3,25,-13,-25,-57,-30,-12,50,-59
11,-6,-42,-44,-68,-94,-24,41,-226
74,-31,-37,-21,-110,-114,-39,76,-202
-2,29,-50,-18,-42,-52,-7,52,-90
8,-7,-25,-25,-80,-50,-13,37,-155
51,16,-7,42,-66,-58,-31,91,38
-7,16,-38,-47,-89,-79,24,103,-117
-4,22,-4,-27,16,-27,13,33,22
1,51,-62,-79,-190,-64,23,126,-194
0,42,-17,-18,-50,-93,-18,58,-96
19,5,-14,-7,-84,-48,-4,48,-85
0,9,-34,-34,-63,-79,10,47,-144
8,-15,-48,-32,-106,-96,-34,106,-217
0,-20,-57,-12,-58,-55,-9,-1,-212
15,7,-46,-71,-67,-46,0,57,-151
26,8,-30,-11,-30,-42,-4,33,-50
-1,-4,-29,-16,-53,-24,12,33,-82
-14,23,-29,-34,-54,-53,-13,36,-138
4,22,-40,-35,-83,-53,-23,77,-131
-5,7,-12,-24,-35,-59,-22,21,-129
51,12,-13,-1,-52,-86,-27,111,-5
32,-17,-47,8,-113,-88,-18,59,-184
-1,-3,-27,-38,-79,-69,-18,61,-174
70,-28,-13,-23,-117,-99,5,120,-85
-3,26,-21,-16,-50,-68,0,60,-72
9,8,-39,-48,-75,-86,-16,60,-187
46,55,-8,3,-8,-59,23,86,138
20,-30,-58,4,-71,-40,-1,29,-147
103,-24,-61,-16,-128,-176,-18,90,-230
6,-4,-63,11,-113,-56,0,44,-175
32,41,-45,21,-86,-67,28,116,40
-15,-34,-200,-67,-356,-278,-43,208,-785
6,10,1,-11,3,-12,-10,50,37
94,-31,-13,59,-97,-130,-42,83,-77
16,8,-9,-14,-28,-34,-3,16,-48
19,23,-42,-50,-79,-79,-5,91,-122
18,0,-28,-25,-53,-74,-26,43,-145
11,5,-29,-31,-23,-64,-12,43,-100
-12,-20,-105,-111,-145,-125,-35,73,-480
47,-1,-25,0,-42,-64,-14,76,-23
16,-23,-56,-10,-108,-75,14,46,-196
29,0,-33,-27,-66,-107,7,90,-107
10,23,-23,-31,-35,-23,5,46,-28
20,19,-69,-68,-114,-120,-12,74,-270
-98,-53,-103,-23,-137,-172,-83,51,-618
-2,19,-49,-20,-76,-72,-25,66,-159
3,0,-39,-7,-78,-40,-18,58,-121
5,44,-55,-38,-35,-85,-20,58,-126
20,-22,-115,-69,-158,-170,-58,101,-471
10,8,-30,-12,-45,-54,-8,43,-88
-7,-20,-56,-37,-85,-59,-15,45,-234
30,29,-45,-38,-104,-74,25,38,-139
34,20,-21,-27,-50,-1,3,89,47
-19,10,-35,-48,-38,-71,-17,29,-189
47,22,-14,25,-45,-24,1,78,90
22,53,-22,-50,-52,-37,6,76,-4
-46,-14,-80,-16,-124,-101,-50,37,-394
42,57,-29,-62,-127,-118,-14,181,-70
-51,-28,-48,-3,-115,-75,-54,93,-281
28,57,-47,-36,-127,-121,-6,79,-173
30,3,-35,34,-107,4,30,110,69
8,12,-48,-22,-89,-62,3,49,-149
-8,1,-44,-39,-76,-65,-21,67,-185
83,-36,-35,0,-74,-116,-25,65,-138
24,12,-39,-1,-41,-65,-4,29,-85
20,36,-108,-77,-128,-129,-25,85,-326
64,-12,-61,2,-154,-153,-1,69,-246
-5,5,-44,-6,-56,-56,-6,7,-161
23,-14,-62,18,-141,-110,-35,41,-280
-8,13,-22,23,-58,-22,-6,39,-41
-3,14,-47,-26,-105,-84,-29,78,-202
27,26,-7,-14,-27,-54,-3,24,-28
17,22,-28,-11,-38,-15,13,48,8
22,8,-65,-19,-60,-52,-3,33,-136
-7,2,-45,-5,-115,-63,-8,89,-152
-37,0,-179,-136,-278,-284,-79,156,-837
-4,37,-77,-52,-88,-105,-21,83,-227
21,-7,-18,-51,-48,-67,-10,31,-149
52,0,-41,5,-71,-34,23,83,17
18,18,-20,-32,-42,-15,11,67,5
6,-3,-28,-23,-48,-84,-10,27,-163
60,1,-9,-65,-61,-161,-26,80,-181
10,7,-33,-23,-105,-81,-27,51,-201
-16,-41,-87,-41,-135,-109,-37,25,-441
19,27,-12,0,-57,-60,-1,52,-32
30,-14,-36,4,-42,-27,-18,39,-64
16,23,-25,-6,-19,-30,5,20,-16
4,28,-56,-55,-74,-97,-23,42,-231
18,19,-13,5,-103,-63,-8,46,-99
-3,41,-34,-41,-63,-55,-6,75,-86
-4,23,-56,-43,-72,-19,6,76,-89
17,8,-36,-24,-63,-52,-23,84,-89
1,18,-15,-4,-84,-64,-15,56,-107
-6,22,-17,-11,-52,-156,-41,134,-127
-5,23,-95,-60,-205,-122,-27,126,-365
22,-1,-32,-22,-7,-53,2,33,-58
23,5,-21,-33,-66,-47,-5,12,-132
14,34,-89,-65,-144,-110,-30,101,-289
30,-4,-46,-47,-70,-85,-2,43,-181
20,-29,-60,-69,-160,-135,-20,151,-302
4,38,1,-11,3,-57,-12,52,18
19,60,-44,-58,-55,-59,5,94,-38
9,-2,-48,-40,-68,-75,-34,65,-193
3,23,-27,-29,-58,-72,-31,59,-132
-13,28,-56,-47,-96,-69,-23,96,-180
76,-11,-42,2,-190,-112,19,158,-100
51,6,-31,-24,-53,-113,-12,91,-85
99,106,-71,-114,-53,-251,-44,198,-130
53,46,-164,-38,-284,-285,-58,180,-550
-27,-73,-88,-145,-109,-157,-92,106,-585
60,32,-21,-13,-117,-85,17,112,-15
0,4,-40,-34,-60,-46,2,37,-137
0,28,-18,-19,-36,-36,-15,65,-31
-1,20,-12,-20,-21,-4,3,23,-12
43,49,-143,-85,-194,-131,16,107,-338
74,5,-36,-63,-74,-140,-20,110,-144
25,15,-9,13,-22,-14,19,47,74
49,52,-58,-10,-146,-116,-5,56,-178
45,-1,-64,-8,-119,-97,0,74,-170
33,53,-88,-96,-126,-154,-43,179,-242
42,56,-21,-17,-62,-151,-5,74,-84
55,14,-68,12,-87,-67,14,68,-59
48,23,-58,-20,-72,-84,-45,73,-135
94,-3,-124,-70,-188,-195,37,95,-354
-24,-2,-26,0,-72,3,1,51,-69
18,9,-19,-15,-19,-69,-32,56,-71
59,5,-19,-53,-27,-59,-5,53,-46
41,37,-24,-13,-36,-55,-1,29,-22
93,9,-28,-35,-95,-124,10,176,6
19,24,-42,-42,-116,-61,31,70,-117
47,28,-27,-11,-48,-56,-1,44,-24
28,55,-41,-34,-113,-92,-16,99,-114
40,1,-62,-16,-99,-29,3,89,-73
0,18,-25,-11,-57,-31,4,45,-57
11,41,-8,-45,-71,-94,-25,106,-85
37,-2,-65,-6,-94,-139,-15,23,-261
10,29,-28,-53,-46,-64,-20,27,-145
41,51,-43,-70,-118,-107,-5,99,-152
103,0,19,21,-79,-144,-17,126,29
38,34,-38,11,-141,-62,1,93,-64
63,3,-2,25,-98,-51,-11,94,23
14,6,-6,-13,-19,-58,-2,35,-43
24,-20,-28,-21,-117,-88,-21,43,-228
36,5,-22,-13,-61,-27,14,23,-45
4,-5,-28,-10,-52,-58,-5,48,-106
10,11,-22,-18,-36,-39,5,22,-67
10,-2,-29,-15,-7,-33,-9,9,-76
1,1,-26,-18,-44,-52,-2,29,-111
40,-15,-42,-15,-83,-109,-7,19,-212
10,-5,17,10,-13,-12,-12,48,43
11,-7,2,8,-20,23,1,24,42
7,-15,-43,-12,-146,-101,-39,130,-219
22,35,-46,-10,-123,-73,-4,116,-83
1,22,-40,3,-52,-22,2,23,-63
-9,30,-41,-45,-109,-68,-7,74,-175
-1,23,-33,-19,-47,-29,-12,56,-62
-10,-3,-67,-47,-117,-27,-3,71,-203
-5,33,-2,8,-33,8,0,37,46
-5,-12,-89,-44,-104,-114,-1,49,-320
14,10,-25,10,-54,-26,14,20,-37
4,24,-27,-2,-30,-24,-6,48,-13
-2,14,-28,-7,-93,-33,3,74,-72
21,48,-16,-18,-43,-61,-6,63,-12
14,38,-48,-26,-70,-87,-47,64,-162
-11,15,-30,-40,-43,-118,-39,53,-213
19,15,-46,-23,-115,-79,-13,64,-178
15,-2,-55,-16,-113,-68,-3,37,-205
13,-5,-23,-38,-81,-75,-20,77,-152
-9,-4,-10,-8,-33,-44,-14,23,-99
108,6,-48,-10,-130,-177,-22,112,-161
8,20,-27,-33,-55,-44,-2,58,-75
40,25,-69,-47,-152,-98,17,97,-187
22,-11,-22,12,-53,-66,-11,22,-107
29,30,-40,-19,-17,-60,8,56,-13
2,8,-86,-71,-111,-111,-28,79,-318
80,3,-54,72,-147,-102,32,51,-65
-10,46,-75,-56,-97,-175,-38,108,-297
32,89,-124,-128,-144,-267,-45,128,-459
-5,-5,-23,-29,-59,-33,-20,39,-135
51,16,-10,-29,8,-74,-13,36,-15
22,-20,-21,-29,-100,-177,-35,128,-232
-2,31,-24,-66,-54,-94,-20,71,-158
-28,28,-130,-107,-238,-340,-113,132,-796
18,15,-22,-15,-90,-49,-4,49,-98
7,24,-39,-20,-68,-54,-11,38,-123
74,22,-88,31,-116,-101,16,51,-111
32,13,-19,1,-31,-31,5,58,28
5,31,-25,-43,2,-72,9,36,-57
24,4,-27,-3,-96,-54,-10,72,-90
20,29,-37,5,-51,-61,-20,78,-37
31,30,-68,-10,-141,-80,7,92,-139
20,29,-10,-21,-60,-103,-12,111,-46
-11,-1,-38,-14,-37,-15,-2,32,-86
-25,-17,-20,-45,-121,-129,-62,136,-283
33,28,-10,-50,-69,-147,-19,88,-146
17,10,-19,-24,-50,-89,-11,32,-134
4,5,-10,-26,-40,-38,-12,32,-85
16,12,-11,-12,-28,-12,13,23,1
54,9,-45,-15,-64,-52,6,25,-82
10,5,-25,-4,-47,-47,-10,23,-95
28,2,-81,-82,-162,-115,-17,44,-383
-5,-11,-83,-103,-125,-148,-42,73,-444
47,-31,-78,36,-220,-166,-29,102,-339
33,1,-15,-10,4,-50,-27,64,0
21,76,-76,-35,-80,-59,16,133,-4
27,37,-16,-4,-25,-29,15,38,43
-11,10,-26,-29,-63,-100,-25,39,-205
115,20,-94,-11,-162,-116,3,137,-108
56,-7,-14,-13,-27,-30,16,45,26
24,-38,-20,-25,-86,-90,-6,33,-208
-106,-27,-102,-75,-117,-158,-125,80,-630
4,-13,-36,-34,-63,-57,1,63,-135
58,-21,-70,-22,-104,-148,6,84,-217
1,15,-43,-50,-103,-88,-16,93,-191
6,6,-77,-58,-147,-110,-43,124,-299
13,-12,-50,-39,-80,-83,-7,33,-225
45,6,-61,-20,-82,-105,-24,119,-122
10,-14,-28,-16,-58,-53,8,51,-100
-9,1,-26,-38,-49,-33,-6,14,-146
17,14,-29,5,-62,-42,5,31,-61
27,-2,-59,-40,-88,-126,-19,73,-234
21,-9,-53,0,-172,-66,-4,66,-217
29,47,-38,-16,-56,-52,-7,66,-27
52,4,-29,-42,-27,-85,-9,25,-111
15,0,-73,-55,-113,-75,-20,75,-246
30,-4,-74,-27,-129,-81,-44,62,-267
11,12,-29,-12,-72,-32,-2,43,-81
14,49,11,-48,3,-62,-23,73,17
-4,20,-26,-51,-37,-72,-8,73,-105
2,0,-42,-41,-104,-56,4,59,-178
31,34,-20,-20,-37,-7,30,57,68
12,34,-9,-23,-42,-53,4,47,-30
22,1,-15,-21,-12,-26,24,23,-4
12,2,-32,-30,-76,-21,-4,46,-103
23,-1,5,-22,-51,-117,-35,58,-140
44,-27,-39,14,-109,-104,-12,81,-152
15,24,-16,-13,-29,-47,-1,56,-11
18,0,-27,6,-51,-31,10,53,-22
7,15,-37,-20,-75,-75,-8,43,-150
28,14,-4,-24,-30,-19,-7,48,6
7,22,-18,-21,-24,-38,0,50,-22
34,53,-59,-59,-99,-111,-30,108,-163
-63,-11,-46,-30,-54,-68,-32,53,-251
-3,25,-42,-43,-66,-177,-20,105,-221
-72,-42,-61,-72,-78,-95,-81,38,-463
20,9,-31,-20,-41,-31,4,12,-78
19,-20,-33,-25,-98,-85,-27,51,-218
5,24,-28,-20,-41,-37,5,49,-43
18,13,-14,-15,-18,-45,-6,30,-37
8,-5,-13,-27,-14,-19,-14,36,-48
6,-7,-64,-6,-106,-89,-21,28,-259
30,13,-46,-39,-95,-104,22,37,-182
28,-9,-47,-51,-107,-68,-28,80,-202
44,8,-39,-10,-59,-59,-7,40,-82
-4,46,-2,-10,-12,-6,7,34,53
-10,-1,-48,-42,-104,-101,-13,62,-257
26,26,-28,-48,-47,-107,-46,38,-186
43,44,5,-32,-56,-66,-8,91,21
14,-9,-22,-32,-63,-59,-13,70,-114
17,7,-43,-20,-39,-28,-2,11,-97
24,17,-46,-15,-91,-35,9,67,-70
20,1,-32,-7,-50,-46,-42,29,-127
25,4,-93,-72,-121,-188,-52,91,-406
35,-8,-16,-7,-79,-132,-22,57,-172
26,24,10,-28,-22,-45,4,68,37
76,12,-62,-29,-104,-116,-14,52,-185
2,-14,-37,-26,-49,-57,5,18,-158
-1,9,-58,-21,-119,-85,-28,68,-235
30,14,-26,-27,-45,-77,-21,73,-79
-19,-9,-81,-29,-133,-29,14,64,-222
14,27,-49,-36,-47,-47,-13,70,-81
30,-2,-41,9,-93,-97,-5,51,-148
41,31,-38,-42,6,-28,5,46,21
6,4,-24,-14,-80,-29,11,47,-79
-3,44,-25,1,2,-49,2,28,0
32,-8,-44,-1,-96,-94,-21,85,-147
1,17,-47,-44,-59,-55,0,40,-147
35,71,-21,-36,-23,-36,16,89,95
18,11,4,-1,-36,-60,-20,27,-57
-6,1,-14,-15,-61,-33,-13,59,-82
0,21,-30,-42,-35,-27,23,67,-23
26,27,-18,-8,-57,-29,4,54,-1
-9,7,-17,-32,-20,-32,-12,16,-99
53,27,-33,-14,-101,-66,-39,109,-64
1,20,-17,-34,-49,-15,7,68,-19
23,16,12,-20,-7,-18,7,30,43
30,7,-52,-17,-50,-87,-6,50,-125
59,5,-35,18,-92,-131,-12,57,-131
11,37,-57,-66,-120,-118,-19,132,-200
10,6,-51,-43,-86,-62,-13,60,-179
54,-26,-60,-67,-117,-91,-17,63,-261
-12,16,-35,13,-93,13,6,97,5
11,24,-71,-48,-101,-43,-3,59,-172
15,15,-19,-13,-46,-38,4,33,-49
2,41,-36,-46,-57,-61,-8,86,-79
23,-17,-50,-29,-71,-84,6,-5,-227
49,19,-47,36,-139,-96,14,69,-95
21,20,-26,-11,-87,-32,15,72,-28
59,28,-22,-8,-22,-45,0,13,3
26,-4,-84,-18,-112,-55,12,46,-189
-6,14,-51,-34,-49,-117,-42,47,-238
-1,20,-28,-18,-26,-47,14,62,-24
9,-24,-38,-32,-44,-47,8,19,-149
33,28,-57,-36,-155,-67,7,93,-154
-2,-1,-38,-35,-58,-62,-20,31,-185
68,11,-65,-33,-96,-35,-13,87,-76
3,22,-36,-52,-41,-79,-22,86,-119
41,5,-25,-25,-85,-61,9,36,-105
35,9,-62,-10,-145,-126,13,71,-215
46,-29,-122,-25,-245,-148,16,89,-418
36,38,-33,-37,-21,-93,-13,46,-77
-1,6,-52,-28,-47,-88,-29,36,-203
7,4,-36,5,-58,-40,11,33,-74
90,72,-99,-15,-113,-120,-5,106,-84
56,25,-14,-9,-64,-78,0,57,-27
47,32,-15,-30,-44,-76,-22,64,-44
6,10,-27,-69,-46,-92,-33,101,-150
-53,-26,-66,-19,-93,-91,-53,32,-369
-5,4,-38,-20,-49,-47,-23,26,-152
14,30,-75,-50,-102,-47,28,77,-125
57,1,-44,14,-137,-53,-14,115,-61
16,-16,-46,-17,-60,-73,-10,32,-174
33,9,-30,-32,-43,-97,-26,88,-98
82,-41,-67,-17,-180,-180,-57,169,-291
28,-8,-14,-8,-40,-60,-32,59,-75
42,17,-62,4,-83,-57,24,56,-59
27,27,-17,-15,-27,-29,-1,52,17
22,-10,-56,-11,-132,-92,-18,72,-225
-27,22,-67,-63,-88,-63,-32,77,-241
33,60,31,22,-32,-97,-39,76,54
50,58,8,31,-66,-91,-16,68,42
41,0,-23,-21,-101,-20,8,122,6
16,20,-25,-32,-84,-33,1,60,-77
10,-5,-34,-42,-39,-68,-5,35,-148
-5,-2,-36,-24,-42,-38,-2,25,-124
5,12,-30,-29,-32,-90,-24,65,-123
40,51,-119,-17,-171,-232,0,89,-359
47,1,-93,-15,-174,-98,7,43,-282
29,112,-15,-36,-88,-97,20,223,148
19,7,-23,1,-57,-15,8,68,8
17,20,-25,-12,-26,-21,-2,39,-10
35,15,-18,6,-30,-21,9,7,3
21,-3,-96,-35,-183,-111,3,49,-355
19,-15,-50,-28,-68,-78,-37,64,-193
36,10,-44,1,-77,-66,-6,32,-114
0,15,-81,-63,-56,-69,21,44,-189
22,-1,-76,-32,-114,-110,-5,66,-250
39,-7,-12,-1,-51,-47,-1,41,-39
68,38,-79,-38,-179,-222,-25,140,-297
-11,9,-35,-12,-25,-27,-12,35,-78
25,5,-18,-22,-57,-83,-36,65,-121
11,2,-31,-44,-62,-52,12,78,-86
97,31,-76,2,-124,-89,-5,95,-69
44,9,-59,-3,-92,-41,22,40,-80
28,-18,-23,-18,-29,-39,5,64,-30
-27,-3,-30,-42,-37,-46,-34,43,-176
15,19,-22,-7,-40,-18,5,36,-12
3,15,-95,-42,-133,-165,-46,86,-377
19,-15,0,-22,-60,-43,-4,70,-55
4,1,-13,-22,-59,-32,6,59,-56
26,-6,-16,-16,-41,-36,8,29,-52
-91,-62,-111,-23,-176,-142,-82,80,-607
-7,37,-23,-58,-44,-57,-11,81,-82
-39,-43,-42,-44,-58,-53,-23,41,-261
2,24,-17,-18,-28,-4,10,36,5
23,10,-35,-40,-49,-65,-11,52,-115
-7,-5,-25,-29,-75,-22,-15,49,-129
62,44,-96,-34,-49,-86,-38,60,-137
1,18,-21,-9,-42,-59,0,35,-77
46,-44,-49,-34,-95,-145,-12,61,-272
16,12,-82,-18,-133,-57,19,47,-196
9,17,-18,-9,-17,-33,5,46,0
33,-11,-30,-39,-81,-81,-27,53,-183
17,-5,-36,-12,-89,-51,35,113,-28
30,3,-76,-14,-164,-108,-19,34,-314
1,52,-7,-1,-20,-65,-20,71,11
-12,12,-19,-22,-17,-21,-8,11,-76
-3,22,-46,-33,-37,-77,-34,78,-130
15,15,-32,-15,-21,-41,-12,27,-64
27,13,-41,-21,-82,-66,0,47,-123
68,63,-90,-71,-163,-199,-51,145,-298
41,-12,-96,-28,-147,-107,11,101,-237
51,-18,-33,10,-109,-69,12,104,-52
39,13,-62,-6,-67,-76,-5,21,-143
33,32,-27,-30,-48,-111,-21,56,-116
5,50,-53,-67,-74,-114,-44,118,-179
-4,13,-37,-23,-29,-27,-16,13,-110
98,78,-7,2,-77,-71,24,107,154
22,46,-30,-36,-72,-72,1,63,-78
19,8,-34,-18,-21,-41,1,16,-70
4,23,-21,-25,-58,-14,8,40,-43
27,24,-32,-29,-77,-79,15,58,-93
-1,17,-59,0,-122,-83,-47,74,-221
56,24,5,-22,-87,-92,-33,171,22
26,-7,-28,-33,-74,-83,-22,55,-166
-12,-32,-24,-21,-86,-39,-2,44,-172
28,-12,-23,1,-49,-40,8,13,-74
4,18,-26,-18,-41,-83,-39,29,-156
43,29,-67,-57,-112,-143,18,95,-194
35,43,-11,-19,-26,-11,16,45,72
-11,3,-38,-40,-52,-83,-42,43,-220
38,18,-40,-6,-92,-99,6,58,-117
29,33,-53,-78,-105,-91,-23,105,-183
38,20,-17,-27,-56,-75,-11,24,-104
18,-2,-52,-36,-46,-63,-11,21,-171
4,3,-54,-45,-111,-48,18,59,-174
41,17,-65,-22,-88,-85,-24,40,-186
-2,13,-4,5,-34,-31,2,46,-5
7,24,-36,-52,-84,-37,15,91,-72
22,4,-28,-42,-52,-54,-4,4,-150
-8,-6,-75,-45,-161,-124,-8,90,-337
76,53,-10,-26,-136,-117,8,180,28
21,19,-18,19,-32,-50,-7,40,-8
27,-8,-30,-50,-95,-82,-13,51,-200
3,16,-37,-10,-70,-5,-9,61,-51
47,-13,8,-20,-45,-87,-34,78,-66
25,-6,-75,11,-146,-97,-8,67,-229
-20,0,-39,6,-63,-90,-45,32,-219
-86,-30,-130,1,-153,-287,-111,114,-682
3,33,-3,2,-42,6,1,59,59
23,0,-44,-4,-73,-19,17,53,-47
0,-4,-21,-32,-44,-28,-6,26,-109
20,21,-3,7,-29,-70,-20,28,-46
11,25,-21,-21,-44,-18,36,52,20
47,38,-43,-49,-70,-72,16,72,-61
15,-3,-63,-19,-78,-81,-5,32,-202
34,7,-10,-7,-29,-53,-1,23,-36
-12,6,-22,-28,-30,-16,-17,29,-90
18,2,-58,-1,-132,-60,10,59,-162
8,9,-20,-39,-36,-20,20,58,-20
33,39,-16,-11,-34,-53,7,55,20
11,17,-7,-19,-32,-39,8,41,-20
5,2,-35,-13,-113,-60,27,45,-142
22,30,-19,-28,-18,-40,2,50,-1
19,25,-50,-1,-25,-11,32,29,18
30,15,-40,-13,-66,-81,5,18,-132
-3,14,-11,-2,-37,-33,-5,34,-43
35,-5,-29,1,-90,-73,4,53,-104
-10,32,-27,-34,-70,-81,-8,69,-129
-74,-50,-111,-20,-172,-151,-46,76,-548
-39,-17,-31,-21,-66,-66,-43,39,-244
74,75,15,-44,-91,-132,-36,77,-62
36,2,-38,-11,-97,-45,8,52,-93
3,10,-20,-36,-32,-25,-6,32,-74
24,-12,-37,-9,-88,-89,-1,67,-145
20,-4,-20,-25,-27,-40,-2,21,-77
26,24,-16,-50,-62,-69,-12,54,-105
5,34,-8,-31,-20,-74,-12,28,-78
15,25,-14,-25,-44,-46,-1,76,-14
-3,-2,-29,-18,-22,-28,4,29,-69
24,-8,-60,-32,-103,-71,0,24,-226
71,17,-172,-81,-288,-264,-38,69,-686
30,6,-42,-4,-78,-43,9,30,-92
7,-14,-46,-26,-54,-83,-21,38,-199
25,2,-18,6,-73,-42,-6,24,-82
30,10,-32,14,-125,-117,-4,84,-140
42,57,-18,-22,-6,-101,-8,72,16
2,16,-32,-38,-50,-92,-19,69,-144
-3,42,-10,-21,-47,-78,-26,78,-65
8,17,-14,-8,-34,-58,-21,23,-87
10,21,-105,-44,-137,-110,5,90,-270
13,5,-20,-5,-46,-21,-3,35,-42
8,31,-36,-22,-19,-43,-2,35,-48
27,-2,-124,-107,-207,-332,-167,232,-680
-6,61,-32,-31,-37,-50,-6,79,-22
-16,17,-18,-29,-71,-33,-12,41,-121
-17,-9,-38,-35,-34,-26,-18,24,-153
46,34,-26,42,-170,-76,16,82,-52
8,5,-42,-26,-112,-74,13,51,-177
23,15,-23,-10,-29,-29,14,-9,-48
14,17,-43,-42,-142,-112,0,90,-218
10,-13,-16,-42,-43,-60,-24,47,-141
2,31,-112,-86,-201,-225,-77,185,-483
14,13,-47,-31,-77,-54,-25,76,-131
3,15,-86,-44,-76,-85,1,57,-215
4,14,-53,-39,-82,-80,-9,72,-173
28,88,-82,-47,-132,-127,-2,146,-128
32,7,-67,-4,-68,-45,2,20,-123
62,36,-98,-47,-161,-167,-9,120,-264
-8,36,-59,-18,-90,-42,16,92,-73
7,-2,-34,-7,-94,-49,2,42,-135
7,-1,-48,-19,-105,-120,-14,68,-232
23,-22,-30,6,-71,-41,-2,36,-101
25,57,-14,-10,-62,-55,6,71,18
-29,-8,-100,-72,-129,-154,-70,85,-477
14,12,-60,-14,-98,-64,0,56,-154
22,11,-24,-7,-42,-34,10,46,-18
-14,12,-34,-33,-24,-47,-10,23,-127
15,-17,-46,-2,-126,-65,-11,37,-215
-3,-2,1,-6,-34,-11,-15,54,-16
21,12,-35,-33,-53,-88,-20,63,-133
7,-4,-34,-9,-95,-85,-3,34,-189
4,-1,-68,-7,-97,-69,-4,50,-192
3,14,-36,-10,-85,-46,-15,61,-114
3,15,-29,-15,-35,-27,-7,15,-80
50,34,-39,-79,-99,-198,-51,166,-216
-107,-7,-134,-98,-160,-142,-86,111,-623
32,38,22,-34,-3,-74,0,86,67
8,40,-43,-48,-22,-81,-13,35,-124
5,-18,-20,-28,-48,-68,-19,61,-135
12,4,-28,-9,-45,-27,3,26,-64
62,38,-2,-14,-78,-15,24,137,152
28,52,-20,-21,-94,-92,-1,36,-112
42,2,-59,-19,-64,-112,10,53,-147
-14,20,-58,-55,-80,-50,-15,50,-202
19,-5,-53,-6,-59,-59,-2,46,-119
7,19,-11,-12,-34,-28,5,40,-14
14,31,-26,22,-67,-75,-14,35,-80
40,51,-10,2,-14,-40,26,66,121
5,1,-34,-23,-41,-28,-8,26,-102
30,-4,-40,-24,-48,-40,-12,29,-109
18,-5,-87,-32,-201,-121,-24,73,-379
15,12,-25,3,-35,-52,19,38,-25
28,38,-12,-43,-105,-78,17,76,-79
20,45,-38,-12,-89,-52,16,74,-36
6,-10,-68,-11,-117,-39,1,72,-166
30,47,-18,-21,-25,-106,6,71,-16
-3,5,-84,-52,-135,-65,9,67,-258
-54,-11,-88,-4,-143,-147,-24,92,-379
85,-4,-108,-11,-177,-119,-9,74,-269
11,6,-18,-33,-28,-61,-16,64,-75
23,15,-1,-19,-97,-49,11,66,-51
4,4,-25,-26,-51,-71,-29,43,-151
22,4,-33,-42,-8,-47,-7,47,-64
22,32,-35,-25,-40,-60,-6,59,-53
44,10,-40,-14,-85,-104,-23,120,-92
21,-5,-6,-18,-45,-52,10,66,-29
42,9,-40,10,-71,-45,5,26,-64
33,7,-57,3,-45,-18,14,41,-22
16,3,-28,-22,-72,-47,-1,36,-115
9,19,1,-17,-13,-43,-11,34,-21
-1,4,-47,-37,-38,-104,-52,54,-221
36,22,23,-8,-91,-62,-8,129,41
25,4,-75,-13,-92,-38,7,44,-138
-26,14,-15,-33,-50,-23,-6,47,-92
-1,6,-46,-26,-65,-85,-22,40,-199
27,-16,-60,-47,-65,-99,3,40,-217
-7,25,-49,-69,-79,-90,-33,67,-235
-14,35,-25,-21,-53,-62,-51,26,-165
60,10,3,24,-77,-65,-34,99,20
75,39,-33,-15,-207,-220,-63,225,-199
108,-93,-153,89,-175,-75,75,65,-159
28,16,-10,-3,-94,-68,-4,51,-84
95,-23,-72,2,-212,-175,17,117,-251
16,40,-11,90,-213,2,-65,149,8
6,16,-28,-36,-53,-73,-27,64,-131
48,54,-27,-31,-83,-82,7,98,-16
19,54,-38,-13,-120,-107,-33,137,-101
8,36,-69,-56,-90,-35,-8,77,-137
9,19,-27,-8,-69,-32,-6,29,-85
25,-18,-24,10,-70,-32,-10,49,-70
24,36,-4,-11,-26,-48,4,76,51
17,23,-30,-16,-15,-28,11,54,16
-1,6,-53,-52,-81,-68,-6,90,-165
54,22,-21,-56,-23,-124,-21,96,-73
33,-18,-79,-6,-140,-75,0,41,-244
-24,31,-58,-47,-78,-65,16,70,-155
13,27,-50,-32,-92,-107,-22,83,-180
56,0,-68,-22,-125,-132,-4,57,-238
-1,-6,-30,-14,-39,-33,-21,23,-121
16,-16,-117,-26,-179,-123,1,134,-310
14,62,-13,-11,-38,-103,-5,65,-29
20,28,-32,9,-86,-121,-19,42,-159
49,-3,-59,23,-108,-69,11,67,-89
40,8,-61,11,-132,-79,-5,69,-149
-1,-11,-25,-47,-78,-65,-21,39,-209
-3,-2,-76,5,-117,-66,14,44,-201
41,-24,-120,-82,-214,-253,-114,91,-675
8,-2,-29,-19,-39,-30,-16,33,-94
-1,12,-33,-15,-43,-23,-10,41,-72
-2,32,-45,-29,-62,-64,-10,83,-97
5,26,-30,-30,-77,-102,-43,37,-214
31,62,5,-12,-19,-61,3,90,99
42,-4,-77,-53,-107,-87,-12,70,-228
4,13,-18,-9,-26,-55,-22,32,-81
9,13,-18,-1,-29,-63,-10,36,-63
21,19,-67,-35,-88,-83,8,34,-191
31,9,-64,-60,-136,-59,-5,79,-205
9,10,-28,-8,-25,-21,-10,26,-47
15,68,-28,-27,-31,-55,28,109,79
-9,24,-44,-44,2,-72,-16,25,-134
12,-11,-36,-27,-58,-22,-21,10,-153
-2,38,-45,-29,-84,-72,-15,70,-139
34,23,-32,-29,-84,-66,-6,103,-57
26,10,-78,-16,-175,-108,-2,71,-272
34,69,-10,-18,-91,-100,-9,190,65
35,-15,-25,-22,-83,-100,-27,75,-162
6,-6,-107,-78,-146,-209,-21,111,-450
0,5,-37,-39,-38,-41,1,23,-126
23,5,-53,-42,-65,-103,-7,73,-169
24,10,-43,-27,-18,-24,12,25,-41
20,23,-12,8,-38,-28,6,24,3
5,11,-43,-21,-40,-28,-3,30,-89
38,2,4,47,-67,-30,-8,57,43
3,19,-35,-13,-1,-33,-15,30,-45
8,8,-37,-21,-46,-39,-5,46,-86
6,-1,-38,-41,-91,-89,-27,77,-204
4,21,-45,-51,-76,-41,-6,37,-157
8,40,-68,-55,-80,-99,-11,96,-169
24,40,-8,3,-55,-34,1,66,37
63,18,-55,-30,-114,-119,10,60,-167
4,25,-25,-46,-46,-55,-11,41,-113
-89,-22,-107,-48,-174,-138,-88,90,-576
4,11,-22,-14,-38,-75,-30,59,-105
18,6,-41,-20,-28,-75,-3,38,-105
22,27,-11,-4,-55,-33,5,72,23
50,42,-22,-60,-28,-112,-3,50,-83
14,22,9,13,-35,-6,-6,95,106
-20,-38,-102,-32,-120,-137,-50,75,-424
19,1,-82,-15,-173,-100,-24,91,-283
40,39,-48,-24,-31,-73,1,70,-26
-17,-2,-42,-35,-30,-44,2,39,-129
13,20,-15,-23,-16,-30,18,26,-7
25,15,-6,-16,4,-33,-4,50,35
45,39,-39,8,-142,-37,24,138,36
43,43,-87,-64,-98,-175,-62,85,-315
22,45,-6,-28,-4,-59,-7,38,1
-8,19,-24,-24,-91,-18,1,67,-78
17,28,-20,-1,-66,50,44,68,120
23,4,-23,-54,-50,-113,-20,34,-199
44,19,-37,-15,-54,-90,2,39,-92
31,31,-19,11,-40,14,26,63,117
58,-25,-65,-58,-144,-95,-70,79,-320
-25,-4,-32,-56,-51,-57,-22,40,-207
51,14,-60,-3,-93,-73,25,32,-107
46,51,-14,43,-109,-25,-28,147,111
23,-3,-18,-20,-24,-41,6,25,-52
28,60,-28,-53,-90,-160,-46,104,-185
17,19,2,-51,-23,-101,-21,58,-100
10,15,-13,-18,-32,-39,-9,26,-60
0,7,-21,-32,-15,-44,-18,33,-90
7,32,-42,-18,-52,-79,9,69,-74
83,59,3,-41,-76,-179,-24,163,-12
9,20,-15,-30,-47,-10,20,47,-6
12,21,-28,-2,-14,-39,11,28,-11
-4,25,-59,-53,-109,-95,-38,63,-270
9,26,-39,-68,-72,-87,-19,47,-203
-5,-35,-40,-45,-60,-70,-31,46,-240
-1,-22,-53,-24,-170,-148,-28,65,-381
10,-39,-127,-76,-229,-219,-73,68,-685
59,-18,-27,4,-118,-119,-19,81,-157
3,16,-16,-5,-15,-27,-9,47,-6
78,14,-60,32,-173,-131,7,77,-156
5,50,-39,-61,-148,-58,14,85,-152
2,2,-26,-9,-26,-10,-6,14,-59
16,2,-23,-25,-36,-87,-26,52,-127
53,9,-17,-17,-52,-96,15,57,-48
6,14,-21,-14,-37,-19,9,45,-17
24,-12,-58,4,-114,-68,-2,66,-160
10,-3,-16,-18,-28,-42,-16,-3,-116
-1,30,-82,-61,-93,-125,-41,78,-295
59,15,-49,-11,-73,-88,6,66,-75
5,23,-5,-71,-78,-56,-34,121,-95
10,20,-37,-46,-23,-38,-3,31,-86
14,6,-23,-16,-37,-42,-10,18,-90
54,12,-69,-25,-80,-76,13,40,-131
-16,25,-25,-49,-74,-15,-14,119,-49
-8,18,-45,-45,-83,-103,-30,88,-208
48,-10,-73,-19,-93,-74,29,39,-153
22,26,-39,-27,-67,-108,-17,64,-146
1,85,-83,-114,-64,-128,-2,139,-166
4,20,-23,-42,-40,-100,5,63,-113
17,16,-53,-5,-94,-57,29,44,-103
9,18,-74,-22,-87,-64,-3,56,-167
4,-8,-100,-109,-86,-115,-29,127,-316
19,14,-72,-24,-166,-82,11,99,-201
-8,12,-18,-20,-30,-26,-13,55,-48
45,13,-66,-3,-94,-91,13,47,-136
23,19,-70,-33,-131,-79,10,66,-195
14,41,-44,-15,-93,-117,-5,73,-146
25,15,-10,-10,-57,-60,-3,33,-67
23,30,-18,-9,-46,-51,-7,23,-55
19,18,-54,-32,-53,-37,3,62,-74
19,5,-41,-8,-96,-67,15,53,-120
30,10,-41,-14,-85,-72,10,55,-107
20,24,-15,-7,-36,-59,5,65,-3
8,19,-32,-63,-34,-100,-30,44,-188
33,29,-24,-11,-23,-35,0,35,4
8,12,-45,-38,-86,-58,-1,39,-169
7,23,-30,0,-90,-52,-19,73,-88
15,19,-13,6,-47,-49,-14,45,-38
60,-35,-164,-64,-270,-232,2,138,-565
39,26,0,-36,-37,-28,6,89,59
6,13,-33,-9,-22,-2,0,11,-36
19,32,-31,-28,-89,-60,5,74,-78
40,16,-65,-61,-159,-146,7,74,-294
43,36,-47,-29,-110,-122,5,58,-166
16,24,-44,-54,-103,-77,-4,65,-177
26,-6,-79,-27,-92,-98,-26,78,-224
10,33,-11,4,-34,-48,-26,32,-40
35,26,-27,-19,-76,-50,-11,28,-94
8,-3,-19,-17,-30,-43,-15,35,-84
14,63,-54,-79,-90,-207,-23,156,-220
19,39,-49,-40,-17,-64,8,59,-45
15,26,5,42,-87,-23,-13,87,52
12,20,-29,-52,-45,-67,-19,42,-138
-10,4,-24,-32,-27,-46,-27,37,-125
12,-2,-57,-64,-105,-58,-11,87,-198
41,31,-50,-24,-80,-95,-3,65,-115
25,-6,-28,-29,-60,-44,9,20,-113
18,-1,-54,-58,-80,-120,1,74,-220
6,24,-20,-13,-113,-80,-42,69,-169
12,-6,-26,7,-63,-46,-11,22,-111
-3,31,-25,-27,-80,-84,-8,55,-141
21,19,-10,37,-64,-39,-14,48,-2
15,-3,-31,-44,-52,-61,-3,28,-151
1,23,0,-4,-20,-10,-11,42,21
38,26,-34,-9,-77,-57,1,81,-31
7,17,-6,-15,-36,-16,0,39,-10
12,45,-49,-34,-49,-58,-1,77,-57
-2,39,2,-9,-4,-48,-17,66,27
43,-4,-70,-43,-74,-144,-43,91,-244
-2,21,-11,-3,-22,-74,2,37,-52
19,15,-26,-28,-56,-56,-3,40,-95
-13,54,-43,-73,-83,-107,-26,120,-171
20,-4,-23,-14,-26,-60,-17,46,-78
46,9,-35,3,-42,-66,0,25,-60
-1,3,-39,-59,-32,-47,-11,45,-141
5,-4,-30,-11,-52,-28,-1,28,-93
17,2,-39,-17,-73,-74,-10,41,-153
2,11,-11,-10,-28,-31,8,27,-32
17,18,-53,-78,-91,-80,13,64,-190
23,30,-24,14,-81,-55,-23,88,-28
1,-1,-58,-32,-74,-60,-28,54,-198
30,53,4,-23,-28,-44,7,72,71
2,-5,-41,12,-52,-62,-19,20,-145
-11,18,-141,-91,-180,-283,-20,114,-594
8,6,-14,-12,-11,-37,-15,47,-28
44,29,-25,-11,-63,-96,-36,61,-97
15,14,-33,-5,-38,-56,1,37,-65
12,-22,-55,-9,-72,-72,-6,32,-192
33,18,-77,-14,-95,-91,5,55,-166
-1,21,-16,-23,-34,-33,-7,20,-73
3,14,-43,-7,-86,-19,-11,48,-101
-41,-18,-43,-15,-56,-71,-33,51,-226
18,18,-16,-30,-45,-65,11,56,-53
27,55,18,-11,-18,-120,-48,83,-14
9,3,-50,-39,-66,-67,-13,45,-178
34,-3,-65,5,-107,-113,-4,56,-197
16,36,-41,-73,-90,-61,1,101,-111
20,15,-44,-18,-66,-41,11,43,-80
27,42,-39,-19,-81,-49,8,86,-25
18,-7,-45,-41,-63,-125,-11,49,-225
-2,-27,-80,-22,-146,-80,-20,60,-317
5,26,-38,-40,-70,-63,-12,44,-148
6,26,-48,-43,-75,-101,-19,45,-209
-54,-45,-80,-34,-80,-92,-50,35,-400
11,1,-16,-12,-26,-46,-10,26,-72
40,-2,-56,-29,-111,-122,-20,49,-251
42,18,-126,-100,-221,-317,-126,147,-683
51,7,-31,11,-141,-18,-21,117,-25
22,43,13,7,-24,11,-8,50,114
10,16,-15,13,-59,-30,6,47,-12
46,35,-21,-51,-14,-70,9,62,-4
8,15,-32,-17,-56,-36,-4,42,-80
49,12,-2,10,-64,-53,-8,92,36
4,-29,-81,-50,-143,-145,-49,86,-407
31,-10,-30,-21,-25,-58,2,30,-81
36,12,-29,-35,-30,-40,-14,41,-59
-11,11,-31,-30,-12,-42,-18,40,-93
25,-12,-64,-34,-105,-75,-18,55,-228
54,33,-45,-18,-78,-116,-3,78,-95
43,37,-10,-30,-53,-96,7,113,11
-3,13,-15,-24,-13,-25,5,28,-34
4,25,-37,-42,-94,-82,-27,81,-172
8,13,-24,-1,-68,-44,1,45,-70
26,14,-18,-2,-28,-71,-11,39,-51
4,41,-22,-37,-40,-82,-31,92,-75
-2,-1,-24,-35,-49,-74,-10,59,-136
-35,-11,-59,-32,-57,-79,-9,48,-234
34,9,-17,-45,-47,-90,-33,80,-109
28,18,-2,-8,-62,-50,-1,46,-31
51,14,-20,4,-87,-121,0,24,-135
-11,11,-6,-28,-24,-38,0,66,-30
138,-5,4,-21,-154,-152,-33,148,-75
-10,2,-54,-37,-63,-84,-33,61,-218
15,-9,-48,-19,-116,-57,-31,75,-190
6,42,-36,-31,-58,-82,-20,86,-93
4,41,-5,-11,-13,-14,-5,38,35
6,-6,-19,-49,-25,-57,-6,51,-105
59,72,-12,-19,-62,-128,-36,107,-19
-6,-7,-47,-55,-69,-54,-16,28,-226
43,5,-37,25,-101,-86,-8,77,-82
23,-16,-29,-22,-52,-51,-33,47,-133
24,36,-51,-48,-64,-120,-25,94,-154
12,28,-43,-5,-81,-23,18,72,-22
7,-4,-31,-24,-37,-66,-11,46,-120
23,16,-46,-38,-77,-10,29,62,-41
6,20,0,14,-13,-24,5,43,51
19,26,-23,-10,-32,-24,9,32,-3
25,47,-135,-106,-204,-200,-23,171,-425
3,-18,-32,-27,-47,-37,-3,49,-112
58,1,-16,9,-60,-64,1,55,-16
27,9,-20,-4,-87,-78,-4,55,-102
25,83,-34,-23,-78,-95,-18,81,-59
74,57,-15,24,-121,-101,-12,136,42
31,44,-65,-71,-159,-101,-12,140,-193
-1,20,-69,-69,-119,-179,-30,102,-345
19,9,-13,-20,-30,-41,3,42,-31
54,18,-61,-37,-30,-43,6,49,-44
50,-18,-37,-34,-90,-128,-14,64,-207
-19,22,-80,-41,-116,-125,-12,104,-267
25,-34,-10,7,-88,-89,-20,41,-168
34,43,-6,-7,-47,-33,2,54,40
10,15,-93,-57,-134,-101,6,92,-262
12,-1,-49,-19,-103,-98,-26,68,-216
3,-8,12,-43,-25,-50,4,58,-49
103,60,-33,-1,-147,-134,3,74,-75
6,14,-25,-8,-48,-22,14,46,-23
42,35,-59,-87,-131,-132,-105,141,-296
22,43,-20,-26,-24,-50,-8,84,21
33,-2,-61,42,-124,-91,-8,90,-121
8,-9,-39,-1,-83,-40,6,44,-114
4,22,-16,-3,-14,-24,8,43,20
9,1,-37,-22,-71,-39,-6,26,-139
-16,-17,-33,16,-75,-34,10,30,-119
11,-3,-37,-13,-58,-66,-18,21,-163
31,39,-110,-101,-120,-192,-28,98,-383
10,15,-31,-11,-14,-9,8,15,-17
48,38,-55,-56,-77,-46,-8,142,-14
40,10,-46,8,-95,-79,0,61,-101
62,-22,-12,-39,-80,-59,-26,91,-85
67,3,-57,14,-94,-78,16,90,-39
-4,10,-31,-21,-33,-59,-9,44,-103
-1,-4,-38,-22,-60,-60,-11,52,-144
-9,21,-24,-29,-38,-23,-2,33,-71
26,13,-25,-27,-59,-94,-74,86,-154
3,3,-7,-24,-50,-84,-18,75,-102
104,67,-72,-44,-147,-136,31,67,-130
31,13,-23,-15,-54,-54,-25,24,-103
0,-4,-41,-18,-45,-20,-28,47,-109
1,-3,-45,-39,-52,-83,-39,33,-227
12,5,-35,-12,-62,-72,-4,41,-127
0,-18,-45,-35,-78,-45,-8,31,-198
8,6,-42,-34,-88,-72,-35,53,-204
6,11,-38,-20,-107,-56,-18,84,-138
29,41,-49,-47,-84,-85,12,86,-97
-7,44,-18,-18,-28,-72,-19,53,-65
33,21,-42,-9,-86,-41,-1,50,-75
5,45,-27,-24,-66,-101,-11,45,-134
16,-9,-20,8,-40,-78,-11,34,-100
-12,2,-34,-34,-44,-58,9,50,-121
6,7,-33,-22,-44,-56,-5,38,-109
-22,32,-79,-78,-117,-116,-30,69,-341
36,0,-42,5,-104,-81,0,52,-134
63,5,-81,17,-94,-77,16,39,-112
10,1,-33,-13,-46,-23,-8,34,-78
55,31,-24,14,-183,-120,-9,113,-123
5,3,-32,-28,-74,-57,-23,17,-189
-41,-59,-74,-29,-107,-125,-45,37,-443
11,40,-65,-62,-103,-82,-19,99,-181
0,-28,-53,-46,-67,-54,-2,17,-233
-12,24,-27,-31,-58,-54,-16,54,-120
7,6,-44,-32,-57,-40,13,36,-111
5,26,-11,-17,-55,-64,-17,40,-93
15,-11,-31,-12,-24,-48,-8,14,-105
53,36,-40,-43,-73,-100,-13,66,-114
5,38,-40,-44,-49,-57,4,45,-98
2,16,-22,7,-104,-71,-9,63,-118
17,11,-24,-31,-94,-94,-13,137,-91
52,2,-58,-15,-122,-97,0,71,-167
8,16,-18,0,-53,-49,-20,57,-59
-2,-6,-58,-21,-87,-42,-15,30,-201
19,11,-14,-16,-23,-48,16,22,-33
50,35,-38,-44,-97,-138,-6,45,-193
-5,22,-40,-16,-61,-36,-14,39,-111
12,137,-6,-25,-127,-82,-60,178,27
10,9,-62,7,-119,-131,-8,91,-203
28,-3,-60,-27,-79,-59,13,50,-137
36,5,-28,-4,-48,-51,13,23,-54
-92,-28,-131,-26,-159,-142,-54,93,-539
31,33,6,-26,-86,-46,19,60,-9
130,49,-74,14,-107,-81,77,141,149
-3,20,-12,-14,-23,-57,-19,39,-69
43,76,-65,-67,-164,-165,-25,135,-232
8,21,5,-16,-55,-116,-37,95,-95
23,34,2,-26,-41,-120,-43,99,-72
37,9,-53,-30,-46,-50,-28,22,-139
-7,9,-62,-1,-120,-11,-1,60,-133
20,6,-29,-22,-60,-30,9,33,-73
14,20,-94,-70,-141,-88,-18,99,-278
4,14,-46,-21,-78,-92,10,80,-129
18,19,-61,-19,-159,-96,-3,118,-183
10,7,-32,-31,-67,-81,-35,70,-159
-23,19,-75,-44,-85,-61,-23,46,-246
-17,45,-40,-60,-54,-63,16,105,-68
5,42,-29,-41,-75,-56,-4,81,-77
32,13,-50,-35,-54,-113,-12,100,-119
12,6,-35,4,-113,-61,2,72,-113
4,8,-7,-6,-15,-30,0,22,-24
18,0,-40,-3,-45,-32,8,27,-67
-5,17,-22,-29,-43,-52,-18,36,-116
27,-8,-56,-46,-169,-116,-11,69,-310
26,-14,6,-6,-19,-34,-1,49,7
62,44,-52,25,-143,-124,8,80,-100
5,13,-22,-13,-54,-48,-8,38,-89
28,19,-31,-37,-109,-93,-3,105,-121
23,54,-46,-54,-123,-60,18,113,-75
13,65,5,21,-92,-53,-21,139,77
14,30,-28,-29,-17,-72,-10,50,-62
101,47,-10,-8,-117,-118,57,90,42
43,11,-54,-8,-98,-88,-4,24,-174
25,17,-44,-31,-77,-49,-13,59,-113
34,3,-43,-13,-79,-62,12,50,-98
31,53,-93,-40,-158,-89,41,104,-151
21,17,-54,-6,-114,-63,-12,21,-190
-8,48,21,1,-76,38,23,95,142
23,23,-38,-32,-71,-50,14,62,-69
6,49,3,-52,-14,-74,-16,66,-32
77,13,-8,-2,-53,-83,25,64,33
-9,22,-45,-60,-80,-149,-33,66,-288
5,-12,-59,6,-110,-69,-2,50,-191
42,1,-49,-20,-117,-133,-18,85,-209
19,1,-27,-56,-74,-78,1,57,-157
32,17,-30,-37,-68,-95,-4,41,-144
45,12,-102,5,-220,-112,-4,49,-327
6,-4,-40,-14,-69,-25,14,35,-97
8,34,-40,-87,-58,-141,-50,114,-220
30,27,-65,-65,-179,-114,-8,67,-307
34,12,-29,-12,-47,-41,-13,64,-32
33,16,-19,-2,-95,-64,4,53,-74
-23,34,-21,-53,-63,-94,-3,88,-135
24,-7,-47,-6,-135,-105,1,65,-210
52,33,-14,-27,-45,-35,-2,46,8
31,25,-69,-26,-78,-55,15,30,-127
