protein-water,protein-carbon,hydrogen bond (long-range),pi-pi (long-range),disorder (long),K-Beta similarity,disorder (short),electrostatic (short-range),8-feature sum
35,72,22,-41,-76,-13,-41,34,-8
-27,-32,-19,-57,-70,-20,-40,-8,-273
1,7,-70,-77,-106,-122,-92,-107,-566
-19,3,-15,-46,-48,-38,-39,-21,-223
-32,-4,-34,-64,-58,-39,-43,-15,-289
-26,-19,2,-56,-114,-53,-47,6,-307
-19,16,-53,-57,-66,-19,-40,1,-237
-8,1,-4,-64,-71,-61,-42,10,-239
-5,26,-12,-18,-35,-10,-44,37,-61
-1,-4,-23,-22,-59,-10,-31,-4,-154
-8,-13,-14,-19,-31,-22,-20,-38,-165
-19,7,-8,-40,-44,-23,-31,5,-153
-30,-5,-47,-76,-29,-37,-33,-14,-271
1,2,-16,-42,-49,-22,-36,33,-129
-14,-2,-19,-22,-57,-22,-56,-9,-201
-37,-32,-44,-79,-73,-58,-50,-8,-381
-1,-14,-8,-42,-91,-62,-58,-44,-320
13,-6,-27,-6,-31,-21,-22,1,-99
-27,33,-60,-103,-69,-40,-51,-49,-366
-17,1,-15,-48,-27,-14,-28,0,-148
-50,-29,-24,-92,-112,-47,-69,6,-417
-17,-39,-34,-102,-147,-89,-84,-38,-550
-16,-2,-20,-60,-92,-61,-61,-22,-334
-15,24,-36,-68,-58,-31,-36,24,-196
27,0,-2,-18,-73,-72,-33,-46,-217
-54,-32,-49,-117,-121,-76,-81,-5,-535
13,-12,-21,-8,-47,-34,-35,-23,-167
-18,11,-31,-101,-84,-77,-75,-20,-395
-20,-19,-26,-58,-113,-32,-55,-27,-350
-12,8,-49,-80,-51,-22,-37,-35,-278
11,24,-18,-36,-56,-51,-46,-14,-186
-26,3,-51,-108,-44,-20,-42,-10,-298
-56,-22,-56,-101,-98,-1,-54,-3,-391
-12,-34,-11,-39,-76,-41,-31,-14,-258
-11,-11,-14,-19,-39,-10,-27,-15,-146
10,-7,-7,-31,-71,-44,-29,-8,-187
-30,23,-56,-107,-72,-59,-54,-1,-356
3,-8,-30,-53,-95,-69,-60,-39,-351
3,10,-38,-47,-39,-37,-25,13,-160
-14,-4,-42,-60,-67,-63,-56,-17,-323
-12,12,-15,-28,-30,17,-24,21,-59
-6,-18,-38,-67,-163,-116,-112,-36,-556
-8,-11,-9,-34,-37,-18,-24,6,-135
-6,-9,-27,-68,-74,-48,-65,-14,-311
-18,-1,-49,-65,-80,-49,-60,-37,-359
2,6,-3,-73,-60,-66,-53,-26,-273
8,-28,-14,-75,-108,-54,-61,-38,-370
-44,-11,-68,-103,-79,-47,-66,3,-415
4,-11,0,-15,-59,-41,-24,-11,-157
-5,21,-44,-65,-94,-66,-56,-53,-362
-19,-8,-11,-64,-51,-37,-29,-17,-236
4,-27,-47,-79,-130,-93,-70,-43,-485
11,-6,-29,-48,-68,-59,-55,-45,-299
35,-29,-14,-38,-173,-95,-74,-54,-442
-25,29,-45,-97,-93,-27,-60,-6,-324
9,-17,-30,-30,-91,-49,-36,-11,-255
-1,27,-9,-56,-147,-9,-51,13,-233
-6,9,-21,-32,-31,16,-4,25,-44
-1,-33,-21,-91,-154,-80,-64,-11,-455
-39,-6,-26,-78,-121,-39,-68,1,-376
-8,-5,-10,-47,-70,-42,-47,-30,-259
-15,7,-28,-50,-103,-44,-56,2,-287
-19,13,-42,-80,-121,-33,-82,-20,-384
-19,-15,-18,-30,-35,11,-15,14,-107
24,-4,-11,-24,-133,-48,-89,19,-266
22,4,-43,-59,-196,-133,-116,-53,-574
-126,-13,-147,-296,-212,-124,-191,-84,-1193
-19,-22,-36,-46,-75,-14,-21,4,-229
-29,-1,-8,-43,-36,-11,-30,0,-158
-8,28,-50,-86,-106,-39,-66,9,-318
11,-2,2,-42,-49,-41,-71,28,-164
-21,-8,-57,-76,-62,-31,-49,-5,-309
-42,10,-42,-91,-122,-30,-55,14,-358
3,1,-18,-75,-60,-74,-44,-10,-277
47,9,-7,-38,-149,-86,-63,18,-269
-29,-15,-22,-67,-71,-49,-63,3,-313
15,-5,-29,-62,-64,-64,-58,-16,-283
61,86,29,30,2,-25,-74,77,186
-37,-8,-44,-70,-49,-68,-78,-21,-375
10,9,-19,-2,-1,-13,-16,-4,-36
20,-3,-34,-55,-65,-9,-54,14,-186
-8,-22,-17,-47,-53,-37,-27,1,-210
0,-13,-16,-77,-81,-105,-78,-9,-379
-9,-4,-11,-23,-63,-19,-24,-2,-155
-53,-17,-39,-67,-64,-17,-47,-39,-343
8,-13,-4,-35,-121,-67,-73,-26,-331
-7,5,-24,-49,-35,-30,-27,-12,-179
-8,-12,-31,-78,-144,-88,-90,-34,-485
-5,-5,-14,-49,-62,-27,-21,15,-168
3,-9,-20,-37,-78,-44,-44,-36,-265
-9,19,-29,-48,-54,-21,-62,-15,-219
-11,-2,-17,-38,-49,-26,-39,-3,-185
-18,-10,-18,-42,-55,-3,-13,21,-138
3,-5,-30,-15,-78,-13,-48,7,-179
-15,23,-42,-97,-109,-75,-73,-40,-428
-3,9,-1,-16,-35,-11,-16,-5,-78
-27,32,-18,-40,-4,-17,-33,1,-106
2,15,-39,-64,-30,-37,-61,36,-178
1,-20,-18,-44,-123,-20,-57,-12,-293
9,33,-10,-27,-66,-14,-20,45,-50
25,-29,15,-14,-113,-57,-36,8,-201
-24,-1,-27,-50,-31,-27,-37,-30,-227
10,6,-5,-10,-70,-26,-41,-18,-154
-41,-11,-25,-113,-72,-40,-54,13,-343
-34,-41,-36,-89,-53,-49,-50,7,-345
-21,-9,-23,-45,-46,-24,-16,3,-181
-18,8,-20,-46,-51,6,-26,6,-141
11,3,-5,-13,-10,-16,-13,-9,-52
-42,-18,-44,-65,-82,-56,-57,-41,-405
-29,11,-29,-64,-45,-34,-33,-5,-228
-5,8,-42,-53,-75,-16,-45,-25,-253
-31,-6,-28,-74,-39,-31,-41,-16,-266
7,6,-37,-62,-109,-24,-78,-21,-318
16,34,-10,-12,-33,-17,-30,50,-2
40,21,-8,-62,-124,-78,-52,-2,-265
55,75,30,-28,-108,-60,-51,57,-30
-8,0,-11,-58,-52,-26,7,1,-147
-12,-5,-5,-38,-28,-1,-21,12,-98
-3,1,-32,-83,-99,-72,-40,-3,-331
-23,-8,-26,-58,-43,-25,-20,0,-203
2,5,-26,-41,-108,-23,-43,-12,-246
-1,45,-12,-57,-12,-24,-35,25,-71
-18,8,-43,-49,-56,-21,-32,-21,-232
-19,4,-27,-43,-20,-25,-25,13,-142
13,20,-35,-61,-65,-59,-86,9,-264
7,21,11,-20,-57,-15,-58,19,-92
-33,2,-16,-64,-48,0,-31,14,-176
-13,7,-33,-126,-159,-111,-122,-15,-572
-19,-28,-6,-23,-64,-60,-44,-23,-267
4,2,2,-26,-16,-9,-1,12,-32
-31,-12,-26,-32,-56,5,-21,53,-120
-23,-21,-28,-40,-36,-11,-22,-8,-189
28,7,-7,-3,-22,-20,-26,20,-23
-35,-5,-45,-153,-171,-74,-66,18,-531
-18,-8,-17,-60,-70,-44,-34,-10,-261
28,24,-4,16,-36,-23,-42,21,-16
-10,0,-23,-99,-116,-35,-60,13,-330
-18,20,-59,-112,-58,-72,-75,-47,-421
22,14,0,-34,-73,-46,-32,-21,-170
-25,-16,-24,-59,-34,-17,-16,21,-170
-24,2,-12,-59,-62,-36,-42,31,-202
50,29,25,46,-44,-27,-35,35,79
-5,7,0,-28,-41,-40,-46,-8,-161
90,83,21,47,-53,-9,-62,63,180
13,0,-22,-26,-63,-45,-52,-27,-222
-56,-31,-90,-170,-115,-55,-75,-49,-641
-1,14,-42,-77,-134,-49,-72,-19,-380
31,25,-14,-64,-112,-62,-61,1,-256
-6,-1,2,-26,-44,-7,-4,5,-81
2,11,-11,-38,-38,-37,-29,-12,-152
3,-25,-12,-8,-138,-29,-49,-3,-261
-19,61,-79,-213,-227,-87,-164,-20,-748
-14,-36,-5,-34,-129,-21,-66,-8,-313
10,-1,-16,-18,-76,-42,-33,-3,-179
-1,10,-7,-66,-108,-18,-64,-3,-257
-3,12,-7,-50,-59,-30,-31,-3,-171
-8,-20,-10,-13,-63,-45,-37,-16,-212
32,-24,-40,27,-41,-29,-42,24,-93
13,7,4,-37,-61,-40,-34,4,-144
-4,8,-24,-97,-127,-58,-60,-46,-408
20,21,-5,-30,-62,-22,-33,-12,-123
12,-14,-7,-8,-104,-58,-39,1,-217
-26,-6,-43,-84,-76,-32,-38,-19,-324
-11,-7,-9,-30,-40,-21,-18,9,-127
-11,-2,-4,-33,-22,-4,-19,30,-65
-20,28,-12,-76,-55,-10,-38,63,-120
-3,-4,-20,-38,-72,-30,-29,-15,-211
1,-15,-28,-57,-120,-37,-60,-27,-343
42,-22,-11,16,-119,-56,-62,-9,-221
-6,-18,1,-32,-51,-29,-20,-15,-170
-28,-9,-52,-109,-97,-18,-42,-18,-373
-6,12,-26,-78,-52,-50,-49,4,-245
-4,-7,-34,-63,-99,-46,-64,-42,-359
-13,8,-15,-31,-50,-12,-25,16,-122
3,17,-10,-21,-64,-24,-38,-22,-159
-29,30,-13,-96,-62,-29,-10,21,-188
-28,13,-23,-71,-63,-50,-53,-46,-321
-15,8,-24,-43,-35,-28,-23,-18,-178
-44,-7,-63,-95,-55,-42,-40,9,-337
-13,4,-19,-25,-21,-37,-39,-18,-168
-15,31,-52,-155,-75,-115,-103,78,-406
-36,-22,-40,-50,-71,-22,-45,-11,-297
-19,-44,-43,-150,-202,-134,-120,-83,-795
-28,2,-25,-77,-111,-61,-76,-5,-381
19,8,-12,-60,-104,-98,-62,-33,-342
-5,0,-10,-49,-41,-43,-33,-36,-217
0,15,-12,-28,-43,-26,-25,4,-115
-4,7,-34,-34,-72,-47,-46,-2,-232
-67,12,-60,-115,-59,-25,-54,-9,-377
-21,-1,-30,-84,-87,-42,-50,9,-306
-10,15,-16,-44,-34,-20,-38,-10,-157
-24,-23,-15,-54,-70,-19,-31,0,-236
-45,-7,-56,-190,-164,-86,-86,-43,-677
-38,-8,-23,-50,-9,-10,-13,1,-150
-5,15,-12,-45,-41,-59,-45,-49,-241
-18,-4,-34,-53,-35,-23,-35,-23,-225
-1,3,-4,-49,-100,-52,-56,3,-256
-51,-28,-35,-106,-66,-35,-57,0,-378
37,20,-13,-9,-32,-35,-36,-41,-109
-28,15,-21,-57,-60,-22,-47,-11,-231
-24,-79,-41,-115,-113,-72,-100,-9,-553
-29,13,-36,-89,-70,-59,-59,-28,-357
-19,11,-39,-62,-67,-9,-45,0,-230
21,0,-3,-16,-44,-8,-21,-26,-97
-4,-17,-27,-51,-105,-80,-84,-32,-400
-10,1,-1,-52,-42,-14,-24,4,-138
-47,-24,-46,-105,-92,-76,-68,-47,-505
-21,-22,-45,-50,-49,-17,-39,9,-234
-51,9,-50,-115,-69,-32,-65,-18,-391
-10,5,-26,-57,-52,-32,-38,-21,-231
21,13,-27,-48,-63,-39,-16,-1,-160
-14,-14,-2,-50,-62,-22,-40,21,-183
27,25,0,-15,-99,-27,-44,3,-130
8,18,-18,-55,-63,-41,-43,-25,-219
-32,-85,-61,-106,-242,-113,-240,-63,-942
-21,-61,-78,-91,-204,-143,-222,-88,-908
7,-12,-24,-26,-52,-7,-24,-7,-145
-28,15,-33,-65,-39,-6,-34,-2,-192
-11,9,-16,-41,-53,-25,-24,0,-161
-16,-13,-22,-48,-50,-36,-55,-25,-265
-5,-10,-13,-31,-26,-4,-16,26,-79
24,-7,-21,-51,-167,-102,-61,-32,-417
15,-10,2,-9,-33,-37,-21,-21,-114
-22,-7,-40,-58,-32,-24,-41,-6,-230
0,8,-35,-78,-111,-85,-83,-56,-440
7,5,-48,-84,-136,-122,-118,-48,-544
-22,-31,-29,-49,-87,-54,-76,-12,-360
4,-5,4,-77,-152,-37,-88,10,-341
-15,-4,-17,-67,-18,-35,-42,-5,-203
2,1,-6,-13,-58,-31,-36,1,-140
-15,-13,-61,-85,-41,-84,-81,-14,-394
-12,-11,-13,-15,-38,-1,-16,11,-95
-11,6,-34,-34,-18,-23,-21,-1,-136
-6,24,-13,-30,-25,-4,-11,-20,-85
-14,6,6,-41,-22,-8,-13,8,-78
-24,-3,-19,-73,-34,-20,-22,1,-194
-18,2,-30,-86,-72,-59,-55,-24,-342
-37,-30,-33,-106,-126,-55,-70,10,-447
103,40,12,38,-115,-67,-78,39,-28
-30,-23,-28,-63,-77,-38,-36,-20,-315
-15,-24,-34,-70,-110,-63,-58,12,-362
-10,-18,-26,-27,-60,-21,-34,-15,-211
8,13,-9,-16,5,5,-8,-11,-13
-5,26,-15,-56,-5,-11,-8,11,-63
-23,-1,-28,-50,-72,-44,-68,-1,-287
-41,-33,-46,-75,-87,-51,-61,-1,-395
4,27,-11,-50,-34,-47,-31,6,-136
-4,15,-11,-49,-5,-16,-23,6,-87
17,-8,-32,-71,-142,-67,-72,-38,-413
-50,-40,-38,-61,-86,-26,-70,-1,-372
-36,18,-37,-71,-71,-47,-33,-6,-283
-32,-3,5,-43,-44,22,-11,53,-53
72,-7,-10,44,-104,-92,-74,-11,-182
-18,23,-31,-54,-39,-28,-33,-21,-201
0,-8,-3,-22,-45,-26,-22,22,-104
31,-11,-21,-24,-117,-53,-66,-32,-293
-37,55,-65,-109,-33,-75,-86,-23,-373
9,21,-47,-180,-155,-143,-92,-125,-712
-4,-44,-7,-40,-54,3,-30,19,-157
-12,10,-16,-35,-58,-10,-36,27,-130
15,6,-23,-40,-112,-63,-75,-22,-314
-10,16,-23,-61,-60,10,-24,-31,-183
-34,7,-51,-80,-40,-16,-52,15,-251
-5,34,-34,-96,-59,-48,-51,-31,-290
-10,12,7,6,-9,23,-40,31,20
25,-31,-22,12,-151,-57,-66,-18,-308
12,17,-61,-42,-164,-48,-90,0,-376
8,-6,-12,-30,-68,-40,-32,-10,-190
-15,-5,-15,-34,-37,-22,-20,2,-146
-8,-16,-18,-54,-2,-31,-34,-20,-183
-30,-13,-99,-149,-131,-98,-99,-63,-682
17,-11,-5,-55,-138,-51,-53,2,-294
-18,-11,-15,-48,-50,-23,-20,-2,-187
-12,-8,-28,-55,-37,-32,-56,-5,-233
49,19,2,10,-95,5,-27,-5,-42
6,12,-21,-45,-56,-47,-43,12,-182
-8,-3,-1,-29,-41,-3,-5,1,-89
6,18,-11,-32,-78,-24,-46,12,-155
18,-4,-14,-40,-93,-39,-54,-24,-250
3,-11,7,-29,-84,-53,-59,-15,-241
-7,13,-19,-27,-30,-19,-28,8,-109
14,-6,-18,-22,-103,-21,-34,-7,-197
5,-9,-29,-84,-150,-66,-73,-77,-483
-21,-4,-26,-43,-26,-2,-24,-4,-150
5,-18,-32,-72,-111,-85,-54,-37,-404
-2,-4,-29,-43,-86,-38,-52,-7,-261
-31,0,-44,-106,-84,-56,-62,-50,-433
-4,20,-56,-96,-113,-79,-94,-34,-456
2,1,-15,-44,-70,-38,-70,-27,-261
0,58,-18,-90,-126,-80,-87,58,-285
-1,-45,-6,-35,-112,-80,-52,-35,-366
-1,11,-33,-101,-127,-118,-106,-74,-549
0,-6,-26,-50,-63,-41,-50,11,-225
-43,-29,-46,-97,-88,-54,-70,2,-425
-22,-2,-9,-57,-17,-16,-16,-13,-152
-23,-6,-46,-154,-249,-91,-121,-6,-696
-38,23,-8,-93,-58,-42,-49,-1,-266
44,-8,8,-23,-125,-53,-58,-19,-234
53,-30,28,-46,-224,-83,-133,-17,-452
23,-16,-12,-42,-108,-74,-77,-56,-362
19,47,-12,-34,-48,32,-9,88,83
-33,50,-69,-125,-86,-104,-91,-49,-507
-43,25,-37,-124,-26,-68,-49,-20,-342
7,-25,-28,-48,-170,-65,-83,-16,-428
16,3,-6,-48,-133,-82,-53,-10,-313
-56,-3,-51,-139,-153,-92,-89,-48,-631
19,7,-22,-22,-77,-30,-35,-30,-190
-10,-7,-10,-55,-86,-20,-39,0,-227
-25,-8,-19,-64,-49,-38,-39,-1,-243
-9,3,-25,-41,-49,-28,-30,-24,-203
13,49,7,-54,-171,-27,-48,90,-141
-5,24,-29,-40,-39,-22,-38,30,-119
2,5,-20,-65,-27,-45,-21,-7,-178
-9,-31,-7,-36,-60,-30,-18,-14,-205
-12,-11,-25,-36,-52,-28,-29,-43,-236
-15,16,-8,-47,-27,-4,-7,1,-91
9,15,0,-44,-119,-51,-99,7,-282
-19,7,-13,-21,-21,-12,-10,13,-76
-30,4,-19,-64,-62,-47,-57,-36,-311
-14,-22,-41,-49,-108,-14,-50,-28,-326
-20,2,-55,-140,-72,-99,-56,-32,-472
7,6,13,-28,-111,-56,-53,2,-220
-43,22,-65,-154,-90,-38,-74,-55,-497
-9,-37,-30,-61,-123,-86,-54,-29,-429
31,-9,-19,-20,-116,-31,-70,0,-234
-38,-41,-66,-136,-157,-85,-92,-46,-661
-6,29,-27,-59,-47,-21,-25,-27,-183
-12,4,-20,-46,-63,-34,-44,-12,-227
-26,17,-40,-42,-12,-2,-27,7,-125
21,14,-6,6,-89,-39,-61,-28,-182
3,3,-37,-59,-52,-62,-45,-28,-277
-1,-13,-7,-24,-95,-28,-38,13,-193
15,8,-28,-69,-87,-97,-62,-52,-372
3,27,-2,-34,-43,-43,-39,-13,-144
13,28,-36,-65,-51,-72,-60,-55,-298
21,-36,-5,-7,-62,-52,-83,-60,-284
-17,-11,-26,-101,-226,-108,-134,-80,-703
-20,6,-16,-62,-15,-26,-30,-13,-176
15,-9,-4,-13,-11,12,-6,15,-1
3,14,-27,-55,-98,-45,-32,-23,-263
-29,-12,-20,-74,-42,-24,-18,-13,-232
24,25,-3,7,-74,-13,-14,51,3
10,-1,7,-7,-53,-13,-24,21,-60
-12,-3,4,-20,-33,-15,-26,11,-94
-1,-1,3,-36,-78,-38,-35,11,-175
9,14,3,-38,-13,-1,-30,21,-35
-8,-33,-13,-30,-124,-39,-65,-14,-326
-9,9,-15,-30,-99,-40,-70,-8,-262
1,28,-17,-81,-63,-9,-46,31,-156
4,-10,-10,-37,-53,-14,-22,12,-130
15,0,-34,-38,-75,-60,-51,-47,-290
-24,-12,-24,-47,-92,-41,-43,3,-280
39,-3,2,1,-116,-50,-50,-22,-199
23,28,-45,-49,-63,-90,-69,-52,-317
21,-18,-43,-65,-171,-105,-117,-21,-519
32,10,9,-63,-119,-94,-51,-32,-308
-37,-4,-16,-62,-67,-20,-38,13,-231
-14,-7,-67,-106,-56,-65,-66,-5,-386
-4,8,-37,-91,-73,-54,-61,-47,-359
-43,-19,-25,-52,-61,-29,-47,-8,-284
-18,-7,-20,-51,-18,-31,-16,2,-159
-5,33,-3,-16,-41,14,-25,-4,-47
6,12,-15,-52,-92,-61,-54,-19,-275
-31,-3,-13,-53,-34,-15,-29,14,-164
8,-19,-18,-47,-113,-67,-63,-29,-348
-46,-13,-105,-238,-159,-148,-143,41,-811
0,12,-5,-59,-121,-55,-64,-15,-307
-4,2,-14,-105,-166,-84,-97,-50,-518
2,15,-12,-16,-32,-18,-14,12,-63
-28,-13,-25,-124,-206,-95,-108,19,-580
41,-11,-30,-36,-132,-104,-77,-34,-383
-81,-44,-105,-150,-115,-96,-148,-56,-795
25,42,3,14,-37,-36,-53,27,-15
12,-2,-18,-110,-237,-128,-111,-47,-641
5,2,-16,-32,-27,-2,-12,28,-54
-36,-4,-27,-58,-38,-15,-26,12,-192
-43,-28,-66,-86,-128,-69,-149,-35,-604
16,27,5,-4,-75,-1,-49,45,-36
-2,-2,-7,-39,-39,-16,-24,20,-109
9,-5,-32,-64,-118,-95,-90,-50,-445
-9,13,-19,-56,-35,-53,-46,-3,-208
-2,26,-25,-90,-91,-43,-36,-23,-284
-5,11,-17,-29,-11,-15,-15,19,-62
-26,-45,-30,-28,-45,-27,-56,-2,-259
3,17,-35,-33,-4,1,-11,25,-37
-12,-14,-21,-55,-59,-18,-22,5,-196
-9,-8,-19,-44,-56,-30,-26,2,-190
3,-11,-14,-57,-121,-79,-64,-45,-388
23,21,0,-7,-42,39,-7,43,70
-15,-12,-47,-92,-139,-83,-92,-36,-516
9,2,-18,-22,-67,-41,-48,-17,-202
-8,4,-1,-31,-62,-36,-38,-26,-198
0,6,-19,-33,-58,-16,-31,55,-96
10,-3,-10,-3,-7,0,-8,-3,-24
41,27,12,30,-170,-22,-44,5,-121
4,5,-1,-13,-23,27,-18,14,-5
-3,-11,-29,-58,-111,-58,-81,-35,-386
16,-19,-15,-65,-111,-55,-54,-41,-344
17,-15,-23,-30,-97,-75,-59,-43,-325
8,-2,-31,-44,-54,-53,-49,-21,-246
-10,-30,-6,-63,-67,-61,-43,-20,-300
-12,18,-2,-51,-31,-5,-1,36,-48
-23,59,-57,-103,-49,-13,-44,-4,-234
-21,-14,-22,-31,-41,-9,-21,-4,-163
8,16,-22,-17,-27,11,-11,26,-16
32,6,11,-8,-94,-48,-61,-13,-175
-16,15,-39,-55,-70,-27,-22,-8,-222
42,30,-31,-77,-139,-128,-100,-66,-469
22,47,-1,-51,-63,-31,-29,38,-68
15,-3,-16,-36,-109,-43,-49,-38,-279
-30,-12,-52,-101,-82,-57,-63,-23,-420
-9,15,-4,-17,-33,-16,-14,11,-67
-15,-14,-22,-32,-69,-15,-33,-16,-216
26,23,2,-20,-9,-21,-40,-5,-44
-5,13,-9,-35,-28,-7,-3,36,-38
-29,-13,-63,-109,-137,-34,-115,-28,-528
-23,0,-34,-56,-48,-40,-46,-22,-269
49,26,-48,-82,-151,-153,-141,-119,-619
-14,-2,-24,-95,-132,-44,-67,20,-358
42,-43,-10,-98,-242,-152,-136,-55,-694
-10,7,8,-18,-59,-39,-17,6,-122
-9,-42,-15,-17,-99,-34,-54,-12,-282
14,41,-14,-71,-83,-13,-63,-54,-243
-22,-16,-23,-60,-61,-43,-52,-22,-299
-7,29,-5,-41,-45,0,-9,7,-71
23,-6,-24,-38,-154,-103,-70,-70,-442
38,37,18,-38,-138,-42,-70,3,-192
101,68,41,66,-23,40,-5,115,403
-3,-2,-17,-17,-76,-4,-28,-1,-148
-19,3,-23,-52,-35,-40,-27,-19,-212
-23,6,-33,-47,-33,-40,-41,6,-205
-2,3,-10,-28,-77,-40,-62,-16,-232
7,-32,-44,-68,-84,-62,-99,-44,-426
-5,-1,-17,-32,-21,-8,-20,-4,-108
-4,10,-5,-18,-41,-33,-18,4,-105
8,-16,-19,-54,-123,-55,-56,-44,-359
-5,17,-21,-32,-29,-4,-20,-8,-102
-115,-45,-125,-274,-224,-56,-124,-34,-997
-9,-4,-19,-33,-25,-8,-18,0,-116
9,-12,-18,-18,-92,-65,-21,-44,-261
-5,-27,-20,-29,-51,-34,-38,-4,-208
21,42,5,3,-29,-5,0,-12,25
-1,9,-3,-14,-75,-31,-48,6,-157
-39,-25,-35,-119,-91,-38,-69,-2,-418
8,-10,-31,-39,-49,-52,-64,-46,-283
-25,-15,-25,-64,-86,-34,-55,-22,-326
11,2,-50,-68,-118,-78,-85,-45,-431
-19,-6,0,-66,-62,-18,-49,-22,-242
1,67,-44,-123,-63,-80,-78,-2,-322
31,29,-23,-52,-148,-82,-73,-64,-382
14,-10,-18,-31,-63,-35,-50,3,-190
-12,-12,-31,-57,-75,-62,-69,-39,-357
-11,10,-26,-50,-51,-27,-40,-8,-203
-27,-6,-23,-51,-48,-21,-47,6,-217
16,13,-23,-70,-114,-78,-90,-37,-383
-4,1,-4,-37,-43,-38,-23,-8,-156
0,-7,-35,-106,-185,-87,-101,-12,-533
-15,-4,-20,-56,-58,-29,-30,-7,-219
7,-7,-49,-100,-94,-100,-80,-52,-475
39,16,-14,-59,-94,-35,-77,49,-175
2,19,-7,-100,-221,-110,-121,-80,-618
-22,4,-25,-65,-61,-31,-63,-17,-280
-19,1,-51,-81,-102,-79,-84,-76,-491
-21,6,-38,-105,-68,-57,-60,-13,-356
-38,-2,-49,-79,-98,-56,-65,-6,-393
-8,0,-42,-55,-69,-61,-66,-60,-361
-33,-5,-20,-56,-35,-21,-30,-14,-214
39,-9,-9,-161,-299,-163,-149,-34,-785
3,1,-7,-19,-52,-3,-13,-3,-93
17,-42,-13,-14,-129,-55,-57,-18,-311
2,25,-14,-29,-8,-9,-35,7,-61
30,26,6,23,-36,1,-36,68,82
-37,-29,-35,-70,-45,-46,-66,-3,-331
14,2,7,-8,-63,-50,-44,-6,-148
22,37,-20,-107,-43,-75,-26,-15,-227
-7,24,-35,-65,-48,-60,-50,-24,-265
140,82,-7,-38,-143,-38,-159,136,-27
-19,19,-48,-61,-75,-62,-57,-2,-305
25,-4,1,-16,-46,-44,-12,8,-88
-25,-25,-31,-76,-67,-38,-40,-29,-331
-28,4,-25,-49,-31,-10,-31,-12,-182
-14,-27,-23,-54,-80,-43,-42,-20,-303
34,14,20,-39,-183,-136,-77,-33,-400
26,47,-9,-47,-93,-45,-54,2,-173
-21,-1,-34,-58,-45,-15,-41,-14,-229
-3,-14,-9,-29,-51,-30,-32,-23,-191
-21,-27,-32,-61,-35,-30,-32,-31,-269
-15,2,-18,-23,-37,-12,-31,21,-113
-20,-5,-21,-40,-34,-23,-28,-12,-183
-26,-8,-41,-65,-84,-29,-60,3,-310
6,-42,-46,-62,-123,-110,-86,-32,-495
-17,6,-17,-75,-43,-44,-25,-25,-240
1,13,-18,-67,-59,-50,-66,-23,-269
9,-5,-4,-18,-69,-45,-32,-22,-186
-31,9,-43,-64,-45,-30,-45,-36,-285
-19,-6,1,-48,-44,-42,-26,3,-181
1,30,-23,-56,-45,-45,-35,12,-161
1,-2,-7,-54,-40,-26,-17,-9,-154
-19,6,-24,-45,-35,-34,-45,1,-195
-14,-15,-26,-45,-159,-57,-76,-31,-423
24,28,-25,-48,-86,-40,-54,-25,-226
16,24,6,-39,-52,-16,-37,-1,-99
-29,-29,-37,-73,-111,-37,-69,-23,-408
-11,13,-33,-102,-64,-64,-51,-41,-353
-14,6,-73,-178,-184,-112,-129,-45,-729
39,27,2,28,-68,-53,-40,12,-53
39,20,-27,-51,-85,-65,-44,-55,-268
41,19,-19,-41,-94,-77,-68,-88,-327
57,-35,-8,-46,-156,-101,-123,-42,-454
16,-14,-33,-43,-173,-99,-70,-68,-484
-3,-29,-44,-88,-148,-120,-68,-56,-556
-12,1,-32,-97,-124,-77,-90,32,-399
-8,-4,-10,-53,-79,-45,-21,-18,-238
-20,17,-60,-99,-76,-71,-99,-45,-453
-29,-35,-23,-86,-102,-53,-61,-27,-416
15,10,-11,-46,-71,-31,-39,-37,-210
22,21,-29,-78,-91,-62,-71,-44,-332
-3,-9,-20,-56,-86,-59,-48,-14,-295
12,-23,-39,-80,-140,-55,-79,-41,-445
-15,4,-8,-41,-56,-23,-31,0,-170
49,19,-5,-59,-137,-111,-62,-69,-375
37,8,-46,-114,-191,-130,-138,-57,-631
17,-8,-28,-25,-25,-28,-31,-22,-150
-8,-17,-32,-61,-87,-70,-73,-59,-407
47,13,9,30,-100,-34,-51,-15,-101
-3,-7,-33,-50,-52,-36,-33,-25,-239
63,-29,24,26,-60,-7,-59,46,4
-8,-6,-2,-38,-28,-9,1,16,-74
-4,3,-16,-35,-20,-10,-25,23,-84
20,-3,4,2,-28,-25,-28,60,2
66,74,9,8,-94,-59,-33,-18,-47
24,15,-42,-123,-150,-117,-90,-87,-570
-3,5,-66,-122,-119,-110,-107,-50,-572
-20,20,-51,-88,-62,-31,-70,-38,-340
-27,-3,-18,-56,-39,-5,-15,0,-163
24,1,-17,-51,-107,-81,-76,-51,-358
-7,0,-22,-50,-60,-17,-22,-7,-185
-7,-11,-22,-29,-75,-18,-42,11,-193
-30,-26,-22,-49,-48,-18,-46,-18,-257
-23,11,-38,-80,-27,-17,-54,-26,-254
-11,17,-7,-58,-63,-48,-39,-21,-230
31,12,-29,-86,-107,-97,-72,-103,-451
7,-5,0,1,-29,22,-13,14,-3
-8,25,-38,-103,-123,-98,-60,-32,-437
6,13,-13,-53,-34,-59,-28,11,-157
16,-16,-15,-40,-51,2,-40,72,-72
24,22,-35,-83,-79,-77,-53,-59,-340
-38,10,-12,-60,-26,-12,-40,-3,-181
-5,13,-44,-185,-140,-109,-83,-38,-591
13,-1,-1,-27,-51,-36,-31,18,-116
-35,-14,-28,-72,-55,-14,-46,17,-247
6,5,-34,-67,-33,-24,-73,5,-215
-9,19,-13,-41,-38,-34,-33,-12,-161
0,8,-14,-9,-38,-32,-30,-4,-119
-19,-3,-34,-57,-70,-37,-56,-22,-298
-18,-3,-24,-51,-52,-25,-45,-10,-228
-32,24,-38,-71,-97,-33,-58,3,-302
-1,13,-24,-37,-48,-43,-40,-11,-191
-6,-17,-19,-35,-82,-62,-54,-23,-298
-25,26,-32,-60,-45,-27,-58,-11,-232
17,25,-15,-29,-65,-59,-58,-45,-229
-12,19,-12,-27,-45,-15,-31,10,-113
-8,0,-19,-28,-42,-32,-36,-24,-189
-51,-26,-46,-97,-42,-35,-37,-20,-354
-27,19,-53,-101,-65,-38,-55,-17,-337
-29,-29,-57,-120,-101,-57,-62,32,-423
-5,-15,-20,-32,-61,-28,-46,-11,-218
-7,10,-25,-59,-87,-40,-37,-17,-262
-20,17,-14,-99,-89,-63,-75,-26,-369
25,-3,-28,-60,-82,-60,-68,-37,-313
-21,10,-8,-42,-31,-21,-30,0,-143
-20,-12,-16,-68,-71,-2,-45,4,-230
-41,-26,-26,-88,-45,-10,-40,29,-247
5,23,0,-50,-14,2,-42,19,-57
-16,-1,-27,-50,-73,-28,-45,-14,-254
-9,9,-27,-20,-34,-13,-15,-4,-113
45,13,38,-24,-32,4,-15,59,88
13,11,10,-30,-53,-27,-7,10,-73
1,1,-1,-23,-44,-13,-22,9,-92
18,23,14,-2,-44,-31,5,-14,-31
-2,49,-77,-82,-77,8,-4,10,-175
57,25,-13,-15,-103,-47,-67,-62,-225
-35,-2,-29,-78,-53,-46,-54,-18,-315
-15,15,-19,-42,-23,-32,-22,-4,-142
73,-45,47,4,-70,-26,-55,50,-22
59,-11,-23,-58,-209,-143,-112,-42,-539
-15,6,-28,-108,-183,-120,-82,-64,-594
-46,2,-44,-60,-14,6,-31,-10,-197
-17,27,-41,-78,-96,-76,-82,-40,-403
-16,-5,-16,-40,-42,-12,-33,20,-144
4,16,-43,-99,-59,-101,-75,-50,-407
-30,2,-50,-96,-76,-37,-67,-44,-398
0,15,-11,-77,-85,-11,-47,20,-196
71,23,15,-1,-82,14,-68,-1,-29
21,8,-8,-69,-75,-13,-45,-8,-189
15,7,6,2,-25,-5,-40,15,-25
-11,33,-29,-63,-10,-34,-3,-33,-150
11,2,-25,-29,-87,-30,-53,-22,-233
-32,-32,-58,-84,-85,-63,-86,-26,-466
5,2,-79,-194,-257,-202,-183,-128,-1036
-44,-3,-14,-101,-64,-42,-67,5,-330
12,6,-11,-9,-13,9,7,-7,-6
16,6,-26,-14,-55,-17,-4,-21,-115
-6,-3,-17,-43,-78,-35,-33,0,-215
6,16,-50,-60,-76,-44,-51,-64,-323
7,-8,-16,-27,-69,-43,-60,-9,-225
-6,-1,-21,-40,-54,-38,-46,-18,-224
-118,-97,-108,-242,-253,-64,-122,-53,-1057
-19,-7,-43,-51,-62,-33,-42,-24,-281
-6,-3,-22,-65,-88,-78,-67,-41,-370
-15,-32,-42,-54,-137,-59,-67,-17,-423
-36,10,-43,-74,-34,-12,-33,-15,-237
-23,-9,-38,-58,-74,-4,-47,-31,-284
-26,-3,-31,-72,-85,-30,-44,55,-236
-16,-7,-15,-112,-148,-89,-53,35,-405
4,-7,-9,-36,-62,-35,-23,-9,-177
-29,-1,-44,-118,-49,-56,-67,-11,-375
-7,-7,-40,-61,-53,-49,-66,-57,-340
-4,13,-21,-21,-34,7,-13,1,-72
9,-24,-51,-98,-135,-117,-99,-103,-618
-32,-22,-26,-64,-58,-21,-30,-7,-260
49,5,-40,-88,-93,-111,-96,-108,-482
28,11,-47,-109,-91,-85,-77,-99,-469
-16,2,-8,-37,-38,-28,-42,-18,-185
26,27,-35,-55,-121,-94,-72,-85,-409
-10,25,-54,-118,-144,-44,-83,-57,-485
-1,0,0,-20,-73,-46,-32,-14,-186
-17,11,-27,-67,-83,-65,-51,-5,-304
1,-4,-30,3,-57,-12,-32,-6,-137
-30,-2,-29,-52,-39,-41,-44,-17,-254
-7,5,-56,-189,-150,-136,-93,-52,-678
-5,10,-40,-62,-29,-4,-31,-1,-162
5,0,-22,-35,-9,13,0,26,-22
-11,-2,-38,-71,-82,-100,-74,-38,-416
-7,-3,-12,-42,-53,-50,-52,-29,-248
17,3,-7,-53,-168,-110,-87,-45,-450
9,18,-20,-22,-26,-27,-26,-5,-99
-32,-3,-31,-64,-60,-4,-39,7,-226
-1,16,-16,-26,-16,-12,-27,3,-79
-40,-25,-43,-58,-42,-10,-30,-16,-264
-6,17,-42,-51,-85,-49,-42,-16,-274
-27,-20,-19,-74,-31,-13,-11,5,-190
9,8,-46,-93,-122,-37,-97,-43,-421
-24,-19,1,-24,-81,-3,-49,49,-150
8,-16,-27,-40,-93,-43,-48,-13,-272
-43,-20,-42,-71,-87,-36,-47,-9,-355
12,0,-14,-53,-95,-65,-39,-23,-277
-1,2,-28,-36,-68,-33,-46,-13,-223
-18,15,-45,-60,-38,-32,-63,-43,-284
-6,-1,-20,-41,-78,-58,-44,-12,-260
26,42,27,24,8,31,-11,72,219
13,-30,-13,-52,-52,-9,-44,44,-143
-3,12,-29,-58,-10,-27,-43,1,-157
-10,12,-28,-49,-30,2,-42,12,-133
21,23,-5,-12,-34,1,-13,-4,-23
-20,-21,-25,-74,-136,-45,-51,-17,-389
-2,38,-60,-170,-225,-179,-184,-90,-872
22,28,2,-7,-50,-17,-20,53,11
-17,23,-10,-45,-50,-27,-31,-8,-165
-16,-6,-14,-37,-21,4,-20,4,-106
-29,-5,-11,-55,-111,9,-54,15,-241
19,-18,-17,-23,-77,-47,-37,-10,-210
19,21,-36,-74,-85,-81,-53,-50,-339
-5,13,-30,-34,-56,-36,-41,5,-184
17,-4,-15,-22,-128,-71,-50,-41,-314
13,-11,-20,-48,-82,-39,-58,-31,-276
0,-2,-32,-110,-169,-88,-89,-1,-491
-5,3,2,-25,-93,-63,-39,-11,-231
-13,6,-44,-84,-72,-26,-65,-16,-314
8,14,-26,-24,-53,-40,-25,2,-144
23,7,-8,-22,-92,-64,-66,-35,-257
-38,-6,-25,-66,-56,-10,-23,-5,-229
-76,47,-60,-142,-56,11,-16,5,-287
-53,11,-57,-91,-22,-10,-26,-5,-253
-1,-4,-13,-33,-23,-39,-13,8,-118
-8,-8,-16,-47,-48,-48,-47,-10,-232
-29,-10,-24,-45,-41,-13,-34,0,-196
15,-15,-15,-7,-66,-41,-39,-15,-183
21,-15,-16,-71,-120,-83,-71,-53,-408
0,23,-32,-87,-69,-62,-75,-40,-342
-21,-6,-25,-40,-29,-14,-46,4,-177
-27,-20,-17,-51,-48,-19,-29,-5,-216
2,11,-14,-42,-36,-30,-31,-12,-152
-2,2,-36,-58,-51,-24,-19,-21,-209
-16,20,-16,-53,-99,-25,-66,4,-251
13,16,-1,-38,-103,-50,-49,-21,-233
1,-12,-13,-31,-30,-10,-37,-26,-158
-3,15,-13,-42,-8,-30,-40,9,-112
1,19,-50,-110,-79,-85,-63,-59,-426
-36,-17,1,-39,-46,-9,-37,40,-143
-1,20,-30,-58,-89,-25,-45,-25,-253
-14,8,-18,-25,-38,5,-37,13,-106
22,29,10,-21,-120,-63,-78,-61,-282
-24,-7,-20,-56,-50,-8,-32,-3,-200
0,27,-19,-37,-99,-3,-42,-16,-189
-37,14,-40,-108,-101,-44,-57,-7,-380
28,30,4,-46,-105,-54,-58,-19,-220
-9,-14,-32,-32,-117,-41,-80,-6,-331
11,5,1,-28,-98,-36,-45,-2,-192
16,10,-20,-29,-75,-62,-41,-23,-224
-42,-9,-32,-91,-89,-50,-68,-21,-402
9,-23,-11,-73,-136,-114,-55,-46,-449
-47,-19,-36,-100,-94,-41,-39,-35,-411
-12,12,-28,-53,-54,-46,-49,2,-228
-13,-16,-7,-46,-52,-11,-29,9,-165
28,11,12,-20,-93,-38,-32,13,-119
-17,12,-10,-79,-118,-38,-50,18,-282
-89,68,-145,-270,8,-110,-114,-70,-722
13,1,-42,-81,-125,-104,-93,-49,-480
-36,-9,-32,-121,-176,-44,-77,8,-487
-61,17,-66,-188,-173,-71,-81,-59,-682
2,0,-5,-31,-29,-17,-43,-15,-138
-76,-19,-67,-155,-123,-97,-93,4,-626
-12,34,-9,-54,-38,-28,-34,-27,-168
-8,-6,-17,-45,-56,-36,-25,-1,-194
-2,34,-41,-90,-79,-24,-34,-10,-246
20,13,-1,-43,-122,-53,-69,-21,-276
12,17,-15,-46,-37,-22,-15,-23,-129
4,9,-57,-110,-92,-107,-76,-103,-532
2,20,-33,-65,-62,-63,-42,-50,-293
-5,-18,-25,-11,-64,-55,-55,-21,-254
-1,16,-11,-51,-51,-38,-26,29,-133
-15,-1,-25,-51,-70,-66,-54,41,-241
0,18,-2,-31,-18,-10,5,-1,-39
25,16,-2,-42,-151,-60,-62,4,-272
-29,-9,-25,-57,-46,-25,-33,-17,-241
-4,-7,-45,-60,-159,-56,-86,-27,-444
-36,-6,-47,-84,-45,-32,-45,8,-287
-12,10,-45,-78,-61,-42,-52,-4,-284
-33,11,-71,-129,-103,-50,-83,-10,-468
-3,3,-25,-31,-14,-8,-15,-1,-94
-4,-13,-32,-43,-60,-39,-47,-6,-244
-1,-20,-13,-29,-58,-45,-58,-21,-245
-45,-19,-29,-93,-88,-31,-51,7,-349
-41,-4,-55,-94,-93,-62,-49,-20,-418
-5,12,8,-40,-77,-29,-24,-2,-157
-36,1,-45,-83,-112,-41,-84,-4,-404
-46,-20,-42,-65,-58,-41,-33,-28,-333
-57,28,-43,-105,-87,-59,-72,-31,-426
45,68,4,-22,-70,10,-41,47,41
-70,19,-80,-136,-91,-65,-77,-2,-502
-5,1,-11,-11,-18,40,-7,46,35
-1,-13,-14,-36,-69,-48,-33,-24,-238
-16,2,-21,-40,-19,-22,-13,2,-127
31,32,9,-30,-56,-9,-15,19,-19
44,2,-28,-66,-158,-91,-74,-90,-461
-4,-16,-15,-26,-47,-26,-17,-6,-157
-3,4,-7,-20,-15,-3,-3,15,-32
50,-2,-66,-89,-237,-140,-124,-99,-707
-2,-3,-17,-41,-45,-24,-34,0,-166
18,-2,5,-58,-57,-65,-64,-28,-251
-33,9,-41,-66,-12,-5,-23,24,-147
47,14,-20,-39,-85,-85,-67,-42,-277
-27,-13,-12,-64,-52,-51,-29,-13,-261
-7,21,10,-32,-14,-21,-35,16,-62
-11,13,-21,-32,-28,-1,-33,23,-90
-17,-16,-42,-75,-92,-50,-77,8,-361
-6,-21,-18,-58,-71,-50,-52,-27,-303
-42,-15,-24,-65,-81,-14,-41,9,-273
-4,-20,-26,-60,-80,-43,-48,54,-227
-11,-13,-23,-40,-33,-10,-31,21,-140
53,-9,13,-53,-84,-63,-86,27,-202
-23,-11,-53,-97,-82,-67,-89,-12,-434
-20,6,-44,-100,-45,-18,-43,34,-230
-36,-13,-17,-54,-82,-25,-37,2,-262
1,49,-41,-67,-63,1,-9,56,-73
-47,-39,-44,-103,-102,-53,-58,-17,-463
28,15,-11,-15,-39,-19,-43,-13,-97
-18,-44,-9,-23,-76,-11,-55,14,-222
11,30,-62,-14,-74,-16,-42,51,-116
-20,24,-17,-56,-90,-29,-43,-10,-241
38,8,-19,-9,-45,-11,-5,-19,-62
-13,-12,-25,-28,-32,-15,-41,-19,-185
0,38,-17,-51,-49,-33,-23,-12,-147
30,-12,-14,-45,-204,-118,-77,-7,-447
-10,3,-25,-39,-35,-37,-42,-8,-193
-6,12,-10,-58,-30,-38,-30,-2,-162
4,14,-18,-24,-27,-14,-26,-23,-114
7,7,-33,-34,-60,-24,-48,-14,-199
-1,20,-25,-26,7,-18,-15,30,-28
-1,5,-12,-27,-25,-15,-21,-5,-101
-25,0,-22,-61,-75,-19,-50,-10,-262
-5,25,-14,-81,-21,-41,-54,10,-181
8,-16,-26,-69,-100,-76,-57,-51,-387
-23,12,-24,-62,-41,-39,-38,7,-208
-24,8,-17,-48,-18,-24,-27,-15,-165
-78,25,-86,-191,-102,-70,-112,0,-614
-15,11,-22,-60,-48,-33,-40,-31,-238
-4,2,-25,-40,-56,-35,-28,-38,-224
-28,0,-28,-53,-57,-19,-44,-24,-253
0,-21,-13,-42,-111,-61,-63,-1,-312
-3,11,-29,-44,-49,-19,-35,23,-145
-33,0,-44,-71,-65,-29,-40,-15,-297
11,1,-16,-34,-47,-56,-25,-18,-184
40,-25,-17,-44,-168,-75,-86,-18,-393
-14,-12,-36,-67,-47,-56,-65,-56,-353
-1,12,-9,-18,-37,-28,-12,0,-93
-11,-12,-46,-65,-20,-32,-37,-22,-245
0,-2,-9,-26,-53,-16,-22,-10,-138
-12,22,-23,-42,-79,-17,-48,5,-194
-17,2,-18,-68,-48,-20,-33,28,-174
-30,-14,-62,-66,-83,-40,-56,1,-350
-10,-10,-23,-101,-135,-71,-73,-18,-441
-9,-3,-16,-44,-45,-31,-41,22,-167
-9,-7,-14,-53,-72,-39,-42,-8,-244
0,-3,-23,-68,8,-23,-6,47,-68
-1,4,-17,-36,-74,-61,-56,-28,-269
3,-4,-3,-56,-95,-56,-56,-31,-298
-20,-26,-26,-52,-55,-33,-38,-11,-261
24,-14,-57,-111,-137,-141,-98,-92,-626
16,19,-28,-52,-114,-63,-78,-30,-330
-17,-52,-45,-121,-133,-56,-82,-9,-515
35,-4,-35,-47,-43,-51,-51,8,-188
-20,13,-14,-51,-24,-38,-27,-16,-177
-36,16,-31,-87,-28,-26,-38,-7,-237
-10,-7,-30,-43,-45,-49,-45,-26,-255
21,9,-35,-71,-117,-78,-68,-68,-407
17,5,-17,-40,-66,-59,-34,-35,-229
4,14,-6,-31,-71,-24,-45,-23,-182
-37,12,-42,-108,-85,-42,-47,-34,-383
6,0,-40,-75,-102,-81,-66,-49,-407
-14,13,-32,-64,-51,-40,-51,-30,-269
-19,35,-43,-140,-118,-37,-61,11,-372
-1,17,-16,-49,-34,-46,-31,-40,-200
-11,6,-5,-55,-28,-29,-30,-7,-159
66,65,-21,-26,-88,-45,-54,18,-85
23,48,4,-88,-14,-8,-2,85,48
-20,6,-36,-64,-39,-26,-47,-8,-234
7,-56,-35,-100,-150,-45,-53,-6,-438
1,-13,-27,-23,-93,-58,-67,-37,-317
-16,14,-33,-70,-112,-1,-35,5,-248
67,62,-20,-110,-93,-112,-79,-132,-417
7,14,-13,1,-42,-5,-23,-1,-62
-4,2,-27,-67,-87,-59,-81,-17,-340
-16,-2,-47,-68,-65,-13,-48,-2,-261
38,-1,-9,-1,-91,-54,-49,-28,-195
-3,-1,-18,-54,-80,-74,-54,-40,-324
-27,-8,-33,-74,-67,-32,-38,-10,-289
40,35,-11,23,-60,-46,-14,-46,-79
35,17,-19,-28,-123,-83,-73,-24,-298
-20,-15,-33,-69,-57,-18,-39,-13,-264
24,30,-58,-87,-89,-113,-94,-92,-479
-5,17,-8,-41,-42,-27,-21,11,-116
5,4,-16,-49,-45,-32,-34,-19,-186
-27,16,-15,-57,-39,-9,-31,-5,-167
30,-20,4,-24,-60,-24,-35,-3,-132
-47,-21,-33,-83,-94,-44,-76,-11,-409
-13,27,-9,-66,-57,-45,-33,-13,-209
-39,-28,-27,-97,-179,-74,-77,-4,-525
0,16,-40,-42,-35,-28,-28,-31,-188
-5,-3,-24,-43,-56,-52,-41,-25,-249
14,-19,-23,-53,-92,-71,-46,-30,-320
-48,-10,-60,-132,-102,-61,-85,-13,-511
-21,-20,-24,-28,-53,-17,-12,5,-170
-10,10,-36,-59,-39,-38,-67,-24,-263
-4,23,-31,-43,-7,-13,-10,35,-50
-1,1,-18,-41,-14,-15,-3,31,-60
-47,-5,-36,-113,-82,-48,-52,-6,-389
12,8,-24,-48,-38,-40,-49,-11,-190
3,1,-55,-120,-126,-92,-114,-22,-525
-65,-33,-52,-153,-125,-66,-64,-55,-613
-27,10,-23,-68,-43,-13,-32,-18,-214
-16,2,-24,-89,-69,-20,-42,-26,-284
-60,-2,-75,-120,-52,-51,-79,-35,-474
-2,-27,-37,-60,-79,-26,-86,-4,-321
21,22,-5,-104,-112,-70,-21,26,-243
-9,-4,-20,-38,-32,-38,-30,-21,-192
-20,-7,-14,-54,-17,-30,-38,-30,-210
140,116,40,14,-113,-60,-96,65,106
5,23,-21,-74,-33,-56,-32,-64,-252
-22,-4,-42,-52,-43,-23,-57,-3,-246
-22,26,-46,-97,-73,-34,-67,-39,-352
16,8,-11,-68,-126,-56,-53,-39,-329
-39,10,-48,-114,-83,-19,-46,-7,-346
26,3,-20,-77,-156,-100,-66,-34,-424
-2,15,-21,-50,-45,-29,-26,-10,-168
-21,13,-15,-64,-47,-30,-34,8,-190
-33,-34,-20,-55,-69,-29,-27,10,-257
38,6,-17,-42,-191,-44,-99,-14,-363
1,-6,-19,-33,-21,-27,-26,0,-131
-85,-21,-90,-188,-115,-48,-87,-34,-668
-5,3,-12,-72,-67,-69,-45,-12,-279
-4,-6,-28,-21,-37,-10,-20,-6,-132
-19,14,-14,-63,-63,-38,-46,-4,-233
-31,-21,-26,-41,-120,-55,-93,-19,-406
-52,-8,-52,-101,-45,-54,-71,-51,-434
-3,7,-12,-28,-34,-16,-22,21,-87
-21,16,-45,-60,-41,-37,-67,-44,-299
17,20,7,-51,-47,-28,-45,-16,-143
-40,34,-43,-89,-64,-27,-60,-1,-290
-17,7,-22,-27,-21,8,-15,14,-73
-19,2,-5,-41,-36,-31,-13,10,-133
-47,-51,-19,-116,-135,-61,-98,52,-475
-18,-9,-7,-47,-37,-18,-31,21,-146
-13,-1,-7,-41,-40,-25,-32,-22,-181
-19,-8,-5,-42,-34,-9,-30,-2,-149
32,17,5,14,-12,-3,-23,10,40
17,2,-15,-5,-67,-52,-40,-19,-179
19,27,-69,-64,-83,-105,-82,-99,-456
3,23,-32,-35,-37,-34,-58,-45,-215
-27,1,-28,-85,-47,-38,-57,-30,-311
2,-3,-36,-41,-76,-52,-46,-21,-273
-48,29,-77,-164,-126,-35,-61,-33,-515
23,0,3,-13,-107,-19,-47,42,-118
-41,-32,-38,-94,-86,-89,-98,-26,-504
2,8,-16,-21,-60,-53,-23,-16,-179
-34,6,-46,-105,-21,-53,-33,-38,-324
23,13,-16,-22,-105,-64,-44,-39,-254
44,26,37,1,-37,-6,-38,30,57
-23,3,-28,-60,-34,-16,-49,-41,-248
-13,-1,-18,-44,-44,-38,-41,-6,-205
-3,-24,-23,-36,-77,-47,-53,-11,-274
-49,32,-105,-124,-75,-53,-88,-40,-502
-9,-3,-34,-55,-91,-55,-47,-43,-337
-47,-4,-51,-78,-74,-62,-79,-15,-410
-85,-33,-91,-205,-147,-49,-108,59,-659
-36,12,-35,-59,-11,3,-51,-15,-192
-4,-7,-24,-61,-102,-83,-58,-24,-363
-8,3,-26,-53,-56,-26,-34,-11,-211
-1,-2,-21,-23,-60,-27,-33,-17,-184
9,6,-11,-57,-107,-72,-67,-28,-327
16,7,-24,-27,-85,-67,-41,-39,-260
-67,36,-42,-181,-130,-45,-54,11,-472
-39,-52,-27,-86,-75,-17,-66,-3,-365
19,-11,21,-33,-95,-21,-74,36,-158
8,11,13,9,-9,-6,-20,-4,2
-4,5,-30,-88,-104,-83,-53,-36,-393
-10,-21,-12,-31,-87,-48,-47,-28,-284
7,5,-28,-34,-95,-82,-47,-45,-319
-9,19,-15,-50,-20,-9,-21,-3,-108
-33,5,-32,-59,-67,-49,-60,-16,-311
12,-35,-44,-45,-91,-35,-52,-10,-300
-20,-8,-34,-98,-127,-53,-52,3,-389
8,-7,4,-46,-54,-57,-33,5,-180
-25,-19,-41,-61,-48,-23,-51,-12,-280
-2,4,-9,-38,-71,-45,-23,-21,-205
15,-6,1,-22,18,12,-9,21,30
-13,-15,-47,-137,-50,-40,-78,12,-368
-7,-10,-21,-46,-48,-15,-53,16,-184
-11,6,-45,-87,-115,-52,-78,-14,-396
-47,0,-66,-110,-69,-58,-65,-50,-465
-17,-11,-24,-62,-53,-36,-64,-47,-314
6,21,-28,-56,-69,-9,-44,11,-168
-20,14,-19,-61,-26,-37,-21,-22,-192
26,2,-16,-67,-178,-123,-101,-58,-515
11,21,-29,-62,-99,-76,-54,-17,-305
-3,-7,-12,-29,12,-8,-20,-2,-69
74,-19,-3,-103,-141,-130,-121,8,-435
-39,-50,-63,-104,-171,-97,-205,-7,-736
58,-18,-8,-35,-121,-110,-70,-28,-332
-33,-27,-39,-95,-128,-84,-90,10,-486
-35,-21,-23,-79,-70,-44,-55,13,-314
-19,-80,7,-101,-176,-100,-106,37,-538
-7,5,-21,-93,-75,-71,-65,-45,-372
-43,-41,-24,-60,-74,-54,-62,-15,-373
-31,-2,-16,-50,-26,-8,-14,19,-128
-40,-19,-32,-67,-74,-36,-48,0,-316
-22,8,-23,-73,-32,-38,-32,-21,-233
-2,9,-35,-47,-39,-28,-34,-13,-189
2,-28,-54,-79,-144,-91,-70,-43,-507
6,11,-15,-35,-54,-54,-39,-36,-216
-7,38,-51,-68,-48,-42,-72,-26,-276
-42,-11,-33,-70,-59,-30,-46,22,-269
-32,-12,-9,-104,-150,-58,-90,-35,-490
22,17,-10,-29,-94,-69,-56,-43,-262
-11,13,-31,-44,-27,-16,-37,-13,-166
-18,3,-27,-53,-36,-39,-46,-12,-228
-8,15,-10,-29,-46,-2,-36,5,-111
-55,-38,-77,-136,-84,-96,-72,-44,-602
3,13,-22,-62,-75,-54,-53,-39,-289
60,86,7,-46,-74,-29,-52,78,30
-29,-15,-38,-89,-43,-50,-50,-14,-328
-23,23,-41,-100,-81,-77,-51,-18,-368
7,9,-20,-58,-83,-51,-70,-3,-269
-31,-39,-31,-76,-102,-63,-60,2,-400
-9,-15,-8,-15,-46,-10,-34,13,-124
22,-6,-13,-26,-138,-62,-54,-26,-303
0,6,1,-18,-98,-10,-52,20,-151
5,19,-17,-58,-6,-29,-22,10,-98
-6,-7,-25,-31,-43,-23,-23,-10,-168
-44,-14,-42,-91,-81,-49,-82,-29,-432
8,14,-19,-30,-33,-52,-48,-47,-207
-9,-13,-33,-53,-75,-53,-68,-54,-358
-43,4,-63,-101,-104,-52,-69,-34,-462
7,-4,-26,-83,-107,-84,-78,-1,-376
-21,2,-39,-65,-46,-26,-43,-7,-245
-17,-13,-10,-43,-47,-27,-25,14,-168
-1,4,-16,-32,-31,-26,-11,-8,-121
33,-1,-9,-16,-108,-94,-61,-42,-298
-12,-52,-13,-79,-121,-101,-84,34,-428
45,2,44,28,-5,8,-34,48,136
-41,-48,-42,-83,-86,-26,-63,10,-379
21,-34,5,-64,-132,-60,-97,-15,-376
3,15,-48,-54,-46,-38,-63,-32,-263
-14,-16,-25,-59,-146,-30,-57,-25,-372
-5,-8,-18,-22,-36,-19,-19,3,-124
-25,-28,-31,-63,-87,-59,-59,-29,-381
-5,15,-7,-25,-62,-40,-36,-8,-168
-7,3,-12,-75,-71,-54,-39,2,-253
2,-1,-33,-76,-94,-94,-62,-60,-418
26,-1,-23,-19,-68,-66,-21,-50,-222
-11,21,-14,-54,-22,-19,-24,1,-122
-14,-22,-15,-54,-54,-51,-36,-14,-260
-40,18,-67,-119,-71,-13,-53,25,-320
-13,5,-26,-88,-109,-105,-83,-39,-458
4,11,-22,-25,-25,-25,-19,-24,-125
0,27,-27,-51,-91,-79,-54,-33,-308
12,-7,-6,-21,-79,-70,-39,-8,-218
-20,-55,-50,-82,-150,-106,-94,-40,-597
-7,13,-17,-50,-51,-39,-43,-22,-216
15,-4,-9,-20,-59,-43,-44,-32,-196
15,12,-20,-43,-36,-34,-25,3,-128
-16,-3,-52,-132,-110,-101,-64,-77,-555
-4,28,-12,-108,-79,-66,-44,-66,-351
13,13,-14,-50,-63,-26,-51,-8,-186
-14,6,-43,-107,-117,-47,-51,-27,-400
-30,-18,-39,-81,-35,-36,-52,-3,-294
16,-20,-6,-12,-53,-31,-28,-6,-140
-51,-18,-33,-98,-126,-68,-83,-36,-513
-15,-6,-27,-64,-52,-40,-38,-15,-257
-10,-4,-31,-47,-67,-45,-43,0,-247
-1,25,-16,-63,-39,-30,-25,19,-130
-15,-22,-27,-82,-72,-20,-39,3,-274
2,27,-29,-66,-23,-49,-30,-39,-207
-1,13,-20,-29,-11,-13,-12,15,-58
14,1,-13,-40,-115,-87,-67,-17,-324
3,20,-26,-50,-48,-51,-33,-42,-227
-14,5,-3,-51,-111,-36,-45,-13,-268
-39,-23,-57,-57,-32,-18,-57,11,-272
-18,-18,-17,-110,-138,-114,-101,-42,-558
-4,9,3,-49,-18,-25,-27,-8,-119
-4,19,-24,-51,-129,-59,-96,19,-325
-14,31,-44,-107,-69,-43,-42,-34,-322
-49,7,-89,-134,-133,-65,-112,31,-544
-11,21,-12,-60,-20,-12,-37,41,-90
-30,2,-37,-110,-160,-79,-99,-16,-529
-46,39,-72,-144,-78,-13,-11,19,-306
-19,0,-30,-72,-65,-56,-54,-32,-328
9,44,-7,-48,-41,-17,-22,13,-69
-21,-4,-29,-37,-43,-31,-37,-8,-210
-25,-20,-22,-54,-100,-41,-61,1,-322
4,18,-1,-50,-19,-22,-41,3,-108
24,14,-24,-93,-147,-136,-102,-61,-525
-30,-9,-35,-41,-29,-28,-48,0,-220
-3,20,-16,-72,-109,-68,-78,6,-320
8,7,-39,-103,-166,-62,-89,-20,-464
-24,9,-23,-63,-85,-49,-57,4,-288
-12,15,-34,-76,-59,-38,-44,-2,-250
-38,6,-36,-91,-70,-9,-25,31,-232
-1,-15,-42,-76,-98,-63,-84,-48,-427
13,1,-53,-148,-220,-171,-162,-42,-782
-11,11,-20,-48,-43,-38,-20,-11,-180
60,40,-18,-118,-176,-152,-90,-101,-555
-11,9,-36,-61,-41,-48,-36,-25,-249
-27,-17,-37,-51,-45,-3,-41,-10,-231
-17,12,-11,-50,-54,-36,-48,12,-192
2,-17,-33,-66,-96,-45,-54,-16,-325
-17,-4,-10,-109,-136,-85,-54,-1,-416
-10,-24,-4,-10,-48,8,-22,20,-90
47,27,29,3,-50,-7,-34,53,68
69,15,12,-27,-112,-59,-72,-4,-178
-8,6,-8,-46,-92,-57,-51,5,-251
-8,20,-29,-74,-57,-38,-41,-9,-236
-34,36,-29,-85,-81,-56,-54,-1,-304
63,39,-9,-49,-76,-98,-47,-53,-230
-3,36,-7,-48,-74,-12,-53,22,-139
13,8,-7,-34,-39,-40,-29,-39,-167
-40,-22,-29,-31,-56,-12,-40,3,-227
-38,-3,-49,-80,-59,-35,-47,-8,-319
-33,-13,-50,-56,-46,-11,-40,-3,-252
8,9,-35,-45,-84,-39,-67,-34,-287
18,22,3,-32,-27,-22,-10,10,-38
-23,24,-24,-69,-9,-14,-29,-14,-158
-37,-4,-22,-70,-29,-29,-35,2,-224
14,-1,-26,-33,-66,-32,-35,21,-158
11,3,-12,-43,-138,-40,-78,-75,-372
-40,-7,-59,-179,-113,-105,-143,3,-643
-33,1,-46,-97,-34,-42,-47,-23,-321
39,-20,-10,-71,-220,-148,-93,-112,-635
6,-1,0,-10,-24,-4,-18,-4,-55
-10,5,-14,-43,-35,-21,-17,4,-131
-9,12,-12,-75,-54,-56,-36,-9,-239
-12,-9,-19,-59,-72,-67,-40,-24,-302
19,3,3,21,-40,-10,-12,15,-1
-7,-3,-3,-25,-128,-68,-67,-35,-336
55,32,-30,-54,-95,-107,-86,-81,-366
-25,-21,-39,-96,-164,-60,-80,-5,-490
10,21,-9,-4,-14,17,6,34,61
-14,16,-39,-47,-19,-35,-42,3,-177
2,6,-37,-83,-142,-99,-77,-22,-452
-1,11,-18,-92,-122,-76,-92,-38,-428
0,-12,-30,-58,-85,-66,-61,-24,-336
-11,-5,-23,-67,-31,-2,-32,20,-151
-22,4,-13,-54,-33,-23,-31,-16,-188
39,-9,-25,-60,-136,-94,-76,-31,-392
-30,-6,-6,-55,-79,-12,-39,43,-184
-32,-25,-9,-45,-46,-8,-35,-16,-216
-33,-28,-33,-73,-91,-39,-67,-4,-368
-25,10,-51,-89,-86,-51,-57,-29,-378
-29,-26,-49,-84,-74,-48,-73,-10,-393
-19,-25,-12,-25,-36,-13,-21,12,-139
11,-16,-23,-81,-113,-81,-94,-43,-440
-23,-12,-25,-56,-62,-48,-54,-20,-300
-10,-14,-27,-40,-56,-27,-36,-28,-238
-26,-19,-39,-68,-89,-42,-66,-42,-391
-45,-5,-64,-109,-30,-38,-55,-21,-367
9,16,-9,-76,-31,-35,-37,19,-144
6,3,-36,-48,-70,-63,-58,-69,-335
8,13,-2,-58,-72,-43,-48,13,-189
18,-17,-27,-25,-58,-50,-47,-32,-238
-24,4,-18,-45,-19,-11,-15,4,-124
-9,-18,-37,-30,-68,-22,-77,24,-237
-5,-8,-15,1,-8,9,-4,18,-12
-7,1,-37,-106,-125,-107,-69,-61,-511
-3,26,-22,-32,-11,-6,-16,-6,-70
-7,-19,-42,-80,-98,-40,-60,-28,-374
-35,-40,-38,-84,-56,-30,-48,4,-327
1,15,4,-55,-40,6,-13,39,-43
-68,27,-85,-188,-117,-121,-124,-9,-685
-28,-5,-33,-61,-18,-31,-32,-20,-228
3,2,3,-25,-54,-25,-13,-32,-141
-29,6,-31,-56,-45,-10,-26,-7,-198
-8,17,-38,-62,-22,-34,-26,-33,-206
-3,38,-41,-77,-59,-56,-66,3,-261
-11,6,-20,-38,-49,-26,-37,-17,-192
-7,-23,-45,-59,-83,-49,-47,-18,-331
-13,0,-33,-41,-35,-39,-49,-18,-228
1,-19,-12,-46,-5,-17,-28,25,-101
-2,5,-19,-60,-50,-40,-32,-34,-232
30,13,-46,-83,-165,-122,-123,-60,-556
14,-5,-16,-76,-120,-56,-69,-26,-354
-34,1,-30,-70,-53,-19,-28,-3,-236
-45,3,-49,-71,-50,-15,-39,0,-266
-25,-9,-22,-47,-60,-26,-31,3,-217
-18,19,-30,-75,-54,-20,-39,-30,-247
-42,1,-53,-71,-24,-24,-28,16,-225
-23,-5,-28,-34,-14,-13,-24,-32,-173
-18,-1,-22,-59,-38,-37,-45,5,-215
-66,16,-81,-176,-102,-103,-142,-12,-666
7,25,-48,-102,-87,-101,-77,-73,-456
2,20,-42,-95,-105,-125,-81,-73,-499
6,-14,-11,-73,-104,-69,-45,-3,-313
-28,-18,-32,-63,-82,-65,-62,-13,-363
0,15,-24,-46,-71,-29,-31,-5,-191
4,0,-10,-37,-54,-41,-15,-13,-166
-14,-8,-16,-26,-54,-3,-7,3,-125
-22,9,-23,-64,-49,-33,-49,-34,-265
-14,5,-33,-75,-29,-24,-42,-5,-217
-4,21,-56,-98,-50,-58,-63,15,-293
-13,22,-24,-70,-72,-21,-66,6,-238
-3,-1,-1,12,-50,18,-23,16,-32
-6,5,-7,-67,-18,-45,-26,-14,-178
18,15,-9,-16,-71,-40,-29,-40,-172
1,2,-3,-30,-56,-16,-29,-25,-156
-10,5,-8,-62,-69,-46,-48,-4,-242
2,2,-15,-27,-51,-42,-40,-8,-179
19,1,-22,-23,-64,-39,-32,-29,-189
42,8,-6,-24,-144,-61,-47,0,-232
7,4,-15,-62,-36,-52,-61,-12,-227
-13,-36,-31,-78,-145,-79,-69,-27,-478
71,31,20,22,-89,-26,-40,38,27
10,-46,-34,-86,-155,-147,-104,-69,-631
-17,-27,-19,-43,-56,-37,-49,-32,-280
23,-14,-18,-29,-90,-86,-44,-55,-313
-74,-23,-66,-155,-190,-55,-98,-27,-688
10,12,-15,-23,-32,-34,-40,-4,-126
-5,1,-62,-95,-89,-60,-58,-39,-407
12,23,-9,-36,-53,-15,-14,-6,-98
-14,-1,-23,-48,-65,-51,-36,-3,-241
-24,-17,-34,-71,-74,-36,-60,-15,-331
-12,9,-16,-69,-63,-60,-50,11,-250
7,-6,-36,-58,-79,-57,-36,-23,-288
-18,1,-17,-46,-57,-12,-39,-4,-192
-1,34,-16,-43,-35,-28,-33,14,-108
-30,15,-43,-107,-99,-69,-69,-14,-416
-46,-10,-60,-133,-132,-76,-80,-17,-554
-45,-8,-59,-120,-125,-55,-69,-12,-493
-32,-28,-21,-46,-56,4,-35,14,-200
8,0,-50,-63,-127,-94,-83,-68,-477
-15,0,-17,-37,-50,-24,-16,8,-151
-36,8,-66,-120,-94,-62,-86,-32,-488
-22,-1,-51,-75,-68,-62,-63,-8,-350
69,4,6,-24,-179,-128,-86,-59,-397
-18,1,-28,-63,-79,-5,-28,8,-212
-37,-6,-25,-66,-111,-32,-64,28,-313
21,2,-6,-9,-105,-46,-48,-17,-208
-9,-25,-34,-81,-107,-66,-75,-12,-409
-45,-52,-42,-76,-87,-27,-39,14,-354
-20,23,-41,-69,-37,-41,-54,-46,-285
-32,-11,-19,-66,-44,-24,-29,4,-221
7,25,-22,-41,-86,0,-43,4,-156
9,1,-51,-27,-163,-96,-129,-70,-526
-22,-26,-18,-31,-24,-11,-11,0,-143
0,-30,-43,-56,-101,-59,-53,-28,-370
-28,14,-30,-56,-23,-7,-22,-11,-163
-9,17,-50,-59,-114,-55,-81,5,-346
-8,-6,-21,-23,-12,-12,-6,-11,-99
-2,7,-9,-72,-66,-51,-55,13,-235
-44,-11,-48,-100,-96,-69,-90,-8,-466
-68,-13,-26,-134,-111,-58,-46,-6,-462
13,-11,-36,-110,-224,-123,-91,-33,-615
-10,-18,-39,-50,-62,-48,-64,-26,-317
-8,-13,-13,-49,-85,-53,-45,-32,-298
-8,-2,-29,-29,-30,-19,-38,5,-150
8,-6,-11,-35,-104,-69,-55,-30,-302
-3,-8,-2,-20,-21,-3,-5,8,-54
5,7,4,-26,-61,-42,-12,9,-116
-16,-24,-23,-41,-38,-9,-28,9,-170
-16,7,-16,-36,-50,-31,-37,17,-162
1,17,3,-14,-27,26,-10,24,20
2,0,-8,-39,-68,-57,-55,-26,-251
-23,-4,-39,-42,-33,-19,-30,-5,-195
-16,6,-27,-60,-88,-73,-54,-15,-327
-11,29,-15,-36,-20,-22,-5,17,-63
1,11,-17,-25,-44,-16,-11,-7,-108
-13,24,-18,-43,-24,-23,-49,38,-108
20,-2,-13,-16,-91,-73,-57,-26,-258
-1,-1,-49,-96,-142,-84,-63,-14,-450
19,11,-43,-54,-77,-88,-65,-43,-340
12,20,0,-10,-27,-6,-8,30,11
-31,0,-8,-86,-107,-28,-58,-3,-321
59,0,11,-24,-192,-114,-138,-74,-472
15,10,-3,-3,-49,-31,-17,-9,-87
-3,43,-36,-76,-39,7,-39,10,-133
-4,-5,-12,-52,-68,-31,-19,-10,-201
-11,-20,-25,-35,-43,-30,-32,-4,-200
-16,-26,-30,-43,-85,-8,-38,0,-246
-2,19,-27,-71,-47,-47,-50,6,-219
-21,3,-24,-57,-57,-12,-33,13,-188
29,-1,-29,-30,-99,-88,-60,-70,-348
-12,8,-9,-41,-20,-27,-19,-13,-133
-14,6,-28,-33,-5,9,7,34,-24
22,-7,11,-12,-144,-41,-76,-2,-249
3,17,-15,-37,-42,-42,-37,-32,-185
-2,-11,-25,-35,-71,-38,-55,-40,-277
22,8,-7,-59,-117,-74,-76,-15,-318
3,-10,-15,-10,-29,-5,-9,-9,-84
20,-24,11,-13,-40,-11,-28,65,-20
-21,-21,-39,-60,-134,-48,-68,-5,-396
-3,-15,-55,-89,-131,-107,-88,-31,-519
26,-11,-31,-36,-119,-69,-48,-11,-299
-19,11,0,-25,-37,-27,-24,-7,-128
3,-7,-25,-24,-79,-18,-39,-19,-208
-72,-6,-114,-195,-158,-105,-99,-43,-792
46,4,-3,17,-98,-45,-59,44,-94
-53,25,-46,-118,-102,-31,-78,-54,-457
-30,-2,-67,-142,-131,-105,-82,-34,-593
2,10,-27,-30,-23,-1,7,5,-57
10,-9,-19,-20,-92,-53,-52,-27,-262
8,16,-41,-49,-120,-55,-90,35,-296
-33,6,-40,-60,-60,-15,-61,4,-259
54,0,-23,-59,-52,-96,-77,13,-240
-27,-9,-35,-43,-27,-3,-21,8,-157
27,30,-14,-35,-29,-35,-52,-37,-145
-16,11,-35,-86,-118,-78,-53,-4,-379
-22,15,-54,-157,-36,-62,-75,-73,-464
-28,13,-18,-50,-37,-11,-30,-19,-180
50,-15,-21,-68,-157,-114,-95,-59,-479
-71,22,-104,-168,-65,-66,-100,22,-530
-5,12,14,-33,-110,-48,-67,42,-195
10,12,-12,-30,-56,-2,-44,15,-107
-14,-31,-28,-73,-128,-25,-56,-10,-365
-16,16,3,-35,-20,-21,-6,29,-50
-45,-12,-40,-87,-68,-53,-52,-1,-358
-8,9,-31,-36,-38,-12,-36,-4,-156
6,32,0,-36,-54,-55,-51,31,-127
-31,15,-35,-65,-29,-35,-39,-4,-223
-15,3,-37,-55,-57,-26,-39,3,-223
85,22,-1,-27,-67,-78,-73,33,-106
-14,24,-19,-79,-86,-59,-34,2,-265
-16,-5,-34,-70,-51,-35,-35,-20,-266
-19,-10,-16,-20,-67,-50,-29,-17,-228
52,26,1,-58,-131,-78,-72,93,-167
-27,12,-60,-98,-70,-58,-71,-22,-394
1,-5,-4,-37,-66,-9,-26,-15,-161
0,7,-18,-57,-60,-40,-45,-2,-215
-3,16,-18,-47,-2,-17,-22,21,-72
41,5,30,31,-31,8,-52,41,73
6,-8,-6,-24,-42,-36,-35,-1,-146
7,-11,0,-44,-63,-17,-8,16,-120
94,-13,-13,-109,-307,-237,-163,-103,-851
3,1,-25,-6,-45,11,-16,33,-44
8,-12,-16,1,-37,-7,-20,25,-58
-9,-6,-19,-27,-27,-26,-33,2,-145
-17,-4,-15,-48,-33,-36,-30,-4,-187
6,31,-33,-40,-90,-23,-64,21,-192
70,18,-58,-137,-233,-199,-151,-149,-839
-2,8,-7,-67,-74,-75,-59,15,-261
18,-2,-27,-34,-47,-41,-31,-25,-189
20,27,-12,-48,-36,-10,-44,32,-71
-8,4,-33,-71,-65,-70,-59,-38,-340
-19,2,-27,-75,-28,-24,-33,-22,-226
-19,4,-7,-93,-107,-43,-81,-16,-362
24,-13,-21,-70,-140,-118,-49,-41,-428
-7,-10,-25,-37,-49,-32,-36,-22,-218
-12,-15,-9,-38,-45,-5,-17,-7,-148
9,-26,-40,-142,-182,-155,-116,-91,-743
-24,27,-20,-43,-47,-24,-40,-12,-183
-8,-20,-5,11,-41,-32,-17,24,-88
12,-15,-2,-20,-65,-52,-44,-20,-206
30,29,-17,-31,-70,-69,-71,-28,-227
-10,11,-11,-71,-72,-56,-49,-33,-291
-11,-49,-19,-87,-157,-108,-85,-28,-544
-23,7,-56,-103,-77,-49,-80,23,-358
2,5,-18,-38,-43,-33,-39,36,-128
31,10,-5,16,-34,-25,-21,2,-26
-10,-1,-16,-33,-45,-29,-16,-22,-172
-4,8,-32,-30,-62,7,-49,7,-155
-7,-4,-46,-113,-184,-65,-97,-24,-540
-9,-4,2,-38,-70,-7,-44,11,-159
-10,0,-13,-53,-24,-21,-22,20,-123
-20,20,-17,-57,-28,-23,-41,-10,-176
-28,-27,-21,-61,-49,-14,-27,33,-194
-24,7,-13,-25,-42,-29,-11,26,-111
-16,10,-28,-41,-35,-25,-21,0,-156
5,-1,-38,-111,-108,-108,-70,-64,-495
-14,4,-15,-47,-68,-40,-42,-7,-229
-34,15,-14,-99,-84,-68,-70,-30,-384
-19,21,-10,-40,-40,8,-27,32,-75
2,-12,-16,-42,-107,-81,-59,-18,-333
-6,-28,-9,-49,-106,-38,-30,-7,-273
-7,-7,-11,-29,-29,-20,-24,-1,-128
-31,-22,-43,-85,-73,-37,-38,43,-286
-4,9,-23,-41,-48,-12,-32,15,-136
0,3,-45,-48,-74,-6,-32,-36,-238
-31,-8,-67,-122,-54,-24,-42,32,-316
13,9,-5,-129,-276,-160,-130,-83,-761
-53,-2,-65,-188,-180,-143,-152,-33,-816
13,12,-21,-34,-53,-53,-46,-32,-214
0,5,-13,-22,-44,-25,-20,13,-106
3,4,-12,-31,-65,-46,-42,-25,-214
10,-10,-36,-92,-195,-124,-74,-60,-581
-54,-19,-66,-188,-127,-138,-192,-54,-838
23,21,-6,4,-47,-4,-68,42,-35
0,21,-23,-44,-71,-73,-57,11,-236
8,9,-30,-66,-18,-53,-34,-21,-205
12,-13,-6,-48,-94,-87,-51,-7,-294
-62,-2,-84,-207,-167,-111,-134,-17,-784
11,20,-23,-59,-50,-48,-44,1,-192
-15,2,-32,-45,-6,-14,-11,0,-121
-7,1,-17,-46,-83,-74,-56,-50,-332
-1,-10,-17,-18,-62,-53,-50,-11,-222
-39,-12,-28,-54,-18,-15,-18,5,-179
-33,-24,-54,-114,-104,-86,-88,-32,-535
-60,-9,-119,-109,-92,-36,-83,10,-498
-17,-1,-25,-47,-39,-46,-53,-30,-258
-37,-46,-40,-56,-57,-29,-28,12,-281
3,-1,-5,-70,-88,-86,-47,-35,-329
49,-11,-7,-74,-286,-173,-116,-78,-696
2,-15,-21,-97,-107,-103,-67,-55,-463
-4,-21,-16,-22,-28,-15,-48,10,-144
-10,-4,-20,-60,-55,-51,-33,-29,-262
24,-21,3,-32,-133,-91,-61,-39,-350
-3,-1,-26,-59,-34,-56,-49,7,-221
1,9,-11,-26,-35,7,-8,25,-38
-29,32,-68,-116,-25,-55,-52,-34,-347
-70,-33,-78,-156,-106,-80,-106,4,-625
-6,-48,-5,-55,-46,-23,-47,29,-201
-31,-18,-51,-92,-96,-62,-73,7,-416
133,20,61,59,-202,-101,-149,55,-124
-39,24,-65,-84,-47,-30,-39,-27,-307
-83,-11,-176,-335,-239,-220,-275,-104,-1443
15,7,-34,-40,-63,-29,-50,-39,-233
-12,-4,-17,-40,-51,-25,-19,26,-142
-22,2,-30,-47,-37,-32,-12,11,-167
-7,11,-10,-45,-11,-7,-10,21,-58
-34,-1,-27,-90,-67,-37,-49,-33,-338
46,17,-31,-66,-219,-174,-122,-58,-607
9,10,-14,-115,-128,-138,-87,-89,-552
-36,10,-35,-104,-48,-29,-24,-9,-275
-32,-29,-26,-110,-89,-77,-84,-5,-452
-32,-33,-21,-53,-36,-28,-37,-12,-252
-18,-25,-25,-47,-45,-22,-35,13,-204
26,-7,-13,-16,-120,-72,-75,-55,-332
-57,-39,-87,-130,-127,-95,-124,-33,-692
11,-43,5,-26,-100,-60,-71,27,-257
3,40,-21,-41,-62,6,-26,38,-63
1,49,-13,-52,-30,-11,-12,75,7
28,19,-16,-84,-153,-40,-49,-4,-299
25,28,-46,-159,-221,-161,-128,-54,-716
-13,0,-31,-75,-89,-40,-44,10,-282
-45,-29,-42,-95,-71,-24,-72,-10,-388
3,-16,-13,-10,-79,-45,-45,-25,-230
-9,-22,-5,-50,-62,-50,-28,-19,-245
11,15,1,-29,-67,4,-38,77,-26
-11,17,-3,-29,-13,-14,-13,9,-57
-31,33,-96,-109,-63,-16,-56,-1,-339
18,10,-22,-83,-196,-93,-91,-77,-534
-17,-23,-26,-75,-108,-60,-62,-48,-419
-20,24,-8,-61,-26,-6,-21,10,-108
44,18,-29,-31,-84,-74,-60,-75,-291
10,-14,-11,-66,-133,-81,-56,-43,-394
-35,-16,-40,-84,-49,-32,-51,-17,-324
-20,-1,-39,-83,-50,-12,-36,-15,-256
-54,-50,-55,-130,-195,-64,-85,-21,-654
-17,4,-19,-49,-51,-8,-24,-13,-177
-22,-3,-23,-51,-62,11,-38,-2,-190
-8,2,-34,-69,-61,-55,-49,-59,-333
-30,-23,-18,-34,-79,6,-22,0,-200
33,11,-48,-56,-88,-69,-55,-59,-331
4,-9,-26,-52,-112,-68,-55,-23,-341
-57,-8,-57,-132,-48,-34,-74,-33,-443
58,24,-11,-32,-90,-105,-67,-89,-312
-34,-11,-36,-76,-55,-21,-38,-32,-303
58,18,-46,-90,-147,-166,-110,-134,-617
19,8,-27,-23,-89,-71,-70,-15,-268
-14,-1,-20,-48,-63,25,-13,22,-112
-78,-13,-46,-105,-85,-42,-68,-14,-451
0,3,-24,-113,-124,-118,-85,-53,-514
-12,-17,-22,-94,-181,-66,-118,39,-471
-30,14,-36,-62,-45,-40,-33,-3,-235
-9,2,-21,-39,-21,-27,-33,-6,-154
14,10,-13,-42,-136,-31,-69,-28,-295
-29,-27,-30,-78,-94,-49,-69,-29,-405
-13,-64,-28,-55,-144,-55,-112,19,-452
-9,6,-4,-30,-11,-3,-7,1,-57
14,40,-10,-30,4,-34,-35,-24,-75
75,37,0,-8,-72,-5,-53,152,126
43,28,-9,-48,-101,-53,-45,7,-178
29,-28,-20,-36,-137,-98,-93,-34,-417
-19,12,-13,-101,-108,-39,-53,0,-321
0,17,-1,-65,-97,-30,-58,71,-163
-8,5,-24,-35,-44,-29,-38,-11,-184
13,-3,1,-15,-132,-42,-47,-31,-256
18,-3,-11,-17,-51,-54,-32,-50,-200
11,1,-31,-51,-88,-76,-65,-49,-348
35,-4,-5,-30,-134,-93,-81,-89,-401
-21,3,-35,-72,-84,-70,-51,-48,-378
1,-9,-38,-110,-157,-75,-110,-43,-541
-24,-6,-22,-55,-46,-19,-42,-17,-231
9,38,-59,-99,-75,-100,-61,-92,-439
14,0,-21,-48,-78,-68,-45,-34,-280
11,-2,-2,-21,-76,-1,-30,-5,-126
15,-2,-24,-32,-102,-37,-53,-24,-259
-14,-17,-21,-44,-120,-46,-95,34,-323
15,5,-15,-30,-44,-45,-29,-12,-155
-35,-8,-43,-83,-73,-17,-50,-24,-333
-27,21,-53,-101,-57,-33,-50,4,-296
-69,-26,-42,-85,-80,-26,-60,6,-382
32,-12,-27,-58,-139,-107,-58,-77,-446
-70,-10,-80,-192,-112,-32,-104,38,-562
-59,0,-144,-274,-309,-142,-210,-34,-1172
-8,3,-63,-120,-135,-113,-127,-45,-608
13,-19,10,19,-28,0,-32,63,26
-36,-6,-42,-120,-113,-55,-80,-31,-483
-49,-34,-17,-80,-128,-43,-90,-25,-466
-7,-38,-48,-71,-71,-44,-77,-32,-388
79,78,74,13,-192,-37,-114,21,-78
-48,-11,-35,-85,-79,-19,-62,-16,-355
46,16,-21,-52,-171,-114,-77,-57,-430
4,8,-3,-4,-20,5,-12,47,25
35,26,-13,-35,-110,-71,-87,-50,-305
-16,11,-20,-49,-32,-32,-28,-17,-183
12,-40,-32,-38,-125,-79,-50,5,-347
15,2,-40,-59,-110,-76,-54,-56,-378
16,-6,-27,-35,-82,-57,-30,-16,-237
38,20,-29,-58,-113,-112,-74,-97,-425
-2,-23,-35,-89,-157,-109,-98,-66,-579
2,-9,-13,-57,-155,-54,-75,-11,-372
-28,3,-32,-76,-62,-19,-67,-17,-298
-3,-6,-15,-28,-46,-32,-30,3,-157
44,34,10,15,-67,-40,-30,17,-17
-77,-48,-53,-223,-198,-91,-98,-35,-823
-51,-2,-61,-142,-111,-47,-83,-34,-531
31,-11,13,6,-107,-39,-43,-24,-174
-26,-22,-21,-76,-96,-37,-64,3,-339
-9,-4,-41,-99,-50,-54,-48,29,-276
13,-1,2,-16,-31,-31,-24,-31,-119
-14,-17,-16,-39,-34,-26,-51,-21,-218
-10,-15,-18,-34,-61,-39,-47,-33,-257
-58,-15,-34,-140,-100,-57,-63,-15,-482
-25,-3,-44,-84,-70,-52,-44,-22,-344
34,3,-2,-30,-151,-93,-76,-43,-358
-26,2,-19,-55,-36,-26,-39,-29,-228
-11,15,-31,-49,-43,-27,-39,0,-185
-22,4,-34,-86,-81,-80,-71,-16,-386
4,19,-6,-22,-25,-5,-25,29,-31
-10,6,-14,-54,-30,-37,-37,14,-162
0,-12,-1,-26,-78,-40,-46,-3,-206
-95,-37,-107,-157,-113,-27,-83,7,-612
27,45,-18,-92,-129,-87,-63,11,-306
-78,-31,-48,-129,-81,-9,-57,-11,-444
47,8,1,18,-58,-17,-18,-12,-31
109,11,-8,-60,-245,-197,-97,-90,-577
19,32,-45,-133,-163,-160,-101,-119,-670
-18,-21,-30,-43,-106,-49,-54,-18,-339
0,21,-15,-21,-37,-26,-24,12,-90
-15,1,5,-32,-22,-1,-10,-9,-83
-7,7,-15,-68,-123,-68,-60,-14,-348
-34,-1,-61,-92,-65,-21,-85,-2,-361
18,0,-17,-50,-77,-60,-52,30,-208
-59,4,-61,-184,-194,-143,-169,-15,-821
-16,8,-34,-51,-35,-28,-17,-16,-189
-9,-4,-7,-17,-65,-28,-33,7,-156
-14,20,-36,-85,-97,-39,-62,-33,-346
-58,-15,-49,-84,-48,-20,-45,-32,-351
-9,1,-18,-49,-66,-66,-39,-10,-256
-43,-22,-26,-43,-65,-44,-55,11,-287
0,-49,-19,-35,-87,-62,-56,-27,-335
14,-22,-32,-30,-136,-84,-85,-58,-433
18,17,-25,-48,-69,-65,-58,-63,-293
-21,14,-19,-41,-59,-1,-26,-1,-154
-36,19,-28,-78,-31,-19,-39,1,-211
-16,-9,-24,-79,-72,-10,-22,27,-205
-19,2,-36,-79,-21,-30,-40,-11,-234
3,13,-18,-54,-64,-43,-48,-31,-242
12,0,-1,-45,-111,-66,-28,19,-220
-4,20,6,-52,-103,-52,-58,12,-231
11,-1,-14,-41,-75,-46,-60,5,-221
-24,-15,-43,-110,-64,-75,-56,-34,-421
11,3,-8,-26,-58,-35,-18,-8,-139
21,-3,-30,-52,-26,-39,-47,9,-167
-1,24,-7,-83,-34,-65,-23,-9,-198
-8,-12,-23,-33,-48,-5,-41,-2,-172
24,13,7,7,-46,2,-6,-14,-13
-10,1,-5,-50,-41,-12,-23,11,-129
-15,12,-16,-33,-25,-18,-26,1,-120
11,-1,-10,-9,-36,-23,-14,2,-80
-42,30,-32,-59,-25,17,-22,4,-129
-11,4,-16,-53,-60,-44,-17,8,-189
-27,-18,-37,-96,-64,-44,-46,-12,-344
-17,29,-54,-113,-74,-65,-108,-57,-459
10,-29,-15,-22,-94,-60,-63,-23,-296
4,-5,-20,-72,-84,-92,-64,-25,-358
-1,-12,-41,-110,-118,-118,-78,-86,-564
-41,3,-74,-83,-68,-22,-81,-8,-374
34,4,-19,-64,-99,-98,-71,-54,-367
5,-8,-3,-25,-70,-42,-34,-20,-197
4,-32,-15,-35,-121,-56,-45,-32,-332
-18,-2,-11,-54,-91,-30,-32,46,-192
-4,-32,-28,-84,-125,-45,-72,23,-367
3,3,-9,-32,-53,-29,-38,-4,-159
-20,-3,-43,-72,-78,-72,-76,-3,-367
-7,-21,-12,-61,-89,-61,-49,-23,-323
-20,-20,-41,-56,-63,-26,-54,0,-280
-19,-13,-48,-60,-55,-24,-53,-34,-306
66,-5,40,39,-73,23,-60,85,115
-1,14,-25,-60,-74,-69,-50,-47,-312
27,1,-36,-73,-155,-139,-76,-100,-551
1,-38,-13,-58,-90,-66,-54,-18,-336
8,-10,-21,-50,-181,-136,-122,-18,-530
-7,-21,-23,-37,-80,-51,-51,-24,-294
-37,5,-50,-120,-99,-106,-93,12,-488
-37,17,-53,-107,-90,-41,-81,-12,-404
-23,7,-13,-53,-49,-37,-27,7,-188
7,-7,-23,-17,-61,-49,-52,0,-202
-63,4,-137,-165,-108,-126,-153,-6,-754
9,-25,-11,-29,-106,-13,-31,14,-192
-4,-11,-39,-21,-32,-22,-21,-22,-172
8,4,16,-66,-162,-65,-72,10,-327
-1,5,-24,-22,-40,-22,-38,-16,-158
-49,-36,-78,-171,-175,-85,-119,-20,-733
-4,3,-20,-32,-49,-39,-29,-19,-189
-38,-6,-39,-88,-71,-22,-42,2,-304
-34,-54,-36,-64,-98,-57,-52,-9,-404
4,-16,-17,-18,-57,-51,-37,-9,-201
-23,-19,-28,-67,-73,-20,-39,-15,-284
-17,12,-48,-119,-118,-71,-115,24,-452
-6,-8,-10,-32,-54,-45,-32,-11,-198
-15,-11,-14,-36,-54,-23,-20,2,-171
10,9,-22,-52,-111,-90,-60,-39,-355
-40,-6,-42,-85,-33,-17,-29,-7,-259
-32,12,-40,-45,-38,-11,-19,24,-149
-18,0,-24,-43,-28,-21,-28,-10,-172
-21,-3,-36,-63,-57,-26,-26,-24,-256
-6,27,-16,-46,-44,-25,-48,-10,-168
-5,-4,-26,-33,-71,-20,-50,-10,-219
-17,23,-18,-72,-51,-46,-49,32,-198
39,27,34,-16,-112,-3,-38,51,-18
-3,20,-33,-59,-128,-80,-65,-36,-384
-13,6,-25,-47,-28,-33,-28,1,-167
35,-16,21,-11,-13,-6,-42,23,-9
5,30,-5,-22,-42,-25,-46,-18,-123
15,-23,-32,-60,-137,-117,-104,-65,-523
-40,6,-31,-83,-24,-20,-35,12,-215
141,87,29,-33,-160,-160,-129,37,-188
-5,11,-21,-77,-64,-35,-50,-6,-247
-1,12,-20,-11,-82,-16,-44,18,-144
20,2,-9,-24,-63,-45,-37,-31,-187
-8,31,-13,-69,-26,-39,-52,-12,-188
0,12,-1,-31,-52,-25,-33,-3,-133
-13,-7,-17,-35,-34,-33,-28,4,-163
8,14,-4,-42,6,-3,-24,17,-28
-26,-1,-26,-43,-37,-28,-31,15,-177
43,-17,-3,5,-110,-36,-32,-18,-168
-1,23,-28,-46,-44,-32,-53,-34,-215
-31,-15,-65,-123,-146,-78,-79,-84,-621
16,-5,16,-22,-58,-29,-24,-4,-110
-31,-18,-26,-59,-25,11,-10,-5,-163
-41,-14,-47,-98,-95,-57,-64,-44,-460
-21,2,-21,-42,-25,-20,-28,14,-141
8,5,-5,-29,-69,-49,-34,-2,-175
-20,11,-25,-46,-40,-23,-39,-25,-207
-1,-3,-12,-14,-35,-28,-29,-13,-135
1,4,-4,-27,-16,-15,-4,-6,-67
-5,23,-16,-32,-53,3,-49,52,-77
-22,8,-37,-110,-80,-50,-42,-30,-363
30,1,-7,-38,-45,-50,-37,18,-128
-26,12,-38,-86,-52,-45,-39,-30,-304
-19,7,-21,-93,-56,-51,-50,-20,-303
-4,2,0,-31,-15,7,-23,13,-51
-14,-17,-12,-22,-34,-20,-21,9,-131
-12,14,-46,-73,-69,-54,-62,-23,-325
4,42,-4,-47,-13,-24,-6,44,-4
17,4,-11,-55,-82,-71,-51,-35,-284
-28,-16,-19,-33,-39,-6,-19,9,-151
-28,3,-33,-43,-22,-18,-27,-8,-176
-16,-9,-19,-58,-88,-64,-46,-36,-336
-9,29,-21,-75,-42,-38,-45,-18,-219
-20,-4,-20,-54,-40,-20,-39,-12,-209
-10,-4,-15,-35,-42,-28,-20,24,-130
-6,28,-13,-47,-61,-12,-25,6,-130
-19,26,-28,-82,-54,-41,-47,-5,-250
14,-10,-19,-31,-86,-83,-44,-16,-275
24,11,0,-25,-56,-48,-13,-19,-126
10,-11,-18,-41,-88,-66,-53,-5,-272
-3,-6,-44,-75,-97,-74,-82,-36,-417
-17,15,-65,-86,-87,-49,-56,-9,-354
-24,11,-38,-83,-63,-18,-45,-39,-299
-17,2,-28,-111,-131,-46,-80,12,-399
-32,9,-45,-100,-57,-46,-69,-23,-363
49,6,-41,-56,-155,-120,-77,-55,-449
34,39,-38,-86,-111,-108,-86,-65,-421
-21,-12,-28,-73,-84,-65,-46,-33,-362
-15,-33,-95,-235,-273,-237,-164,-113,-1165
-50,-4,-43,-91,-89,-32,-53,3,-359
12,-4,-9,-18,-58,-28,-31,-19,-155
-20,-11,-36,-46,-22,-21,-29,-20,-205
-33,-13,-27,-91,-45,-18,-35,0,-262
-53,-30,-54,-88,-61,-55,-64,-1,-406
-31,5,-40,-102,-77,-27,-29,-6,-307
-22,15,-54,-134,-89,-62,-74,-30,-450
-25,7,-38,-51,-45,-24,-31,-1,-208
2,-3,-21,-62,-102,-85,-59,-30,-360
3,-15,-18,-53,-79,-38,-32,0,-232
-44,3,-37,-75,-55,-31,-59,-7,-305
9,-15,-14,-87,-83,-81,-48,-12,-331
34,32,11,3,-13,-21,-29,19,36
7,4,-11,-59,-77,-55,-59,-38,-288
-17,22,-50,-72,-41,-11,-49,-9,-227
-16,-7,-44,-61,-72,-18,-40,-26,-284
-18,1,-30,-73,-110,-45,-68,3,-340
8,21,22,7,-13,27,-19,46,99
-24,18,-24,-74,-37,-23,-22,-9,-195
-4,-1,-16,-41,-46,-42,-26,-12,-188
8,1,-7,-34,-69,-47,-44,-8,-200
-18,-27,-34,-40,-74,-52,-59,-5,-309
-9,-6,-14,-35,-63,-46,-51,-16,-240
-20,20,-29,-73,-33,-12,-37,-20,-204
-15,-19,-42,-87,-116,-89,-77,-54,-499
29,46,-15,-43,-46,-57,-41,0,-127
-20,-33,-66,-55,-68,-82,-89,-61,-474
-10,13,-38,-28,-40,-5,-26,-21,-155
-13,-6,-50,-70,-104,-59,-61,-37,-400
-18,-26,-17,-26,-68,-43,-32,6,-224
-16,8,-29,-72,-84,-59,-61,-7,-320
15,0,-30,-49,-110,-62,-79,-7,-322
29,-6,-32,-15,-102,-44,-42,-6,-218
12,-1,-30,-68,-62,-81,-49,-24,-303
5,-30,-38,-48,-138,-98,-84,-59,-490
-6,2,-7,-13,-47,-4,-31,13,-93
2,2,-15,-34,-45,-7,-15,5,-107
-16,-7,-24,-51,-28,-31,-25,-30,-212
-40,-3,-50,-82,-44,-36,-39,2,-292
65,-27,46,-39,-117,-100,-65,-11,-248
11,4,-7,8,-37,-37,-20,-2,-80
-15,-3,-39,-46,-48,-30,-45,-26,-252
-5,12,-2,-21,-29,-9,-8,3,-59
-41,-6,-91,-196,-175,-137,-151,-20,-817
3,24,-12,-68,-68,-33,-26,-14,-194
52,65,-32,-52,-234,-84,-113,22,-376
-9,9,-31,-83,-59,-60,-35,-25,-293
-17,-10,-20,-26,-51,7,-31,-15,-163
-5,1,-16,-40,-49,-31,-13,-8,-161
17,-24,-26,-46,-92,-49,-61,23,-258
11,6,-4,-34,-103,-63,-62,-37,-286
13,33,-15,-33,-40,-55,-31,-7,-135
6,11,-14,-82,-88,-73,-73,-30,-343
7,16,-4,-17,-18,-13,-24,0,-53
-42,-3,-48,-72,-29,-26,-48,7,-261
-17,10,-13,-56,-68,-11,-45,16,-184
-17,-25,-82,-139,-144,-123,-117,-28,-675
-13,-5,-39,-48,-52,-22,-26,2,-203
-19,-17,-26,-62,-36,-28,-37,-2,-227
-12,10,-46,-71,-66,-35,-50,5,-265
-11,12,-23,-94,-35,-35,-40,2,-224
-21,-24,-59,-109,-95,-64,-108,-43,-523
2,14,-39,-70,-64,-102,-64,-43,-366
-1,16,-10,-50,-52,-42,-40,0,-179
-14,-2,-30,-43,-43,-23,-45,-14,-214
-5,-6,-16,-29,-38,-20,-22,32,-104
11,-9,-36,-50,-92,-57,-67,-15,-315
-2,-23,-39,-106,-139,-112,-100,-42,-563
15,28,-22,-62,-92,-104,-80,-31,-348
10,-31,-27,-56,-143,-59,-54,-7,-367
-19,17,-21,-31,-41,-14,-26,-17,-152
-17,4,-27,-38,-48,3,-34,-8,-165
18,-13,3,-27,-71,-63,-25,-8,-186
-8,28,-8,-47,-18,-21,-24,-8,-106
-26,-1,-17,-43,-39,8,-24,22,-120
-26,-44,-50,-81,-135,-84,-73,-36,-529
-33,-7,-36,-59,-25,-37,-25,0,-222
-12,16,-16,-41,-66,-50,-33,-24,-226
-25,-28,-47,-82,-111,-90,-101,-4,-488
-36,2,-35,-96,-103,-54,-60,-9,-391
-4,4,-20,-48,-46,-47,-14,-21,-196
-10,-23,-26,-31,-56,-58,-43,-27,-274
-17,9,-17,-48,-25,-28,-24,-1,-151
8,-23,-32,-26,-104,-70,-46,-47,-340
-24,-6,-24,-62,-57,-33,-30,-6,-242
7,-8,-15,-39,-25,-37,-22,16,-123
-35,-19,-49,-175,-182,-168,-117,-87,-832
-35,47,-20,-102,-101,-64,-66,18,-323
7,-13,-1,-20,-33,-20,-16,4,-92
-1,-5,-22,-19,-28,-8,-13,12,-84
-20,10,-32,-71,-72,-10,-37,22,-210
-32,13,-55,-110,-96,-13,-76,9,-360
-3,-2,-10,-9,-47,-9,-24,10,-94
-25,1,-46,-68,-94,-23,-67,7,-315
-19,-16,-17,-54,-32,-24,-28,-18,-208
1,18,-20,-61,-55,-6,-35,14,-144
-84,-40,-76,-152,-74,-49,-104,-48,-627
11,12,-40,-45,-27,-51,-45,-24,-209
11,-28,-20,-61,-36,-49,-66,2,-247
-49,6,-61,-91,-42,-23,-29,-32,-321
52,96,3,-28,-91,-75,-77,73,-47
-30,2,-40,-76,-52,-67,-56,-15,-334
-18,-5,-40,-115,-77,-35,-43,-20,-353
44,14,-7,-79,-86,-84,-60,57,-201
-4,5,-15,-33,-23,-14,-11,-29,-124
-27,-17,-28,-140,-74,-23,-60,61,-308
-7,-18,-15,-72,-117,-49,-71,-20,-369
-21,24,-47,-43,-89,-82,-47,-1,-306
-28,2,-17,-57,-87,-38,-58,18,-265
-26,-21,-45,-44,-78,-37,-55,3,-303
-10,13,-14,-32,-53,-25,-38,-3,-162
-13,18,-24,-40,-41,-17,-35,26,-126
-8,3,14,-41,-104,13,-33,-5,-161
44,6,10,-10,-93,-54,-31,-44,-172
32,14,-16,-35,-125,-34,-64,-23,-251
9,5,14,-22,-26,7,-28,31,-10
-2,4,-29,-40,-102,-46,-51,-3,-269
-33,28,-65,-90,-37,-28,-33,39,-219
-26,2,-43,-80,-52,-23,-41,5,-258
-13,-27,-29,-56,-87,-63,-64,-2,-341
-47,-13,-28,-89,-74,-26,-34,-10,-321
-37,6,-19,-63,-45,-24,-37,3,-216
-6,1,-32,-147,-124,-92,-106,71,-435
28,-8,-11,-62,-112,-126,-87,-70,-448
-5,6,-18,-28,-11,-6,-2,3,-61
-26,10,-67,-123,-64,-85,-66,-24,-445
31,-8,-12,-21,-82,-61,-29,-38,-220
17,-5,-9,8,-31,-5,-7,42,10
-8,-6,-34,-99,-71,-76,-75,-32,-401
-1,-11,-11,-27,-49,-30,-30,10,-149
-5,0,-27,-63,-30,-48,-40,-16,-229
-7,8,-16,-43,-17,-17,-18,-21,-131
-3,9,-26,-81,-87,-105,-82,-57,-432
-18,12,-16,-49,-17,-46,-28,-15,-177
-13,22,-17,-58,-45,-33,-55,-6,-205
6,3,-20,-40,-69,-37,-21,5,-173
61,24,15,-11,-38,2,-41,63,75
-25,36,-72,-139,-82,-81,-110,-55,-528
-5,2,-10,-53,-53,-32,-26,-8,-185
6,24,14,-12,-18,-4,-42,4,-28
-34,17,-60,-79,-68,-50,-33,12,-295
-11,-19,-24,-61,-55,-36,-21,15,-212
-6,51,-45,-98,-51,-57,-44,29,-221
-19,4,-35,-42,-13,-27,-30,27,-135
-19,-3,-17,-58,-63,-19,-35,8,-206
-44,0,-19,-79,-66,-48,-53,-1,-310
-11,5,-22,-33,-54,-25,-30,4,-166
0,4,4,-52,-88,-26,-39,25,-172
66,9,18,-30,-57,-51,-43,31,-57
6,4,-7,-46,-88,-30,-47,-32,-240
-13,19,-56,-114,-193,-124,-126,-71,-678
2,12,-21,-15,-19,-15,-20,7,-69
3,4,-38,-61,-92,-28,-67,19,-260
-8,-15,-50,-126,-128,-114,-84,-59,-584
-19,9,-37,-82,-101,-65,-62,-13,-370
-8,-3,-48,-71,-54,-35,-31,-32,-282
2,17,-7,-50,-36,-47,-20,-12,-153
-42,-19,-29,-74,-38,-34,-57,-10,-303
-11,5,-18,-28,-48,-7,-22,25,-104
7,-29,-12,-40,-113,-73,-60,-22,-342
33,-1,-17,-37,-115,-91,-69,-44,-341
9,11,-34,-37,-13,-13,-32,10,-99
9,-17,-19,-8,-105,-51,-53,-18,-262
23,19,6,-4,-8,-13,-12,9,20
11,-14,-10,-19,-16,-25,-16,5,-84
8,-5,-12,-26,-51,-38,-29,-8,-161
38,1,0,18,-17,-15,-37,13,1
37,13,1,-43,-127,-88,-93,-38,-338
-29,16,-28,-46,-21,-7,-14,-5,-134
-12,4,-21,-47,-26,-34,-10,-16,-162
3,9,-39,-75,-87,-108,-72,-38,-407
-2,0,-13,-33,-39,-31,-15,-12,-145
-12,-3,-20,-47,-55,-41,-40,-10,-228
-80,23,-81,-168,-96,-49,-91,57,-485
-20,-15,-26,-33,-104,-25,-62,-29,-314
-10,17,-22,-30,-76,-19,-41,19,-162
-16,2,-23,-72,-86,-60,-34,11,-278
61,34,-24,-33,-107,-81,-66,-66,-282
-13,9,-48,-80,-30,0,-23,18,-167
-3,-47,-15,-24,-186,-68,-116,-44,-503
-4,-8,-24,-58,-52,-47,-36,-23,-252
43,-10,-20,-6,-122,-81,-44,6,-234
-17,-36,-11,-48,-65,-56,-38,-18,-289
-30,5,-15,-49,-36,-24,-39,-2,-190
-20,9,-32,-59,-6,-40,-30,9,-169
37,31,-6,-28,-104,-84,-41,-56,-251
-65,-6,-76,-169,-89,-67,-73,-68,-613
-4,4,-4,-41,-35,-10,-34,3,-121
-2,20,-27,-45,-58,-44,-38,-28,-222
32,7,-15,-18,-78,-96,-54,-49,-271
-18,5,-29,-32,-43,-23,-38,-4,-182
17,-10,-24,-53,-141,-100,-73,-33,-417
-13,14,-19,-65,-27,-10,-48,-8,-176
27,-28,-8,-109,-177,-164,-106,-103,-668
7,-18,-14,-48,-102,-67,-38,-23,-303
-7,11,-1,-35,-41,-15,-36,1,-123
5,-11,-10,-31,-7,-13,-18,2,-83
19,16,5,-5,-31,17,-6,26,41
-9,7,-17,-45,-46,-28,-31,2,-167
-11,1,-8,-27,-67,-9,-29,2,-148
-12,-11,-37,-91,-108,-75,-57,-39,-430
0,-7,-13,-19,-53,-14,-32,-1,-139
-25,-11,-35,-29,-39,-16,-30,-10,-195
1,-30,11,-58,-102,-58,-48,33,-251
-16,-14,-54,-95,-123,-87,-95,2,-482
16,1,-15,-12,-48,-47,-37,-30,-172
10,10,-13,-44,-97,-60,-75,-8,-277
-62,-13,-36,-117,-77,-78,-84,-29,-496
16,29,-21,-57,-91,-35,-47,-23,-229
-23,-65,3,-123,-140,-94,-36,46,-432
-2,1,-14,-27,-59,-33,-24,-17,-175
6,-25,-16,-36,-115,-79,-52,-25,-342
2,0,-31,-41,-106,-70,-73,-37,-356
-52,2,-86,-133,-100,-59,-62,3,-487
-3,9,-15,-42,-36,-31,-11,-2,-131
-1,-16,-11,4,-51,1,-31,14,-91
19,-15,-21,-32,-143,-86,-76,-31,-385
-18,-28,-54,-79,-94,-52,-53,-50,-428
7,21,-57,-80,-94,-71,-60,-66,-400
-23,-13,-14,-65,-52,-53,-29,36,-213
-18,3,-24,-47,-51,-18,-30,15,-170
-6,7,-8,-42,-8,-15,-17,10,-79
-21,-7,-36,-68,-62,-31,-65,18,-272
8,13,-18,-60,-70,-11,-14,1,-151
25,54,-16,-64,-51,-48,-22,-12,-134
-13,3,-6,-53,-92,-39,-63,-10,-273
-2,9,-22,-28,-48,-27,-28,-17,-163
-38,-5,-43,-87,-37,-24,-49,9,-274
-23,6,-44,-70,-37,-40,-42,-47,-297
-58,-23,-48,-94,-96,-29,-38,-16,-402
-21,-10,-27,-78,-97,-32,-61,19,-307
-44,7,-59,-103,-75,-57,-54,14,-371
26,15,-17,-89,-70,-80,-64,-24,-303
5,17,10,-10,-34,1,-14,9,-16
-34,-5,-43,-70,-93,29,-24,62,-178
-20,19,-21,-49,-58,-56,-61,-23,-269
27,26,-67,-111,-162,-152,-140,-115,-694
-14,12,-24,-47,-54,-5,-28,21,-139
-3,-2,-7,-26,-23,-6,-19,36,-50
-42,-34,-55,-84,-74,-12,-70,19,-352
-23,8,-27,-60,-15,-21,-31,-12,-181
4,29,-10,-73,-80,-4,-32,-20,-186
-36,-33,-31,-62,-72,-36,-31,28,-273
-8,18,-39,-90,-135,-22,-54,24,-306
-25,-22,-11,-52,-55,-35,-37,0,-237
12,11,-1,-12,3,4,6,0,23
6,-7,-8,-40,-67,-33,-53,-4,-206
-1,1,-15,-38,-37,-28,-31,-18,-167
-9,8,-30,-81,-102,-70,-66,-47,-397
26,6,-11,-48,-79,-58,-66,-23,-253
-24,2,-29,-54,-52,-47,-47,-26,-277
7,1,-27,-35,-13,-1,-25,7,-86
-7,12,-9,-60,-142,-55,-72,31,-302
-14,2,-28,-57,-53,-30,-59,-4,-243
30,47,-44,-139,-105,-123,-80,-77,-491
-67,-11,-58,-113,-80,-41,-61,-34,-465
8,-30,-43,-88,-113,-53,-91,-34,-444
-27,41,-47,-105,-54,-60,-33,-38,-323
-6,-2,-37,-41,-92,-52,-59,-29,-318
-13,8,-7,-36,-47,-44,-34,-12,-185
15,-3,-13,-33,-58,-51,-32,-29,-204
-14,-6,-23,-38,-51,-5,-43,11,-169
-47,-2,-27,-91,-77,-16,-46,14,-292
-3,-6,-10,-42,-49,-48,-28,-20,-206
-21,20,-31,-69,-88,-43,-59,-20,-311
42,2,-25,-36,-161,-106,-99,-75,-458
-9,-38,-4,-33,-14,-17,-27,4,-138
-22,-2,-35,-59,-61,-38,-43,-16,-276
1,-21,17,-29,-69,-43,-57,9,-192
-20,-1,-16,-51,-31,-15,-18,-5,-157
26,-2,-22,-50,-113,-54,-63,-24,-302
12,9,-17,-43,-40,-32,-21,-20,-152
-3,-6,-10,-33,-96,-56,-58,-23,-285
65,-2,-12,5,-180,-113,-106,-46,-389
-8,35,-32,-91,-61,-50,-48,-33,-288
-19,26,-53,-69,-78,-62,-66,-17,-338
-17,-17,-52,-130,-125,-111,-58,-44,-554
-24,-2,-33,-84,-72,-50,-56,-27,-348
-4,16,-21,-64,-52,-55,-25,-17,-222
-12,-12,-24,-106,-171,-80,-72,-37,-514
-12,-16,-42,-73,-84,-49,-40,17,-299
-6,27,-32,-40,-5,5,-40,37,-54
-22,38,-65,-154,-160,-116,-74,-37,-590
-42,-27,-55,-83,-64,-68,-107,-54,-500
-22,-8,-18,-44,-21,-25,-31,-12,-181
43,-2,-40,-51,-156,-113,-111,-72,-502
21,-45,-11,-81,-189,-116,-117,-28,-566
4,41,-14,-81,-91,-69,-61,4,-267
-36,1,-23,-63,-54,-26,-45,-4,-250
-15,-4,-22,-43,-30,-17,-25,3,-153
16,2,-13,-60,-105,-85,-68,-41,-354
0,11,-18,-45,-72,-44,-51,-25,-244
22,36,4,-28,-56,-34,-24,16,-64
-4,-8,-24,-25,-105,-39,-50,-33,-288
-26,-8,-18,-50,-49,-27,-41,5,-214
11,-7,-18,-23,-67,-58,-36,-48,-246
-24,-18,-44,-122,-120,-58,-73,-39,-498
57,10,-35,-79,-169,-127,-117,-73,-533
-19,11,-1,-44,-33,-21,-8,9,-106
-96,-13,-88,-225,-205,-99,-172,-46,-944
-43,-46,-50,-68,-59,-32,-50,-35,-383
24,12,-14,-21,-109,-50,-68,-24,-250
43,-4,-15,-36,-154,-120,-89,-80,-455
13,11,0,-19,-34,-43,-25,-4,-101
-8,5,-10,-27,-21,-6,-12,-15,-94
3,-17,-18,-54,-90,-37,-52,-15,-280
72,-9,-10,-88,-158,-130,-109,-13,-445
-19,-28,-30,-34,-51,-10,-35,20,-187
-45,-24,-52,-81,-81,-53,-54,3,-387
41,7,-7,-29,-105,-38,-53,-10,-194
-24,28,-12,-64,-8,3,-22,-25,-124
-4,-15,-16,-38,-67,-31,-35,-18,-224
-15,8,-24,-65,-58,-44,-51,-29,-278
0,0,-31,-67,-126,-23,-81,12,-316
-26,0,-21,-66,-50,-30,-43,-21,-257
-24,13,-46,-77,-70,-47,-64,-2,-317
-13,9,-35,-54,-48,-33,-44,-20,-238
-16,-16,-26,-44,-38,-21,-13,5,-169
-16,17,-9,-39,-36,10,-17,-3,-93
8,9,-15,-15,-50,-31,-37,-9,-140
-10,-13,-15,-58,-69,-46,-42,-18,-271
20,15,-27,-51,-95,-85,-73,-56,-352
1,-1,-31,-50,-21,-6,-11,23,-96
-24,-31,-45,-126,-173,-144,-126,-131,-800
-46,29,-31,-85,-56,-19,-54,6,-256
0,-5,-41,-90,-155,-103,-84,-13,-491
-12,4,-2,-40,-33,2,-18,18,-81
-12,11,-23,-77,-50,-36,-35,17,-205
-69,9,-66,-120,-67,-44,-71,-8,-436
-16,1,-18,-46,-30,-22,-24,6,-149
-6,3,-13,-55,-98,-15,-71,-3,-258
-34,8,-55,-144,-110,-77,-106,-42,-560
-30,-4,-34,-55,-42,-23,-50,0,-238
-71,-1,-56,-108,-76,-41,-83,-36,-472
-11,8,-24,-65,-73,-42,-66,-21,-294
12,-29,-35,-60,-133,-82,-86,-50,-463
6,7,-4,-31,-33,-41,-34,-17,-147
-12,22,-40,-56,-25,-24,-41,-9,-185
-36,5,-21,-61,-32,-22,-36,-40,-243
-2,22,-70,-60,-85,-55,-71,8,-313
77,31,-50,-86,-122,-161,-97,-108,-516
-15,5,-59,-84,-52,-24,-44,6,-267
4,28,-2,-26,-8,-18,-15,-15,-52
31,31,-16,-49,-102,-75,-38,-25,-243
-17,-7,-18,-22,-38,-28,-29,16,-143
-3,14,-41,-70,-47,-62,-54,-26,-289
-20,38,-66,-86,-95,-43,-88,66,-294
-21,-24,-13,-43,-60,-25,-28,8,-206
-31,29,-81,-101,-107,-38,-62,-9,-400
-9,12,-17,-31,-58,5,-18,-2,-118
-22,-4,-23,-36,-41,-33,-51,-32,-242
-8,23,-18,-23,-25,-21,-26,35,-63
-10,24,-54,-107,-196,-91,-126,-69,-629
-19,-8,-12,-57,-50,-52,-61,-5,-264
-26,4,-13,-43,-34,-15,-34,3,-158
-17,1,-14,-31,-8,-16,-32,-1,-118
-23,-11,-36,-35,-40,-11,-11,-7,-174
-6,15,-32,-54,-74,-62,-57,-49,-319
7,13,3,-3,-42,3,-56,42,-33
11,-6,-1,-41,-141,-100,-76,-19,-373
-42,-13,-26,-103,-56,-25,-54,-10,-329
-52,-42,-54,-134,-78,-16,-55,32,-399
-3,10,-10,-64,-30,-53,-53,-30,-233
0,-10,-9,-19,-52,-40,-22,-27,-179
-22,-1,-9,-41,-43,-15,-13,16,-128
-23,11,-38,-54,-37,-9,-24,-28,-202
8,8,-30,-53,-81,-58,-78,-24,-308
-8,-10,-25,-41,-69,-48,-51,-16,-268
9,17,-23,-15,-47,-49,-44,-14,-166
-15,3,-17,-39,-85,-4,-52,20,-189
6,-1,-8,-70,-86,-84,-58,-32,-333
-16,-6,-25,-31,-64,-17,-32,-5,-196
-40,-44,-93,-92,-195,-116,-158,-35,-773
-12,21,-39,-70,-65,-27,-46,-31,-269
-27,-3,-52,-122,-108,-64,-92,-58,-526
-46,1,-48,-78,-41,-32,-51,-11,-306
-11,-4,-9,-18,-49,-21,-24,-2,-138
-13,-3,-15,-63,-48,-11,-49,-2,-204
7,-11,-64,-110,-106,-86,-127,39,-458
-10,-3,-11,-31,-43,-20,-21,-11,-150
16,-7,-36,-30,-133,-87,-90,-54,-421
6,-1,-19,-9,-47,-11,-19,-15,-115
-5,19,-18,-34,-13,-11,-22,-6,-90
3,-20,-44,-116,-258,-143,-119,-26,-723
2,4,-10,-49,-68,-45,-48,-22,-236
-5,18,-82,-142,-109,-64,-96,-76,-556
-10,29,-18,-43,-41,10,-20,-3,-96
-18,10,-27,-52,1,-6,-26,-15,-133
47,41,22,36,-65,-29,-49,38,41
-4,45,-21,-107,-52,-52,-47,26,-212
-15,-9,-11,-38,-71,-39,-34,-8,-225
18,0,-21,-51,-110,-78,-72,-45,-359
2,2,-22,-35,-79,-14,-38,21,-163
-20,6,-31,-59,-59,-26,-41,-31,-261
16,7,-18,-17,-36,-17,-48,2,-111
73,42,-26,-65,-156,-71,-88,44,-247
18,13,-58,-83,-101,-77,-95,-13,-396
-18,21,-37,-82,-58,-55,-78,-39,-346
-40,8,-56,-144,-113,-90,-90,-39,-564
-1,3,-11,-21,-43,-22,-26,-1,-122
-32,16,-87,-95,-51,-61,-102,-64,-476
13,15,-11,-45,-55,-48,-34,-7,-172
10,-9,-51,-146,-204,-164,-104,-93,-761
-62,-33,-105,-210,-148,-136,-122,-34,-850
-37,-28,-61,-39,-96,-6,-49,21,-295
16,-3,-34,-66,-132,-91,-81,-43,-434
-18,-15,-14,-36,-31,-16,-11,18,-123
-21,-11,-16,-62,-93,-39,-41,27,-256
36,1,-41,-30,-127,-97,-96,-85,-439
16,3,-7,-21,-38,-22,-38,32,-75
1,0,-12,-16,-39,-15,-33,0,-114
-8,24,-26,-74,-136,-102,-88,-23,-433
-28,-25,-17,-55,-48,-26,-25,-11,-235
20,-4,-4,-41,-87,-75,-50,-48,-289
-13,0,-31,-68,-45,-74,-54,-34,-319
-62,-41,-106,-162,-163,-119,-157,-60,-870
32,12,-6,-28,-107,-82,-56,-22,-257
-13,-14,-2,-24,-73,-33,-38,-4,-201
14,17,-14,-13,-36,-22,-27,-12,-93
-8,-26,-7,-30,-66,-57,-44,-6,-244
-13,-4,-23,-43,-74,-40,-52,-20,-269
-31,5,-30,-99,-123,-32,-62,-10,-382
-14,-2,-13,-46,-50,-49,-21,-14,-209
-16,4,-38,-55,-41,-10,-30,3,-183
-13,13,-16,-59,-52,-27,-32,10,-176
-6,12,-28,-35,-21,-23,-19,-4,-124
-10,10,-27,-32,-110,-6,-49,4,-220
9,-18,-39,-45,-68,-74,-54,-37,-326
19,40,3,-53,-23,-38,-16,26,-42
-22,-16,-20,-41,-53,-29,-27,-17,-225
42,-2,-12,-57,-180,-147,-111,-71,-538
-17,19,-30,-40,-2,15,-7,21,-41
24,5,10,-64,-15,-9,-27,52,-24
21,-8,-31,-55,-130,-82,-82,-25,-392
49,-5,-5,-10,-124,-122,-49,-44,-310
-12,12,-14,-38,-27,-8,-34,32,-89
-22,-16,-30,-41,-87,-31,-45,-11,-283
-4,-13,-11,-93,-119,-135,-99,-24,-498
17,-1,-1,-14,-94,-50,-43,-23,-209
-40,7,-32,-88,-59,-22,-39,40,-233
-36,38,-54,-124,-46,-64,-75,-27,-388
-69,-98,-58,-92,-207,-122,-179,-27,-852
3,9,-5,-19,-35,-30,-24,-16,-117
-27,-30,-54,-92,-64,-48,-56,-51,-422
2,-2,-11,-19,-61,-17,-33,-7,-148
-28,15,-61,-153,-125,-128,-93,1,-572
1,0,2,-19,-47,-10,-23,45,-51
3,27,-22,-44,-57,-43,-47,-18,-201
12,27,-20,-31,-34,-21,-20,-7,-94
25,2,-15,-33,-123,-86,-68,-43,-341
-84,-40,-114,-209,-191,-97,-154,-45,-934
-1,-18,-27,-37,-106,-52,-66,3,-304
-25,52,-63,-130,-86,-117,-92,-63,-524
13,28,-13,-14,-37,-33,-21,-21,-98
5,56,6,0,5,25,-35,30,92
-6,-20,2,-31,-83,-46,-23,-12,-219
47,-5,23,7,-142,-48,-79,-26,-223
1,-9,-7,-30,-92,-31,-23,-14,-205
-23,-11,-29,-93,-83,-69,-51,11,-348
-34,-21,-42,-59,-40,-31,-37,-13,-277
14,-17,-26,-43,-146,-91,-71,-21,-401
-8,38,-72,-127,-82,-54,-60,-36,-401
11,24,-29,-78,-34,-74,-52,-24,-256
-16,16,-25,-43,-21,-20,-37,9,-137
-46,-23,-32,-58,-58,-17,-61,-1,-296
7,-11,0,-26,-145,-34,-64,5,-268
-1,34,-6,-56,-65,-42,-51,14,-173
-22,-11,-32,-46,-52,-20,-46,-9,-238
14,19,-40,-64,-102,-20,-57,-20,-270
30,4,-17,-18,-134,-46,-45,-42,-268
-16,2,-19,-50,-53,-29,-35,-7,-207
-37,1,-63,-152,-149,-126,-132,-4,-662
-30,3,-48,-67,-41,-47,-51,-28,-309
1,-6,-6,-38,-91,-20,-49,46,-163
-24,21,-35,-53,-13,-26,-21,-3,-154
-15,-4,-14,-71,-59,-60,-39,-9,-271
30,50,8,36,-96,2,-46,60,44
-2,8,-26,-55,-65,-8,-30,40,-138
-54,-24,-61,-139,-143,-74,-83,-43,-621
-50,-77,-47,-139,-95,-86,-113,-37,-644
-36,43,-34,-68,-18,-6,-31,-21,-171
2,33,-31,-82,-95,-84,-74,-41,-372
-17,0,-32,-57,-67,-47,-56,-29,-305
-49,-41,-37,-80,-95,-25,-42,-1,-370
7,7,-31,-73,-90,-38,-36,-15,-269
12,-6,-23,-72,-127,-103,-52,-45,-416
16,-24,-6,-6,-99,-29,-50,29,-169
12,-5,-19,-64,-121,-79,-73,-28,-377
15,10,-8,8,-59,-10,-12,11,-45
51,-3,7,-27,-142,-79,-77,-53,-323
-31,-2,-36,-80,-42,-31,-26,-6,-254
22,14,-10,-42,-99,-67,-53,-51,-286
-12,1,-1,-52,-62,-23,-34,9,-174
-2,4,-25,-95,-63,-65,-63,-12,-321
-43,1,-55,-152,-150,-135,-114,-42,-690
-14,6,-17,-23,-35,-7,-21,-11,-122
-24,-31,-19,-50,-79,-57,-72,-42,-374
23,8,-5,-43,-77,17,-26,22,-81
-13,14,-30,-56,-35,-43,-36,-12,-211
-19,-17,-16,-39,-41,-9,-28,14,-155
-27,-19,-37,-71,-63,-53,-46,-35,-351
32,19,-8,-28,-60,-43,-25,-38,-151
-18,-10,-28,-45,-49,-40,-24,-18,-232
-11,21,-20,-32,-26,-17,-24,9,-100
-4,-21,-30,-47,-73,-37,-47,-16,-275
-23,-2,-37,-47,-33,-21,-46,-4,-213
-52,-27,-31,-97,-89,-43,-38,-1,-378
29,38,14,20,-13,-19,-74,18,13
-8,16,-20,-50,-42,-28,-45,-1,-178
-7,6,-6,-64,-84,-70,-41,-15,-281
-17,5,-9,-102,-63,-42,-82,81,-229
-1,21,3,-49,-31,-27,-30,8,-106
-6,13,-44,-52,-75,-24,-72,-34,-294
-11,-5,-29,-40,-122,-24,-49,10,-270
-38,-27,-41,-100,-106,-56,-50,-6,-424
-4,14,15,-43,-61,4,-32,10,-97
-39,3,-134,-160,-108,-67,-103,-55,-663
-16,20,-44,-105,-134,-42,-74,23,-372
6,-1,-48,-104,-148,-83,-112,-1,-491
-3,-14,-12,-25,-31,-28,-25,-12,-150
-20,13,-39,-73,-76,-39,-43,2,-275
-37,19,-50,-123,-80,-79,-97,-37,-484
29,41,-19,-134,-163,-96,-78,-16,-436
-55,-9,-44,-113,-67,-74,-72,-6,-440
-5,15,-30,-38,-41,-27,-31,-36,-193
-16,4,-26,-54,-48,-21,-23,-13,-197
3,21,-36,-75,-71,-76,-85,-43,-362
-12,3,-23,-47,-60,-46,-44,8,-221
-12,15,-28,-49,-22,-15,-32,4,-139
6,-3,-13,-42,-67,-9,-16,18,-126
-20,-8,-33,-61,-68,-38,-50,-10,-288
62,51,-71,-169,-80,-153,-64,-101,-525
-7,14,-27,-54,-39,-14,-29,-12,-168
-38,-7,-61,-75,-58,-27,-50,-23,-339
-11,20,-36,-63,-20,-50,-54,-25,-239
-6,39,-62,-217,-121,-124,-95,-10,-596
-7,-4,-8,-28,-37,-16,-14,13,-101
-31,5,-31,-67,-61,-43,-32,-13,-273
-10,-17,-35,-45,-90,-58,-58,-22,-335
-4,-2,-24,-89,-135,-91,-78,-13,-436
-42,-24,-35,-95,-86,-25,-44,17,-334
54,59,-31,-24,-101,-44,-57,1,-143
18,20,-47,-105,-175,-76,-104,-8,-477
35,-4,-20,-14,-98,-74,-62,-52,-289
-13,22,-34,-86,-103,-52,-79,-35,-380
-13,-11,-7,-40,-40,-28,-32,-16,-187
-26,1,-20,-45,-37,0,-11,-21,-159
-23,-12,-30,-44,-40,-21,-49,7,-212
-56,-1,-41,-80,-88,-27,-51,17,-327
5,0,-7,-18,-92,-39,-55,8,-198
13,35,-25,-73,-49,-33,-46,-9,-187
3,-8,-21,-94,-157,-114,-77,-37,-505
-54,7,-73,-127,-118,-33,-78,85,-391
-17,17,-31,-47,-91,-31,-57,25,-232
30,1,-32,-20,-120,-73,-81,-87,-382
-7,-5,-17,-38,-55,-10,-21,18,-135
4,-7,-15,-50,-118,-46,-62,-22,-316
26,12,-17,-56,-82,-84,-56,-40,-297
-39,-8,-40,-73,-39,-19,-50,0,-268
-24,-26,-65,-70,-129,-106,-102,-23,-545
-73,6,-75,-155,-122,-76,-104,-31,-630
27,-26,-26,-34,-152,-96,-72,-57,-436
2,11,-16,-31,-51,-40,-43,-17,-185
-26,13,-40,-76,-62,-20,-54,-21,-286
18,34,-30,-87,-156,-95,-84,-33,-433
-20,13,-40,-100,-49,7,-27,-4,-220
12,-31,-14,-47,-104,-52,-48,-18,-302
-34,-16,-21,-42,-57,-18,-36,8,-216
4,-4,8,-26,-60,-29,-28,9,-126
8,1,-9,-22,-42,-11,-12,2,-85
-18,-5,-18,-40,-48,-1,-12,10,-132
6,-23,-36,-94,-198,-126,-93,-42,-606
9,3,-7,-36,-39,-34,-19,-14,-137
-9,-4,-23,-18,-30,-22,-38,-3,-147
5,13,5,-10,-2,7,-20,22,20
-16,-2,-50,-85,-146,-76,-50,-11,-436
-26,-6,-55,-186,-253,-114,-111,-64,-815
-11,20,-16,-61,-87,-18,-64,33,-204
-2,26,-56,-57,-127,-50,-108,-37,-411
0,40,-8,-37,-63,12,-7,23,-40
48,9,-30,-32,-100,-89,-73,-59,-326
3,16,-25,-27,-75,-3,-27,-10,-148
48,-2,-4,-18,-131,-53,-63,-18,-241
-9,2,-57,-86,-81,-82,-91,-4,-408
-17,-4,-46,-75,-92,-60,-62,-44,-400
-24,8,-18,-91,-95,-49,-75,14,-330
35,-29,-7,-19,-167,-101,-73,-39,-400
7,-8,-1,-51,-100,-46,-65,-24,-288
13,-4,-15,-57,-82,-80,-68,2,-291
-7,24,-67,-74,-29,-37,-49,-46,-285
15,18,-22,-11,-57,-37,-54,15,-133
-13,-6,-22,-28,-30,-10,-31,-9,-149
16,13,-4,-56,-81,-67,-35,-26,-240
7,5,-24,-61,-57,-41,-51,-33,-255
10,-2,-35,-100,-146,-64,-81,-2,-420
-13,-12,-30,-30,-55,-37,-24,-19,-220
45,0,-25,-4,-109,-62,-58,-10,-223
42,5,33,-25,-142,-107,-107,8,-293
-38,-2,-29,-89,-76,-45,-64,-23,-366
21,-14,-10,-49,-106,-51,-53,-8,-270
25,18,1,-6,-48,-29,-7,-3,-49
-13,50,-31,-90,-68,-47,-64,19,-244
2,-23,-32,-49,-86,-48,-53,-35,-324
-90,14,-72,-168,-128,-73,-93,-18,-628
-52,-4,-20,-102,-79,-26,-54,0,-337
20,3,20,-32,-34,-21,-17,35,-26
15,25,-35,-44,-39,-24,-28,-40,-170
-19,-1,-39,-43,-29,-14,-19,-16,-180
-32,-8,-44,-98,-78,-17,-67,-10,-354
-19,-35,-31,-88,-106,-77,-79,-19,-454
49,-12,14,2,-108,-64,-70,-19,-208
36,7,-13,-39,-128,-112,-77,-65,-391
-6,-21,-47,-82,-53,-25,-48,33,-249
19,5,-1,-25,-55,-39,-19,6,-109
-5,30,-21,-31,-21,16,4,22,-6
-1,-17,-25,-61,-91,-64,-68,-45,-372
-18,1,-3,-40,-34,-50,-29,9,-164
31,17,-8,-20,-21,-18,-27,2,-44
30,20,-4,-69,-24,-21,-36,24,-80
-73,-37,-103,-163,-156,-134,-120,-29,-815
-23,24,-30,-53,-5,-19,-21,8,-119
-8,16,-22,-81,-129,-29,-68,1,-320
6,-8,-34,-56,-57,-12,-33,7,-187
-5,21,-19,-43,-46,-39,-32,-5,-168
-6,22,-15,-86,-56,-67,-51,-25,-284
18,36,-25,-44,-43,-54,-30,10,-132
7,4,-28,-43,-96,-74,-71,-46,-347
-12,9,-30,-62,-87,-45,-47,-19,-293
16,5,-2,-107,-101,-67,-10,4,-262
-27,-2,-30,-58,-24,-20,-28,-32,-221
-32,3,-14,-51,-19,-8,-18,14,-125
24,-16,-15,-32,-130,-77,-59,-59,-364
0,46,-11,-60,-91,14,-24,52,-74
-67,-11,-123,-163,-175,-100,-169,-63,-871
9,-53,-34,9,-85,-7,-28,20,-169
40,-7,-31,-62,-160,-120,-106,-63,-509
-15,5,-11,-52,-38,-39,-34,-19,-203
22,-2,1,-17,-131,-75,-81,-58,-341
-42,5,-53,-91,-47,-28,-73,-3,-332
70,51,-15,54,-94,-55,-40,15,-14
-24,-3,-33,-86,-70,-2,-38,-8,-264
11,3,2,-14,-97,-51,-43,-9,-198
26,15,9,53,-46,-19,-53,26,11
-2,14,-11,-35,-26,-21,-4,8,-77
-14,-9,-35,-44,-32,-18,-46,-27,-225
-12,-17,-41,-56,-21,-32,-40,-5,-224
14,-11,-36,-44,-127,-68,-63,-12,-347
28,-21,-17,-62,-92,-92,-65,-41,-362
100,30,-35,-65,-229,-223,-138,-113,-673
-46,22,-71,-102,-60,-10,-47,-14,-328
-54,-29,-112,-165,-182,-56,-122,-51,-771
17,-12,-12,-54,-82,-58,-47,-46,-294
44,43,-15,-39,-155,-124,-86,-54,-386
-12,1,-12,-31,-41,-35,-36,2,-164
8,17,-36,-31,-29,-18,-19,32,-76
-16,8,-39,-74,-75,-29,-66,12,-279
1,4,-58,-87,-101,-60,-79,-40,-420
24,-11,-21,-20,-112,-55,-51,-36,-282
-60,10,-58,-119,-82,-61,-95,-42,-507
-60,-13,-51,-113,-75,-30,-55,-43,-440
42,-9,-21,-31,-121,-80,-77,-53,-350
-43,-10,-65,-93,-54,-52,-95,-42,-454
-16,-36,-25,-69,-95,-65,-80,-55,-441
-4,-21,-4,-39,-102,-39,-51,-8,-268
-11,-16,-27,-33,-48,-29,-30,-7,-201
-26,-20,-76,-77,-112,-45,-82,-25,-463
31,-3,-2,-23,-129,-74,-61,-17,-278
-11,12,-16,-48,-29,-30,-44,-48,-214
-16,2,-4,-38,-65,-6,-30,25,-132
18,8,-19,-35,-92,-33,-56,-23,-232
-23,-9,-27,-69,-54,-30,-66,47,-231
6,28,-37,-43,-50,-13,-15,31,-93
-38,-23,-16,-53,-109,-23,-53,24,-291
-12,5,5,-41,-54,-9,-38,5,-139
7,-1,-5,-27,-51,-39,-29,-7,-152
-16,3,-30,-45,-17,-13,-20,-3,-141
8,20,-7,-31,-26,-20,-56,-13,-125
-11,30,-25,-52,-68,-28,-37,-23,-214
-41,-20,-74,-94,-90,-58,-66,12,-431
-19,-7,-33,-36,-70,4,-35,20,-176
-9,-6,-40,-51,-93,-48,-39,-33,-319
-26,-17,-35,-45,-30,-25,-21,-13,-212
21,-18,-18,-63,-125,-96,-68,-34,-401
-145,-88,-195,-221,-197,-126,-240,-20,-1232
35,-29,-17,-43,-125,-97,-103,-42,-421
-3,19,-18,-41,-39,-57,-51,-37,-227
3,3,11,-22,-34,-19,-13,17,-54
6,-18,-17,-66,-76,-95,-76,-13,-355
-9,15,-32,-43,-50,-15,-17,-12,-163
-18,-5,-21,-62,-30,-52,-47,-31,-266
-21,13,0,-80,-49,-41,-24,12,-190
25,20,-13,-55,-119,-66,-59,-14,-281
0,-4,-22,-35,-84,-59,-56,-25,-285
-26,11,-30,-52,-34,-10,-29,-1,-171
-72,43,-100,-230,-108,-165,-189,-80,-901
15,8,-6,-37,-52,-45,-64,3,-178
-59,8,-65,-108,-33,-35,-82,-2,-376
-23,-6,-29,-51,-71,-41,-53,-5,-279
-66,-21,-155,-171,-220,-154,-258,-112,-1157
-69,-20,-153,-178,-146,-137,-208,-75,-986
-16,-31,-18,-37,-29,-38,-44,8,-205
-12,-35,-25,-68,-115,-64,-55,-26,-400
22,25,6,-36,-80,-51,-48,-18,-180
-14,-5,-21,-44,-62,-30,-44,-8,-228
-15,-10,-41,-47,-68,-34,-26,0,-241
-4,0,-66,-65,-114,-60,-96,-17,-422
-21,-20,-5,-54,-81,-31,-47,27,-232
-13,-3,-26,-31,-37,-17,-32,-27,-186
-46,-28,-19,-59,-86,-31,-47,10,-306
48,-9,8,-43,-221,-86,-120,68,-355
-20,8,-34,-43,-15,-21,-31,-8,-164
-25,-11,-33,-81,-24,13,-16,9,-168
8,3,-16,-61,-135,-79,-49,-48,-377
-5,-60,-35,-60,-123,-76,-83,-25,-467
16,2,-14,-49,-90,-75,-71,-37,-318
41,-7,-21,-44,-96,-99,-73,-36,-335
19,-28,-11,-91,-164,-108,-98,-73,-554
-14,-16,-33,-55,-53,-30,-55,-33,-289
-59,-20,-56,-92,-65,-16,-78,1,-385
19,8,9,-25,-101,13,-49,8,-118
23,9,-35,-90,-143,-121,-107,-107,-571
-19,0,-19,-32,-34,-12,-18,-1,-135
16,6,2,-17,-28,-23,-13,9,-48
-61,-17,-46,-94,-68,-25,-78,-35,-424
-2,-2,-24,-25,-48,-35,-25,-10,-171
-22,2,-24,-65,-60,-35,-43,-27,-274
-11,-11,-28,-24,-46,-14,-47,5,-176
5,-8,-17,-41,-35,-40,-35,-17,-188
11,7,-6,8,-31,8,-14,5,-12
-99,-44,-66,-158,-127,-56,-112,-31,-693
-10,-20,-16,-58,-37,-22,-13,9,-167
-9,18,-20,-48,-29,-33,-28,-13,-162
-10,-22,-30,-56,-13,8,-19,44,-98
-14,-6,-22,-13,-16,8,-21,24,-60
-7,12,-13,-34,-44,4,-18,13,-87
-33,-36,-57,-97,-53,-116,-94,-21,-507
-57,-1,-41,-94,-55,-16,-47,11,-300
18,-7,-38,-61,-103,-40,-88,18,-301
65,9,-22,22,-103,-45,-67,35,-106
14,10,-14,-29,-29,-43,-38,-31,-160
32,15,11,-60,-76,-78,-44,-25,-225
3,-1,-22,-28,-48,-33,-26,-17,-172
12,44,10,-52,-102,-67,-55,-5,-215
-32,5,-31,-67,-25,-35,-39,-12,-236
12,22,-14,-43,-111,-72,-83,-24,-313
36,43,-28,-61,-83,-55,-47,-8,-203
-2,20,13,-33,-51,-27,-37,24,-93
-48,12,-76,-164,-88,-72,-95,-40,-571
65,39,15,2,-49,-21,-29,44,66
75,147,12,-115,-104,29,-34,96,106
40,12,4,18,-56,-38,-26,-19,-65
-27,9,-40,-86,-57,-40,-55,-5,-301
52,55,-6,-40,-68,-89,-42,-34,-172
-44,40,-38,-140,-191,-59,-74,10,-496
-12,14,-14,-34,-59,-12,-34,7,-144
-18,-13,-15,-38,-52,-24,-26,-8,-194
35,38,0,-35,-66,-42,-31,38,-63
-8,34,-34,-97,-98,-85,-72,-39,-399
18,18,-19,-86,-107,-109,-102,42,-345
-6,39,-42,-92,-66,-81,-67,-25,-340
-58,-10,-72,-129,-62,-66,-76,-31,-504
-31,-19,-36,-61,-49,-35,-59,-22,-312
26,12,-38,-36,-149,-113,-89,-69,-456
-47,0,-53,-78,-42,-3,-24,-5,-252
-30,7,-38,-84,-56,-21,-57,5,-274
-30,-39,-35,-74,-108,-11,-54,17,-334
0,-29,-20,-61,-113,-68,-70,-17,-378
-18,20,-8,-36,-38,0,-16,12,-84
3,8,-44,-144,-96,-108,-91,-69,-541
-12,26,-27,-58,-54,-11,-32,-45,-213
-65,19,-57,-105,-35,-47,-61,24,-327
-41,-10,-43,-66,-53,-39,-56,-13,-321
-12,-8,-6,-40,-66,-27,-41,36,-164
-20,11,-23,-40,-17,-36,-31,19,-137
10,-10,-30,-52,-65,-48,-44,-26,-265
-4,-7,-48,-37,-72,-57,-73,2,-296
-4,-5,1,-41,-81,4,-39,-9,-174
9,-6,-40,-64,-89,-74,-78,-3,-345
-27,30,-88,-205,-195,-83,-155,-38,-761
-14,15,-25,-70,-40,-8,-12,-17,-171
-23,-2,-35,-89,-97,-84,-82,-31,-443
-27,1,-51,-76,-103,-47,-64,-10,-377
-2,-17,3,-8,-59,-35,-9,16,-111
-33,23,-33,-53,-47,-26,-30,-26,-225
19,12,-6,-46,-58,-46,-43,-7,-175
-2,-17,-21,-63,-64,-43,-40,-19,-269
46,17,-27,-23,-115,-94,-77,-44,-317
11,21,7,-5,-24,-16,-14,13,-7
-24,-5,-19,-51,-94,-44,-49,-35,-321
-5,-3,-14,-30,-34,-9,-33,3,-125
-16,5,-33,-53,-44,-29,-39,-33,-242
-6,-6,-24,-49,-56,-29,-37,15,-192
22,21,-18,-37,-90,-63,-69,-59,-293
22,34,10,3,-37,-11,-23,-7,-9
36,77,4,10,-29,-12,2,49,137
31,21,-4,8,-33,-18,-33,-35,-63
-1,29,-25,-106,-95,-81,-78,-13,-370
-33,-11,-10,-42,-53,3,-27,17,-156
3,-4,-16,-18,-70,-30,-41,-10,-186
-21,-8,-25,-48,-71,-39,-42,-16,-270
7,-10,4,-16,-51,-32,-21,-8,-127
27,39,-6,-5,-61,-28,-74,28,-80
-27,-6,-20,-31,-53,11,-31,5,-152
-36,-4,-34,-58,-102,-1,-71,15,-291
-50,-21,-69,-116,-73,-62,-94,-19,-504
-11,-3,-11,-81,-119,-71,-54,-3,-353
13,14,-16,-13,-9,-7,-17,17,-18
12,-19,-7,-43,-138,-84,-76,-27,-382
-43,-27,-54,-75,-69,-55,-58,-17,-398
18,12,-22,-62,-104,-55,-49,-52,-314
-20,50,-65,-169,-63,-63,-98,-43,-471
-6,-10,-8,-31,-46,-33,-17,-16,-167
7,32,10,-21,-34,-16,-36,33,-25
-12,-48,-39,-4,-67,-29,-51,-15,-265
-39,-13,-42,-78,-104,-48,-63,-7,-394
22,-10,-23,-21,-90,-52,-51,6,-219
11,5,-1,-14,-31,-21,-13,-8,-72
-24,-7,-22,-46,-13,-15,-33,-21,-181
44,33,8,19,-57,-6,-10,0,31
-23,-12,-35,-59,-68,-22,-41,8,-252
14,22,-10,-41,-63,-49,-23,-15,-165
42,-26,-61,-130,-206,-207,-165,-128,-881
-6,-17,-61,-117,-189,-123,-91,12,-592
18,39,-23,-96,-114,-105,-59,-12,-352
0,-8,-27,-36,-46,-30,-27,1,-173
2,13,-25,-56,-37,-17,-37,-2,-159
-4,4,-47,-59,-113,-38,-59,-37,-353
-47,-21,-43,-83,-125,-50,-74,4,-439
4,-22,-13,-41,-118,-55,-49,-21,-315
-2,-4,-13,-76,-90,-59,-50,-15,-309
-51,-5,-62,-116,-78,-24,-86,0,-422
-30,13,-40,-67,-53,-45,-57,-37,-316
25,20,-42,-54,-139,-49,-84,-51,-374
-9,-7,-22,-47,-62,-43,-54,4,-240
-12,-11,-6,-45,-61,-36,-31,-23,-225
-13,-41,-41,-73,-135,-130,-87,-55,-575
-78,-4,-104,-139,-107,-29,-65,14,-512
-62,-28,-56,-119,-125,-17,-79,16,-470
-20,-17,-39,-47,-89,-15,-27,37,-217
-10,7,-10,-29,-33,-12,-26,2,-111
-41,12,-46,-92,-32,-61,-89,-48,-397
-19,11,-12,-15,-23,-9,-6,5,-68
4,-11,-17,-62,-96,-73,-50,5,-300
-22,-3,-9,-73,-71,-21,-34,42,-191
-26,2,-52,-112,-77,-46,-72,18,-365
-35,3,-14,-78,-37,-18,-18,-4,-201
1,14,-33,-51,-46,-20,-30,-23,-188
57,54,-14,-3,-126,-18,-37,22,-65
-2,84,-33,-140,-81,-119,-76,-23,-390
-6,-4,-33,-66,-95,-75,-28,-42,-349
-32,3,-44,-88,-52,-15,-33,-26,-287
40,29,-5,-20,-38,-39,-37,-65,-135
5,-13,-29,-73,-101,-87,-62,-42,-402
-14,-20,-4,-29,-57,-45,-41,-27,-237
-2,-15,-16,-40,-117,-64,-59,-20,-333
-47,16,-49,-129,-110,-62,-57,-18,-456
-17,7,-30,-75,-49,-37,-48,-12,-261
-34,-23,-41,-81,-83,-69,-75,-17,-423
52,-35,-10,-16,-114,-78,-96,25,-272
-46,15,-55,-108,-29,-33,-40,-23,-319
-14,-13,-2,-37,-107,-31,-42,-23,-269
52,22,10,10,-16,-23,-68,11,-2
-14,3,-25,-103,-88,-15,-24,2,-264
-30,14,-14,-45,-2,-25,0,12,-90
-6,17,-9,-139,-147,-55,-70,35,-374
2,10,-46,-85,-72,-101,-81,-58,-431
17,11,4,-38,-83,-35,-36,-24,-184
-8,-1,-17,-64,-83,-44,-49,-25,-291
-36,-20,-49,-96,-87,-20,-50,28,-330
-5,-10,-26,-21,-64,-25,-35,-43,-229
-51,-21,-26,-81,-98,-19,-51,23,-324
-42,-1,-30,-52,-34,-13,-16,-5,-193
-1,-3,-3,-48,-63,-12,-36,-14,-180
-22,8,-34,-87,-62,-35,-37,-23,-292
0,34,-33,-80,-54,-29,-53,10,-205
-30,3,-33,-51,-26,-36,-42,-1,-216
68,24,5,-34,-54,1,-40,29,-1
14,-15,-31,-26,-129,-69,-64,-43,-363
-24,-19,-33,-60,-71,-45,-59,19,-292
39,-32,15,-29,-134,-111,-78,13,-317
-18,9,-28,-59,-65,-40,-40,4,-237
-44,-21,-28,-117,-109,-87,-67,-6,-479
23,16,-29,-70,-18,-61,-42,-2,-183
15,-15,-18,4,-65,-3,-15,0,-97
46,-25,8,-40,-118,-83,-68,-35,-315
25,23,-23,-10,-108,-46,-54,-37,-230
33,16,-27,-28,-71,-89,-55,-6,-227
-10,-23,-96,-210,-340,-175,-232,-15,-1101
-8,4,-16,-19,5,-15,-19,30,-38
77,-18,-21,37,-87,-90,-75,-19,-196
17,8,-6,-20,-42,-17,-19,-5,-84
-39,13,-47,-106,-41,-47,-50,65,-252
-23,-26,-29,-70,-50,-41,-55,-23,-317
-17,-13,-25,-54,-37,-45,-39,-10,-240
-71,-73,-54,-116,-192,-45,-124,34,-641
38,-9,-24,7,-27,-28,-50,35,-58
37,-17,-5,-6,-116,-64,-55,-26,-252
0,-15,-13,-57,-131,-81,-100,-17,-414
-6,4,-20,-32,-35,-32,-23,19,-125
-9,24,-46,-116,-132,-134,-94,-25,-532
-52,-39,-92,-126,-182,-91,-178,-64,-824
-12,18,-40,-58,-70,-30,-59,-28,-279
-3,6,-13,-29,-55,-19,-46,24,-135
-74,11,-63,-109,-45,-54,-55,-26,-415
-90,-33,-124,-198,-173,-52,-106,-32,-808
-9,8,-28,-42,-56,-35,-42,-20,-224
-16,-27,-42,-72,-106,-44,-58,-7,-372
-3,18,-19,-63,-117,-78,-61,-30,-353
15,-4,-6,-5,-27,39,-10,56,58
-35,-10,-43,-82,-60,-37,-39,-9,-315
57,2,12,23,-53,-14,-27,13,13
-39,22,-21,-88,-53,-35,-33,26,-221
-33,-7,-66,-91,-136,-67,-108,-64,-572
6,27,-43,-161,-122,-96,-63,63,-389
4,-15,-39,-81,-110,-28,-116,-9,-394
46,36,-37,-93,-172,-152,-105,-41,-518
33,56,16,-6,-54,34,-15,28,92
12,11,-24,-68,-102,-61,-43,-42,-317
-14,-9,-48,-64,-69,-36,-63,4,-299
62,-17,-17,-1,-69,-47,-55,28,-116
16,11,-24,-17,-34,-24,-26,-23,-121
-28,17,-59,-123,-167,-48,-85,-19,-512
68,-47,-23,-22,-203,-160,-115,-56,-558
-6,4,-20,-50,-51,-26,-49,-51,-249
51,-2,-25,-5,-150,-105,-93,-70,-399
18,26,8,0,-41,-23,-36,3,-45
-29,12,-37,-87,-97,-62,-75,-18,-393
26,8,-15,-32,-67,-70,-47,-50,-247
13,12,-8,-14,-45,-19,-20,9,-72
-14,6,-46,-46,-45,-4,-24,3,-170
17,18,-38,-64,-88,-23,-53,47,-184
-182,-82,-157,-306,-277,-194,-276,-87,-1561
-24,25,-65,-119,-108,-44,-73,-30,-438
-6,-35,-13,-51,-45,-11,-21,26,-156
56,6,-10,13,-36,-19,-26,20,4
-35,-3,6,-52,-48,-8,-28,38,-130
-27,-20,-35,-65,-61,-49,-59,-27,-343
13,-65,-34,-106,-131,-103,-73,-7,-506
-12,1,-10,-63,-126,-58,-87,-38,-393
-35,-41,-52,-92,-132,-62,-101,-46,-561
19,7,-14,-29,-57,-56,-55,-14,-199
18,13,-13,7,-34,-4,-20,23,-10
3,30,-7,-21,-16,-25,-12,5,-43
-34,15,-63,-114,-59,-39,-64,-1,-359
24,2,-9,-25,-116,-68,-60,-27,-279
-17,17,-18,-101,-77,-12,-52,-23,-283
-26,21,-9,-49,-69,-31,-44,58,-149
-26,9,-45,-70,-44,-13,-31,26,-194
26,22,-19,-54,-103,-78,-58,-44,-308
-54,22,-86,-146,-40,-110,-95,-49,-558
-23,17,-70,-142,-201,-59,-105,-27,-610
-5,-29,-17,-26,-31,-19,-23,6,-144
-1,-13,-4,-26,-77,-54,-38,-39,-252
-71,-8,-66,-159,-113,-48,-86,-16,-567
28,-21,-18,-53,-92,-69,-66,-33,-324
-54,-46,-81,-139,-156,-77,-112,116,-549
-12,14,-29,-63,-1,-51,-32,-18,-192
-38,30,-42,-126,-58,-53,-34,14,-307
-41,4,-47,-96,-59,-47,-50,14,-322
-25,23,-46,-64,-55,-37,-59,-3,-266
-51,10,-33,-103,-99,-71,-66,-2,-415
65,-3,23,-15,-217,-83,-85,9,-306
16,-13,-40,-59,-91,-60,-60,29,-278
-122,23,-141,-275,-63,-102,-121,18,-783
-35,51,-154,-197,-267,-161,-196,-83,-1042
-133,-87,-143,-228,-144,-50,-109,18,-876
6,-1,1,-41,-125,-91,-37,22,-266
-36,-20,-18,-45,-60,-28,-42,19,-230
-4,4,-21,-64,-54,-26,-41,3,-203
-4,3,-5,-29,-15,11,-10,17,-32
20,32,-23,-106,-227,-77,-114,-25,-520
-8,-35,-44,-65,-100,-52,-44,18,-330
21,17,0,-6,-7,-6,5,8,32
15,27,-29,-90,-118,-112,-102,-79,-488
-13,11,-46,-78,-98,-49,-60,-29,-362
-93,6,-119,-195,-116,-65,-97,19,-660
54,32,-41,-145,-102,-127,-91,-133,-553
51,21,-14,-8,-48,-25,-42,-12,-77
-11,44,-62,-61,-40,2,-33,38,-123
-10,-42,-39,-85,-215,-133,-110,-49,-683
5,12,-1,-12,-61,3,-35,19,-70
5,11,-3,-27,-13,-34,-49,26,-84
0,-3,-15,-26,-47,-31,-34,38,-118
-18,6,-8,-50,-46,-29,-46,-23,-214
56,-3,1,-73,-121,-76,-93,36,-273
0,-12,-7,-69,-151,-88,-68,9,-386
-9,2,-27,-54,-49,-23,-34,-6,-200
-35,24,-61,-118,-93,-59,-71,-7,-420
3,-14,-33,-9,-77,-3,-46,16,-163
8,19,-19,-28,-49,-35,-35,-2,-141
-49,11,-65,-123,-61,-57,-40,-1,-385
13,-6,-36,-56,-136,-120,-90,-58,-489
-34,-13,-36,-101,-70,-68,-50,-19,-391
-19,2,-26,-132,-133,-91,-87,3,-483
94,-32,10,-50,-68,-123,-121,-16,-306
58,55,14,-27,-131,-77,-59,-12,-179
62,-10,8,15,-58,-36,-25,34,-10
16,2,-7,-51,-32,-60,-41,-15,-188
4,-32,-12,-35,-127,-64,-68,3,-331
19,-1,1,-34,-75,-51,-19,-13,-173
-1,-20,-20,-34,-51,-42,-31,1,-198
10,3,-10,-32,-42,-32,-28,-6,-137
-11,-11,-16,-14,-21,-13,-9,27,-68
-11,-16,-28,-38,-37,-25,-21,-11,-187
12,-17,-29,-45,-141,-101,-84,-85,-490
18,18,8,-7,8,24,-3,4,70
7,2,-4,19,-8,35,-7,29,73
14,-18,-31,-85,-114,-14,-81,25,-304
9,35,-24,-80,-68,-47,-66,6,-235
-14,17,-24,-28,-34,-8,-26,-13,-130
-24,3,-24,-91,-101,-81,-59,-24,-401
-29,31,-20,-55,-36,-30,-40,28,-151
-22,-17,-31,-64,-132,-24,-31,17,-304
24,28,-3,-23,-28,-9,-23,2,-32
-18,-28,-69,-81,-106,-61,-79,-60,-502
24,15,-13,-24,-55,-39,-30,-33,-155
3,20,-33,-28,-26,-13,-33,-10,-120
-10,3,2,-30,-80,-22,-43,4,-176
4,42,-19,-72,-41,-66,-43,-17,-212
-55,13,-70,-109,-46,-28,-74,25,-344
-54,2,-51,-107,-56,-77,-97,-39,-479
-5,4,-7,-60,-108,-81,-67,-12,-336
5,-11,-10,-41,-115,-71,-66,-28,-337
-11,17,-24,-98,-99,-22,-64,-4,-305
-15,-2,-16,-36,-37,-35,-37,-15,-193
61,-42,-8,-10,-127,-85,-106,38,-279
-18,0,-13,-50,-60,-45,-34,5,-215
-4,4,-31,-101,-188,-98,-68,-29,-515
23,1,-14,-10,-55,-41,-30,-48,-174
8,8,-17,-55,-23,-3,-12,7,-87
-36,25,-41,-136,-160,-72,-78,3,-495
78,19,-7,41,-97,-69,-59,-56,-150
-51,37,-97,-182,-105,-120,-124,-58,-700
-86,5,-123,-295,-224,-209,-188,-111,-1231
-25,0,-29,-47,-41,-11,-24,0,-177
-11,5,-28,-59,-1,-26,-19,8,-131
-11,-37,-59,-105,-136,-100,-114,14,-548
-50,-19,-42,-120,-82,-70,-78,-20,-481
-123,-24,-180,-311,-231,-221,-279,-146,-1515
21,1,-17,-41,-76,-60,-40,-4,-216
5,2,-16,-68,-64,-37,-52,-17,-247
55,21,-19,27,-79,-37,-63,-32,-127
6,8,-5,-21,-23,-10,-8,23,-30
-32,1,-28,-93,-34,-51,-31,-36,-304
11,1,-3,-32,-72,-34,-50,-12,-191
20,61,-16,-21,-23,-44,-26,4,-45
48,36,-1,-35,-162,-101,-107,-21,-343
-11,42,-36,-121,-43,-40,-73,18,-264
-12,8,-23,-28,-41,5,-23,0,-114
-19,2,-56,-91,-132,-66,-125,66,-421
4,-11,-34,-128,-113,-134,-88,-53,-557
4,4,-22,-50,-76,-64,-46,-13,-263
-19,4,-15,-40,-42,-38,-33,-5,-188
2,2,-1,-25,-34,-11,-15,0,-82
19,6,-10,-6,-56,-27,-11,-18,-103
-10,-5,-28,-32,-29,-16,-43,-28,-191
-24,-30,-41,-112,-182,-109,-97,-63,-658
-66,-38,-79,-167,-167,-79,-106,-6,-708
64,-55,-28,0,-244,-153,-142,-76,-634
12,-3,-24,13,5,-13,-36,64,18
-25,79,-84,-137,-31,11,-20,29,-178
-26,13,5,-41,1,-12,-34,5,-89
-51,-9,-49,-117,-75,-71,-92,-53,-517
25,23,-40,-61,-134,-50,-72,14,-295
22,-2,-5,10,-30,-12,-8,29,4
-1,-52,-1,-47,-139,-83,-62,-44,-429
-108,-22,-152,-218,-148,-81,-171,-66,-966
-14,-17,-15,-58,-82,-40,-53,9,-270
16,-32,-16,-45,-104,-66,-85,-19,-351
-30,-8,-21,-99,-121,-65,-66,10,-400
-45,10,-60,-153,-135,-72,-76,0,-531
-22,-28,-34,-73,-110,-67,-46,-36,-416
-18,18,-58,-80,-57,-23,-62,26,-254
-13,-35,-12,-41,-67,-24,-31,-6,-229
-31,-15,-20,-67,-68,-28,-44,-27,-300
1,3,-15,-46,-58,-41,-51,-9,-216
-26,-17,-49,-95,-100,-83,-72,-45,-487
29,14,13,-16,-156,-51,-71,-23,-261
-8,31,-12,-54,-53,-22,-42,15,-145
16,-37,-9,-40,-103,-84,-65,-27,-349
-10,8,-37,-66,-127,-50,-62,-1,-345
-19,5,-70,-74,-111,-17,-57,-16,-359
-3,10,-18,-26,-68,-52,-33,5,-185
1,-2,-12,-94,-35,-56,-65,-2,-265
-45,-26,-41,-93,-72,-55,-69,-3,-404
-10,-19,-26,-65,-109,-41,-66,-24,-360
14,21,0,-50,-25,-22,-9,10,-61
-22,17,-39,-55,-28,-36,-20,1,-182
2,-21,-5,-24,-40,-26,-18,-2,-134
-6,8,-16,-50,-61,-15,-12,8,-144
-9,2,-28,-56,-61,-71,-73,-23,-319
43,9,-21,29,-79,-75,-88,23,-159
-11,18,-25,-48,-49,-31,-23,-2,-171
18,0,-8,-22,-37,-33,-23,2,-103
13,-11,-8,-22,-86,-42,-39,0,-195
0,-6,-2,-26,-25,-7,-20,31,-55
2,27,-25,-42,-20,-22,-25,3,-102
-103,19,-96,-171,-79,-61,-58,-33,-582
-33,5,-55,-74,-50,-34,-62,-12,-315
-48,-14,-65,-184,-87,-126,-119,-60,-703
-87,-48,-80,-137,-82,-47,-100,-11,-592
6,3,-15,-20,-51,-31,-18,-13,-139
23,-25,-13,-45,-135,-84,-79,-13,-371
-20,-4,-30,-59,-47,-49,-25,-19,-253
-2,1,-18,-38,-49,-27,-26,-14,-173
-22,-11,-20,-37,-25,-7,-25,10,-137
13,0,-30,-36,-105,-51,-69,-44,-322
13,-13,-8,-60,-147,-97,-71,-24,-407
11,-6,-23,-73,-126,-48,-65,28,-302
16,7,-19,-23,-50,-41,-41,-13,-164
-28,31,-15,-39,-17,-21,-26,-1,-116
-18,-18,-36,-77,-123,-80,-95,-36,-483
-43,-2,-76,-94,-55,-49,-54,-23,-396
-23,0,3,-102,-78,-58,-50,-3,-311
3,-13,-1,-49,-64,-26,-41,24,-167
-13,-1,-5,-34,-55,-11,-20,0,-139
6,-5,-13,-39,-77,-46,-50,-8,-232
-4,27,-25,-15,-40,-7,-43,36,-71
-107,-58,-113,-190,-136,-89,-156,-49,-898
30,-22,-11,-61,-114,-101,-85,-75,-439
4,13,-7,-59,-11,-27,-18,38,-67
33,7,-29,-25,-83,-54,-56,-14,-221
-7,-24,-27,-41,-73,-57,-41,-20,-290
-36,16,-66,-97,-109,-67,-84,-25,-468
-1,-4,-35,-61,-53,-20,-48,-1,-223
11,4,-21,-23,-131,-17,-49,-9,-235
-49,21,-42,-68,-32,0,-36,28,-178
27,-10,-28,-45,-76,-68,-66,-13,-279
-6,26,-21,-37,-8,7,0,35,-4
-4,-17,-14,-36,-76,-32,-35,26,-188
-22,14,-33,-62,-2,-21,-25,-29,-180
10,17,-49,-82,-83,-42,-47,-29,-305
-40,-4,-37,-93,-69,-34,-43,-6,-326
14,41,-6,-81,-25,-66,-46,22,-147
-11,-10,-24,-41,-34,-51,-42,-17,-230
-1,30,7,-35,-48,-13,-37,19,-78
-36,5,-24,-78,-42,-30,-12,38,-179
0,29,3,-27,-32,-33,-18,45,-33
-34,-20,-13,-53,-47,-16,-33,4,-212
13,41,-23,-30,-72,-8,-74,98,-55
-28,3,-24,-66,-47,-29,-30,59,-162
7,9,8,-9,-25,-25,1,16,-18
-6,15,-36,-56,-40,-4,-24,4,-147
23,-12,-48,-37,-85,-79,-56,-62,-356
-44,28,-62,-136,-90,-30,-75,77,-332
-48,-10,-27,-60,-78,-37,-51,5,-306
-12,-46,-32,-74,-120,-43,-52,14,-365
-3,21,-6,-28,-123,-12,-55,38,-168
-45,1,-40,-78,-121,-6,-41,2,-328
-2,18,-14,-31,-32,-25,-22,-5,-113
-22,28,-37,-104,-72,-43,-43,0,-293
-13,-24,-23,-29,-103,-59,-70,-43,-364
46,11,20,0,-154,-116,-72,-16,-281
14,30,1,-24,-66,-19,-31,24,-71
1,16,-10,1,-18,13,6,-7,2
12,-7,-20,-13,-128,-21,-49,-15,-241
-38,-1,-63,-108,-88,-52,-58,-33,-441
-8,23,-21,-46,-38,-40,-46,2,-174
-9,-35,-25,-43,-62,-38,-23,-29,-264
21,8,-11,-99,-181,-113,-72,-30,-477
-36,-19,-39,-70,-65,-43,-51,2,-321
31,34,-18,-5,-63,33,-16,77,73
-51,-7,-38,-108,-66,-51,-80,23,-378
13,4,6,-19,-84,-44,-27,-10,-161
18,23,-10,-68,-160,-98,-76,-38,-409
59,-39,-42,-57,-252,-136,-113,-40,-620
-33,-18,-27,-96,-66,-38,-56,-34,-368
-31,-21,-54,-98,-53,-51,-72,-29,-409
13,0,-11,-6,-76,-43,-44,-4,-171
0,56,-69,-95,-51,-23,-64,-24,-270
1,13,5,-53,-73,-86,-65,-59,-317
-13,15,-38,-49,-34,-33,-26,-11,-189
-46,-5,-49,-112,-56,-32,-62,12,-350
-37,-4,-55,-102,-115,-70,-104,-46,-533
-20,0,-19,-57,-61,-32,-58,-26,-273
-17,12,-53,-105,-73,4,-9,35,-206
61,15,-6,-6,-101,9,-75,49,-54
-15,-31,-38,-41,-62,-17,-49,-1,-254
-25,-7,-33,-97,-54,-19,-72,36,-271
13,-6,-64,-58,-130,-63,-85,72,-321
20,-4,-20,-9,-44,-18,-38,9,-104
43,11,-29,-11,-88,-78,-48,-29,-229
2,29,-8,-18,-14,-25,-5,50,11
-2,11,-24,-44,-119,-44,-73,-27,-322
-48,32,-94,-140,-61,-10,-68,16,-373
69,68,-11,-70,-44,-107,-60,-43,-198
63,50,-6,-48,-84,-98,-68,-39,-230
8,6,-4,-42,-81,45,-26,44,-50
-13,0,-3,-48,-87,-24,-38,9,-204
-18,-15,-23,-63,-70,-35,-28,-14,-266
-13,-9,-16,-33,-51,-24,-17,-1,-164
-32,-4,-54,-91,-52,-48,-48,-30,-359
56,46,-83,-188,-208,-210,-153,-182,-922
51,10,-8,-25,-183,-122,-95,-48,-420
3,41,-30,-154,-84,-85,-101,49,-361
13,19,-19,-14,-44,-1,-13,33,-26
-7,7,-25,-28,-27,-2,-13,5,-90
6,2,6,-12,-19,-2,-18,-24,-61
21,-22,-29,-43,-201,-106,-108,-55,-543
-35,-18,-43,-56,-61,-18,-53,1,-283
16,-8,-22,-35,-94,-77,-65,-51,-336
-51,-14,-47,-114,-60,-20,-44,-18,-368
-35,-42,-48,-70,-122,-65,-82,-44,-508
3,-15,-23,-26,-43,-26,-23,-18,-171
55,-15,-46,-131,-195,-185,-165,-99,-781
-24,1,-33,-50,-31,4,-28,-7,-168
-20,-13,-55,-66,-41,-45,-55,11,-284
-3,-2,-22,-60,-60,-59,-48,48,-206
47,42,-16,-24,-52,-33,-44,27,-53
14,1,-4,-17,-60,-29,-25,3,-117
25,2,-8,-14,-15,-14,-28,33,-19
-30,-6,-40,-60,-47,-30,-66,14,-265
-1,12,-1,-10,-40,-33,-22,-17,-112
-80,-22,-99,-166,-124,-95,-141,-45,-772
9,1,-1,-20,-57,-14,-34,36,-80
-5,-7,-5,-44,-44,-14,-41,54,-106
8,-14,-4,-8,-76,-41,-33,-15,-183
-61,-32,-90,-124,-166,-89,-171,-34,-767
-41,4,-34,-127,-78,-26,-54,-26,-382
-48,-39,-32,-72,-101,-53,-69,17,-397
3,8,-3,-24,-14,9,-6,24,-3
-23,-7,-30,-56,-76,-40,-48,-7,-287
-27,-12,-23,-62,-68,-30,-53,-1,-276
-95,12,-113,-135,-23,17,-27,-32,-396
-14,5,-34,-65,-50,-43,-34,-27,-262
6,-53,-27,-33,-86,-43,-73,17,-292
4,14,-32,-63,-125,-46,-45,-32,-325
-14,6,-27,-35,-18,-23,-28,3,-136
-39,-38,-22,-61,-82,-51,-68,15,-346
19,-12,19,-15,-119,-34,-44,24,-162
25,-16,-26,-54,-188,-98,-110,-70,-537
-13,45,-46,-89,-17,-58,-48,-14,-240
-32,-9,-28,-56,-31,-30,-24,-10,-220
-61,6,-71,-95,-45,-17,-51,11,-323
-40,1,-29,-53,-25,-8,-36,0,-190
-2,-12,-40,-68,-78,-54,-21,-15,-290
-20,15,-86,-149,-176,-140,-125,-65,-746
-4,-12,-29,-75,-149,-101,-83,9,-444
16,1,-3,-27,-103,-57,-50,14,-209
1,2,-34,-34,-44,-13,-37,-37,-196
-1,-4,-49,-89,-58,-83,-54,-49,-387
-84,30,-84,-151,-54,-77,-86,6,-500
-19,16,-26,-35,-35,-9,-28,-3,-139
110,63,18,-36,-92,-118,-74,-16,-145
13,21,-16,-65,-101,-87,-60,-14,-309
-7,1,-18,-29,-20,-7,-16,6,-90
2,19,-8,-30,-45,-16,-6,6,-78
12,-1,-21,-50,-94,-81,-77,-21,-333
-3,28,-58,-52,-143,-58,-106,-41,-433
9,32,-9,-69,-87,-44,-79,88,-159
14,-7,-28,-70,-101,-81,-56,-32,-361
-21,-26,-10,-37,-70,-19,-39,-6,-228
17,-11,10,8,-62,-26,-28,-2,-94
-29,-9,-37,-78,-57,-44,-71,-53,-378
-16,-42,-39,-96,-138,-92,-71,7,-487
-6,30,-3,-28,-43,-23,-10,-1,-84
-43,11,-44,-79,-39,-29,-79,24,-278
37,-13,-25,-43,-133,-118,-76,-41,-412
-16,13,-54,-118,-139,-24,-73,-7,-418
13,3,0,-32,-72,-70,-61,-31,-250
1,0,-24,-32,-85,-26,-50,-9,-225
-11,-17,-26,-73,-107,-64,-54,-2,-354
-3,5,-61,-53,-82,-24,-35,-38,-291
3,-2,-20,-17,-36,-21,-29,5,-117
1,-10,-31,-78,-84,-28,-55,-13,-298
-7,-1,-3,-50,-91,-64,-29,-21,-266
-12,-18,-59,-107,-148,-81,-94,-27,-546
46,27,-12,-86,-108,-70,-74,41,-236
-3,5,-22,-40,-18,-22,-36,-21,-157
5,-23,-5,-32,-127,-87,-78,-31,-378
-2,43,1,-45,-37,1,-35,58,-16
8,-19,13,-22,-39,-31,-51,80,-61
30,-17,-33,-22,-130,-93,-93,-81,-439
-1,17,-56,-53,-74,-50,-81,-63,-361
-6,-2,-178,-183,-170,-180,-253,-168,-1140
6,41,-9,-36,-19,7,-2,25,13
6,23,-10,-7,-35,-3,-12,40,2
-1,-6,-4,-14,-56,-32,-31,6,-138
-1,19,-31,-55,-27,-58,-48,-35,-236
2,7,-14,-41,-45,-37,-10,20,-118
-41,6,1,-106,-126,-62,-82,-15,-425
-5,-23,-41,-49,-68,-43,-51,-19,-299
33,1,-10,-32,-42,-41,-19,-32,-142
-40,8,-15,-32,-31,0,-42,26,-126
13,-13,-4,-38,-143,-77,-71,-19,-352
-3,16,-19,-59,-47,-1,-8,9,-112
10,27,-11,-45,-58,-75,-40,-6,-198
8,1,4,-37,-64,-34,-27,-1,-150
18,-5,-2,-41,-151,-85,-48,-41,-355
-14,-4,-20,-38,-17,-11,-24,14,-114
12,17,-16,-10,-23,2,2,0,-16
28,3,-22,-51,-96,-75,-66,-69,-348
-2,10,-20,-42,-46,-43,-28,-13,-184
18,-26,-31,-43,-97,-64,-50,-23,-316
-25,10,-37,-95,-56,-68,-70,-12,-353
-16,-28,-84,-109,-187,-107,-149,-38,-718
-40,-23,-36,-81,-64,-42,-82,-11,-379
45,39,27,-88,-152,-154,-100,-37,-420
14,4,3,-30,-84,-29,-35,3,-154
-15,-3,-16,-50,-49,-27,-28,-4,-192
18,-33,-29,-49,-109,-77,-69,-19,-367
4,-15,-17,-9,-45,-38,-24,12,-132
-3,3,5,-67,-101,-78,-52,10,-283
-29,-3,-18,-81,-58,-63,-65,-48,-365
1,31,-13,-54,-36,-34,-48,21,-132
-12,1,-21,-41,-38,-38,-20,3,-166
-3,-26,-16,-21,-116,-61,-71,-31,-345
-49,-14,-100,-211,-262,-177,-208,-200,-1221
17,-5,-9,-11,-78,-48,-32,-26,-192
-19,-24,-45,-57,-59,-42,-62,-28,-336
16,-5,1,-7,-76,-25,-37,-13,-146
64,-12,-4,-26,-148,-126,-77,-34,-363
-27,27,-34,-68,-21,-39,-37,-6,-205
-23,19,-41,-96,-47,-82,-48,-20,-338
-19,12,-30,-73,-67,-83,-71,-41,-372
-24,-1,-25,-43,-29,-19,-42,-19,-202
-9,4,-67,-120,-128,-77,-83,-26,-506
-5,7,-1,-21,-51,-19,-29,-2,-121
-22,4,-24,-36,-23,-27,-25,-12,-165
-126,-17,-222,-298,-196,-148,-247,44,-1210
-41,30,-26,-59,-48,-29,-45,-8,-226
-20,8,-16,-72,-71,-34,-37,-3,-245
-33,-14,-25,-47,-36,4,-38,10,-179
102,51,39,8,-181,-110,-72,-77,-240
5,-30,-31,-69,-123,-89,-83,-34,-454
4,-2,-13,-7,-29,-15,-35,-25,-122
16,-2,-23,-64,-146,-118,-88,-22,-447
-31,-32,-28,-60,-58,-28,-53,7,-283
-95,13,-141,-237,-174,-136,-158,10,-918
-12,22,-26,-64,-85,-17,-65,20,-227
-29,-2,-56,-85,-84,-26,-36,-30,-348
-7,10,-36,-56,-81,-68,-69,-7,-314
-4,51,-80,-155,-92,-67,-98,-13,-458
27,14,-13,18,-75,-27,-35,-2,-93
-30,4,-74,-152,-162,-123,-118,-15,-670
12,28,10,-46,-78,-16,-45,39,-96
15,0,-12,-33,-89,-58,-51,-15,-243
24,6,-22,-69,-133,-107,-104,-50,-455
1,-15,-8,-9,-62,-14,-24,4,-127
36,40,-20,-38,-52,-64,-59,-21,-178
-38,-20,-84,-137,-182,-88,-145,-39,-733
22,28,-13,-41,-77,-37,-56,-6,-180
23,0,3,-17,-39,-19,-14,-5,-68
-25,-9,-27,-67,-50,-20,-36,-31,-265
29,0,-15,-18,-126,-73,-56,-16,-275
-12,5,-12,-15,-30,3,-15,25,-51
-32,10,-44,-83,-81,-52,-65,-16,-363
11,-3,-9,-60,-125,-95,-75,-53,-409
-2,3,-35,-34,-93,-58,-65,-21,-305
-5,7,-32,-42,-61,-15,-35,10,-173
-22,9,-16,-35,-44,-30,-24,-12,-174
-34,-2,-88,-182,-93,-58,-112,42,-527
-94,8,-107,-204,-167,-72,-165,-15,-816
10,-14,-7,-86,-11,-84,-75,15,-252
-46,2,-62,-107,-57,-37,-33,-53,-393
-38,-26,-34,-75,-94,-50,-52,0,-369
8,4,-14,-28,-51,-26,-31,5,-133
63,-10,31,-32,-64,-50,-51,60,-53
20,27,-15,-76,-108,-98,-55,-88,-393
4,-27,-34,-54,-76,-63,-50,-23,-323
-26,7,-33,-81,-88,-32,-51,17,-287
14,1,-18,-24,-63,-41,-35,-13,-179
9,4,-3,-38,-53,-34,-26,0,-141
25,19,-31,-34,-57,-68,-59,-46,-251
28,19,-8,-46,-9,-69,-35,-5,-125
-10,-2,-16,-36,-43,-6,-24,11,-126
-13,-1,-28,-14,-35,1,-22,10,-102
20,9,-32,-86,-200,-93,-94,-57,-533
6,3,-27,-25,-34,-21,-21,-38,-157
33,11,4,-95,-161,-113,-93,-43,-457
20,30,-8,-42,-118,-79,-53,-13,-263
28,-1,-14,-29,-125,-40,-68,9,-240
-19,-5,-41,-97,-47,-65,-71,-16,-361
5,-4,-24,-76,-175,-41,-71,-50,-436
-6,8,-60,-112,-153,-101,-127,-29,-580
62,5,-6,13,-159,-68,-88,15,-226
-20,-18,-29,-80,-31,-33,-41,29,-223
-7,-3,-14,-38,-90,-61,-32,14,-231
-25,-8,-38,-67,-63,-59,-42,-10,-312
-26,-10,-33,-63,-39,-22,-13,12,-194
-9,16,-33,-75,-20,2,-19,14,-124
16,-2,-62,-70,-34,-40,-86,33,-245
-31,-39,8,-44,-57,-50,-35,30,-218
37,-2,-21,-15,-68,-54,-44,-47,-214
16,-8,-25,0,-45,3,-15,10,-64
14,-8,-13,-25,-81,-42,-50,-34,-239
-12,0,-14,-40,-26,-38,-33,-13,-176
-67,8,-72,-119,-52,-31,-55,-29,-417
32,-16,35,-30,-93,-60,-57,2,-187
25,12,-12,-5,-93,-17,-46,4,-132
-22,9,-4,-37,-64,-17,-39,23,-151
-37,-13,-36,-81,-64,-47,-65,-7,-350
-27,-44,-33,-62,-101,-48,-47,-41,-403
-58,18,-46,-133,-80,-70,-76,10,-435
-17,18,-65,-94,-43,-16,-54,-62,-333
70,29,14,-5,-21,-68,-54,32,-3
-2,16,-59,-146,-199,-162,-174,6,-720
84,-44,0,97,-166,-76,-55,-51,-211
25,-6,4,-36,-117,-67,-63,-27,-287
40,-52,-11,-43,-202,-103,-96,-41,-508
93,145,72,18,-168,30,-68,48,170
-59,-1,-51,-96,-60,-19,-51,10,-327
31,-6,-2,-99,-81,-86,-81,-14,-338
-13,60,-80,-128,-53,-52,-67,36,-297
-35,4,-41,-83,-71,-15,-34,25,-250
8,18,-12,-19,-87,-15,-43,-18,-168
0,-19,-10,5,-52,-21,-32,35,-94
-9,12,-21,-58,-29,-36,-28,28,-141
-1,11,-14,-48,-30,-23,-32,22,-115
-23,-2,-27,-69,-86,-23,-58,-2,-290
-41,-25,-36,-93,-58,-56,-40,12,-337
19,-8,-29,-13,-134,-39,-42,-16,-262
-61,10,-43,-147,-92,-32,-38,-6,-409
-37,0,-36,-91,-98,-31,-71,-4,-368
3,-34,-48,-81,-176,-148,-89,-80,-653
-17,-5,-31,-28,-46,-16,-32,-7,-182
-11,-18,-60,-94,-196,-108,-104,-31,-622
-10,32,-46,-102,-47,-69,-68,-63,-373
23,17,-40,-45,-72,-91,-79,-83,-370
47,-19,-2,-4,-126,-79,-43,-27,-253
63,7,-1,-8,-138,-73,-48,-8,-206
-4,-12,-16,-53,-105,-64,-66,0,-320
24,19,-7,-22,-120,-37,-54,-18,-215
-69,-39,-132,-190,-209,-101,-148,-64,-952
-8,12,-22,-29,-30,-4,-21,2,-100
-20,14,-14,-45,-36,-1,-29,23,-108
-51,21,-34,-118,-58,-41,-50,0,-331
-23,13,-53,-105,-65,-59,-91,-53,-436
12,29,-18,-77,-15,-43,-73,-11,-196
-19,-10,-58,-75,-76,-25,-37,33,-267
-14,10,-40,-67,-23,-37,-40,-28,-239
26,-7,-20,-34,-54,-59,-45,-31,-224
-30,-23,-32,-67,-94,-27,-50,-11,-334
13,-14,-1,-53,-181,-51,-90,-1,-378
-21,5,-20,-28,-32,-15,-17,-11,-139
-34,23,-20,-95,-62,-70,-63,29,-292
-44,-13,-43,-99,-37,-31,-45,-40,-352
-10,-25,-18,-7,-72,-8,-38,-12,-190
-33,32,-27,-76,-81,-56,-40,2,-279
9,50,-29,-36,-85,-65,-21,16,-161
28,-10,-31,-40,-193,-88,-102,-66,-502
14,31,-23,-99,-80,-89,-90,44,-292
22,-15,-37,-48,-90,-72,-74,-26,-340
-83,-24,-123,-196,-166,-123,-123,-37,-875
-22,-13,-23,-26,-52,-17,-37,10,-180
-16,-18,-40,-87,-89,-36,-46,-11,-343
-8,6,-25,-25,-32,-12,-16,25,-87
29,0,-1,-10,-55,-47,-38,-3,-125
-20,-13,-14,-48,-53,-10,-36,-31,-225
55,4,13,8,-37,-35,-32,-19,-43
-15,20,-32,-34,-14,-4,-27,5,-101
2,15,-16,-24,-43,28,-34,9,-63
-22,-17,-27,-95,-102,-85,-86,-12,-446
-24,4,-26,-57,-63,-20,-50,-15,-251
-41,24,-65,-120,-71,-37,-66,2,-374
7,45,6,-32,-20,-39,-34,50,-17
22,-20,-22,-62,-128,-129,-81,-35,-455
-27,5,-27,-60,-49,-39,-45,7,-235
-68,-11,-105,-166,-181,-84,-188,-13,-816
-20,-3,-47,-76,-39,-41,-60,-33,-319
-6,6,-33,-59,-54,-34,-39,-15,-234
2,39,1,-49,-28,-38,-15,48,-40
9,6,-27,-86,-89,-118,-76,-44,-425
20,12,14,4,-62,-15,-61,37,-51
-45,-48,-91,-96,-130,-87,-121,-76,-694
22,-6,-36,-59,-175,-74,-90,-35,-453
-32,8,-48,-69,-29,-14,-37,13,-208
-46,-7,-24,-62,-61,-37,-47,-1,-285
-2,-1,-12,-30,-19,-15,-5,11,-73
4,0,-20,-58,-19,-13,11,17,-78
39,52,16,-33,-116,-40,-69,45,-106
-73,15,-95,-171,-109,-57,-122,-46,-658
-11,5,-21,-79,-17,-50,-34,-38,-245
8,17,-6,-42,-94,-28,-28,5,-168
18,23,14,8,-64,36,5,35,75
-19,-19,-31,-85,-96,-63,-59,-53,-425
0,9,-26,-52,-42,-46,-49,-21,-227
23,31,12,-12,-11,14,-7,39,89
12,-9,-26,-30,-129,-2,-68,47,-205
-77,-43,-47,-107,-62,-46,-48,2,-428
31,-1,-19,-26,-108,-80,-48,-51,-302
58,80,9,-3,-45,-1,-38,58,118
2,-11,-9,-11,-34,-3,-10,9,-67
-51,17,-78,-160,-88,-70,-95,-62,-587
-30,-3,-40,-113,-71,-72,-51,-5,-385
-10,8,-31,-27,-28,-13,-12,10,-103
-28,-6,-26,-32,-38,-22,-41,3,-190
1,1,-36,-64,-61,-83,-50,-29,-321
32,-26,-32,-156,-101,-175,-142,-43,-643
-3,7,6,-33,-29,-14,-19,32,-53
-9,13,-25,-51,-5,2,2,-10,-83
-32,20,-55,-118,-108,-29,-61,-42,-425
-6,8,-21,-73,-134,-102,-84,-34,-446
-51,-26,-34,-64,-81,-3,-26,10,-275
12,-23,-22,-74,-201,-164,-136,-88,-696
-23,-48,-72,-150,-271,-190,-176,-114,-1044
18,8,-23,-9,-94,-71,-66,21,-216
-12,15,-17,-26,-8,-19,-28,16,-79
59,11,-23,-48,-160,-134,-114,-73,-482
-13,12,-12,-108,-135,-72,-42,12,-358
-6,10,-8,-3,-44,2,-26,5,-70
-29,5,-44,-75,-37,-29,-43,-24,-276
26,-5,-2,-30,-71,-89,-51,-47,-269
7,5,-5,-41,-48,-25,-27,4,-130
18,-5,-14,-3,-104,-54,-62,-26,-250
-8,-11,-3,-21,-54,-35,-38,-16,-186
-54,15,-90,-142,-69,-35,-69,-21,-465
8,-7,-21,-58,-63,-33,-43,-12,-229
-58,19,-24,-125,-79,-50,-63,67,-313
-20,-6,-21,-34,-47,-21,-36,21,-164
-7,-2,-30,-27,-29,-18,-20,3,-130
6,8,-20,-43,-76,-29,-36,-2,-192
-16,10,-21,-75,-75,-22,-81,27,-253
-55,7,-66,-139,-77,-66,-47,-14,-457
26,-33,7,-34,-97,-54,-47,-20,-252
9,-11,-52,-76,-100,-103,-71,-43,-447
-57,18,-85,-198,-127,-82,-99,24,-606
-27,8,-31,-85,-76,-50,-61,-2,-324
20,16,-16,-44,-85,-50,-45,-24,-228
-8,3,-38,-54,-77,-30,-66,-12,-282
-129,-60,-104,-167,-87,-17,-57,21,-600
-33,6,-20,-98,-146,-69,-89,-29,-478
-4,16,-24,-50,-8,-9,-23,16,-86
10,-21,-22,-40,-87,-57,-62,-31,-310
19,-17,-26,-67,-166,-101,-90,-28,-476
10,16,-38,-101,-115,-99,-89,-72,-488
20,1,-17,-25,-61,-50,-40,-34,-206
9,21,-19,-37,-58,-61,-43,-6,-194
-37,0,-56,-83,-34,1,-19,22,-206
16,5,-25,-39,-92,-62,-52,-47,-296
35,11,-7,-33,-92,-63,-41,-31,-221
-10,19,-1,-67,-55,-30,-40,-15,-199
-53,-21,-48,-125,-65,-63,-76,-19,-470
7,35,-14,-12,-15,-2,0,5,4
-15,7,-28,-44,-78,-56,-59,-36,-309
2,33,-20,-49,-70,-58,-65,18,-209
-8,20,-31,-39,-19,-29,-32,-8,-146
-4,-53,-56,-165,-290,-163,-183,-87,-1001
-17,7,-3,-57,-24,-4,-6,55,-49
-8,5,-12,-22,-20,33,-10,-14,-48
10,19,-22,-66,-89,-81,-62,-2,-293
19,-19,-42,-117,-208,-156,-87,-89,-699
5,0,-38,-92,-118,-111,-87,-57,-498
3,20,-27,-98,-110,-54,-62,-30,-358
-34,16,-68,-94,-76,-37,-56,1,-348
-17,19,-19,-56,-14,-10,-50,-40,-187
5,4,-19,-40,-77,-86,-54,-19,-286
-25,0,-30,-39,-31,-19,-25,22,-147
-21,9,-82,-226,-117,-160,-157,-62,-816
-29,8,-14,-76,-67,-21,-54,8,-245
29,44,28,36,-47,-41,-59,38,28
-24,-1,-26,-76,-77,-29,-44,3,-274
-23,9,-26,-48,-31,-13,-30,17,-145
-38,-43,-13,-85,-114,-32,-61,51,-335
15,14,-30,-62,-87,-46,-64,-14,-274
13,-15,3,-17,-99,-46,-27,-6,-194
-8,1,-31,-111,-117,-69,-69,-12,-416
-24,8,-28,-66,-121,-55,-85,-15,-386
17,0,-19,-12,-75,-50,-51,-38,-228
-15,33,-37,-94,-75,-73,-48,-25,-334
42,24,9,17,-40,-34,-43,3,-22
-16,-30,-12,-72,-94,-73,-41,-27,-365
9,26,4,-25,-10,18,-21,16,17
7,14,-23,-30,-85,-42,-49,15,-193
-10,2,-24,-32,-35,6,-3,1,-95
-37,18,-37,-94,-47,-47,-51,27,-268
-6,26,-26,-67,-5,-54,-44,-21,-197
-36,-14,-89,-103,-76,-30,-53,-15,-416
-9,10,-12,-66,-43,-24,-51,-47,-242
-2,-2,-17,-50,-69,-60,-32,-8,-240
-62,22,-65,-158,-100,-49,-73,12,-473
-4,-1,-30,-42,-32,-16,-14,-12,-151
17,-10,-22,-22,-68,-74,-54,-46,-279
-14,0,-22,-64,-63,-24,-37,-5,-229
-12,-2,-14,-28,-44,-14,-36,17,-133
-15,-1,-32,-41,-70,-43,-44,5,-241
-8,-11,-9,-47,-22,-26,-31,-10,-164
-17,-12,-19,-80,-134,-62,-74,-21,-419
-11,23,-19,-43,-78,-16,-62,3,-203
-44,-18,-65,-64,-69,-25,-59,-3,-347
-10,18,-7,-48,-72,-71,-50,-1,-241
19,12,-13,-7,-67,-47,-44,-25,-172
-56,-39,-113,-260,-268,-229,-227,-106,-1298
-20,6,-23,-34,-12,-7,-14,9,-95
-7,12,-45,-63,-36,-54,-74,-3,-270
-12,1,-26,-62,-48,-56,-35,-35,-273
-16,-6,-27,-50,-77,-76,-61,-46,-359
33,-2,-34,-54,-107,-79,-70,-43,-356
7,18,-12,-43,-58,-47,-27,-7,-169
2,14,-7,-14,-76,-13,-45,-22,-161
-31,-13,-37,-61,-54,-28,-63,7,-280
1,-9,-14,-77,-79,-47,-45,-30,-300
-17,27,-51,-128,-27,-97,-61,-54,-408
-52,0,-29,-89,-66,-27,-55,-4,-322
23,-26,-18,-33,-119,-81,-77,-51,-382
-11,5,-11,-112,-118,-46,-55,4,-344
16,11,-5,-41,-63,-28,-39,-25,-174
-1,24,-7,-64,-84,-39,-64,36,-199
-17,-23,-44,-97,-81,-72,-69,-48,-451
14,1,-22,-48,-151,-52,-80,-22,-360
-18,-2,-24,-50,-61,-65,-40,10,-250
-8,11,-31,-79,-98,-103,-64,-50,-422
-58,-35,-69,-94,-98,-43,-104,-13,-514
-12,-5,-13,-25,-36,-26,-27,-3,-147
27,-2,-28,-60,-136,-99,-70,-49,-417
-117,-29,-141,-258,-226,-178,-278,-83,-1310
50,30,4,0,-76,-18,-58,100,32
11,41,3,0,0,-6,-28,26,47
22,10,-12,10,-53,-50,-30,7,-96
-27,-14,-21,-85,-49,-40,-26,-8,-270
11,4,-14,-35,-62,-15,-41,-5,-157
52,6,22,-14,-78,-63,-65,-11,-151
-25,-13,-57,-85,-137,-63,-79,33,-426
6,-23,-17,-44,-40,-25,-35,-8,-186
-12,4,-25,-32,-32,-1,-7,33,-72
-29,9,-39,-56,-16,-15,-32,14,-164
-23,-26,-35,-46,-105,-36,-73,-5,-349
21,29,-13,-39,-70,-50,-72,-18,-212
-11,15,-21,-67,-48,-44,-21,23,-174
-33,-2,-27,-51,-17,-13,-16,0,-159
-9,-8,-31,-87,-100,-79,-89,-28,-431
10,18,-12,-25,-47,-44,-29,-14,-143
2,4,-39,-40,-32,-25,-32,10,-152
-42,14,-64,-117,-45,-52,-60,-22,-388
-29,2,-43,-69,-66,-48,-42,-12,-307
-36,-11,-44,-98,-89,-78,-64,-40,-460
-17,1,-31,-81,-65,-56,-43,5,-287
26,14,1,-34,-78,-82,-47,-33,-233
38,-4,-41,-65,-98,-112,-66,-94,-442
-10,11,3,-49,-38,-2,-49,33,-101
55,-30,5,-21,-148,-80,-97,119,-197
-39,-11,-40,-85,-66,-56,-59,9,-347
-27,-7,-36,-54,-106,-41,-43,12,-302
-17,35,-36,-108,-80,-70,-66,-27,-369
-16,22,-15,-53,-29,-17,-12,-2,-122
-15,-11,-5,-71,-35,-38,-62,24,-213
-49,58,-48,-159,-57,-86,-73,-64,-478
-41,-29,-24,-86,-77,-36,-54,-19,-366
34,-12,-22,-7,-100,-76,-61,-4,-248
-6,-9,-26,-38,-31,-10,-42,7,-155
-45,44,-65,-150,-50,-59,-58,32,-351
-5,32,-18,-37,-52,-21,-20,29,-92
-4,-4,-21,-54,-63,-39,-17,-11,-213
5,5,-4,-33,-64,4,-14,28,-73
14,18,-5,2,-9,-17,-19,7,-9
7,16,-10,-27,-38,-22,-21,8,-87
-114,-30,-107,-257,-186,-82,-135,-23,-934
-25,-21,-22,-41,-53,-19,-28,9,-200
27,11,-12,2,-43,-39,-8,9,-53
23,-9,12,-17,-99,-63,-60,-12,-225
-20,35,-42,-104,-59,-90,-84,-33,-397
66,30,-4,-62,-125,-101,-51,23,-224
-48,11,-68,-148,-151,-72,-117,27,-566
-53,-35,-55,-157,-172,-117,-108,-41,-738
-6,4,-18,-35,-23,-17,-14,-1,-110
-16,31,-33,-42,-39,-4,-5,34,-74
6,-28,-45,-62,-103,-66,-69,-47,-414
-18,44,-50,-124,-131,-100,-100,-33,-512
16,-20,-2,1,-84,-66,-73,14,-214
5,43,-7,-43,-25,-41,-14,43,-39
-3,12,-51,-75,-136,-39,-66,-17,-375
-24,-25,-48,-58,-90,-58,-70,-27,-400
-38,-15,-8,-60,-39,5,-28,35,-148
107,7,2,-39,-241,-184,-105,-99,-552
-1,1,-6,-23,-46,-15,-25,18,-97
-28,59,-85,-158,-84,-62,-114,108,-364
10,25,-25,-63,-39,-51,-50,18,-175
50,38,-18,3,-82,-31,-57,-4,-101
-2,-9,8,-18,-101,-31,-60,11,-202
-14,17,-23,-47,-25,-24,-22,-2,-140
-13,-4,2,-53,-66,-24,-31,-1,-190
2,-2,0,9,-78,-34,-41,-8,-152
-15,-13,-34,-46,-75,-49,-54,-24,-310
-49,-23,-89,-181,-174,-124,-164,-95,-899
1,6,-10,-23,-19,16,-3,5,-27
-17,51,-46,-109,-12,30,-22,53,-72
10,1,-29,-37,-86,-49,-49,-3,-242
-5,-31,-24,-39,-53,5,-22,93,-76
56,11,-23,-17,-56,-22,-78,-11,-140
-28,-2,-33,-46,-51,-44,-37,-11,-252
-17,-2,-24,-49,-57,-17,-34,-8,-208
-7,21,-19,-47,-39,-34,-29,-10,-164
-37,13,-72,-78,-36,-9,-71,40,-250
-13,-14,-36,-88,-69,-61,-77,-4,-362
62,-3,2,-85,-214,-170,-101,-72,-581
14,8,-6,-30,-75,-35,-34,-20,-178
-11,-5,-13,-36,-58,4,-29,22,-126
-51,-10,-50,-72,-48,-36,-60,-8,-335
-15,7,-17,-53,-60,-36,-56,9,-221
4,-24,9,-22,-101,-24,-49,-14,-221
-33,10,-34,-82,-78,-33,-79,26,-303
-17,14,-27,-59,-115,-72,-64,34,-306
25,10,-25,-88,-106,-125,-81,-28,-418
-24,28,-40,-70,-33,-54,-78,-29,-300
0,11,-2,-47,-78,-31,-39,5,-181
9,42,-46,-66,-74,-79,-66,-48,-328
6,-13,-24,-22,-44,-34,-29,-4,-164
-18,-18,-26,-83,-69,-46,-28,-20,-308
3,9,-40,-37,-71,-49,-31,-25,-241
-81,-1,-77,-178,-123,-88,-84,-39,-671
21,-11,-23,-30,-80,-68,-54,-28,-273
36,-1,-19,-5,-85,-45,-45,-34,-198
-5,12,-9,-17,-35,-3,-18,14,-61
94,19,13,-27,-192,-141,-112,-35,-381
-8,-1,-8,-53,-84,-57,-53,-38,-302
-34,-54,-78,-96,-111,-85,-96,-54,-608
-48,3,-56,-131,-102,-55,-72,13,-448
-42,-40,-30,-64,-68,-31,-37,-3,-315
-45,2,-39,-75,-47,-38,-45,-17,-304
-7,-11,-11,-53,-85,-23,-55,1,-244
4,13,-7,-32,-76,-69,-44,-23,-234
-16,-21,-22,-34,-47,-26,-45,-32,-243
-17,13,-27,-79,-88,-44,-69,-6,-317
-9,8,-25,-92,-84,-93,-52,-30,-377
39,28,-1,-54,-106,-72,-86,-25,-277
-21,-14,-56,-109,-80,-54,-63,-29,-426
22,-8,-17,-41,-114,-76,-56,-12,-302
8,20,-33,-28,-36,-16,-24,-8,-117
-18,-12,-25,-38,-93,-25,-63,-25,-299
-10,-4,-12,-18,-33,-28,-16,-4,-125
16,-8,-39,-97,-144,-124,-89,-75,-560
-4,27,-35,-34,-52,-28,-36,-7,-169
-54,140,-100,-155,-73,-35,-136,-10,-423
18,12,-28,-81,-92,-82,-95,-66,-414
-1,-31,-18,-40,-85,-31,-49,5,-250
5,-11,-9,-13,-49,-29,-32,-9,-147
-30,-25,-115,-135,-181,-82,-147,-47,-762
30,-13,17,-76,-121,-70,-55,-20,-308
55,24,-1,-20,-87,-58,-10,28,-69
-5,22,-31,-41,-21,-50,-34,0,-160
4,17,-70,-208,-159,-129,-128,-70,-743
-39,-1,-43,-104,-14,-74,-42,-37,-354
-42,20,-43,-124,-20,-80,-51,-22,-362
-41,19,-53,-36,-25,17,3,-6,-122
8,20,-27,-28,-115,-7,-66,-9,-224
14,-32,-13,-17,-52,-29,-18,5,-142
-62,-24,-53,-135,-121,-60,-78,7,-526
-4,10,-28,-85,-105,-90,-61,-30,-393
-7,19,-45,-78,-136,-69,-81,-11,-408
-28,8,-40,-59,-69,-44,-69,8,-293
-27,19,-53,-93,-88,-23,-63,-9,-337
-45,29,-39,-142,-68,-48,-35,26,-322
-13,33,-38,-88,-76,-66,-61,1,-308
-34,-2,-74,-112,-52,-41,-52,-32,-399
21,9,-10,-28,-105,-69,-62,2,-242
1,4,-8,-13,-5,-1,-4,-8,-34
8,-14,-7,-15,-38,-7,-20,-2,-95
-23,2,-36,-63,-44,-36,-57,-20,-277
26,-27,-16,-71,-188,-112,-89,-20,-497
11,-27,-3,-33,-33,-27,-23,1,-134
66,28,-36,-27,-138,-122,-89,-63,-381
-14,2,-28,-52,-56,-55,-52,-23,-278
-2,17,-10,-80,-149,-78,-55,-11,-368
-50,37,-22,-96,-112,-63,-59,12,-353
74,54,-5,-39,-75,-26,-64,65,-16
-6,-8,-26,-46,-50,-67,-64,-8,-275
49,-17,-4,-93,-135,-123,-67,-56,-446
28,-7,-28,-42,-129,-109,-82,-83,-452
-18,19,-25,-70,-60,-26,-47,17,-210
17,2,-15,-18,-86,-61,-52,-12,-225
6,27,-17,-103,-150,-98,-85,15,-405
39,21,-26,-29,-109,-76,-59,-56,-295
5,24,35,-17,-73,32,-26,52,32
6,23,-8,-51,-81,-70,-54,10,-225
12,4,-23,-101,-46,-82,-58,-34,-328
53,-32,3,-42,-132,-112,-68,-38,-368
-69,-26,-70,-184,-132,-132,-111,-68,-792
11,-9,-20,-24,-106,-53,-51,-36,-288
25,-18,-29,-76,-161,-144,-110,-29,-542
-5,-22,2,-79,-120,-65,-70,-28,-387
4,0,-14,-83,-85,-95,-68,-47,-388
74,11,-15,-34,-222,-143,-116,-87,-532
-3,-18,-14,-23,-67,-34,-49,-14,-222
-96,2,-103,-172,-43,-46,-66,27,-497
39,14,-20,-97,-225,-124,-71,-62,-546
9,9,-13,-18,-30,-11,-9,19,-44
31,4,1,-29,-107,-65,-70,-18,-253
-54,6,-34,-145,-88,-85,-80,-11,-491
60,-17,-12,-22,-161,-108,-57,-24,-341
-1,35,14,-20,-39,13,-14,32,20
29,14,-14,-39,-79,-24,-9,-17,-139
