protein-water,protein-carbon,hydrogen bond (long-range),pi-pi (long-range),disorder (long),K-Beta similarity,disorder (short),electrostatic (short-range),8-feature sum
-1,-20,-30,-16,-36,-13,-40,21,-135
-9,-17,-20,3,-27,-8,-35,34,-79
-1,-18,-20,5,-36,-14,-22,25,-81
-2,-2,-29,16,-29,-18,-40,26,-78
4,2,-16,25,-20,9,-21,45,28
2,-1,-23,20,-26,-4,-37,29,-40
-5,-7,-37,2,-25,-16,-39,35,-92
14,-10,-28,9,-19,-11,-33,36,-42
12,-7,-8,17,-22,3,-29,42,8
-12,-12,-24,8,-28,-14,-37,27,-92
0,-21,-24,13,-15,9,-30,30,-38
-1,-12,-11,18,-18,-2,-43,39,-30
3,-12,-26,17,-26,13,-27,41,-17
-1,-6,-15,14,-20,2,-26,29,-23
9,-3,-19,27,-10,11,-28,44,31
-3,-9,-30,7,-31,-1,-25,22,-70
6,-13,-23,15,-32,-4,-23,26,-48
4,-10,-26,19,-24,-8,-24,30,-39
8,-5,-17,13,-22,0,-22,34,-11
5,-11,-23,9,-36,-10,-24,31,-59
0,-12,-21,4,-16,-6,-17,19,-49
-6,-20,-32,-8,-30,-13,-29,20,-118
-13,-11,-16,13,-25,-1,-16,19,-50
-18,-13,-22,1,-30,-7,-26,15,-100
-1,-8,-14,12,-25,-6,-30,33,-39
7,-4,-20,21,-24,-9,-18,36,-11
-5,-11,-18,19,-21,-5,-26,23,-44
2,-19,-24,9,-35,3,-34,41,-57
4,-10,-11,6,-25,-11,-22,41,-28
-3,-4,-5,-3,-1,-1,-4,0,-21
0,-12,-17,8,-28,-7,-27,33,-50
-5,-12,-21,7,-28,-6,-30,30,-65
-2,-12,-20,3,-30,-7,-26,25,-69
2,-6,-14,7,-22,2,-20,45,-6
-7,-13,-20,0,-30,-7,-28,32,-73
-2,-11,-25,13,-25,-5,-32,23,-64
-21,-21,-32,-14,-23,-14,-38,-1,-164
5,-11,-14,13,-17,-4,-7,28,-7
-4,-19,-14,10,-13,-4,-21,11,-54
-11,-26,-34,-10,-30,0,-32,15,-128
-1,-12,-14,12,-18,-7,-17,28,-29
-4,-19,-35,1,-29,-3,-29,17,-101
-4,-1,-5,1,-6,4,-6,6,-11
0,4,-3,0,-1,-2,-1,0,-3
0,-1,-2,-3,-4,0,-1,1,-10
1,-9,-11,19,-21,11,-9,16,-3
1,-11,-18,13,-29,5,-6,19,-26
0,-13,-28,22,-33,-14,-43,34,-75
-1,-23,-22,18,-36,1,-41,38,-66
-4,-12,-22,8,-24,0,-31,31,-54
-7,-13,-22,7,-30,-5,-37,21,-86
-1,-16,-29,-5,-25,-15,-33,12,-112
-6,-20,-30,-9,-28,3,-17,24,-83
-6,-18,-28,0,-13,-11,-14,8,-82
-10,-23,-27,-4,-36,7,-27,11,-109
-15,-26,-30,-16,-45,-17,-57,-4,-210
-12,-25,-36,-2,-32,-5,-30,11,-131
-532,83,-669,-249,-618,-591,-1095,424,-3247
4,-31,-36,-21,-56,-16,-30,44,-142
-8,-27,-33,0,-24,-5,-28,13,-112
-9,-78,-73,-16,-73,-98,-125,26,-446
0,-10,-11,7,-29,-3,-26,36,-36
-19,-16,-13,-12,-19,5,-16,29,-61
66,-49,-35,24,-21,-82,-58,47,-108
20,-36,-88,10,-48,12,-60,74,-116
-9,-79,-71,-13,-70,-97,-123,27,-435
-14,-12,-21,-10,-33,-15,-34,8,-131
-10,-76,-72,-16,-70,-98,-125,26,-441
-1,-87,-101,-80,-135,-93,-113,31,-579
-17,-79,-73,-22,-71,-98,-129,27,-462
-14,-19,-21,-6,-24,-3,-20,5,-102
-4,-10,-19,1,-24,7,-17,19,-47
100,-126,-182,-30,-156,-228,-286,136,-772
-17,-3,-12,-25,-15,-19,-22,-6,-119
-1,-29,-30,-16,-19,-23,-37,9,-146
2,-14,-16,10,-30,-7,-28,29,-54
-3,-12,-21,4,-29,-9,-37,25,-82
0,-9,-8,22,-31,-10,-42,30,-48
-1,-6,-14,13,-29,12,-21,29,-17
2,-22,-18,16,-19,-6,-14,22,-39
6,-9,-31,7,-23,-9,-11,28,-42
2,-17,-30,5,-31,-2,-31,29,-75
1,2,-5,-4,-5,-3,-5,6,-13
-2,-11,-12,-12,-9,-7,-8,10,-51
-1,-1,-2,-2,-1,0,-1,2,-6
-1,2,-2,-2,-2,1,-2,4,-2
0,0,-1,-2,0,2,2,2,3
-1,3,-3,-3,-4,0,-3,1,-10
-2,0,-1,-3,-1,-2,-3,1,-11
1,-1,-2,-1,-2,0,0,3,-2
6,-21,-14,18,-14,-1,-23,35,-14
0,-24,-19,6,-33,-19,-37,11,-115
-1,-14,-18,17,-11,0,-13,23,-17
4,-17,-24,17,-9,-9,-12,19,-31
-10,-22,-21,2,-24,-8,-23,19,-87
-6,-24,-22,-1,-20,-4,-20,23,-74
-14,-24,-28,-13,-28,-7,-32,6,-140
11,-28,-29,3,-35,0,-24,38,-64
-30,-14,-44,-26,-65,-33,-102,-6,-320
10,-11,-15,26,-35,-12,-39,42,-34
-18,-25,-31,4,-33,-4,-34,14,-127
-5,-7,-24,2,-34,-11,-37,14,-102
4,-29,-29,2,-31,-7,-27,33,-84
3,-5,-19,11,-21,-11,-13,21,-34
5,-10,-20,18,-31,-4,-35,37,-40
-17,-34,-46,-9,-37,-5,-26,14,-160
7,-11,-29,13,-30,-14,-21,27,-58
19,-17,-9,29,-2,3,-3,37,57
3,-8,-16,12,-29,-11,-28,33,-44
9,-6,-21,18,-25,-7,-18,32,-18
1,8,-6,22,-25,4,-31,39,12
4,-11,-22,13,-22,-12,-14,30,-34
-4,-18,-18,12,-31,-5,-34,30,-68
-2,-2,-3,-4,-4,-2,2,0,-15
8,-28,-26,6,-27,-13,-28,34,-74
-7,-13,-20,9,-33,-5,-25,16,-78
3,-24,-36,-9,-25,-14,-22,20,-107
-5,-6,-13,15,-10,3,-21,16,-21
-9,-18,-30,7,-17,6,-26,18,-69
-7,-19,-24,5,-24,0,-22,15,-76
5,-27,-18,11,-18,-4,-14,32,-33
-7,-21,-20,2,-30,-6,-33,25,-90
4,-9,-13,23,-17,-3,-29,22,-22
-8,-12,-18,9,-32,-5,-13,15,-64
0,-26,-30,-6,-32,-11,-22,26,-101
-13,-21,-25,4,-20,-7,-35,7,-110
-3,-22,-23,10,-22,-3,-14,32,-45
-12,-14,-17,-4,-27,3,-33,14,-90
-7,-14,-31,-4,-33,-7,-28,18,-106
0,-22,-24,1,-25,3,-21,27,-61
-6,-19,-20,13,-18,-8,-28,29,-57
-9,-20,-23,9,-22,1,-23,6,-81
-15,-1,-32,-4,-8,-7,-28,1,-94
-14,-18,-33,-12,-14,-14,-41,3,-143
-16,-2,-24,6,-24,-2,-32,12,-82
-13,-16,-21,-4,-9,2,-9,15,-55
-9,-15,-26,9,-26,-6,-22,22,-73
-10,-6,-28,7,-27,-14,-31,14,-95
5,-4,-12,12,-9,14,-9,30,27
2,-11,-13,18,-23,14,-4,21,4
38,-41,-61,-14,-77,-48,-53,19,-237
3,-8,-18,4,-29,-8,-37,28,-65
-4,-17,-19,-5,-31,-11,-19,21,-85
-13,-8,-9,3,-3,-6,-15,5,-46
-5,-86,-132,-46,-163,-148,-228,95,-713
11,-16,-19,14,-26,-8,-14,38,-20
5,-18,-26,4,-31,-1,-35,29,-73
-3,-9,-18,13,-34,-11,-39,21,-80
3,-14,-17,6,-24,0,-22,21,-47
-4,-21,-30,7,-27,-4,-32,15,-96
-8,-14,-23,12,-25,-6,-23,18,-69
15,-25,-19,16,-18,-10,-14,33,-22
6,-4,-20,14,-26,1,-19,25,-23
14,-21,-23,20,-16,-3,1,30,2
14,2,-6,30,-17,2,-20,32,37
7,-15,-25,7,-24,-12,-3,24,-41
2,-34,-26,12,-27,-4,-37,37,-77
14,2,-18,16,-26,-2,-19,32,-1
-1,-1,-24,10,-25,-3,-23,31,-36
10,-14,-11,13,-20,-3,-20,32,-13
3,-15,-25,6,-33,5,-16,31,-44
-5,-22,-24,11,-28,9,-42,43,-58
0,-4,-17,13,-31,-1,-28,38,-30
-11,-39,-37,-7,-35,-11,-27,16,-151
-6,-17,-23,5,-29,-8,-37,27,-88
-2,-2,-13,16,-17,-7,-25,24,-26
1,-3,-5,-4,-3,-3,-3,4,-16
-6,-12,-21,9,-27,-3,-37,28,-69
-5,-8,-12,6,-24,-7,-23,38,-35
-4,-10,-20,6,-31,-5,-34,25,-73
1,-4,-13,6,-26,-9,-34,28,-51
0,-11,-19,12,-31,-8,-24,35,-46
-7,-5,-3,-1,0,1,-4,-2,-21
-22,-24,-33,-13,-29,-18,-43,19,-163
-91,-94,-93,-71,-134,-98,-178,-18,-777
9,-19,-21,10,-22,-11,-5,24,-35
-10,-18,-27,18,-28,-12,-42,36,-83
15,-21,-22,15,-12,-5,-19,32,-17
117,-56,-120,-57,-37,-103,-54,207,-103
-3,1,-5,-4,-4,-2,-3,1,-19
1,-2,-4,-4,-3,-1,0,0,-13
-3,3,-3,-2,-2,-1,1,2,-5
2,-12,-19,14,-30,-16,-26,35,-52
3,-13,-25,14,-19,-7,-18,26,-39
107,40,-35,57,-80,-119,-162,39,-153
-1,0,-3,-3,-3,-1,0,3,-8
1,1,-3,0,-2,3,-1,4,3
1,2,0,-2,-3,-2,0,-2,-6
117,60,-64,67,-66,-143,-198,14,-213
10,-16,-16,13,-22,-4,-21,32,-24
-6,-16,-23,10,-11,-6,-20,24,-48
55,-37,-77,-20,-75,-73,-156,102,-281
-4,-11,-24,4,-24,-9,-14,19,-63
2,-7,-15,14,-12,-4,-14,28,-8
-7,-13,-29,-1,-24,-6,-29,16,-93
-1,-15,-27,6,-33,-22,-37,5,-124
-9,-15,-21,-1,-20,8,-18,24,-52
3,-22,-16,14,-8,-4,-15,32,-16
-5,-11,-18,2,-22,-21,-29,11,-93
-15,-14,-26,-1,-23,-6,-15,23,-77
-9,-21,-25,1,-30,-7,-18,13,-96
-22,-33,-56,-35,-35,-13,-46,29,-211
-15,-37,-48,4,-52,-5,-60,35,-178
3,-16,-14,5,-20,6,-28,17,-47
100,101,-70,245,124,263,27,209,999
22,-17,-46,2,-36,-52,-62,34,-155
-3,-52,-54,-36,-95,-62,-76,54,-324
35,-25,-34,19,-18,-43,-43,17,-92
6,-9,-13,-8,1,-16,-18,7,-50
2,-53,-58,-25,-83,-60,-82,43,-316
20,-6,-18,0,-3,-27,-24,20,-38
17,-8,-11,-1,-1,-23,-12,24,-15
-13,-10,-7,-10,-8,-8,-16,-1,-73
1,-43,-35,-8,-61,-22,-35,22,-181
-8,-17,-13,-8,4,-9,-15,14,-52
-7,-27,-10,3,-21,-18,-22,0,-102
-10,-35,-19,-10,-12,8,-19,13,-84
5,-122,-211,4,-113,2,-169,196,-408
0,-26,-38,-7,-32,-44,-60,31,-176
-37,-56,-49,-36,-70,-47,-79,14,-360
-27,-42,-39,-17,-49,-27,-42,26,-217
-13,-11,-22,-8,-15,-10,-25,10,-94
-29,-31,-47,-36,-56,-52,-69,20,-300
-27,-8,-17,-19,-28,-26,-48,-17,-190
-46,-29,-35,-31,-24,-12,-52,-6,-235
-10,2,-29,-12,7,-8,-11,22,-39
-24,-33,-30,-27,34,-57,-29,12,-154
36,-26,-17,37,-36,8,-58,81,25
10,-91,-193,-122,-139,-65,-119,114,-605
-4,-19,-16,-8,-20,-5,-16,10,-78
-25,-88,-147,-41,-142,-131,-218,61,-731
-41,-48,-53,-34,-46,-13,-55,3,-287
-45,1,-38,-17,-19,-35,-66,-29,-248
-17,-16,-33,-24,-8,-31,-51,21,-159
-13,-20,-15,-4,-8,1,-12,8,-63
-11,-20,-15,-34,-24,-22,-28,-10,-164
0,-20,-19,-8,-30,-28,-40,-9,-154
7,-6,-37,10,-32,-18,-40,29,-87
-29,-42,-38,-27,-51,-23,-53,-10,-273
18,10,-35,0,-7,-36,-46,3,-93
12,-33,-23,-10,-16,-10,-27,18,-89
-2,-8,-17,-5,-16,-6,-20,8,-66
-11,-12,-36,-21,-31,-26,-47,9,-175
-3,-10,-17,-8,-16,-16,-24,8,-86
25,-38,-44,-17,-24,-57,-71,31,-195
-1,-31,-11,1,-1,-2,-18,-3,-66
-2,7,-15,-6,-17,-24,-24,12,-69
34,-92,-148,-34,-159,-177,-219,-5,-800
-3,-21,-23,0,-21,-8,-24,2,-98
183,-159,-191,31,-52,-118,-177,205,-278
-16,-10,-15,-12,-26,-1,-19,6,-93
-9,-59,-31,-9,-17,-22,-59,27,-179
59,70,-14,82,10,10,-27,110,300
-182,96,-25,8,112,-95,-51,-106,-243
-3,-10,-17,-8,-16,-16,-24,8,-86
63,-74,-103,10,-110,-67,-97,100,-278
-4,-13,-21,-6,-20,-7,-17,18,-70
-14,-28,-19,9,-39,-22,-28,13,-128
10,-20,-46,-16,-39,-66,-103,0,-280
-7,22,-7,-3,-5,-7,-17,3,-21
-26,-50,-36,-20,-37,-15,-40,25,-199
-21,-73,-68,-13,-79,-31,-80,36,-329
-86,-118,-111,-103,-130,-51,-129,5,-723
-22,-6,-10,-10,-11,-1,-26,-19,-105
-6,-7,-13,-4,-6,-4,-6,7,-39
-12,-3,-23,-31,-12,-23,-36,-3,-143
-21,-54,-51,7,-52,-16,-55,17,-225
1,-27,-27,-9,-31,-14,-23,26,-104
6,-12,-27,-15,17,-33,-24,35,-53
-4,-7,-12,6,-7,-13,-17,-6,-60
-9,-21,-33,4,-23,-6,-50,-4,-142
-11,-17,-21,-15,-26,-14,-36,6,-134
-15,-2,-19,5,-17,1,-26,6,-67
-23,-27,-29,-23,-33,-12,-32,4,-175
-16,-11,-11,-2,1,12,-15,9,-33
-19,-12,-11,-13,-8,1,-25,-10,-97
-19,-30,-36,-31,-47,-38,-62,11,-252
-32,-55,-63,13,-90,-34,-88,30,-319
-19,-52,-37,0,-43,-8,-51,13,-197
-4,-9,-15,-12,-17,-16,-23,18,-78
14,-18,-31,-28,-21,-21,-29,32,-102
69,-55,-27,11,-15,-54,-71,56,-86
-15,-19,-22,-4,-21,-6,-13,2,-98
35,-28,-18,36,-36,6,-59,82,18
-10,-13,-15,18,-21,-12,-27,-8,-88
-4,-6,-15,1,-25,-19,-24,10,-82
0,-19,-23,4,-25,-7,-16,13,-73
-5,-8,-22,-3,-30,-28,-24,17,-103
0,-37,-31,18,-34,-7,-36,35,-92
-3,-23,-27,-1,-30,0,-22,19,-87
-3,-13,-13,-8,-22,-21,-27,5,-102
-5,-6,-27,-14,-36,-27,-25,26,-114
4,-1,-27,0,-23,-17,-26,11,-79
-9,-14,-12,-15,-19,-23,-29,-5,-126
-12,-43,-33,5,-39,-27,-54,-5,-208
5,-14,-11,16,-10,-9,-10,-3,-36
12,-25,-29,65,-17,-53,-53,16,-84
23,-58,-34,-3,-36,-51,-105,43,-221
-7,-52,-40,-2,-60,-29,-72,-2,-264
-11,-54,-62,4,-108,-46,-86,68,-295
-14,2,-32,-28,-23,-55,-81,24,-207
10,-23,-16,21,-5,-3,-34,30,-20
-30,37,-6,30,-30,-12,-37,-11,-59
-9,33,9,29,-14,-2,-12,-12,22
-34,15,-18,17,-26,-10,-35,-10,-101
-26,34,-7,24,-29,-7,-36,-12,-59
-27,16,-13,13,-27,-13,-33,-11,-95
37,-34,-63,-6,-73,-101,-151,82,-309
-36,26,-13,13,-28,-15,-39,-13,-105
-28,30,-9,29,-31,-13,-36,-13,-71
-26,49,1,37,-39,-8,-42,-20,-48
-31,34,-4,31,-28,-9,-37,-10,-54
-18,-13,-14,-8,-16,-11,-18,-1,-99
-14,-41,-28,-13,-22,6,-6,20,-98
11,6,-20,-4,-16,-29,-40,15,-77
-38,-30,-39,-44,-71,-12,-46,29,-251
24,-27,-47,11,-29,19,-26,49,-26
54,-7,-23,46,-24,-63,-77,51,-43
-21,-27,-35,1,-12,-16,-29,2,-137
-17,-25,-25,4,-21,-10,-26,6,-114
-17,-27,-30,-4,-17,-16,-28,4,-135
-4,-5,-16,1,-12,-4,-21,32,-29
-8,-13,-27,4,-25,-19,-39,5,-122
-21,-24,-35,-5,-15,-18,-34,4,-148
-7,-11,-17,-2,-21,-11,-22,23,-68
2,-8,-20,10,-24,-14,-26,16,-64
-7,-5,-18,6,-12,-9,-31,16,-60
-3,-12,-26,-9,-30,-13,-37,2,-128
-9,-17,-30,-9,-28,-6,-18,12,-105
-18,-20,-27,-7,-30,-8,-25,23,-112
-6,-12,-26,-9,-26,0,-19,36,-62
11,-40,-41,7,-36,-17,-33,28,-121
-60,-138,-184,-35,-160,-72,-219,68,-800
-62,-106,-143,-7,-185,-48,-189,101,-639
70,-91,-29,81,-80,-61,-91,68,-133
-50,-120,-93,27,-137,-66,-163,0,-602
-161,-441,-317,-97,-343,-199,-437,71,-1924
-27,-120,-105,-49,-128,-70,-114,14,-599
24,-137,-159,-31,-99,2,-167,159,-408
-35,-195,-193,-29,-260,-66,-200,40,-938
-54,-71,-156,-88,-216,-99,-209,112,-781
-87,-144,-196,-108,-186,-95,-226,119,-923
-5,-27,-21,16,-27,-6,-19,29,-60
-6,-16,-17,9,-24,6,-30,12,-66
-7,-38,-25,9,-39,1,-16,33,-82
-8,-30,-48,-13,7,-34,-46,35,-137
5,-192,-281,23,-292,-36,-283,207,-849
-30,-5,-52,-17,-67,-40,-106,3,-314
11,-34,-30,4,-15,-3,-8,21,-54
-89,-54,-100,-111,-58,-57,-140,-15,-624
-15,-36,-46,-22,-50,17,-60,54,-158
-4,-38,-38,-2,-62,-27,-64,24,-211
-65,-117,-144,-17,-211,-77,-204,74,-761
-12,-34,-50,-39,-57,-43,-48,24,-259
7,-21,-10,-16,-9,-14,-12,-3,-78
-23,-39,-16,15,-54,-9,-39,20,-145
-1,-21,-22,17,-34,14,-47,58,-36
-11,-32,-51,4,-44,-12,-80,59,-167
-58,-49,-110,-74,-112,-105,-161,14,-655
15,-116,-98,-13,-52,-49,-76,52,-337
-15,-29,-33,-4,-49,-24,-40,-15,-209
-29,-90,-67,-34,-78,-67,-118,33,-450
-63,-84,-78,-34,-97,-51,-118,-3,-528
-21,-45,-80,-21,-69,-45,-76,25,-332
-27,-40,-54,-24,-83,-41,-86,23,-332
-33,-24,-19,-1,-34,2,-49,5,-153
-20,-30,-21,-3,-41,-8,-19,14,-128
-31,-23,-41,-24,-28,-29,-60,-1,-237
-42,-133,-137,-55,-135,-65,-188,47,-708
-40,-71,-74,-51,-66,-75,-110,1,-486
10,-13,-11,15,-35,1,-26,22,-37
-7,8,-76,-19,-31,-6,-32,49,-114
1,-3,-18,13,-13,-4,-22,6,-40
-110,-192,-189,-104,-278,-114,-232,47,-1172
-42,-66,-104,-20,-182,-95,-208,55,-662
-36,19,-47,-65,-103,-115,-208,-22,-577
37,-16,-20,26,11,-6,-36,34,30
-35,-81,-123,-89,-156,-120,-185,-10,-799
34,-62,-1,28,31,-6,-8,74,90
-15,-239,-233,-33,-324,-181,-287,100,-1212
32,-56,-39,19,-69,-30,-95,99,-139
37,-95,-129,-56,-185,-124,-158,51,-659
-37,-46,-64,-16,-89,-51,-97,12,-388
24,22,-5,29,-12,-19,-32,4,11
5,-29,-30,-5,-35,-17,-19,22,-108
-15,-10,-22,-17,-23,-18,-31,3,-133
33,-16,-38,-1,-25,-24,-72,37,-106
7,-18,-23,0,-20,-24,-29,8,-99
-15,-5,-2,1,-6,-14,-16,-8,-65
-12,-33,-30,-15,-27,-3,-46,30,-136
34,-96,-214,-45,-205,-128,-270,244,-680
-62,-100,-69,-4,-97,-28,-80,29,-411
-13,-13,-18,6,-8,-14,-17,-6,-83
28,1,-4,12,16,-9,0,14,58
69,-106,-107,-61,-28,-172,-154,122,-437
-19,-73,-58,-17,-74,-46,-71,41,-317
267,-274,-293,-78,-77,-161,-268,258,-626
7,-105,-127,-17,-162,-51,-139,68,-526
-30,-33,-35,-21,-62,-12,-47,6,-234
3,-29,-46,-1,-36,-11,-60,35,-145
42,-76,-111,-47,-42,-80,-156,134,-336
4,-38,-35,3,-74,-35,-81,-9,-265
-1,-80,-66,-4,-90,-115,-136,56,-436
18,8,-21,25,-41,3,-47,33,-22
53,-74,-52,-28,-81,-110,-130,76,-346
-8,-8,-36,5,-42,3,-37,25,-98
-120,-120,-142,-71,-126,-31,-168,42,-736
-185,-107,-154,-152,-177,-164,-303,-149,-1391
7,-45,-69,-18,-59,-22,-57,39,-224
-23,-101,-119,-49,-158,-101,-151,9,-693
69,-55,-95,45,-98,-141,-185,-13,-473
13,-94,-99,45,-157,-56,-140,110,-378
-36,-129,-89,29,-66,3,-73,61,-300
-62,-101,-120,-66,-121,-99,-178,-14,-761
12,-62,-56,-28,-97,-95,-136,-7,-469
3,-12,-19,8,-30,-11,-24,31,-54
-57,-210,-242,-7,-331,-24,-278,132,-1017
-100,-138,-128,-41,-90,-35,-87,-21,-640
-5,-147,-166,-4,-239,-103,-196,111,-749
-3,-25,-28,8,-35,-22,-36,9,-132
-198,-441,-481,-195,-614,-396,-666,-61,-3052
-59,-128,-126,-8,-166,-43,-193,13,-710
-72,-134,-131,-114,-116,-119,-172,-50,-908
-16,-28,-46,-33,-57,-21,-59,25,-235
-4,-84,-93,0,-65,-63,-104,95,-318
-2,5,-12,3,-21,-10,-16,13,-40
-36,-36,-47,-38,-70,-26,-74,-9,-336
-3,-59,-78,0,-97,-14,-63,40,-274
8,-37,-34,14,-28,-46,-77,56,-144
14,-52,-104,-20,-143,-57,-140,114,-388
71,-114,-107,102,-61,-30,-98,85,-152
-101,-63,-184,-47,-64,-52,-141,-25,-677
-12,-77,-57,-3,-90,-42,-67,22,-326
-23,-23,-41,-12,-57,-2,-45,8,-195
8,-73,-58,-16,-78,-31,-66,31,-283
-3,-22,-25,-6,-32,-21,-24,39,-94
-126,-55,-170,-110,-149,-137,-319,-79,-1145
-100,-250,-242,-97,-308,-176,-261,95,-1339
-35,-20,-33,-21,-39,-32,-50,11,-219
-39,-17,-28,-10,-17,-16,-45,-2,-174
23,-59,-55,-31,-50,-67,-79,54,-264
-6,-24,-37,-18,-44,-32,-54,-15,-230
15,-235,-275,60,-247,-9,-319,262,-748
72,-430,-704,202,-338,-831,-1489,687,-2831
-71,-87,-80,-17,-125,-16,-102,54,-444
-114,-225,-253,-148,-468,-192,-416,93,-1723
23,-146,-215,8,-257,-66,-268,165,-756
-97,-94,-110,-98,-158,-74,-172,14,-789
-102,-102,-87,-77,-134,-97,-164,-9,-772
-40,-164,-142,50,-238,-154,-383,86,-985
-13,-34,-23,-7,-30,-29,-31,3,-164
0,-11,-21,-11,-22,-15,-20,9,-91
-143,-182,-231,-91,-192,-23,-204,83,-983
-10,-19,-15,2,-8,-3,-9,-2,-64
2,-63,-83,-69,-136,-80,-116,12,-533
1,-41,-48,21,-49,-51,-54,22,-199
-95,-147,-188,-55,-266,-66,-233,74,-976
-34,-191,-282,-27,-201,-48,-268,110,-941
-32,-40,-47,-34,-85,-22,-78,6,-332
-163,-83,-146,-82,-174,25,-290,-19,-932
-10,-26,-44,-25,-43,-22,-53,13,-210
-7,-109,-111,26,-144,-85,-133,59,-504
51,-57,-69,-5,-29,-94,-118,67,-254
-29,-40,-42,-4,-68,-4,-57,16,-228
-9,-53,-45,-7,-44,-18,-39,42,-173
-16,-62,-46,-5,-97,-49,-102,62,-315
20,-26,-28,-4,-36,-20,-23,28,-89
15,-18,-25,3,-31,-15,-49,43,-77
-30,-85,-55,27,-133,-34,-112,52,-370
22,-107,-51,-3,-35,-15,-39,77,-151
45,-8,-30,-14,-60,-26,-53,59,-87
-2,-50,-79,-46,-87,-42,-68,72,-302
-83,-98,-102,-58,-113,-46,-105,5,-600
13,-84,-81,-67,-63,-73,-228,15,-568
10,-129,-212,-78,-241,-214,-403,189,-1078
0,-95,-111,-54,-148,-121,-191,82,-638
-1,-97,-92,-65,-72,-65,-247,18,-621
60,-79,-87,-63,12,-56,-98,86,-225
-98,-201,-255,-116,-292,-90,-307,53,-1306
18,-57,-76,-56,-90,-118,-126,26,-479
-62,-94,-128,-18,-158,-6,-150,87,-529
-11,-26,-16,0,-24,-18,-35,8,-122
-44,-27,-22,-8,-13,1,-19,-5,-137
21,-46,-39,-9,-65,-30,-50,1,-217
-46,-111,-72,24,-139,-43,-120,52,-455
-64,-388,-579,-226,-488,29,-410,233,-1893
-55,-58,-128,-9,-158,-69,-194,24,-647
-26,-66,-87,-43,-98,-64,-122,16,-490
2,-87,-77,23,-88,-68,-99,28,-366
39,-46,-4,-19,-14,-71,-105,67,-153
-63,-59,-89,-97,-128,-128,-207,-67,-838
-139,-136,-174,-119,-244,-69,-257,-25,-1163
20,-42,-39,22,-83,-71,-71,15,-249
88,-121,-109,-24,-109,-207,-343,189,-636
99,-63,-103,-60,-9,-187,-325,175,-473
-153,-217,-212,-99,-244,-91,-277,50,-1243
-5,-60,-80,-29,-79,-40,-104,57,-340
-30,-50,-63,-35,-71,-42,-73,-25,-389
83,-76,-119,20,-145,-116,-158,148,-363
-13,-66,-71,-17,-91,-25,-47,62,-268
-61,-101,-101,-30,-98,-29,-135,67,-488
-78,-412,-370,-84,-590,-362,-557,3,-2450
45,46,-52,19,-25,-28,-81,28,-48
16,-89,-175,-126,-207,-241,-297,1,-1118
-2,-34,-20,169,-68,-56,-213,118,-106
4,-149,-169,-68,-185,-80,-158,146,-659
15,-81,-411,-171,-271,18,-331,278,-954
7,-68,-87,-26,-59,-45,-76,15,-339
-9,-26,-36,-6,-13,-20,-29,23,-116
-17,-22,-25,-5,-27,-33,-38,-6,-173
-40,-59,-72,-30,-85,-55,-101,25,-417
-112,-69,-111,-48,-156,-117,-199,-48,-860
3,-11,-24,-9,-14,-13,-19,3,-84
-28,-31,-61,-59,-35,-131,-163,-42,-550
-25,-29,-48,-4,-33,-14,-34,11,-176
-23,-77,-80,-26,-91,-32,-83,25,-387
-53,37,-166,-168,-203,-374,-588,-147,-1662
-37,-22,-49,-31,-40,-120,-180,-48,-527
-8,-25,-22,-19,-32,-6,-19,14,-117
10,-99,-110,-49,-138,-139,-192,7,-710
13,-50,-81,-20,-60,-46,-78,18,-304
-133,-189,-232,-80,-280,-180,-299,40,-1353
-30,-28,-27,-11,-40,-10,-36,-4,-186
105,-123,-166,45,-51,13,-155,225,-107
11,-57,-28,7,-9,-33,-56,13,-152
-78,-91,-97,-52,-105,-62,-108,1,-592
23,-54,-51,22,-38,-26,-61,44,-141
-37,-22,-45,-23,-23,-17,-50,-4,-221
28,-50,-81,-46,-78,-108,-88,39,-384
-144,-108,-147,-138,-168,-141,-216,-37,-1099
1,-40,-51,-32,-84,-53,-92,-33,-384
2,-91,-45,-41,-25,-43,-75,34,-284
1,-36,-59,-45,-57,-42,-89,32,-295
18,-21,-5,21,-33,-51,-66,48,-89
53,-6,-65,-6,-66,-94,-111,21,-274
-77,-108,-90,-50,-128,-26,-108,35,-552
9,-82,-107,-20,-118,-106,-105,24,-505
13,-87,-106,-14,-114,-103,-95,33,-473
-18,-59,-46,-2,-24,-16,-80,18,-227
78,-95,-63,10,-96,-122,-150,142,-296
-73,-110,-96,-23,-142,-35,-120,54,-545
15,-27,-61,-26,-78,-49,-74,38,-262
-10,-91,-128,-43,-146,-87,-158,63,-600
71,64,-61,-42,6,-62,-155,11,-168
4,-30,-46,19,-36,-35,-70,32,-162
64,-30,-1,109,2,-59,-120,92,57
29,-2,-4,12,16,-10,0,13,54
17,-19,-36,4,-90,-76,-65,25,-240
-77,-81,-95,-20,-123,-2,-114,28,-484
-80,-88,-96,-25,-109,-40,-112,-9,-559
-56,-3,-79,-81,-60,-126,-182,-45,-632
-14,-69,-61,-12,-81,-18,-72,22,-305
-69,-96,-93,-39,-136,-8,-94,45,-490
-57,-9,-84,-89,-66,-122,-177,-49,-653
7,-5,-22,-19,-28,-28,-33,3,-125
-8,-91,-102,-18,-126,-82,-121,48,-500
20,-5,-1,35,-42,-23,-38,52,-2
-19,-82,-69,-19,-73,-98,-129,26,-463
-23,-45,-46,-5,-59,-33,-90,-5,-306
-48,-97,-128,-48,-152,-89,-165,70,-657
-16,-37,-34,-1,-32,-8,-48,34,-142
-103,-166,-189,-16,-54,-2,-52,9,-573
6,-11,-25,-4,-22,-31,-35,31,-91
47,-33,-74,-13,-15,-69,-100,63,-194
-20,-32,-33,-31,-50,-45,-61,12,-260
-154,-175,-335,-227,-212,-312,-348,-11,-1774
34,-96,-98,1,-132,-148,-169,7,-601
53,-41,-77,-19,-24,-79,-100,70,-217
-88,-314,-355,-287,-407,-400,-488,78,-2261
-20,-33,-35,-31,-49,-47,-61,12,-264
36,-105,-83,10,-141,-30,-88,59,-342
41,-5,-46,12,-68,-61,-83,24,-186
-96,-30,-78,-59,-69,-76,-178,-31,-617
-85,109,9,-47,-10,-60,-212,-22,-318
-41,-28,-38,-4,-32,-40,-67,1,-249
1,-28,-38,-27,-13,-37,-70,34,-178
2,-79,-68,-28,-81,17,-51,72,-216
79,-89,-137,-58,-134,-171,-208,110,-608
-7,-26,-32,-5,-31,-26,-56,-8,-191
-41,46,-11,-18,-28,-52,-150,-4,-258
-34,-39,-47,-21,-27,-24,-23,9,-206
65,-31,-6,108,-1,-64,-121,89,39
93,-47,-42,48,-31,-102,-119,60,-140
-14,-81,-70,-21,-72,-92,-126,28,-448
29,1,0,20,18,-10,1,16,75
-189,-292,-357,-229,-498,-281,-507,10,-2343
-90,-89,-94,-18,-122,-27,-120,19,-541
25,-45,-40,-13,-49,-63,-89,76,-198
47,-34,-75,-18,-30,-85,-99,64,-230
-102,89,14,-49,-7,-53,-177,-25,-310
10,-11,-27,-15,-32,-33,-35,-12,-155
234,-124,-84,160,18,51,-182,296,369
-48,-115,-152,-70,-137,-88,-173,72,-711
-25,-5,-19,-19,-26,-34,-58,-13,-199
-11,-13,-8,-13,-8,-18,-28,6,-93
-83,-101,-90,-54,-122,-9,-92,43,-508
-13,-39,-80,-18,-71,-32,-57,30,-280
23,-94,-79,-9,-82,-94,-125,37,-423
-13,-32,-70,-6,-79,-58,-97,33,-322
-50,-32,-88,-48,-104,-60,-88,11,-459
8,-51,-42,-13,-40,-65,-74,-12,-289
-45,-25,-42,-7,-54,-43,-59,-7,-282
-9,-13,-15,1,-24,-12,-28,0,-100
-2,-24,-25,-4,-19,-9,-40,2,-121
-2,-17,-33,-5,-28,20,-12,21,-56
73,-30,-81,31,-75,-163,-188,105,-328
-18,-11,-33,4,-28,-16,-50,16,-136
51,-52,-10,41,10,-5,-24,65,76
-15,-120,-123,-43,-127,-73,-125,44,-582
10,-128,-164,-16,-200,-142,-212,48,-804
-28,-39,-25,-5,-16,-11,-33,16,-141
-32,-71,-91,-52,-51,-35,-131,102,-361
-24,-25,-46,-50,-75,-109,-143,-43,-515
-33,-88,-105,-17,-139,-61,-110,41,-512
2,-22,-33,-17,-51,-36,-52,14,-195
-22,-129,-145,-37,-162,-83,-156,110,-624
-75,-131,-123,-40,-153,-41,-142,32,-673
-2,-5,-14,-15,-23,-30,-23,13,-99
-4,-27,-29,-1,-28,-26,-33,11,-137
-66,-82,-81,-18,-117,-12,-96,48,-424
-62,-60,-79,-18,-73,-26,-102,30,-390
-44,-5,-74,-72,-86,-117,-153,-31,-582
1,-5,-68,-16,-73,-94,-132,-20,-407
106,-117,-45,-56,26,-111,-153,161,-189
-22,-48,-94,-53,-84,-60,-110,23,-448
-33,-66,-95,-40,-59,-58,-66,45,-372
27,-31,-69,32,-141,-23,-75,91,-189
7,-21,-24,1,-53,-32,-56,-13,-191
-7,-13,-17,-10,-10,1,-10,15,-51
93,-104,-226,-36,-92,-129,-287,212,-569
-40,-30,-53,-39,-34,1,-94,-18,-307
-57,-69,-77,-26,-94,-42,-103,-20,-488
-40,-65,-68,-14,-132,-39,-92,56,-394
18,6,1,9,16,-8,-7,9,44
-108,-97,-96,-98,-131,-91,-168,-9,-798
-1,-49,-68,-13,-83,-7,-68,54,-235
-5,-24,-24,-28,-43,-36,-31,4,-187
-7,-87,-189,-125,-204,-241,-270,0,-1123
-20,11,-14,-19,-5,-14,-37,0,-98
20,-51,-108,4,-165,-60,-159,45,-474
-10,-14,-11,-17,-7,-12,-16,1,-86
-129,-236,-366,-280,-377,-407,-662,25,-2432
14,-28,-60,1,-40,-29,-45,34,-153
-25,-31,-30,-11,-24,-8,-38,18,-149
-87,-104,-102,-50,-149,-24,-120,48,-588
-24,-19,-28,-15,-30,-15,-55,5,-181
-43,-97,-86,-16,-126,-49,-102,22,-497
-11,-48,-68,-26,-75,-88,-113,1,-428
22,-6,-16,19,2,-7,-22,21,13
-60,-132,-175,-47,-183,-105,-172,44,-830
-18,-54,-53,-3,-83,-21,-69,35,-266
-20,-38,-36,-12,-62,-13,-39,0,-220
-75,-80,-74,-21,-108,-4,-100,33,-429
-13,-100,-97,46,-135,-65,-136,34,-466
3,-19,-30,2,-31,-16,-39,18,-112
-84,-79,-78,-21,-112,-19,-116,30,-479
-95,-144,-156,-27,-100,-39,-95,-12,-668
-5,-80,-62,8,-109,-40,-85,38,-335
10,-69,-47,15,-121,-20,-74,93,-213
44,78,52,52,45,63,-29,103,408
-53,-122,-90,-118,-79,-78,-107,42,-605
-83,-92,-83,-57,-75,-56,-135,65,-516
30,27,-3,43,-73,6,-45,79,64
70,-63,-45,-23,11,-80,-130,82,-178
-48,-88,-58,-63,-50,-66,-90,-13,-476
-136,-247,-311,-143,-397,-87,-318,154,-1485
9,9,-14,5,-10,-14,-10,17,-8
-22,-51,-87,-7,-61,19,-70,64,-215
63,-85,-83,3,-46,-70,-102,38,-282
7,-55,-59,-4,-102,1,-59,67,-204
-7,-81,-98,-16,-147,-107,-154,-40,-650
-7,-22,-17,0,-18,-5,-14,12,-71
-18,-112,-100,-75,-160,-143,-172,-15,-795
-44,-68,-73,-12,-127,-40,-94,52,-406
-5,-13,-16,12,-32,-27,-61,27,-115
-62,-119,-186,6,-144,-43,-235,87,-696
-9,-3,-53,9,-41,-38,-68,10,-193
-26,-56,-114,-69,-138,-151,-265,-83,-902
-26,-55,-62,-2,-64,-50,-64,15,-308
-12,-69,-70,-30,-65,-35,-74,36,-319
-3,-44,-57,-7,-64,-27,-70,54,-218
-61,-25,-56,-77,-62,-67,-112,-13,-473
-68,86,0,-21,-17,-57,-189,-13,-279
-26,-42,-48,-21,-39,-56,-81,35,-278
-31,-64,-48,-12,-92,-18,-71,12,-324
-5,-52,-33,-16,-74,-42,-81,61,-242
-1,-40,-27,11,-69,-12,-49,21,-166
32,-37,-88,-32,-34,-86,-105,59,-291
-85,-91,-97,-47,-135,-1,-119,43,-532
-45,-11,-31,-54,-63,-51,-117,-18,-390
-7,-32,-23,-5,-36,-3,-37,23,-120
-100,-123,-163,-50,-198,-42,-167,55,-788
-27,-22,-39,-34,-46,-51,-77,4,-292
19,-69,-136,16,-137,-31,-142,96,-384
-6,-7,-13,-5,-19,0,-25,2,-73
-111,-52,-110,-88,-115,-68,-168,-55,-767
31,-16,-42,19,-79,-105,-138,58,-272
-65,-79,-75,-56,-67,-55,-125,63,-459
-20,-18,-25,11,-42,-21,-18,29,-104
-19,-30,-31,-30,-48,-42,-58,13,-245
21,-33,-20,57,2,-23,-48,47,3
-39,-98,-89,-63,-75,-77,-103,1,-543
-2,-13,-17,4,-15,1,-14,18,-38
-12,-60,-47,-6,-102,-82,-83,-6,-398
18,-104,-63,34,-121,9,-94,77,-244
25,-68,-54,-54,-24,-64,-102,93,-248
28,-27,-62,-17,-70,-83,-105,1,-335
17,-61,-58,29,-38,-18,-65,77,-117
-8,-2,-22,-16,-22,-22,-30,9,-113
-36,-71,-54,-29,-70,-33,-84,0,-377
-35,-62,-55,-15,-63,-79,-119,30,-398
-1,-77,-74,-24,-55,-62,-75,37,-331
44,-35,-76,-9,-27,-85,-99,64,-223
-59,-78,-66,-39,-62,-62,-116,13,-469
107,-48,-51,32,-25,-131,-140,79,-177
94,-257,-186,-212,-31,-228,-350,99,-1071
-15,-66,-31,-4,-10,-14,-42,16,-166
-4,-37,-43,-12,-66,-42,-69,26,-247
-35,-36,-50,-40,-53,-25,-54,27,-266
-37,-49,-71,-31,-91,-22,-89,34,-356
-26,-12,-25,-13,-34,-19,-52,-9,-190
-67,-77,-85,-28,-109,-6,-94,45,-421
25,-146,-235,-121,-274,-376,-463,118,-1472
-49,-90,-89,-62,-106,-43,-113,19,-533
18,-109,-90,-4,-120,-54,-122,37,-444
-23,-27,-29,-21,-37,-6,-32,7,-168
-45,-76,-91,32,-86,-40,-53,41,-318
-28,-17,-49,-47,-65,-44,-67,-4,-321
-28,-116,-109,-14,-156,-83,-160,-16,-682
-106,-150,-188,-27,-60,-22,-116,-29,-698
-20,-11,-65,-41,-120,-113,-199,52,-517
-42,-116,-138,-21,-174,-61,-178,37,-693
-82,-301,-463,-104,-539,-158,-530,353,-1824
37,-33,-72,-21,-19,-75,-106,61,-228
10,-49,-33,29,-53,-52,-128,18,-258
7,-48,-44,-10,-72,-44,-81,29,-263
37,-4,-25,5,-58,-104,-146,8,-287
16,-59,-90,-72,-95,-128,-152,22,-558
11,-48,-58,-5,-23,-77,-135,34,-301
-10,-9,-36,-37,-35,-53,-78,16,-242
-46,-160,-215,-42,-352,-209,-356,89,-1291
-7,-32,-26,-8,-12,-6,-10,6,-95
-68,-95,-100,-26,-122,-8,-103,43,-479
100,-55,-105,63,-80,-96,-225,156,-242
2,1,-4,6,5,2,-5,-5,2
-16,-73,-63,-33,-114,-79,-107,40,-445
-25,-38,-45,-48,-40,-31,-42,34,-235
37,-215,-318,-8,-319,-150,-387,110,-1250
-65,-100,-104,-88,-98,-125,-235,50,-765
-4,-29,-35,24,-22,-16,-53,15,-120
-8,-5,-21,-16,-23,-20,-19,20,-92
-46,-63,-166,-91,-167,-165,-249,9,-938
-15,-10,-29,-32,-44,-26,-40,-1,-197
-73,-99,-103,-44,-141,-12,-91,62,-501
-38,-84,-73,2,-118,-19,-104,37,-397
-5,-42,-39,-44,-23,-58,-69,61,-219
-17,-30,-21,-15,-17,-27,-26,-16,-169
37,-49,-34,50,-49,-112,-171,55,-273
-26,-49,-58,-18,-99,-21,-87,79,-279
13,-37,-41,17,-39,-18,-72,33,-144
-2,-13,-25,4,-31,-19,-33,22,-97
-22,-17,-30,-25,-34,-39,-55,-21,-243
65,-70,-59,-2,-26,-120,-123,57,-278
-42,-85,-75,-7,-110,-22,-73,41,-373
1,-30,-59,-54,-85,-89,-135,41,-410
7,4,-13,1,-53,-45,-55,-9,-163
-20,-55,-61,-12,-79,1,-51,57,-220
33,-50,-50,4,-65,-44,-59,44,-187
-7,-19,-28,-6,-20,-4,-34,14,-104
-18,-55,-37,-16,-54,-43,-77,25,-275
-16,-18,-36,-15,-47,-33,-56,26,-195
-79,-77,-88,-44,-126,-39,-131,3,-581
11,-58,-83,-24,-74,-82,-108,21,-397
59,-237,-319,-115,-149,-75,-239,216,-859
-20,-70,-99,-13,-81,-62,-87,39,-393
-41,-43,-62,-59,-74,-34,-96,7,-402
20,-64,-129,-47,-130,-134,-171,5,-650
-37,-21,-54,-10,-59,-40,-79,-8,-308
-54,-165,-260,-21,-174,-56,-237,93,-874
-3,-14,-42,-14,-26,-17,-27,11,-132
-77,-100,-87,-36,-126,-4,-107,49,-488
4,7,2,-1,-36,-22,-38,16,-68
7,-70,-107,-58,-93,-57,-112,130,-360
116,-55,-43,53,-44,-176,-191,40,-300
9,-56,-49,-1,-32,-22,-54,35,-170
-31,-30,-74,-60,-36,-130,-169,-39,-569
-16,-29,-40,-6,-15,-31,-33,-11,-181
39,-69,-106,-18,-59,-39,-90,99,-243
-27,-57,-41,1,-48,-15,-76,9,-254
0,-21,-46,23,-48,-28,-47,39,-128
-97,-89,-95,-29,-124,-17,-129,24,-556
48,-233,-329,-121,-154,-68,-243,216,-884
12,-44,-43,-4,-26,-28,-88,86,-135
-95,-97,-98,-69,-148,-22,-118,16,-631
-21,-29,-47,-21,-50,-29,-67,-1,-265
-21,-36,-50,4,-91,-37,-66,-14,-311
-17,-24,-22,-8,-31,-14,-43,2,-157
-90,-97,-89,-27,-120,3,-111,29,-502
60,-115,-207,89,-447,-96,-376,399,-693
-18,-7,-15,-13,-18,-14,-34,15,-104
-280,-430,-455,-160,-142,-41,-259,-33,-1800
-11,-24,-68,-57,-32,-93,-150,9,-426
28,-58,-104,-34,-100,-116,-119,95,-408
-63,-64,-54,-33,-85,11,-78,21,-345
2,-4,-79,-8,-41,-84,-197,202,-209
22,-45,-35,9,-41,-28,-62,36,-144
3,-38,-37,-7,-45,-41,-51,-2,-218
139,-112,-170,83,-135,-128,-216,220,-319
-60,-107,-101,-30,-148,-48,-117,38,-573
-9,-53,-72,-31,-83,-77,-105,60,-370
-158,-191,-253,-66,-64,12,-137,-42,-899
61,-65,-59,-11,15,-43,-68,87,-83
49,-36,-74,-19,-26,-82,-100,69,-219
57,-121,-138,-57,-28,-154,-221,125,-537
-11,-44,-23,-4,-34,-12,-47,24,-151
23,-147,-234,-121,-272,-376,-462,117,-1472
-87,-156,-123,-64,-127,-75,-192,13,-811
-50,-90,-129,-64,-160,-72,-160,91,-634
-42,-30,-33,-36,-20,-21,-43,-17,-242
-15,-69,-62,-18,-94,-18,-76,44,-308
33,-146,-167,-64,-191,-279,-332,13,-1133
-70,-85,-69,-43,-67,-62,-122,24,-494
-28,-74,-126,-25,-120,-55,-133,44,-517
-15,-19,-12,-11,-17,-12,-27,-10,-123
-29,-64,-72,-11,-71,-35,-97,24,-355
26,-49,-18,54,-76,-11,-67,65,-76
-93,-110,-157,-37,-38,22,-71,-12,-496
-15,-35,-51,-11,-18,-41,-54,50,-175
2,-159,-137,-28,-173,-166,-201,51,-811
-13,-8,-13,11,-23,-11,-25,-1,-83
-5,-11,-23,1,-35,-11,-43,20,-107
-113,-145,-144,-116,-134,-38,-180,-42,-912
-8,-13,-27,9,-18,9,-16,20,-44
-5,-179,-196,-21,-298,-221,-339,24,-1235
-50,-165,-323,-137,-320,-124,-357,6,-1470
15,-53,-55,-36,-89,-57,-82,31,-326
-9,-18,-10,-9,-22,0,-15,9,-74
-28,16,-76,-62,-83,-129,-182,-22,-566
-3,-41,-48,-4,-65,-48,-58,-4,-271
18,-49,-30,33,11,19,-40,36,-2
161,-241,-220,75,-294,-262,-515,228,-1068
-95,-185,-282,-143,-333,-397,-654,-187,-2276
232,-311,-319,57,-257,-195,-365,422,-736
-4,-244,-309,-74,-336,-316,-497,166,-1614
3,-78,-68,-60,-88,-158,-233,47,-635
-47,-33,-200,7,-48,-30,-202,254,-299
89,-102,-43,16,-13,-103,-205,168,-193
250,-161,-185,141,-13,-10,-274,395,143
-34,-43,-47,-22,-37,-19,-53,23,-232
41,-68,-132,-54,-154,-128,-211,108,-598
25,-24,1,37,-47,-47,-60,55,-60
33,-47,-55,-30,-50,-89,-102,83,-257
52,-249,-227,42,-263,-50,-240,240,-695
-16,-18,-46,-13,-46,0,-37,22,-154
-11,-26,-13,-5,-17,-14,-23,-10,-119
-2,-22,-33,-18,-32,-25,-66,25,-173
34,-104,-138,66,-174,5,-144,141,-314
16,-35,-29,47,-24,-13,-35,39,-34
-69,-103,-106,-5,-117,14,-128,38,-476
-163,-320,-274,-192,-405,-417,-470,-93,-2334
-36,-82,-93,-52,-71,-76,-102,25,-487
-21,-85,-145,-16,-110,16,-114,123,-352
-73,-109,-161,-71,-222,-144,-248,32,-996
29,-30,-64,-25,-105,-96,-95,19,-367
-32,-117,-139,-13,-113,4,-89,72,-427
-51,-138,-92,-2,-168,-8,-112,100,-471
7,-27,-16,-3,-13,-23,-31,16,-90
-16,-30,-41,-29,-26,-6,-25,28,-145
-238,-180,-280,-24,-128,-67,-147,-61,-1125
44,-70,-110,-42,-126,-90,-119,85,-428
-10,-22,-60,-30,-37,-48,-68,21,-254
-34,7,-64,-35,-68,-123,-174,-29,-520
40,-259,-179,-248,-110,-217,-324,125,-1172
-10,-14,-10,-11,-16,-12,-16,3,-86
1,-111,-118,6,-144,-85,-137,26,-562
-21,-11,-14,-41,-33,-53,-91,-41,-305
-70,-122,-124,-25,-78,-17,-99,10,-525
-1,-24,-28,11,-7,15,-20,23,-31
6,-8,-10,-7,-20,-24,-17,3,-77
-21,-66,-147,-22,-119,-42,-142,79,-480
12,-32,-24,-18,-16,-33,-46,43,-114
-4,-55,-62,-2,-99,-18,-72,59,-253
-6,-75,-81,-33,-92,-65,-65,46,-371
-29,-64,-53,6,-82,-10,-72,1,-303
65,-52,-58,79,-21,-37,-132,104,-52
-39,-38,-31,-30,-64,-28,-72,-7,-309
3,-50,-64,0,-50,-29,-67,45,-212
3,-13,-23,18,-35,0,-16,20,-46
16,-48,-44,-12,-48,-59,-56,67,-184
-8,-17,-22,4,-13,-6,-23,5,-80
10,-4,-19,-10,-2,-26,-30,9,-72
-110,-160,-199,-33,-59,6,-99,-50,-704
-62,-75,-79,-29,-48,-10,-65,-1,-369
-5,-10,-8,-3,-11,-6,-19,-6,-68
8,-14,-37,14,-48,-30,-48,36,-119
-11,-5,-21,-10,-15,-19,-21,4,-98
83,-7,-59,32,7,-62,-64,23,-47
-4,-30,-36,-36,-21,-47,-79,49,-204
-4,-19,-41,-20,-29,-6,-24,36,-107
-8,-47,-39,-43,-25,-44,-75,66,-215
38,-9,-73,7,-68,-28,-40,63,-110
4,-45,-47,-30,-33,-48,-82,53,-228
15,-93,-95,-10,-122,-105,-105,37,-478
18,-40,-40,0,-32,-34,-38,11,-155
-8,-33,-27,-9,-52,-4,-23,36,-120
0,-25,-35,-18,-39,-23,-36,30,-146
4,-36,-33,-1,-59,-38,-51,22,-192
8,-35,-50,-3,-79,-46,-79,48,-236
2,-7,-23,-9,-13,-1,-12,-6,-69
-12,-160,-257,-170,-66,7,-154,174,-638
-109,-125,-153,-40,-71,-10,-86,-43,-637
-48,-133,-211,-68,-99,23,-165,156,-545
-43,-51,-68,-11,-47,-21,-58,3,-296
-8,-82,-94,-2,-113,-39,-93,60,-371
21,-18,-3,9,-21,-14,-17,27,-16
12,-16,-19,15,-26,10,-21,31,-14
40,-54,-47,0,-16,-50,-39,66,-100
-11,-25,-29,-31,-19,-56,-70,58,-183
-7,-17,-22,-4,-33,0,-18,26,-75
-54,-62,-79,-23,-51,-12,-64,4,-341
-9,-63,-49,-4,-60,-27,-78,-1,-291
-72,-127,-146,-46,-103,-15,-138,26,-621
-43,-57,-70,-15,-49,-27,-62,-1,-324
19,-33,-42,-2,-40,-7,-52,61,-96
-6,-64,-64,-24,-56,-35,-74,34,-289
48,-81,-161,-36,-124,-130,-251,128,-607
8,-66,-72,-1,-87,14,-40,78,-166
6,-81,-149,-13,-115,-113,-206,44,-627
-5,-64,-52,-16,-82,-35,-54,24,-284
-4,-107,-177,7,-130,-96,-184,91,-600
-15,-34,-54,20,-99,-61,-123,14,-352
-54,-69,-96,-49,-102,-52,-134,27,-529
-33,-49,-73,-9,-44,-17,-51,2,-274
39,-32,-79,-13,-16,-92,-97,50,-240
-2,-1,-8,0,-12,-2,-5,9,-21
-7,-17,-25,3,-35,-16,-28,9,-116
-48,-120,-88,6,-127,-54,-117,35,-513
30,-63,-35,41,-52,-23,-47,47,-102
0,-23,-15,10,-25,-10,-16,28,-51
36,-20,-29,-5,12,-50,-32,63,-25
-3,0,-14,-7,-33,-34,-41,6,-126
0,-20,-32,8,-25,-10,-29,1,-107
22,-32,-63,-35,-57,-95,-110,84,-286
41,-113,-133,97,-109,66,-138,191,-98
40,-32,-76,-15,-22,-90,-107,56,-246
3,-69,-83,-3,-38,-7,-89,86,-200
-95,-108,-137,-43,-144,-95,-165,11,-776
-15,-36,-39,-40,-22,-54,-70,58,-218
-12,-8,-41,-10,-61,-14,-63,49,-160
-57,-96,-80,-32,-105,-4,-87,37,-424
47,-37,-77,-24,-21,-80,-96,61,-227
-20,-31,-57,-14,-55,0,-47,44,-180
-4,0,-12,-2,-32,-27,-43,17,-103
-24,-35,-92,-76,-143,-174,-189,-25,-758
3,-35,-62,-4,-50,-37,-90,45,-230
-21,-12,-23,-14,-20,-4,-22,5,-111
-5,-84,-75,-50,-77,-85,-116,40,-452
-4,-38,-48,-23,-54,-50,-79,30,-266
-212,-290,-302,-89,-98,-9,-187,-38,-1225
39,-36,-81,-17,-21,-91,-101,58,-250
-117,-112,-134,-55,-90,-13,-103,-7,-631
9,-84,-95,-49,-113,-127,-167,21,-605
91,-20,-27,17,-23,-80,-88,137,7
-64,-44,-50,-59,-60,-48,-108,-17,-450
0,-39,-111,-34,-167,-182,-209,-69,-811
48,-48,-23,27,-2,-27,-46,71,0
-162,-223,-277,-56,-329,12,-316,177,-1174
-11,-72,-64,-40,-64,-25,-37,39,-274
23,-19,-34,0,-15,-21,-50,17,-99
-29,-46,-79,0,-94,-35,-100,33,-350
-28,-27,-23,-19,-49,-31,-52,1,-228
125,-30,-54,51,-49,-116,-137,86,-124
-3,-17,-31,-22,-17,-23,-37,33,-117
-52,-45,-37,-8,-55,-28,-52,-21,-298
-8,-9,-23,-12,-60,-83,-63,-25,-283
5,-27,-12,17,-24,-10,-29,38,-42
-20,-20,-42,-28,-26,3,-25,22,-136
-234,75,-60,-88,143,-21,-124,-142,-451
43,-83,-62,-61,-12,-40,-84,83,-216
-11,-16,-25,-5,-6,-35,-62,21,-139
-23,-46,-29,-22,-39,-6,-32,16,-181
28,-151,-230,160,-459,-49,-387,393,-695
-35,-59,-105,-54,-150,-53,-134,18,-572
-21,-44,-42,-14,-69,-40,-66,4,-292
24,-108,-119,-48,-108,-153,-162,104,-570
-49,-218,-288,-240,-368,-287,-473,186,-1737
1,-41,-57,-25,-73,-30,-76,39,-262
-74,-154,-209,-101,-316,-184,-255,20,-1273
-47,-64,-82,-10,-96,-13,-95,42,-365
6,-15,-20,-12,-15,-33,-29,10,-108
-5,-24,-29,0,-30,-6,-23,2,-115
-121,-98,-194,-227,-182,-209,-350,-91,-1472
110,-82,-117,-50,-92,-165,-238,62,-572
-10,-14,-19,-5,-17,-6,-23,10,-84
51,-71,-38,35,-38,-13,-88,62,-100
54,-117,-147,-61,-31,-152,-214,122,-546
-33,-37,-69,14,-65,-43,-90,25,-298
0,-5,-6,-5,-8,-5,-9,-6,-44
2,-31,-30,-21,-24,-27,-32,18,-145
-112,-168,-174,-73,-290,-66,-172,127,-928
5,-43,-36,-7,-30,-45,-85,17,-224
-29,-63,-77,6,-31,-9,-54,2,-255
39,-32,-18,-16,-35,-22,-55,70,-69
-25,-31,-51,-38,-28,-34,-40,23,-224
3,-14,-17,-25,-32,-25,-68,-19,-197
-22,-99,-91,52,-116,0,-178,72,-382
-2,-31,-38,-18,-50,-32,-74,-3,-248
-61,-97,-102,-28,-114,-8,-108,51,-467
36,44,31,41,-6,23,-26,73,216
6,-17,-60,-5,12,-13,-21,-14,-112
-241,-389,-478,-179,-577,-265,-634,118,-2645
-19,0,-46,-6,-69,-38,-85,16,-247
5,-27,-36,-8,-31,-7,-37,10,-131
-12,-7,-24,-3,-26,-11,-26,2,-107
-25,-41,-31,-18,-31,-4,-40,-9,-199
-33,-46,-68,-15,-102,-76,-111,63,-388
-3,-60,-102,-75,-71,-99,-129,37,-502
15,-67,-26,40,-59,-7,-87,77,-114
7,-61,-126,-87,-56,-70,-174,101,-466
43,16,-15,33,-23,-18,-28,70,78
41,-27,-42,-14,-17,-87,-102,53,-195
22,-1,-19,-3,-5,-6,-24,-18,-54
22,-1,-19,-3,-5,-6,-24,-18,-54
22,-1,-19,-3,-5,-6,-24,-18,-54
-39,-29,-25,-12,-30,-12,-12,1,-158
5,-13,-178,-11,-64,-24,-168,319,-134
67,2,-32,43,-42,-70,-115,81,-66
-29,-23,-59,-22,-68,-41,-110,16,-336
-98,-30,-134,-34,-171,-117,-214,89,-709
-8,-22,-18,1,-33,-1,-33,15,-99
39,-56,-49,17,-15,-37,-72,34,-139
-110,-109,-159,-49,-94,-15,-117,40,-613
-83,-96,-124,-31,-63,-19,-75,-39,-530
-92,-117,-167,-31,-60,29,-83,-26,-547
45,-170,-241,-67,-134,-161,-235,195,-768
-8,-45,-50,-13,-58,-57,-99,7,-323
0,-24,-25,-8,-38,-53,-45,-11,-204
-28,-42,-52,-29,-87,-54,-100,11,-381
-137,-343,-410,-112,-522,-58,-422,176,-1828
23,-26,-36,15,-56,-6,-38,33,-91
-97,-73,-131,-5,-172,-104,-214,-22,-818
-1,-45,-59,-13,-48,-20,-55,43,-198
-5,-91,-67,22,-71,-1,-149,42,-320
-9,-100,-72,24,-87,-7,-157,48,-360
-31,-63,-58,0,-124,-46,-89,62,-349
-2,-46,-48,-65,-44,-85,-127,58,-359
-5,1,-12,-9,-4,-8,-32,28,-41
-91,-157,-236,-14,-91,-61,-129,60,-719
7,-39,-49,-8,-29,8,-3,29,-84
-21,-22,-44,-22,-27,-43,-80,-28,-287
-119,-110,-110,-39,-185,5,-150,70,-638
31,-24,-48,-3,-64,-86,-111,53,-252
-22,-132,-147,-26,-229,-114,-203,56,-817
42,16,-14,29,-28,-30,-24,62,53
58,-52,-43,3,-18,-98,-129,53,-226
-41,-33,-62,-19,-65,-2,-81,12,-291
2,-35,-47,-18,-17,-21,-32,42,-126
-10,-78,-74,-16,-79,-97,-123,27,-450
-28,-53,-55,-3,-87,-25,-64,50,-265
21,-9,-35,6,-21,-56,-63,13,-144
28,-37,-48,-31,-54,-83,-99,73,-251
52,-192,-129,-46,-109,-171,-310,142,-763
-80,-100,-89,-39,-99,-27,-112,-8,-554
-19,-42,-48,-14,-57,-40,-68,11,-277
12,-88,-104,-13,-120,-107,-100,29,-491
3,-50,-33,12,-23,-11,-36,24,-114
-8,-19,-9,-13,-22,3,-26,-3,-97
-7,-24,-31,-19,-38,-35,-32,18,-168
-25,-51,-58,-50,-48,-36,-63,29,-302
-25,-30,-32,-32,-46,-33,-50,9,-239
-53,-116,-159,-71,-199,-119,-195,46,-866
10,-16,-22,3,-26,-10,-19,13,-67
-11,-41,-32,-23,-38,-13,-32,9,-181
-18,-57,-37,-48,-44,-76,-73,33,-320
-4,3,-2,3,-9,-13,-18,-9,-49
-29,-34,-59,-34,-71,-44,-103,13,-361
-6,-37,-31,-6,-19,6,-33,17,-109
-27,-68,-106,-68,-91,-105,-161,17,-609
4,18,-11,3,-32,-40,-28,-1,-87
59,-260,-186,-240,-85,-224,-342,119,-1159
19,-77,-197,-15,-118,-207,-391,93,-893
15,-15,-45,-11,-48,-54,-74,26,-206
-4,-62,-80,-70,-113,-76,-133,13,-525
14,-85,-93,-15,-115,-109,-95,48,-450
-5,-108,-141,8,-82,-19,-133,68,-412
13,-86,-91,-17,-116,-103,-107,39,-468
21,1,-68,-48,-74,-158,-199,90,-435
-3,-16,-28,-7,-21,-4,-15,11,-83
-60,-126,-165,-33,-73,-17,-91,10,-555
15,-86,-97,-13,-116,-106,-108,32,-479
-77,-140,-145,-53,-149,-74,-190,-23,-851
-12,-40,-36,-15,-44,-4,-34,29,-156
19,-90,-99,-17,-134,-95,-131,34,-513
-25,-71,-60,-21,-76,-30,-54,18,-319
25,-50,-125,0,-57,-107,-165,93,-386
45,-20,-65,-13,-63,-100,-121,32,-305
-13,-34,-34,-39,-38,-43,-54,6,-249
18,-89,-104,-12,-117,-106,-102,34,-478
4,-20,-25,-7,-19,-35,-45,37,-110
-5,-8,-21,-14,-22,-26,-41,10,-127
-6,-19,-16,-20,-15,-18,-25,11,-108
-25,-23,-43,14,-49,11,-38,18,-135
14,-89,-95,-10,-118,-106,-108,34,-478
17,-89,-105,-12,-116,-105,-101,34,-477
15,-87,-102,-13,-118,-108,-103,35,-481
6,-34,-29,2,-37,-42,-36,7,-163
15,-90,-96,-10,-119,-109,-103,35,-477
14,-88,-105,-14,-116,-105,-103,33,-484
-26,-6,-50,-54,-74,-122,-139,-41,-512
-22,-36,-63,-43,-32,-126,-158,-45,-525
21,-55,-41,-11,-75,-78,-125,49,-315
34,-45,-90,-30,-27,-78,-89,65,-260
249,-142,-271,107,-234,-99,-363,394,-359
18,-89,-99,-11,-118,-107,-105,36,-475
-6,-4,-3,0,-2,-4,-6,-8,-33
360,-18,-630,255,-97,917,-16,514,1285
94,-39,-20,-5,-27,30,29,34,96
-17,-33,-41,-22,-41,-13,-24,18,-173
72,-260,-182,-221,-93,-219,-348,114,-1137
1,-41,-57,-25,-73,-30,-76,39,-262
-4,-26,-27,-23,-28,-23,-14,4,-141
42,13,-91,-54,-92,-140,-129,-32,-483
-3,-22,-40,-2,-48,-23,-47,28,-157
-8,-58,-75,-39,-39,-59,-85,36,-327
-20,-66,-89,4,-57,-21,-70,30,-289
-4,-35,-46,-25,-38,-38,-38,-9,-233
167,-136,-113,-50,-14,-162,-260,274,-294
532,-501,-431,-52,83,-202,-362,715,-218
12,-29,-17,8,-43,-44,-25,25,-113
13,-47,-65,-20,-52,-78,-93,41,-301
16,-37,-43,-24,-46,-29,-63,50,-176
-45,-91,-76,-74,-76,-64,-110,-6,-542
-51,-119,-94,-112,-80,-67,-89,46,-566
-40,-92,-78,-59,-83,-69,-120,3,-538
-49,-86,-76,-55,-76,-62,-111,1,-514
-31,-25,-20,-10,-39,-17,-51,-8,-201
-49,-119,-101,-110,-71,-67,-108,43,-582
-17,-32,-22,5,-48,-7,-47,6,-162
-24,-20,-11,-32,-16,-21,-36,13,-147
-13,-53,-61,-39,-63,-59,-98,31,-355
0,-11,-23,6,-28,-13,-33,20,-82
2,-16,-4,-15,3,-12,-29,19,-52
-4,-25,-18,7,-17,5,-28,21,-59
21,-29,-53,-25,-55,-91,-129,50,-311
2,-8,-14,17,-20,13,-10,15,-5
9,-3,-28,-6,-42,-71,-62,33,-170
-40,-135,-126,-17,-82,-48,-137,30,-555
-2,-14,-28,-5,-9,-28,-24,-2,-112
-16,-51,-58,-11,-77,3,-47,54,-203
-46,-106,-93,-100,-61,-61,-101,55,-513
-35,-19,-47,-30,-41,-121,-179,-52,-524
11,-17,-38,-8,-31,-34,-49,36,-130
-45,-87,-73,-59,-77,-65,-113,-4,-523
2,-8,-11,-2,-18,-3,-12,6,-46
-93,-123,-160,-28,-183,12,-181,124,-632
-12,-43,-27,-8,-27,-5,-12,20,-114
24,-126,-176,-34,-123,-64,-173,114,-558
-6,-9,-12,-3,-11,9,-14,-8,-54
-23,-35,-32,-10,-51,-6,-23,21,-159
-91,-79,-77,-69,-105,-65,-121,-5,-612
-74,100,1,-19,-14,-56,-200,-14,-276
-22,-9,-30,-22,-20,-15,-31,19,-130
-48,-44,-44,-31,-68,-34,-60,6,-323
-299,145,-44,-71,211,24,-110,-171,-315
3,6,-12,0,-4,-15,-1,3,-20
-19,-43,-35,-19,-29,-19,-50,19,-195
-6,-33,-20,8,-15,-23,-39,22,-106
-28,-60,-59,-28,-60,-14,-77,6,-320
-27,-35,-62,-67,-50,-128,-165,-35,-569
-6,-20,-25,34,-25,-14,-39,10,-85
-4,-20,-50,-27,-47,-17,-52,40,-177
-14,-43,-44,-24,-26,-16,-57,26,-198
-32,-25,-59,-49,-31,-128,-156,-43,-523
16,-18,-30,-10,-25,-32,-33,14,-118
-15,-24,-25,-23,-31,-17,-25,12,-148
3,-22,-19,14,6,7,-2,16,3
-61,-53,-42,-3,-69,-18,-87,5,-328
-29,-22,-55,-48,-36,-118,-160,-33,-501
-30,-24,-32,-15,-28,-15,-41,-2,-187
-17,-11,-16,-11,-7,-12,-19,2,-91
-30,-14,-44,-26,-65,-33,-102,-6,-320
-44,-20,-49,-33,-47,-123,-183,-61,-560
57,-72,-86,-59,-37,-89,-115,109,-292
-69,-5,-224,-163,-350,-535,-709,-224,-2279
-29,-49,-40,23,-65,10,-44,61,-133
-6,-11,-38,-25,-43,-86,-130,6,-333
-19,-14,-32,-52,-25,-48,-76,64,-202
-114,-100,-105,-59,-130,-45,-140,-3,-696
7,-1,-48,-33,-27,-68,-50,33,-187
12,0,-21,-21,3,-42,-51,17,-103
73,-93,-100,-45,0,-31,-109,84,-221
-36,17,-50,-56,-12,-57,-76,-30,-300
-34,-26,-52,-44,-45,-117,-179,-46,-543
-4,-23,-27,-27,-34,-27,-38,15,-165
-13,-10,-22,-19,-25,-14,-29,5,-127
-10,-22,-26,-18,-23,-15,-27,11,-130
-6,-41,-57,-38,-59,-59,-98,12,-346
-2,-6,-18,1,-27,-21,-32,1,-104
-13,-7,-9,-5,-8,5,-14,5,-46
-11,-3,-12,-6,-14,-11,-26,-2,-85
45,-50,-69,-43,-44,-82,-123,83,-283
-96,-268,-330,-122,-339,-155,-345,94,-1561
-37,-36,-38,-8,-25,13,-38,14,-155
-22,-29,-38,-19,-34,-41,-63,25,-221
59,-45,-46,58,-27,-33,-71,58,-47
3,-67,-93,30,-137,-27,-109,47,-353
-47,-43,-68,-42,-62,-26,-72,10,-350
-53,-86,-102,-40,-150,-72,-99,59,-543
-14,-82,-84,-15,-70,-32,-104,14,-387
-46,-45,-48,-54,-74,-33,-67,10,-357
-27,-115,-119,-8,-136,-87,-156,39,-609
-29,-53,-50,-39,-123,-43,-63,69,-331
15,-44,-65,2,-50,-13,-43,36,-162
4,-47,-64,-25,-82,-9,-52,67,-208
-36,-61,-110,-57,-134,-104,-166,40,-628
-119,-188,-222,-124,-315,-147,-311,43,-1383
-29,-123,-103,-15,-192,-79,-227,120,-648
-21,14,11,33,-19,17,-38,-16,-19
25,-9,6,9,-23,-17,-52,79,18
63,-55,-19,68,-62,-26,-113,120,-24
-18,-9,-20,-11,-26,-2,-36,9,-113
0,-37,-56,-6,-74,-59,-70,-33,-335
-3,-27,-28,-17,-25,-10,-11,28,-93
-17,-50,-110,-38,-148,-46,-114,96,-427
-41,-68,-93,-50,-125,-19,-104,59,-441
31,-59,-38,15,-53,28,-35,119,8
-60,-104,-98,-39,-127,-48,-138,1,-613
-20,-100,-89,54,-99,-11,-133,108,-290
-11,-65,-98,-42,-125,-68,-124,83,-450
96,-84,-110,-43,-192,-193,-242,87,-681
20,22,-18,17,-17,-19,-26,26,5
-2,-26,-12,25,-29,-24,-31,4,-95
-6,-14,-27,-14,-27,-32,-48,7,-161
-40,-108,-216,-57,-247,-43,-236,120,-827
-12,-59,-66,-3,-68,-25,-75,62,-246
-97,-165,-168,-17,-220,-26,-226,55,-864
7,-48,-47,-19,-58,-17,-28,41,-169
63,-54,-100,47,-100,-85,-182,84,-327
-9,-51,-38,-14,-81,28,-68,64,-169
-13,-42,-25,0,-34,-17,-46,-15,-192
-77,-128,-119,4,-199,-63,-192,50,-724
-3,-71,-67,-17,-88,-71,-92,57,-352
16,-12,-55,-1,-78,-112,-157,20,-379
-88,-165,-190,-65,-252,4,-210,107,-859
-5,-20,-22,-6,-25,-23,-38,8,-131
-27,-83,-66,-17,-114,-76,-167,-30,-580
-54,-72,-73,-64,-118,-57,-138,-30,-606
13,-20,-32,-10,-54,-40,-38,17,-164
-59,-125,-132,6,-129,-46,-167,77,-575
-75,-67,-96,-45,-91,-35,-108,39,-478
13,-75,-70,-9,-90,-27,-46,58,-246
1,-3,-19,2,-10,-10,-11,1,-49
-15,-18,-36,-25,-30,-28,-51,-1,-204
-77,-119,-123,-17,-126,4,-113,32,-539
30,-83,-91,-11,-115,-90,-164,40,-484
38,-65,-86,-30,-21,-92,-84,58,-282
-19,-60,-48,-30,-76,-33,-58,20,-304
14,-14,-20,3,-33,-27,-45,18,-104
105,-40,-39,42,-110,4,-138,240,64
208,-107,-196,1,-77,-208,-231,212,-398
-44,-91,-111,-63,-129,-93,-144,19,-656
3,-34,-56,-21,-88,-76,-96,-1,-369
42,10,-5,34,-13,-45,-40,41,24
-14,-116,-176,-29,-253,-182,-327,-8,-1105
-15,-57,-75,-46,-97,-83,-98,29,-442
-27,-25,-92,-48,-39,-61,-112,88,-316
-21,-44,-55,-13,-76,-53,-90,44,-308
-5,-39,-45,-6,-39,-19,-34,5,-182
-66,-85,-91,-18,-70,-42,-53,-2,-427
37,-88,-74,19,-74,-36,-56,70,-202
-7,-73,-81,-26,-136,-30,-110,86,-377
31,-119,-96,38,-59,17,-140,96,-232
8,-83,-107,-15,-106,-35,-98,47,-389
34,-23,-23,50,-16,-33,-86,38,-59
-27,-54,-53,12,-88,-8,-73,36,-255
-15,-56,-83,28,-119,-37,-124,88,-318
-102,-192,-224,-107,-264,-214,-319,-37,-1459
21,-57,-82,-39,-95,-31,-96,59,-320
-57,-132,-166,-59,-233,-93,-236,49,-927
-15,-67,-37,-4,-45,10,-28,13,-173
-71,-94,-193,16,-229,-101,-182,67,-787
-41,-82,-136,-53,-204,-39,-154,85,-624
49,-54,-18,73,-13,-75,-94,53,-79
-293,-247,-251,-136,-261,-39,-281,-83,-1591
15,-155,-146,-10,-196,-161,-179,53,-779
-66,-107,-107,-16,-139,-10,-120,43,-522
-13,-24,-7,-9,-36,17,-18,26,-64
-22,-112,-132,-36,-155,-64,-147,61,-607
44,-86,-72,-18,-22,-69,-112,115,-220
-34,-150,-143,-23,-243,-165,-224,-1,-983
46,-46,-54,47,-51,-29,-96,93,-90
-33,-138,-162,17,-292,-208,-273,-17,-1106
-41,-208,-221,-163,-280,-332,-315,12,-1548
60,-56,-74,84,-124,-85,-193,43,-345
-61,-110,-102,-35,-113,-46,-115,28,-554
-16,-25,-26,-14,-17,-1,-12,16,-95
28,-73,-107,34,-200,50,-75,175,-168
-5,-62,-77,-38,-103,-16,-91,47,-345
-72,-102,-117,-66,-200,-47,-174,14,-764
-13,-28,-53,-6,-77,-15,-59,15,-236
-108,-320,-326,-61,-398,-125,-365,157,-1546
5,-130,-163,58,-149,35,-181,149,-376
5,-63,-81,-32,-95,-70,-75,33,-378
-46,-77,-78,18,-86,-20,-125,51,-363
-24,-7,-11,-5,-26,-19,-39,0,-131
-41,-69,-79,0,-101,-77,-121,-9,-497
8,-103,-138,-74,-131,-161,-209,12,-796
-44,8,-67,-48,-39,-149,-126,-47,-512
17,-173,-132,51,-170,38,-155,150,-374
-65,-92,-101,-57,-106,-67,-99,-2,-589
120,-164,-242,-61,-278,-260,-413,264,-1034
-21,-138,-81,28,-152,-17,-126,75,-432
62,-20,-2,56,-46,-34,-39,55,32
-104,-90,-122,-46,-217,-110,-200,-33,-922
-20,-88,-102,-17,-80,-30,-136,49,-424
-42,-82,-113,-37,-143,-11,-120,88,-460
-19,-87,-113,-2,-111,-47,-119,61,-437
16,-1,-10,7,15,-20,-5,8,10
-26,-88,-104,-12,-115,-39,-98,52,-430
-15,-73,-56,14,-68,-55,-122,34,-341
-8,-15,-11,5,-11,-7,-17,-3,-67
-9,-29,-39,-5,-70,-39,-61,24,-228
-4,-28,-25,-10,-17,-26,-31,9,-132
91,-63,-76,2,-20,-65,-93,51,-173
6,-50,-67,-22,-57,-51,-61,21,-281
7,-62,-70,-23,-145,-36,-106,54,-381
-35,-61,-87,-48,-88,-48,-99,17,-449
-132,-383,-317,-10,-560,-286,-676,54,-2310
364,10,130,178,150,-75,-152,473,1078
11,-45,-104,-64,-76,-50,-130,59,-399
-6,-69,-86,-24,-92,-85,-148,60,-450
-73,-126,-117,-35,-139,-33,-156,-15,-694
-23,-27,-62,-42,-62,-1,-60,48,-229
0,-127,-183,-1,-179,30,-193,201,-452
33,-120,-139,-9,-166,-74,-151,82,-544
-57,-95,-105,-60,-92,-61,-138,7,-601
44,-61,-42,87,-52,-50,-129,88,-115
-58,-297,-297,37,-456,-247,-613,307,-1624
-11,-16,-20,4,-10,-5,-31,24,-65
-10,-24,-43,5,-75,9,-55,26,-167
147,-178,-173,68,-268,-130,-303,197,-640
-36,-28,-95,-49,-102,-76,-136,12,-510
-21,-69,-141,-27,-119,-45,-160,65,-517
86,-6,-9,104,-7,-104,-100,8,-28
48,-1,-14,129,-109,-31,-93,119,48
-53,-87,-103,-32,-127,-36,-108,59,-487
-21,-54,-52,-15,-27,-38,-66,-21,-294
-17,-4,-26,-5,-18,-24,-23,12,-105
-44,-65,-65,-44,-79,-72,-106,17,-458
-43,-102,-95,-32,-141,-60,-145,32,-586
-61,-106,-101,-2,-158,16,-107,71,-448
97,-63,-147,-10,-66,6,-82,101,-164
48,-5,-1,67,-17,-30,-59,46,49
-44,-48,-82,-33,-50,-7,-75,39,-300
-15,-106,-84,-38,-98,-58,-108,34,-473
-67,-72,-122,-32,-172,-5,-139,58,-551
15,-23,-36,-1,-37,-9,-35,49,-77
-8,-26,-18,-18,-24,-19,-26,16,-123
6,-71,-63,4,-113,-39,-66,34,-308
9,-21,-65,-8,-155,-51,-108,51,-348
-12,-9,-9,-8,-15,-2,-14,2,-67
31,-66,-94,-21,-121,-154,-151,71,-505
-86,-66,-89,-46,-74,-36,-92,10,-479
18,-78,-69,-33,-35,-23,-105,79,-246
23,-15,-79,27,-57,-69,-126,28,-268
-21,-79,-32,-6,-78,-21,-54,17,-274
-42,-40,-65,-34,-87,-73,-130,23,-448
1,-18,-17,-13,-67,-31,-38,34,-149
14,-78,-58,10,-108,-64,-105,86,-303
-50,-290,-277,-28,-384,-224,-426,96,-1583
28,-187,-138,41,-198,-127,-199,113,-667
-44,-37,-57,3,-62,-8,-67,20,-252
-9,-49,-55,10,-80,-29,-65,23,-254
3,-31,-25,14,-20,-15,-33,7,-100
-87,-383,-373,-76,-645,-185,-537,212,-2074
7,-53,-38,-16,-82,-24,-50,38,-218
-23,-112,-71,-3,-102,-41,-87,29,-410
62,-127,-162,61,-156,-77,-191,150,-440
89,-121,-115,5,-148,-129,-180,120,-479
-2,-32,-48,-8,-62,-29,-66,21,-226
-19,-60,-74,-12,-101,-24,-71,19,-342
-45,-72,-76,-15,-96,-25,-80,23,-386
535,4,92,478,150,-236,-326,544,1241
15,-64,-71,-5,-75,-67,-131,39,-359
-2,-35,-59,-31,-50,-50,-106,23,-310
-20,-31,-50,-13,-25,-23,-42,0,-204
65,-97,-175,42,-139,-108,-239,158,-493
19,-84,-79,-72,-61,-107,-158,102,-440
114,-98,-326,-26,-162,-131,-395,369,-655
-5,-249,-234,-20,-261,-201,-432,217,-1185
5,-3,-18,12,-13,-13,-43,9,-64
-23,-47,-56,-11,-87,-18,-84,87,-239
10,-35,-51,-15,-53,-54,-58,-1,-257
13,-276,-192,42,-259,-1,-208,228,-653
17,-85,-134,-65,-139,-88,-177,104,-567
-90,-89,-110,-61,-147,0,-128,56,-569
-50,-151,-192,-27,-273,-89,-276,143,-915
65,-136,-185,-14,-161,-159,-263,151,-702
39,-160,-218,-76,-144,-256,-428,133,-1110
-10,-16,-28,-29,-31,-23,-40,-16,-193
56,-63,-60,-2,-142,-43,-79,83,-250
21,-48,-52,-17,-42,-23,-48,54,-155
42,-62,-90,11,-79,-53,-81,125,-187
10,-10,-41,9,-41,-23,-122,48,-170
-6,-27,-29,2,-16,-7,-10,1,-92
38,-92,-61,-13,-83,-19,-47,99,-178
20,-49,-46,-27,-43,-39,-45,28,-201
107,-125,-173,-63,-178,-238,-398,259,-809
-3,-27,-21,-17,-54,-32,-38,19,-173
52,-39,-55,16,-31,-39,-31,19,-108
-36,-42,-87,-41,-79,-58,-107,14,-436
60,-81,-86,-11,-109,-8,-82,111,-206
-153,-257,-292,-189,-405,-303,-587,-47,-2233
8,-51,-47,15,-91,-79,-90,-7,-342
-55,-77,-91,-5,-116,-27,-100,32,-439
21,-22,-36,-1,-46,-45,-54,15,-168
168,-87,-175,35,-113,-116,-214,282,-220
-21,-46,-57,-14,-79,-48,-63,27,-301
25,6,-28,0,9,-17,-21,25,-1
-28,-26,-30,-29,-34,-15,-17,7,-172
2,23,1,12,-26,-4,-19,14,3
-19,4,-31,-11,-37,-12,-40,4,-142
3,1,4,2,7,3,-1,-6,13
50,-201,-242,91,-244,-126,-283,132,-823
-30,-49,-45,-14,-78,-3,-56,5,-270
1,-1,-8,-3,3,0,-10,-15,-33
-18,-7,-12,-7,-22,-11,-46,48,-75
-82,-169,-240,-112,-261,-140,-285,35,-1254
14,10,-8,6,-50,-40,-37,24,-81
-10,-11,-16,-13,-18,-1,-14,12,-71
-80,-96,-97,-49,-119,7,-99,18,-515
27,-41,-3,38,-13,19,-49,77,55
-65,-104,-158,-19,-61,-3,-119,-15,-544
-25,-4,-19,14,-24,-23,-39,15,-105
-2,-196,-85,16,-109,-35,-162,80,-493
-41,-103,-86,-9,-81,-35,-146,76,-425
92,-56,-57,43,-125,-61,-132,196,-100
102,-43,-9,49,-88,-55,-156,210,10
-50,-34,-33,-48,-38,-41,-62,2,-304
-48,-72,-295,7,-301,-157,-370,75,-1161
-121,-154,-264,-111,-214,-172,-357,36,-1357
-39,-93,-58,26,-124,-49,-131,59,-409
-38,-30,-19,-10,-58,-22,-54,-6,-237
195,-56,-78,136,-152,-125,-294,300,-74
-20,-62,-59,-2,-98,-22,-101,22,-342
-26,-58,-66,12,-108,-37,-104,16,-371
-32,-22,-56,-30,-110,-50,-96,24,-372
-19,-36,-45,-16,-43,6,-54,37,-170
-21,-32,-41,-22,-33,-43,-72,17,-247
-14,-73,-65,57,-106,-10,-96,94,-213
-91,-126,-117,-52,-176,-85,-173,31,-789
-72,-95,-97,-33,-131,-44,-132,43,-561
-18,-128,-105,-9,-141,-46,-155,42,-560
-31,-35,-44,-23,-62,-21,-61,33,-244
-15,-54,-42,-16,-58,-29,-54,5,-263
407,-319,-634,-169,-104,-991,-1313,920,-2203
-152,-183,-237,-74,-136,-84,-187,-16,-1069
12,-12,-45,23,-44,-15,-34,32,-83
15,-215,-321,-19,-341,-142,-399,83,-1339
-30,-54,-62,-44,-83,-19,-84,28,-348
-29,-68,-45,15,-100,7,-87,62,-245
-60,-187,-215,-27,-368,-111,-233,71,-1130
-13,-81,-78,13,-106,-80,-95,16,-424
4,-41,-59,-8,-98,-54,-76,2,-330
-38,-52,-70,-38,-66,-43,-78,20,-365
16,-63,-45,-10,-78,-64,-50,43,-251
-41,-55,-64,-1,-82,-30,-85,24,-334
10,-10,-4,5,-23,-22,-26,-8,-78
-21,-119,-118,-19,-150,-44,-126,46,-551
42,3,-60,6,-51,-54,-72,38,-148
-99,-264,-300,-231,-334,-267,-380,118,-1757
-17,-64,-59,-41,-55,-44,-60,25,-315
-35,-58,-61,-9,-87,-37,-69,9,-347
-37,-72,-72,-24,-86,-36,-115,18,-424
-9,-31,-62,-37,-79,-42,-84,53,-291
-13,-106,-82,13,-169,-47,-118,84,-438
96,-42,5,62,-44,-59,-52,87,53
13,-24,-64,-34,-60,-42,-71,45,-237
-56,-117,-110,-4,-180,-50,-165,50,-632
35,-94,-57,22,-123,-25,-106,123,-225
14,-64,-53,29,-109,-42,-55,48,-232
36,-207,-181,-127,-66,-170,-204,53,-866
-59,-76,-107,-54,-111,-72,-190,-52,-721
-37,-74,-105,-32,-105,-76,-179,36,-572
9,-87,-85,73,-125,67,-135,158,-125
-61,-121,-138,-44,-230,-126,-233,-27,-980
11,-54,-34,25,-83,-27,-68,44,-186
6,-38,-63,-11,-78,-37,-114,10,-325
-32,-70,-46,-34,-73,-51,-52,9,-349
-39,-55,-50,-8,-76,-3,-60,41,-250
-18,-251,-257,-29,-341,-189,-300,82,-1303
-20,-24,-33,-23,-31,-14,-28,6,-167
36,-34,-62,-10,-3,13,-28,59,-29
-143,-195,-220,-89,-314,-107,-237,48,-1257
-76,-125,-104,-47,-143,-61,-124,24,-656
-12,-50,-33,-13,-45,-13,-23,6,-183
-3,7,-7,-4,3,-28,-28,-26,-86
36,-52,-32,44,-36,-69,-93,43,-159
-53,-128,-98,5,-149,-66,-170,23,-636
-32,-51,-53,8,-62,-24,-83,13,-284
4,-25,-26,-17,-60,-2,-47,11,-162
-120,-211,-224,-81,-318,-156,-352,82,-1380
7,-98,-70,4,-59,-46,-104,67,-299
-82,-108,-90,10,-164,-12,-105,40,-511
-73,-124,-136,-1,-207,-104,-211,23,-833
-4,-57,-59,-1,-77,-8,-48,25,-229
-23,-26,-74,-26,-38,-54,-75,33,-283
50,-103,-109,-33,-338,-150,-252,195,-740
-11,-50,-79,-5,-82,-80,-128,17,-418
-46,-76,-83,-45,-121,-48,-117,34,-502
-20,-66,-80,-30,-70,-27,-48,15,-326
-24,-61,-83,-13,-155,-62,-130,60,-468
-19,-73,-122,-29,-132,-65,-167,64,-543
-32,-66,-41,-23,-139,-78,-103,1,-481
-15,-40,-89,35,-57,-65,-119,-33,-383
-20,-30,-46,6,-35,-11,-59,21,-174
2,-49,-51,-30,-59,-45,-62,25,-269
-28,-23,-35,11,-46,-22,-55,5,-193
5,-47,-33,-9,-54,-21,-60,60,-159
19,-98,-112,-54,-82,-69,-84,96,-384
-21,-61,-78,-14,-83,-53,-108,10,-408
-14,-53,-76,-3,-83,-68,-92,21,-368
5,-9,3,0,-21,-4,-13,18,-21
-18,-3,-36,-18,-64,-53,-73,4,-261
0,-19,-53,-44,-42,-41,-44,11,-232
105,-110,-132,45,-211,-34,-161,222,-276
-80,-85,-98,-76,-134,-104,-200,-32,-809
-29,-22,-21,-10,-33,-2,-40,9,-148
117,-76,-160,41,-255,-118,-330,259,-522
-10,6,6,40,-19,-16,-42,5,-30
7,-56,-63,6,-126,-65,-103,83,-317
-46,-98,-47,-17,-93,-29,-81,3,-408
-15,-30,-51,-35,-49,-35,-63,39,-239
-19,-36,-15,-14,-23,-12,-35,5,-149
11,-148,-138,-37,-200,-82,-194,69,-719
-55,-192,-158,-58,-242,-126,-252,67,-1016
-21,-20,-47,-21,-45,-6,-27,25,-162
-28,-23,-48,-28,-78,-57,-86,-4,-352
-11,-18,-20,-11,-25,4,-17,12,-86
-3,-24,-10,32,-20,-24,-3,-7,-59
-4,-15,-16,-5,-16,-9,-10,-5,-80
17,-31,-41,12,-108,-50,-64,40,-225
-4,-12,-21,5,-16,-2,-13,30,-33
29,-103,-72,64,-30,-111,-149,87,-285
-7,-68,-83,-34,-44,-36,-83,13,-342
-9,-46,-34,12,-54,-10,-40,20,-161
16,-49,-66,-2,-61,-45,-82,50,-239
-19,-58,-75,-36,-76,4,-49,34,-275
-6,-17,-207,-1,-152,-10,-173,60,-506
-31,-119,-107,-8,-182,-36,-139,47,-575
93,-162,-162,41,-188,-173,-299,191,-659
31,-65,-63,46,-97,0,-60,83,-125
-60,-46,-134,-84,-65,-63,-176,2,-626
47,-13,1,32,-11,-20,-36,65,65
-121,-183,-187,-67,-305,-120,-262,-2,-1247
-82,-275,-336,-161,-515,-304,-430,29,-2074
-39,-153,-128,-39,-271,-32,-235,90,-807
-29,-78,-89,16,-107,-29,-134,65,-385
5,1,-30,22,-30,-5,-30,26,-41
66,-71,-84,43,-83,-63,-125,155,-162
18,-135,-226,-31,-279,-165,-292,186,-924
167,-103,-199,100,-36,-58,-177,294,-12
51,-129,-273,-33,-179,-255,-357,117,-1058
32,-175,-206,-82,-122,-133,-243,165,-764
305,-172,-435,45,-382,-210,-555,645,-759
17,-278,-359,-112,-553,-604,-823,-256,-2968
197,-272,-460,-70,-267,-314,-610,431,-1365
440,-293,-190,197,-115,-270,-492,526,-197
-42,-304,-260,-33,-423,-169,-356,265,-1322
-63,-173,-169,-38,-173,-44,-175,142,-693
65,-96,-126,12,-152,-69,-194,178,-382
52,-31,-74,-8,-121,-125,-143,62,-388
81,-133,-273,5,-330,-141,-258,271,-778
-56,-135,-104,-11,-175,-65,-154,48,-652
-69,-73,-163,-82,-72,-93,-255,89,-718
170,-153,-267,9,-117,-135,-462,379,-576
-38,-33,-80,-34,-70,-131,-205,5,-586
-315,-483,-526,-252,-715,-439,-804,-26,-3560
215,-289,-231,-78,-101,-226,-453,354,-809
77,-146,-203,16,-123,-106,-241,219,-507
84,-227,-241,-52,-245,-187,-284,202,-950
3,-124,-113,9,-149,-55,-120,68,-481
94,-61,-213,-17,-319,-86,-339,164,-777
65,-75,-83,53,-115,-36,-117,170,-138
167,-111,-124,94,-97,-138,-214,159,-264
-48,-44,-97,-55,-114,-53,-149,23,-537
107,-125,-192,-60,-265,-197,-291,123,-900
-33,-164,-190,-40,-234,-201,-296,17,-1141
408,-84,-221,20,-141,-305,-360,281,-402
-14,-159,-144,38,-188,-40,-176,156,-527
14,-102,-110,-3,-165,-30,-130,169,-357
-525,-137,-320,-474,-349,-342,-793,-509,-3449
11,-39,-57,0,-61,-58,-111,69,-246
-186,-26,-127,-121,-143,-174,-301,-143,-1221
74,-99,-154,70,-265,-176,-185,16,-719
0,-116,-200,-126,-275,-209,-400,126,-1200
76,-70,-153,100,-129,-188,-244,99,-509
-41,-107,-115,-18,-145,-70,-137,18,-615
11,-48,-54,-7,-71,-79,-96,45,-299
-110,-103,-146,-59,-166,-92,-198,-27,-901
-23,-2,-14,-24,-37,-19,-26,-5,-150
129,-39,-48,28,46,-42,-77,138,135
-53,-248,-218,39,-360,-65,-299,242,-962
101,-120,-122,53,-129,-104,-165,72,-414
-27,-56,-64,-17,-77,-15,-73,29,-300
-35,-85,-42,12,-90,-18,-89,22,-325
-30,-37,-41,36,-64,9,-101,35,-193
13,-74,-54,40,-61,-36,-73,60,-185
-14,-87,-72,9,-85,-40,-91,72,-308
1,7,-11,9,-6,-22,-27,18,-31
-36,-71,-74,-15,-135,-41,-113,31,-454
16,-58,-74,24,-97,-27,-59,57,-218
-1,-63,-54,6,-88,-12,-56,32,-236
-18,-30,-25,1,-26,-13,-46,6,-151
-37,-192,-184,-58,-206,-57,-224,94,-864
-2,-49,-73,4,-92,-47,-75,29,-305
-17,0,-16,-2,-12,-4,-36,12,-75
4,-63,-44,10,-47,-108,-146,61,-333
1,-64,-39,-11,-106,-28,-51,46,-252
3,-25,-24,7,-32,10,-47,63,-45
26,-129,-143,2,-118,-68,-193,150,-473
4,-41,-29,4,-32,-2,-53,78,-71
37,-80,-109,-42,-100,-126,-200,156,-464
-8,-21,-17,5,-28,-7,-22,13,-85
34,13,-13,31,-42,-40,-55,10,-62
55,-84,-25,55,-47,-20,-89,100,-55
-10,-5,-18,-7,-43,-17,-34,3,-131
-4,-52,-60,-28,-80,-40,-56,47,-273
19,-88,-126,31,-180,-102,-167,100,-513
64,-132,-151,2,-206,-188,-271,157,-725
24,-96,-100,-18,-78,-44,-82,83,-311
-35,-76,-99,-21,-94,-14,-76,14,-401
-17,-30,-38,-28,-49,-17,-34,8,-205
72,-30,-46,55,-69,-39,-113,183,13
14,-89,-114,-60,-180,-125,-241,145,-650
-7,-1,-12,2,-8,-21,-32,-13,-92
-20,-108,-90,-69,-90,-62,-136,48,-527
-27,-29,-35,-30,-56,-25,-54,-3,-259
-68,-126,-133,-64,-161,-59,-133,82,-662
-3,-5,-20,-10,-10,-19,-14,2,-79
9,-76,-90,21,-65,-29,-97,60,-267
-65,-147,-162,-63,-179,-61,-179,86,-770
-37,-120,-89,-11,-137,-24,-89,81,-426
65,-422,-494,-5,-654,-615,-863,370,-2618
111,-50,-108,45,-80,-23,-96,153,-48
4,-74,-76,-12,-103,-67,-89,32,-385
95,-28,-3,58,38,-32,-121,173,180
-25,-14,-41,-28,-15,-21,-27,15,-156
-13,-5,-15,-4,-28,-6,-19,4,-86
68,-34,-62,-27,-18,-130,-225,44,-384
-4,-28,-32,-4,-60,-10,-40,28,-150
-101,-111,-120,-35,-174,-49,-173,30,-733
-83,-84,-101,-30,-181,-82,-169,34,-696
-15,-50,-46,-3,-44,-24,-49,-1,-232
2,-127,-144,-28,-189,-126,-200,17,-795
-18,-43,-51,-46,-20,-61,-105,33,-311
-34,-58,-53,-18,-68,-18,-62,35,-276
-82,-76,-120,-61,-153,-54,-182,45,-683
-49,-61,-59,-8,-76,-38,-82,18,-355
-23,-15,-13,-14,-13,-7,-17,5,-97
-10,-78,-63,-9,-75,-37,-59,12,-319
107,-74,-169,22,-64,-58,-159,257,-138
18,-23,-40,8,-69,-36,-69,8,-203
-64,-67,-78,-38,-112,-41,-143,20,-523
-43,-61,-89,4,-130,-36,-157,27,-485
-13,-18,-22,-17,-21,-26,-37,1,-153
-27,-72,-131,-80,-173,-198,-260,-68,-1009
-5,-198,-131,61,-262,-164,-247,-56,-1002
-24,-109,-123,-41,-137,-114,-172,34,-686
22,-73,-104,-27,-89,-41,-103,107,-308
-16,-128,-166,-15,-260,-93,-232,120,-790
11,-23,-41,-12,-50,-45,-46,19,-187
-22,-29,-12,-15,-46,-1,-40,6,-159
-47,-68,-75,-31,-120,-47,-133,12,-509
3,19,-26,14,10,-16,-18,5,-9
-93,-120,-116,-33,-197,-31,-175,101,-664
-74,-119,-168,-67,-195,-82,-221,20,-906
-20,-74,-67,-20,-76,-62,-115,-13,-447
-20,-27,-25,-13,-28,-5,-24,7,-135
-24,-135,-134,-28,-201,-21,-137,55,-625
-21,-11,-42,-3,13,-9,-23,-2,-98
37,-87,-56,24,-80,-32,-104,109,-189
90,-97,-35,8,-46,-108,-162,124,-226
-60,-77,-110,-48,-150,-57,-176,67,-611
41,46,-39,23,-45,-23,-85,60,-22
18,-146,-183,-77,-196,-142,-318,178,-866
-105,-324,-327,-162,-499,-355,-514,66,-2220
55,-6,-7,18,-19,-60,-84,34,-69
-17,-85,-45,28,-94,-29,-72,64,-250
1,-49,-49,21,-55,-39,-52,21,-201
-57,-123,-130,-5,-157,-18,-166,56,-600
-61,-90,-136,-15,-163,-71,-167,50,-653
12,-69,-16,52,-99,-12,-53,76,-109
-49,-37,-127,-52,-203,-112,-185,28,-737
-40,-42,-62,-48,-83,-52,-84,26,-385
-15,-62,-97,-20,-67,-31,-151,68,-375
18,-44,-39,21,-30,-14,-35,53,-70
-18,-23,-31,-15,-3,-13,-34,-14,-151
23,-63,-40,53,-57,4,-61,100,-41
-16,-63,-142,7,-158,38,-141,132,-343
-119,-186,-159,-76,-315,-127,-275,-4,-1261
116,-200,-175,-37,-239,-281,-390,205,-1001
-18,-14,-31,-27,-73,-17,-71,25,-226
-64,-73,-131,-14,-187,-25,-155,94,-555
21,-17,-75,9,-25,-108,-56,100,-151
-43,-6,-106,4,-68,-138,-71,99,-329
360,-157,-446,-25,-256,-543,-824,419,-1472
-16,-72,-109,-18,-145,-69,-118,85,-462
12,1,8,4,7,-15,-15,11,13
-10,-29,-29,7,-38,-7,-45,37,-114
-17,-35,-43,-16,-57,-14,-37,23,-196
-134,-313,-338,-115,-498,-198,-451,164,-1883
-145,-271,-284,-117,-426,-130,-435,109,-1699
-155,-220,-297,-126,-441,-121,-424,124,-1660
4,-75,-29,6,-52,-4,-44,63,-131
-8,-34,-50,-6,-46,-22,-46,19,-193
43,-34,-67,-38,49,-50,-40,96,-41
-124,-169,-186,-43,-199,-36,-254,20,-991
-73,-159,-164,33,-205,-15,-227,73,-737
15,-103,-73,-20,-133,-93,-142,34,-515
-44,-98,-83,-22,-102,-4,-88,46,-395
-20,-31,-34,-26,-28,-3,-25,18,-149
2,-49,-81,-6,-42,-32,-67,41,-234
-19,-60,-78,-2,-53,-24,-53,26,-263
-8,-40,-73,-19,-53,-43,-65,22,-279
-60,-58,-96,-57,-118,-102,-155,-4,-650
-18,-126,-106,5,-155,-49,-110,55,-504
47,-82,-81,3,-89,-59,-120,87,-294
-11,-39,-47,8,-51,-30,-63,-6,-239
-46,-26,-23,-3,-28,-23,-56,-5,-210
1,-45,-41,-8,-54,-23,-53,32,-191
4,-22,-41,-12,-42,-57,-80,27,-223
3,-69,-60,-6,-86,-39,-95,38,-314
90,-5,-8,123,-28,19,-75,135,251
9,-7,-19,13,-38,-24,-25,16,-75
-5,-15,-20,-12,-31,-16,-37,-9,-145
28,-72,-165,4,-136,-62,-113,147,-369
-61,-76,-84,-65,-123,-80,-126,2,-613
-4,-29,-64,3,-30,-2,-50,33,-143
7,-44,-37,-18,-45,-61,-91,24,-265
22,7,-3,104,-104,-26,-91,94,3
3,-53,-45,-22,-65,-43,-71,40,-256
-8,-27,-42,-44,-33,-35,-46,6,-229
-4,-66,-75,-25,-92,-76,-90,24,-404
-25,-103,-127,-76,-136,-118,-171,14,-742
-43,-77,-89,-48,-127,-44,-113,41,-500
-10,-91,-90,-9,-109,-55,-119,39,-444
50,-65,-92,-29,-72,-109,-134,41,-410
168,-119,-149,59,-168,-152,-322,274,-409
-72,-50,-74,-59,-64,-58,-92,-37,-506
-16,-34,-25,15,-34,-2,-48,6,-138
-14,-30,-33,-3,-35,-21,-43,-23,-202
10,-10,-28,-8,-32,6,-3,19,-46
-2,-23,-33,23,-16,-20,-42,29,-84
-17,-12,-37,-16,-26,-19,-50,14,-163
5,-89,-87,-8,-71,-37,-86,67,-306
78,-164,-215,135,-214,-113,-278,132,-639
2,-26,-56,-15,-61,-48,-75,7,-272
-51,-68,-89,-51,-124,-36,-106,63,-462
-45,-87,-115,-62,-118,-67,-196,62,-628
-64,-75,-104,-67,-131,-92,-167,0,-700
-39,-101,-104,-39,-134,-6,-112,72,-463
-43,-134,-105,-34,-191,-73,-154,18,-716
-11,-144,-184,-43,-251,-195,-285,64,-1049
-21,-45,-82,-10,-73,-12,-88,19,-312
-76,-445,-582,-155,-702,-507,-706,94,-3079
8,-139,-159,-17,-151,-119,-248,64,-761
170,-225,-211,-3,-74,-196,-425,241,-723
-10,-92,-126,-33,-101,-33,-132,84,-443
-100,-185,-251,-169,-339,-217,-330,-9,-1600
86,-331,-338,-138,-444,-324,-459,294,-1654
-7,-66,-86,-25,-69,-84,-97,76,-358
116,-11,-83,97,-103,-47,-88,144,25
58,-211,-283,104,-313,-3,-349,373,-624
-52,-89,-146,-23,-108,-54,-120,65,-527
-2,-8,-35,7,-50,-20,-48,13,-143
-31,-73,-70,-23,-119,-72,-77,-7,-472
-53,-110,-82,7,-83,-3,-67,35,-356
-74,-72,-98,-79,-142,-66,-150,0,-681
2,-54,-90,-35,-116,-72,-112,34,-443
7,-41,-38,-10,-29,-6,-17,33,-101
66,-69,-146,48,-175,-139,-263,143,-535
-17,-85,-114,-35,-121,-97,-150,97,-522
48,-66,-16,34,-13,-51,-74,74,-64
-17,-102,-105,-31,-138,-92,-167,28,-624
-2,-72,-74,-33,-67,-97,-161,102,-404
-66,-82,-122,-86,-136,-60,-163,52,-663
-62,-111,-141,-53,-165,-34,-159,86,-639
-92,-118,-176,-81,-255,-114,-229,35,-1030
-20,-56,-44,-15,-79,-52,-89,40,-315
37,-39,-70,-13,-72,-51,-73,55,-226
-9,-38,-47,-25,-67,-59,-67,20,-292
-28,-97,-79,-13,-126,-86,-149,15,-563
-38,-115,-159,-24,-222,-124,-232,99,-815
31,-3,-25,38,-15,-32,-43,30,-19
18,-57,-39,36,-7,-29,-69,66,-81
90,-32,-12,71,-25,-17,-32,92,135
2,-91,-73,-24,-125,-74,-94,20,-459
-16,-64,-63,8,-70,-53,-89,40,-307
-4,-23,-14,-3,-24,-32,-34,15,-119
-12,-9,-20,-9,-20,-12,-19,-3,-104
-103,-126,-161,-98,-202,-98,-217,-12,-1017
-27,-116,-94,-14,-157,-123,-171,3,-699
5,-70,-84,20,-70,-18,-78,61,-234
-3,-89,-72,28,-103,-89,-150,-23,-501
106,-88,-48,-1,-47,-135,-177,103,-287
-27,-81,-158,-4,-167,-78,-184,102,-597
-21,-57,-30,30,-80,-24,-96,43,-235
-45,3,-89,-98,-107,-133,-185,5,-649
2,-51,-38,21,-37,-7,-80,43,-147
-39,-93,-166,-61,-179,-164,-245,6,-941
-45,-41,-82,-44,-107,-59,-150,-11,-539
19,-56,-70,9,-47,-49,-110,67,-237
-26,-143,-149,-38,-247,-133,-274,94,-916
-48,-94,-156,-24,-69,-11,-82,37,-447
27,-52,-74,39,-79,-23,-43,62,-143
-50,-169,-195,-134,-283,-209,-309,27,-1322
-102,-94,-99,-37,-126,-10,-148,1,-615
-4,-124,-114,-1,-178,-59,-147,39,-588
22,-89,-156,-9,-146,-37,-152,123,-444
-6,-114,-154,-77,-191,-109,-140,57,-734
-104,-214,-225,-42,-354,-192,-340,62,-1409
-25,-73,-60,6,-121,-71,-94,9,-429
-97,-81,-126,-28,-63,-51,-89,-26,-561
-13,-46,-63,-18,-78,-78,-134,30,-400
73,-52,-87,31,-53,-56,-161,152,-153
120,-79,-136,65,-93,-20,-102,182,-63
-93,-185,-206,-46,-267,-45,-255,117,-980
-13,-34,-49,2,-94,-12,-92,56,-236
-13,-67,-71,-45,-79,-69,-80,32,-392
28,-56,-94,0,-85,-21,-121,87,-262
-19,-23,-48,-6,-48,-20,-45,23,-186
22,-53,-74,-48,-120,-96,-118,29,-458
-12,-29,-41,-9,-41,-13,-45,1,-189
-31,-20,-18,-32,-17,-16,-38,-10,-182
-216,-391,-477,-131,-86,15,-227,-105,-1618
26,-31,-24,46,-34,-24,-32,68,-5
-33,-98,-100,-36,-132,-39,-138,20,-556
-129,-177,-182,-41,-125,-63,-118,-4,-839
15,-50,-46,-7,-36,-34,-101,59,-200
79,-68,-2,81,20,-72,-104,96,30
-57,-116,-156,-70,-196,-119,-198,44,-868
79,-233,-282,-35,-324,-143,-318,244,-1012
87,-11,19,56,-7,-53,-74,83,100
-40,-105,-130,-99,-105,-86,-161,7,-719
9,-22,-36,31,-40,2,-24,60,-20
13,-9,-37,-12,-39,-23,-39,13,-133
17,-36,-42,-4,-54,-42,-44,-1,-206
41,-83,-69,66,-153,13,-58,135,-108
4,-64,-50,2,-62,-39,-73,18,-264
-82,-129,-167,-65,-192,-64,-193,19,-873
-9,44,-17,-1,-9,-5,-52,5,-44
-36,-133,-132,35,-224,-33,-192,115,-600
122,-237,-246,-4,-250,-101,-332,320,-728
-18,-64,-62,-17,-127,-82,-103,19,-454
-30,-211,-180,-134,-254,-137,-348,167,-1127
58,-95,-51,12,-42,-72,-54,39,-205
13,-107,-82,-27,-86,-77,-140,33,-473
17,-16,-9,18,-27,19,-12,36,26
-10,-16,-43,19,-80,-44,-111,30,-255
116,-363,-159,200,-263,34,-238,286,-387
-34,-102,-149,-16,-185,-43,-136,119,-546
-45,-64,-48,-3,-100,-47,-87,19,-375
27,-41,-93,-49,-124,-59,-97,97,-339
70,-69,-37,24,-11,-76,-128,102,-125
5,-41,-47,-9,-64,-28,-60,13,-231
25,-79,-57,10,-77,-87,-89,1,-353
-105,-125,-176,-40,-247,-36,-225,71,-883
0,-81,-168,-114,-145,-49,-151,83,-625
128,22,-85,68,13,-22,-38,84,170
-90,-317,-431,-121,-583,-348,-732,417,-2205
-43,-61,-67,-68,-111,-57,-99,13,-493
12,6,-14,1,-24,-9,-6,-2,-36
1,-90,-85,-6,-75,-59,-99,25,-388
-35,-104,-112,8,-119,-25,-101,99,-389
-12,-23,-53,-26,-65,-50,-98,45,-282
-66,-122,-144,-60,-258,-23,-200,139,-734
-40,-10,-15,-32,-42,-26,-61,-7,-233
117,-33,-8,25,-3,-62,-143,201,94
-127,-260,-178,-20,-338,-86,-245,101,-1153
7,-35,-5,22,-23,-24,-54,32,-80
117,-10,-46,140,-50,-53,-134,195,159
-27,-122,-117,17,-152,-104,-198,78,-625
-5,-135,-144,-11,-167,-98,-232,176,-616
-62,-95,-63,-56,-119,-30,-73,14,-484
7,-53,-46,-37,-99,-99,-151,86,-392
-31,-53,-67,-59,-106,-89,-117,-11,-533
-43,-52,-76,-18,-88,-32,-92,28,-373
14,-90,-100,17,-137,-22,-110,132,-296
10,-17,-24,-16,-19,-36,-43,3,-142
-18,-79,-59,-15,-57,3,-62,30,-257
-23,-32,-55,-29,-64,-40,-68,30,-281
41,-38,-46,-21,-23,-51,-108,83,-163
59,-21,-13,41,-17,-29,-77,69,12
-6,-57,-98,-44,-102,-106,-161,65,-509
-11,-41,-62,-4,-97,-10,-94,62,-257
-5,-67,-64,4,-54,-17,-78,59,-222
15,-125,-107,26,-141,-76,-127,63,-472
-28,-65,-74,-39,-74,-29,-67,37,-339
-2,-13,-26,-10,-25,-6,-13,6,-89
-16,-61,-53,-3,-64,-59,-103,-7,-366
-63,-188,-199,-62,-317,-182,-283,-1,-1295
82,-109,-166,-65,-92,-240,-316,76,-830
-12,-31,-70,-7,-42,-29,-71,44,-218
0,-6,-29,-15,-56,-37,-44,15,-172
48,-39,-54,37,-68,-18,-64,104,-54
-49,-85,-111,-53,-151,-83,-156,37,-651
-33,-33,-65,-12,-61,-29,-74,30,-277
0,-43,-78,-23,-61,-53,-74,31,-301
-17,-5,-33,-16,-29,-45,-48,-1,-194
-23,-131,-131,-52,-167,-84,-154,79,-663
-62,-138,-136,-71,-154,-26,-131,68,-650
-15,-60,-71,-40,-97,-56,-119,5,-453
-9,-12,-21,12,-54,-9,-44,7,-130
-17,-71,-76,-9,-45,-27,-60,29,-276
-12,-4,-4,7,-48,-39,-55,1,-154
3,-53,-22,19,1,-15,-74,78,-63
27,-41,-54,20,-48,-16,-55,62,-105
-5,-1,-23,10,-24,-23,-29,12,-83
-33,-59,-69,4,-80,8,-72,21,-280
42,-111,-78,-23,-107,-34,-56,76,-291
-82,-52,-98,-81,-103,-84,-194,-17,-711
-15,-33,-36,-6,-34,-27,-51,12,-190
63,-50,-7,26,41,-44,-30,125,124
-16,-43,-43,-24,-59,-25,-47,5,-252
11,-13,-21,7,-11,-14,-12,-11,-64
-14,-15,-24,-12,-17,-7,-30,8,-111
3,-5,-21,1,-20,-10,-19,7,-64
-12,-59,-41,8,-48,5,-59,50,-156
-3,-20,-32,3,-21,-21,-38,20,-112
-14,-44,-45,-5,-75,-24,-60,27,-240
22,-149,-171,38,-156,-102,-182,78,-622
2,-76,-33,24,-66,-2,-13,64,-100
17,7,-15,3,-5,-6,-16,7,-8
-3,-88,-71,-21,-101,-52,-79,34,-381
7,-62,-38,31,-34,-11,-65,49,-123
8,-76,-83,-14,-60,-17,-55,97,-200
-30,-54,-50,-21,-44,2,-37,-7,-241
-44,-137,-86,37,-221,-148,-215,-61,-875
-24,-40,-33,-8,-62,-20,-44,10,-221
-13,-23,-29,1,-52,-9,-56,32,-149
17,-65,-39,8,-47,-62,-78,45,-221
-12,-3,-10,5,-6,-9,-11,-12,-58
7,-7,-22,-15,-40,-28,-39,14,-130
59,57,-52,81,-37,-29,-103,57,33
-58,-59,-70,-27,-90,-14,-80,23,-375
40,-90,-63,-17,-46,-88,-130,104,-290
-28,-28,-39,-29,-70,-4,-60,23,-235
-59,-53,-49,-18,-90,-31,-87,-16,-403
14,-49,-49,-8,-50,-17,-39,44,-154
-16,-26,-18,0,-63,-27,-34,21,-163
-64,-132,-160,-51,-215,-71,-203,42,-854
-61,-108,-107,-34,-130,-41,-109,48,-542
-6,-23,-32,-6,-77,-29,-68,7,-234
35,-49,-28,56,-42,-32,-44,62,-42
28,-67,-36,39,-55,-22,-46,47,-112
18,-30,-47,18,-60,-23,-61,42,-143
5,-17,-8,10,-17,-51,-94,36,-136
8,-19,-21,62,-49,-25,-76,7,-113
-14,-68,-65,-19,-57,-62,-82,-9,-376
15,-2,-6,8,12,-14,-2,-1,10
-27,-52,-46,-11,-59,-16,-67,37,-241
-59,-73,-75,-35,-107,-48,-129,40,-486
-42,-72,-87,-27,-111,-55,-112,58,-448
-23,-44,-78,-4,-137,-42,-159,7,-480
15,-71,-80,9,-88,-49,-85,22,-327
-125,-200,-226,-77,-267,-100,-315,14,-1296
-12,1,-10,-5,-13,-12,-36,-22,-109
-43,-73,-92,-40,-97,-20,-90,31,-424
-22,-29,-47,-23,-32,-16,-48,12,-205
-25,-5,-17,-12,-32,-28,-34,18,-135
-27,-75,-55,42,-80,-57,-91,-13,-356
62,-88,-110,48,-151,-108,-135,72,-410
1,-28,-97,-43,-133,-74,-118,44,-448
-11,-31,-39,-21,-74,-75,-73,16,-308
14,-83,-57,11,-96,-125,-131,4,-463
-18,-29,-48,-49,-60,-38,-93,10,-325
105,-31,12,119,-22,-88,-102,80,73
-6,-63,-103,-82,-140,-97,-121,62,-550
-42,-98,-71,10,-48,-1,-119,32,-337
-14,-84,-108,33,-129,-41,-127,72,-398
-6,-54,-32,38,-58,-11,-71,16,-178
-15,-64,-70,8,-64,-47,-72,9,-315
7,-61,-57,-9,-85,-34,-74,47,-266
-56,-159,-181,-4,-234,-110,-252,60,-936
35,-36,-20,41,-50,-46,-29,2,-103
12,-41,-33,35,-55,8,-68,51,-91
-85,-222,-231,-66,-351,-95,-273,146,-1177
24,-72,-96,5,-131,-39,-90,33,-366
24,15,-46,10,-54,-31,-50,58,-74
-50,-122,-174,-23,-188,-46,-185,71,-717
-68,-113,-106,-37,-135,-26,-112,30,-567
-41,-33,-75,-63,-74,-80,-110,34,-442
21,-124,-86,31,-149,-25,-120,49,-403
3,-96,-111,-59,-166,-164,-260,110,-743
-31,-106,-109,72,-155,23,-137,121,-322
-27,-64,-148,-51,-84,-104,-175,84,-569
-21,-40,-54,-20,-43,-38,-82,1,-297
-25,-21,-32,-16,-32,-6,-46,5,-173
-34,-199,-120,-27,-222,-76,-235,127,-786
-51,-108,-109,-47,-137,-68,-113,6,-627
-3,-7,-28,-21,-32,-27,-34,8,-144
-52,-95,-87,-44,-76,-27,-71,20,-432
-34,-93,-84,-41,-117,-36,-125,35,-495
47,-75,-80,-17,-82,-123,-132,57,-405
-17,-9,-14,-9,-20,-12,-29,-14,-124
-14,-58,-18,10,-28,-15,-63,24,-162
-3,-25,-26,-10,-31,1,-21,22,-93
-30,-36,-29,-25,-39,-14,-27,28,-172
-78,-73,-95,-43,-140,-57,-101,14,-573
-18,-58,-54,-12,-77,-32,-53,-3,-307
-39,-137,-222,-98,-303,-164,-312,125,-1150
-36,-81,-89,42,-151,1,-134,105,-343
6,-37,-42,-8,-73,-69,-120,75,-268
-18,-71,-64,-29,-79,-46,-65,5,-367
-5,-13,-20,7,-27,-21,-21,1,-99
1,-15,-22,-1,-12,-17,-34,-5,-105
13,-10,-25,9,3,-15,-12,13,-24
-131,-391,-488,-204,-731,-394,-738,54,-3023
-53,-156,-187,-102,-255,-156,-319,28,-1200
21,-18,-29,0,-29,-54,-70,3,-176
-19,-30,-21,-10,-39,0,-25,12,-132
-7,-67,-56,24,-101,2,-86,57,-234
-6,-55,-186,-28,-155,-91,-239,63,-697
23,10,-39,11,-11,4,-47,48,-1
12,-6,-47,14,-74,-57,-116,21,-253
46,-67,-110,-39,-116,-94,-127,83,-424
-5,-267,-313,4,-275,-207,-461,243,-1281
-49,-209,-259,38,-280,-25,-330,168,-946
-79,-67,-58,-31,-66,-68,-113,20,-462
-81,-253,-203,-69,-287,-169,-349,178,-1233
86,-55,-111,48,-230,22,-143,270,-113
21,-32,-11,23,-8,-48,-74,41,-88
-29,-42,-63,-24,-131,-21,-77,40,-347
-23,-25,-31,-8,-30,-5,-27,23,-126
23,-6,-27,6,-36,-19,-38,28,-69
-13,-63,-62,-15,-88,-49,-84,62,-312
-2,-13,-11,5,-14,-2,-14,-3,-54
-119,-170,-150,-61,-184,-105,-264,12,-1041
-67,-214,-195,-52,-316,-114,-302,114,-1146
-15,-37,-66,19,-45,-26,-91,16,-245
67,-44,-64,19,-90,-110,-114,62,-274
57,-62,-163,-32,-239,-83,-212,189,-545
38,-35,-65,-10,-100,-31,-96,100,-199
-8,-329,-552,-37,-272,-59,-397,286,-1368
-86,-84,-122,-96,-167,-92,-239,-62,-948
15,-76,-107,23,-60,-61,-189,77,-378
-22,-90,-117,-11,-139,-61,-136,96,-480
-179,-457,-492,-277,-711,-530,-745,0,-3391
-30,-223,-200,-75,-293,-150,-281,71,-1181
42,-53,-101,16,-139,-59,-126,130,-290
140,-219,-220,39,-210,-141,-349,307,-653
-92,-291,-346,-102,-246,-218,-529,84,-1740
8,-89,-132,-26,-201,-92,-168,66,-634
-65,-52,-143,-31,-142,-75,-222,85,-645
38,18,-29,44,-79,-97,-194,36,-263
-13,-129,-191,-23,-265,-149,-276,166,-880
-19,-42,-56,-58,-37,-87,-110,51,-358
-153,-267,-218,-122,-324,-73,-306,84,-1379
48,-120,-232,-83,-290,-142,-364,255,-928
-61,-181,-167,-65,-228,-165,-257,-46,-1170
72,-239,-305,-127,-131,-65,-224,211,-808
-124,-285,-341,-108,-416,-178,-392,194,-1650
-98,-171,-166,-121,-240,-124,-250,-17,-1187
13,-93,-152,67,-69,-15,-167,136,-280
7,-242,-354,-80,-444,-221,-485,274,-1545
73,-99,-102,-15,-109,-70,-141,125,-338
73,-78,-116,41,-194,-77,-169,158,-362
55,-85,-102,44,-127,-55,-139,102,-307
-72,-246,-345,-61,-417,-125,-406,195,-1477
102,-187,-282,-10,-325,-163,-299,344,-820
-98,-194,-226,-123,-310,-144,-306,62,-1339
16,-104,-112,-36,-111,-99,-187,107,-526
-115,-179,-222,-47,-269,-160,-363,116,-1239
96,-206,-256,-16,-286,-243,-451,252,-1110
-7,-93,-93,-5,-147,-122,-206,59,-614
-77,-131,-180,-58,-192,-75,-162,62,-813
5,-5,-6,3,-3,-13,-19,18,-20
-34,-63,-76,1,-98,-11,-87,63,-305
3,-13,-18,-15,-33,2,-12,16,-70
54,-36,-44,58,-66,-19,-83,112,-24
-32,-98,-96,-10,-94,-40,-115,51,-434
-16,-11,-19,-9,-10,-3,-14,7,-75
14,-177,-233,-98,-251,-242,-293,64,-1216
64,-64,-38,8,-6,-81,-166,146,-137
-9,-14,-20,0,-35,-5,-30,3,-110
-68,-77,-94,-43,-126,-39,-125,24,-548
-93,-89,-101,-47,-130,-25,-121,29,-577
-63,-63,-87,-21,-121,-6,-92,57,-396
46,-32,-36,37,-56,-147,-174,10,-352
-106,-232,-248,-80,-392,-123,-328,125,-1384
-24,-126,-95,-25,-125,-73,-121,5,-584
-54,-85,-103,-32,-119,-27,-99,20,-499
-141,-165,-234,-274,-357,-387,-528,-203,-2289
-4,-60,-89,-49,-133,-77,-133,46,-499
-101,-73,-156,-76,-177,-127,-239,-6,-955
-10,-353,-316,101,-288,-52,-358,131,-1145
-4,-101,-119,61,-161,-19,-184,138,-389
43,-285,-293,5,-422,46,-332,437,-801
-57,-123,-74,-10,-139,-71,-201,-30,-705
-124,-151,-105,-16,-192,-53,-180,61,-760
-27,-139,-108,-27,-122,-52,-128,84,-519
42,-71,-28,33,-12,-49,-78,62,-101
42,-56,-68,60,-27,-53,-68,93,-77
-85,-247,-294,-71,-340,-59,-310,153,-1253
-6,-52,-37,-10,-54,-11,-67,36,-201
-41,-87,-98,-7,-109,-6,-132,32,-448
-12,-32,-16,-11,-34,-2,-23,16,-114
158,-363,-190,643,-603,303,-606,916,258
52,-45,-59,5,-52,-70,-107,37,-239
-4,-19,-31,-9,-72,-52,-73,8,-252
67,-146,-209,-87,-244,-150,-261,197,-833
-8,-152,-166,14,-169,-67,-177,94,-631
-50,-239,-283,-34,-357,-137,-296,161,-1235
40,-103,-40,11,-49,-53,-128,133,-189
94,-12,3,69,-28,-73,-64,79,68
-40,-66,-63,-28,-88,-55,-66,-6,-412
19,-131,-93,19,-106,-37,-65,54,-340
15,-49,-19,6,-46,-59,-99,68,-183
-40,-65,-55,-22,-72,-26,-70,13,-337
-10,-15,-15,-11,-1,-8,-16,8,-68
-37,-158,-175,-39,-304,-166,-289,-8,-1176
-3,-9,-24,-21,-14,-21,-25,-8,-125
-97,-268,-374,-110,-508,-134,-427,215,-1703
-55,-133,-174,-65,-173,-109,-180,61,-828
2,2,-29,-8,-26,-34,-43,3,-133
-37,-39,-49,-20,-48,-26,-60,30,-249
-2,-66,-76,-5,-86,-11,-62,22,-286
103,-22,-21,67,-41,-122,-165,92,-109
-16,-99,-72,-14,-105,-54,-100,47,-413
49,-85,-144,-7,-105,-74,-138,87,-417
-17,-19,-35,-14,-14,-11,-41,22,-129
-78,-162,-190,-42,-182,-80,-251,52,-933
-20,-128,-88,-21,-172,-85,-154,59,-609
-11,-23,-31,7,-28,4,-47,14,-115
-6,-9,-15,-5,-15,-6,-8,3,-61
40,-52,-160,8,-141,-56,-155,108,-408
-92,-169,-162,-17,-233,-38,-241,61,-891
-129,-145,-155,-59,-219,-50,-230,36,-951
-40,-97,-97,-38,-89,-87,-118,-2,-568
-58,-138,-178,-150,-164,-239,-342,32,-1237
-8,-53,-59,21,-54,-12,-60,29,-196
-48,-20,-49,-8,-70,-10,-68,35,-238
-43,-58,-72,-15,-87,-25,-98,16,-382
248,-148,-123,120,-87,-112,-175,211,-66
-48,-125,-144,-106,-213,-152,-204,-41,-1033
-36,-126,-112,-37,-157,-70,-139,25,-652
-45,-109,-134,9,-211,-63,-168,44,-677
4,-82,-99,19,-153,-38,-133,46,-436
-3,-32,-57,-3,-70,-82,-72,35,-284
49,-51,-83,-1,-109,-78,-77,43,-307
-5,-76,-83,-41,-60,-45,-94,78,-326
-27,-102,-113,-3,-131,-16,-121,90,-423
-16,-39,-38,12,-72,-3,-53,57,-152
-52,-436,-572,-63,-475,-119,-565,458,-1824
-111,-176,-171,-16,-247,-38,-247,44,-962
-15,-37,-40,-39,-44,-17,-44,17,-219
-18,-26,-35,-21,-29,-11,-44,10,-174
-1,-101,-86,2,-130,-33,-93,58,-384
-1,-29,-15,9,-20,-33,-41,31,-99
-54,-62,-73,-69,-110,-84,-140,-7,-599
-38,-65,-84,-13,-155,-45,-145,28,-517
-43,-73,-45,18,-81,-25,-100,60,-289
-7,-27,-23,8,-21,-7,-22,-3,-102
-14,-92,-63,13,-139,-11,-87,34,-359
-11,-62,-64,-39,-103,-60,-71,27,-383
-218,-259,-333,-84,-480,-139,-443,100,-1856
-4,-64,-62,19,-49,-41,-68,-3,-272
32,-71,-81,15,-147,-76,-215,56,-487
-51,-82,-228,-110,-195,-4,-239,177,-732
-25,-76,-74,-1,-81,-26,-93,35,-341
-42,-89,-75,37,-123,-23,-116,90,-341
115,-124,-336,8,-179,-36,-331,462,-421
-19,-126,-114,-20,-179,-85,-159,48,-654
-5,-8,-10,-2,-20,-12,-8,2,-63
2,-133,-134,8,-176,-23,-179,155,-480
-10,-85,-91,-33,-125,-60,-134,28,-510
-10,-79,-106,-23,-144,-112,-168,35,-607
-20,-21,-24,-16,-18,-9,-25,10,-123
-18,-13,-55,10,-75,-20,-87,53,-205
-21,-49,-26,5,-58,-29,-43,0,-221
-47,-34,-41,-37,-87,-2,-63,15,-296
-93,-33,-148,-107,-186,-114,-258,14,-925
-113,-104,-161,-38,-96,11,-134,36,-599
-15,-105,-78,29,-105,-10,-104,83,-305
-53,-139,-144,-10,-193,-53,-186,87,-691
-20,-28,-24,-24,-49,-23,-40,21,-187
24,-25,-57,-1,-107,-62,-110,51,-287
57,-71,-39,66,-70,-5,-59,99,-22
-99,-94,-95,-78,-134,-91,-178,-16,-785
-111,-101,-93,-90,-132,-98,-174,-19,-818
-135,-111,-121,-107,-143,-85,-204,-29,-935
45,15,-19,32,-28,-26,-24,71,66
-103,-97,-92,-100,-138,-98,-169,-12,-809
-5,-32,-32,-6,-20,-8,-19,21,-101
-38,-101,-97,-13,-93,-17,-116,21,-454
-32,-65,-110,-102,-169,-158,-232,-59,-927
25,-30,-10,-5,-36,-48,-51,10,-145
20,11,0,1,1,-10,4,17,44
-3,-11,-13,21,-44,-18,-48,31,-85
-23,-35,-59,-36,-58,-42,-89,6,-336
-19,-73,-99,-93,-104,-63,-127,19,-559
-164,-220,-378,-146,-525,-174,-565,275,-1897
-82,-20,-186,-165,-101,-55,-234,-15,-858
-2,-16,-17,26,-45,7,-35,53,-29
-58,-90,-91,-49,-103,-49,-110,5,-545
-16,-64,-55,-22,-27,-58,-111,-5,-358
23,4,-18,-5,-17,-26,-19,-9,-67
-72,-43,-76,-47,-68,-25,-96,-17,-444
-153,-136,-168,-135,-179,-154,-320,-29,-1274
0,-20,-31,-1,-24,-13,-24,22,-91
24,-108,-56,40,-74,-11,-82,76,-191
-47,-105,-125,-56,-122,-63,-143,44,-617
-2,3,-18,30,-43,-23,-44,46,-51
148,-205,-239,-171,48,-217,-234,297,-573
16,-39,-49,-29,-50,-25,-52,35,-193
-89,-141,-133,-71,-139,-50,-177,59,-741
-35,-32,-35,-28,-53,-39,-35,7,-250
-21,-36,-28,-15,-39,-27,-53,3,-216
-16,-31,-27,-17,-35,-22,-24,8,-164
39,-13,-32,34,-56,-38,-72,22,-116
-31,-84,-95,2,-89,-89,-115,-9,-510
57,-67,-84,84,-126,-11,-78,78,-147
-10,-76,-41,-10,-82,-47,-95,59,-302
36,-35,-27,63,-28,-5,-41,44,7
-23,-47,-61,-32,-70,-24,-68,9,-316
-14,-13,-7,-8,-18,-18,-22,-13,-113
-4,-15,-28,-25,-20,3,-13,24,-78
-28,-58,-68,1,-106,-36,-67,55,-307
24,-31,-17,21,-39,-5,-40,49,-38
-52,-88,-99,-25,-137,10,-68,96,-363
-13,-54,-106,-9,-70,28,-96,88,-232
47,3,4,8,-1,-42,-65,13,-33
-42,-48,-45,-19,-74,-17,-82,8,-319
-19,-26,-38,-19,-41,-19,-36,35,-163
-49,-97,-92,-33,-97,-77,-142,20,-567
-54,-76,-84,-34,-72,-5,-69,35,-359
-20,-125,-115,-43,-138,-29,-123,92,-501
-8,-48,-56,3,-57,-13,-47,40,-186
-6,-90,-87,25,-84,-15,-126,124,-259
4,-99,-79,31,-77,-62,-163,127,-318
13,-101,-92,-8,-100,-100,-146,100,-434
-7,-118,-152,-10,-216,-62,-177,74,-668
-33,-34,-73,-38,-74,-52,-111,27,-388
-25,-33,-70,-60,-76,-63,-103,0,-430
-71,-157,-233,-62,-333,-130,-380,65,-1301
94,-83,-156,20,-210,-156,-279,281,-489
-25,-150,-190,-33,-242,-113,-194,85,-862
-50,-311,-314,-13,-485,-75,-343,281,-1310
13,-47,-78,-44,-89,-75,-117,42,-395
13,-195,-255,-27,-303,-51,-175,240,-753
80,-73,-91,-32,-42,-18,-85,96,-165
105,-113,-57,101,-84,-50,-133,174,-57
2,-88,-61,-23,-104,-62,-92,16,-412
-24,-235,-309,-194,-285,-306,-504,187,-1670
2,-36,-65,6,-139,-144,-190,34,-532
-10,-45,-85,-31,-86,-51,-110,29,-389
-33,-86,-97,-20,-99,-34,-81,46,-404
54,-62,-58,54,-80,-140,-223,121,-334
-5,-76,-117,67,-106,-38,-151,89,-337
-30,-42,-77,31,-109,-94,-161,107,-375
18,-112,-108,-27,-112,-126,-204,24,-647
57,-90,-66,56,-168,10,-41,125,-117
-36,-107,-99,-32,-145,-99,-158,70,-606
-66,-153,-149,57,-188,-84,-303,99,-787
-74,-177,-230,-88,-286,-117,-320,126,-1166
-1,2,-59,202,-78,-235,-303,89,-383
69,-126,-197,112,-374,-135,-294,178,-767
36,-147,-115,-12,-181,-116,-178,132,-581
-105,-225,-234,-120,-351,-87,-265,132,-1255
107,-204,-101,74,-74,-81,-150,176,-253
-42,-97,-142,-47,-142,-41,-189,72,-628
-182,-143,-159,-125,-208,-187,-326,-116,-1446
0,-69,-79,-40,-117,8,-82,38,-341
119,-152,-208,44,-294,-177,-348,182,-834
-99,-72,-106,-26,-88,1,-66,-2,-458
-73,-92,-119,-56,-118,-124,-191,-3,-776
145,-131,-180,-27,-162,-118,-223,225,-471
-41,-170,-249,-58,-325,-151,-305,138,-1161
16,-68,-63,10,-104,-2,-72,83,-200
-45,-189,-241,-36,-280,-143,-270,152,-1052
51,-279,-246,92,-351,-113,-266,244,-868
28,-66,-68,5,-104,-14,-96,115,-200
1,-45,-60,-7,-90,-9,-59,54,-215
-87,-46,-160,-127,-179,-248,-412,-38,-1297
4,-147,-205,-86,-276,-235,-327,-48,-1320
48,-198,-381,-305,-523,-278,-371,294,-1714
-113,-70,-145,-160,-173,-181,-349,-110,-1301
69,-161,-236,-5,-91,-98,-143,180,-485
-7,-88,-183,-136,-135,-60,-125,111,-623
-21,-203,-208,-52,-318,-195,-324,65,-1256
47,-2,-81,-15,-104,-122,-227,79,-425
-40,-174,-270,-129,-407,-328,-453,-15,-1816
177,-60,-81,79,-24,-97,-124,250,120
-26,-79,-94,-3,-105,-35,-110,77,-375
8,-250,-286,-161,-362,-195,-319,270,-1295
-11,-152,-176,6,-179,-39,-156,167,-540
-171,-411,-415,-104,-567,-271,-614,-21,-2574
56,-32,-119,-51,-34,-24,-98,120,-182
55,-98,-154,12,-235,-165,-219,83,-721
42,-102,-94,16,-133,-133,-192,103,-493
76,-95,-92,69,-63,-87,-168,97,-263
109,26,66,160,56,-19,-13,116,501
374,-182,-358,120,-296,-174,-425,449,-492
-47,-179,-178,-57,-232,-168,-289,62,-1088
-65,-119,-192,-93,-240,-72,-237,86,-932
54,-16,9,55,-18,3,-46,48,89
38,-87,-68,31,-137,-54,-97,82,-292
-46,-45,-54,-44,-80,-39,-83,-1,-392
34,-274,-158,42,-383,-166,-328,133,-1100
-52,-111,-94,-108,-71,-62,-105,50,-553
-13,-47,-58,-10,-73,-57,-82,23,-317
15,-29,-56,2,-69,-59,-78,8,-266
10,-8,-27,18,-18,2,-18,18,-23
-5,-45,-22,9,-66,-27,-43,51,-148
-13,-13,-30,-17,-9,-10,-48,-8,-148
-105,-104,-142,-17,-70,-22,-76,-55,-591
9,-24,-22,0,-37,-29,-35,8,-130
-7,-59,-106,-52,-108,-80,-159,88,-483
-6,-63,-53,-20,-99,-63,-78,44,-338
71,-113,-159,-29,-205,-137,-180,152,-600
-37,-133,-86,7,-159,-44,-116,48,-520
-46,-114,-75,-8,-134,-31,-108,52,-464
1,-36,-64,-2,-70,-21,-79,13,-258
-31,-59,-58,-3,-68,-16,-84,26,-293
-23,-50,-47,-7,-37,-43,-84,19,-272
-37,-73,-49,-14,-51,-28,-87,-14,-353
-9,-10,-21,-8,-24,-6,-20,6,-92
-14,-123,-137,-65,-151,-105,-211,40,-766
6,-112,-121,6,-110,-42,-124,112,-385
-110,-56,-99,-114,-48,-104,-224,-103,-858
25,-78,-63,3,-53,-53,-75,48,-246
-119,-78,-208,-171,-260,-195,-381,-12,-1424
-124,-90,-203,-174,-244,-202,-381,-46,-1464
26,-185,-136,16,-174,-53,-167,202,-471
10,-18,-12,35,-43,-8,-16,27,-25
-42,-160,-117,-56,-157,-74,-186,26,-766
-53,-88,-93,-50,-134,-22,-90,61,-469
-23,-44,-34,-23,-69,-61,-97,-10,-361
-93,-119,-153,-43,-27,13,-69,-37,-528
-15,-7,-13,-24,-12,-13,-28,-9,-121
-13,-6,-18,-11,-16,-18,-27,-5,-114
9,-67,-57,-14,-75,-50,-91,18,-327
-39,-54,-70,-30,-68,-45,-90,14,-382
8,-98,-102,3,-135,-58,-108,52,-438
1,-102,-89,43,-114,-4,-118,84,-299
-1,-46,-90,-3,-98,-35,-102,52,-323
2,-41,-25,-11,-19,-35,-64,38,-155
69,-163,-163,28,-57,-90,-132,126,-382
144,-6,-68,57,-2,-19,-31,71,146
42,-59,-40,34,-28,-61,-79,48,-143
-10,-49,-48,-35,-49,-17,-31,8,-231
41,-97,-114,61,-175,-81,-119,53,-431
0,-25,-91,-36,-72,-48,-72,39,-305
18,-16,-5,26,-3,0,-18,12,14
362,-266,-235,146,-402,166,-76,635,330
-102,-155,-184,-68,-59,-4,-105,-32,-709
109,-248,-360,-87,-252,-119,-380,402,-935
-14,-8,-18,-11,-41,-10,-32,27,-107
-6,-6,-11,3,-26,-8,-22,12,-64
18,3,-61,-18,-44,-41,-90,68,-165
45,-60,-111,-13,-186,-86,-110,109,-412
53,-121,-100,11,-156,-165,-294,154,-618
21,-43,-48,21,-99,-38,-45,84,-147
-64,-90,-136,-25,-143,-47,-156,51,-610
-60,-82,-119,-51,-151,-60,-127,56,-594
14,-66,-83,13,-94,-51,-97,17,-347
-9,-30,-31,-10,-20,-33,-43,-3,-179
-13,-23,-15,-15,-19,-6,-19,14,-96
-18,-44,-42,3,-62,-24,-69,4,-252
109,-95,-100,44,-77,-64,-123,104,-202
-5,-72,-160,-2,-62,-76,-201,58,-520
7,5,-14,15,-18,-1,-18,19,-5
43,-62,-131,-8,-97,-59,-185,53,-446
-22,-29,-25,-9,-64,-19,-53,13,-208
-57,-264,-449,-74,-553,-125,-545,251,-1816
-34,-108,-96,-9,-186,-91,-156,40,-640
-17,18,-68,-25,-69,-227,-270,15,-643
4,-47,-47,-38,-47,-45,-54,41,-233
-40,-80,-103,-53,-133,-103,-122,60,-574
1,-64,-102,-39,-128,-128,-250,85,-625
7,-48,-48,-1,-59,-49,-67,-1,-266
-49,-63,-47,-20,-63,5,-47,25,-259
-154,-177,-213,-75,-61,-6,-138,-47,-871
-4,-13,-9,-8,-21,-7,-17,0,-79
-21,-72,-84,-5,-131,-42,-121,13,-463
-36,-323,-361,149,-398,188,-298,358,-721
67,9,-14,76,-45,-74,-89,47,-23
-51,-882,-851,138,-757,223,-839,996,-2023
7,0,-24,10,-34,-33,-41,39,-76
-78,-171,-213,-63,-269,-171,-288,-36,-1289
-18,-88,-81,-14,-88,-48,-96,19,-414
-19,-68,-79,-25,-95,-67,-75,23,-405
20,15,-3,10,-4,-10,0,15,43
-75,-177,-185,-72,-242,-82,-198,129,-902
-25,-29,-44,-22,-74,-25,-53,35,-237
-9,-66,-77,-18,-89,-56,-91,57,-349
-18,-107,-135,-41,-91,-85,-113,67,-523
-72,-76,-69,-36,-81,-48,-86,-13,-481
-95,-180,-210,-50,-254,-102,-273,65,-1099
33,-8,-34,-5,-52,-67,-83,27,-189
-4,-1,-79,-23,-3,-20,-44,19,-155
-7,-64,-62,-4,-75,-27,-85,10,-314
-83,-76,-77,-16,-106,-92,-135,-25,-610
-24,-52,-52,3,-102,-54,-95,16,-360
21,-84,-70,27,-103,-63,-108,58,-322
3,-59,-54,-26,-79,-36,-43,20,-274
-17,-57,-64,-19,-66,-36,-92,37,-314
-31,-34,-58,8,-39,0,-44,82,-116
-1,3,-43,-14,-13,-1,-42,-2,-113
-10,-90,-46,25,-43,-2,-66,27,-205
-3,-5,1,11,-12,-7,-4,-7,-26
-24,-43,-64,-31,-77,-22,-56,10,-307
-10,-83,-151,-21,-126,-37,-131,88,-471
16,-76,-74,2,-77,-8,-74,48,-243
15,-5,-30,2,-8,-22,-64,42,-70
55,32,33,80,13,-60,-80,76,149
10,-43,-50,-33,-51,-91,-107,-17,-382
3,-86,-80,58,-155,-54,-111,78,-347
27,-76,-59,33,-86,-15,-55,46,-185
-2,-6,-19,-4,-14,-25,-22,-10,-102
-18,-204,-145,-33,-238,-157,-307,2,-1100
46,-56,-123,6,-181,8,-51,122,-229
-8,-20,-56,1,-69,-88,-99,10,-329
101,-66,-74,41,-23,-42,-58,128,7
4,-19,-80,-14,-6,14,-35,25,-111
-10,-8,-12,3,-23,-16,-30,-5,-101
-8,-35,-26,-10,-82,-65,-85,-15,-326
13,-33,-46,36,-53,-28,-61,24,-148
38,-99,-104,15,-131,-92,-141,46,-468
-33,-42,-46,6,-56,3,-64,17,-215
-84,-61,-61,-60,-109,-76,-96,-41,-588
-16,-10,-27,-18,-26,-18,-46,-15,-176
16,-106,-219,-52,-270,-145,-270,171,-875
7,-228,-172,77,-365,-65,-321,169,-898
-17,-108,-152,-28,-173,-86,-167,37,-694
-16,-54,-44,-13,-49,-16,-44,18,-218
-16,-517,-730,-2,-966,-293,-937,596,-2865
28,-69,-47,-19,-24,-63,-116,77,-233
-1,-32,-10,11,-31,-10,-44,19,-98
-11,-21,-24,-12,-50,-15,-43,8,-168
-9,-39,-46,19,-118,-43,-126,36,-326
24,-99,-111,-22,-169,-109,-162,-4,-652
61,-111,-68,29,-20,-29,-90,91,-137
-30,-69,-79,43,-94,-51,-141,49,-372
-3,2,-25,-10,-27,-1,-34,41,-57
4,-24,-17,12,-48,-27,-40,17,-123
-17,-52,-73,-46,-100,-82,-96,23,-443
-2,-78,-88,-70,-103,-76,-77,80,-414
-38,-53,-42,-43,-99,-53,-96,8,-416
-14,-136,-109,21,-69,-46,-149,106,-396
-6,-43,-66,-23,-79,-53,-102,59,-313
13,-41,-44,-1,-49,-34,-55,26,-185
26,-38,-62,20,-63,-18,-62,58,-139
-4,-52,-70,36,-92,-6,-79,37,-230
18,-26,-25,24,-39,-46,-90,43,-141
30,16,10,32,-21,-42,-23,26,28
-203,-320,-317,-163,-563,-227,-479,3,-2269
13,-79,-92,-7,-122,-65,-97,26,-423
-9,-44,-35,-25,-62,-20,-38,14,-219
-107,-100,-157,-134,-171,-111,-299,-48,-1127
18,-53,-78,-4,-61,-19,-76,56,-217
14,-84,-113,-69,-165,-139,-211,50,-717
-32,-69,-74,-28,-83,-17,-63,61,-305
-29,-42,-78,-34,-101,-22,-82,68,-320
-32,-52,-77,-36,-80,-22,-73,48,-324
-37,-43,-71,-57,-43,-93,-125,-29,-498
24,-45,-48,32,-98,-42,-94,37,-234
2,-80,-40,3,-77,-47,-64,6,-297
-29,19,-52,48,-78,-22,-93,8,-199
-465,-532,-620,-480,-727,-395,-850,-59,-4128
-87,-209,-202,-46,-380,-192,-354,126,-1344
0,-59,-44,-2,-79,14,-44,61,-153
-8,-14,-20,-6,-23,-9,-20,5,-95
-39,-60,-63,-30,-72,-37,-85,18,-368
-9,-43,-44,-13,-33,-8,-32,15,-167
-32,-41,-43,-28,-88,-65,-68,-13,-378
9,-105,-142,53,-193,-16,-175,164,-405
-5,-96,-73,26,-94,-63,-126,2,-429
-21,-123,-129,9,-197,-71,-155,63,-624
-130,-274,-300,-77,-327,-79,-360,58,-1489
-99,-86,-156,-60,-190,-58,-185,65,-769
-53,-101,-55,-18,-89,-15,-79,22,-388
-151,-161,-216,-46,-299,-109,-259,9,-1232
-24,-47,-77,-29,-31,-56,-89,13,-340
-4,-13,-64,-31,-99,-56,-79,26,-320
26,-29,-44,-10,-28,-25,-73,30,-153
-20,-91,-87,-32,-119,-91,-127,51,-516
14,-64,-70,-10,-113,-31,-88,53,-309
16,-21,-32,24,-51,-43,-41,31,-117
15,-56,-54,-2,-75,-33,-60,35,-230
-6,-73,-50,0,-75,-23,-56,38,-245
-62,-122,-107,-3,-139,-31,-136,27,-573
-44,-65,-81,-70,-117,-111,-154,-24,-666
79,-35,-117,11,-49,-106,-156,95,-278
51,-150,-194,-84,-203,-208,-285,151,-922
0,-91,-134,-43,-144,-110,-194,83,-633
-14,-24,-21,-5,-38,-11,-39,14,-138
-40,-68,-93,-33,-83,-17,-83,26,-391
-163,-116,-143,-62,-102,-21,-90,18,-679
0,-24,-44,-15,-37,-8,-50,38,-140
19,-3,-20,6,-12,-33,-35,24,-54
1,-36,-49,-21,-84,-41,-59,-1,-290
5,-60,-41,-5,-57,-7,-67,58,-174
-37,-40,-70,7,-102,-12,-72,34,-292
4,-18,-26,-3,-46,-36,-54,-24,-203
-11,-35,-20,3,-43,-7,-46,15,-144
2,-84,-70,-24,-82,-50,-81,28,-361
-19,-50,-41,34,-59,-6,-76,19,-198
-68,-142,-154,-107,-246,-168,-241,-7,-1133
-72,-88,-123,-52,-128,-33,-161,34,-623
-35,-99,-65,-4,-98,-9,-70,30,-350
33,-55,-91,-49,-96,-108,-208,55,-519
-3,-23,-32,-18,-31,-40,-56,7,-196
13,-46,-44,4,-47,-24,-63,31,-176
3,-57,-43,40,-78,-6,-58,19,-180
-22,-86,-85,-38,-128,-89,-137,32,-553
-25,-36,-55,-26,-50,-41,-62,24,-271
-100,-77,-115,-62,-149,-46,-146,10,-685
28,-211,-168,170,-218,8,-265,210,-446
4,-42,-19,5,-34,-11,-29,3,-123
36,-54,-75,-15,-42,-36,-72,65,-193
11,-16,-48,-12,-57,-50,-63,38,-197
79,-78,-103,-11,-218,-57,-140,101,-427
8,-6,-16,3,-23,-18,-18,26,-44
-10,-72,-54,-5,-49,-20,-28,-15,-253
-97,-160,-164,-64,-196,-16,-206,85,-818
-16,-92,-80,-60,-86,-84,-128,34,-512
-33,-43,-69,-41,-75,-42,-91,1,-393
-22,-116,-80,0,-144,-90,-160,42,-570
-86,-130,-128,-73,-168,-109,-195,25,-864
44,-153,-89,-71,-31,-138,-133,90,-481
-15,-59,-54,-44,-79,-39,-83,5,-368
0,-143,-145,7,-225,-161,-270,103,-834
-24,-64,-97,-25,-72,-1,-95,54,-324
-26,-33,-31,-15,-68,3,-50,30,-190
-11,-112,-113,-9,-114,-67,-124,95,-455
2,-23,-20,9,-14,-7,-22,23,-52
-83,-361,-243,-103,-379,-216,-440,192,-1633
-9,-112,-142,-37,-125,-41,-136,107,-495
-30,-97,-128,-43,-126,-45,-119,148,-440
-8,-38,-25,2,-36,-23,-56,-13,-197
-14,-35,-20,-30,-56,-43,-62,-15,-275
-12,-78,-46,1,-93,-29,-47,35,-269
-28,-23,-32,-28,-19,-34,-50,-26,-240
1,-17,-32,-5,-18,-17,-27,7,-108
-39,-92,-93,-15,-133,-34,-146,58,-494
5,-41,-21,6,-24,-20,-29,-8,-132
-10,-93,-91,-42,-71,-98,-143,35,-513
-11,-34,-25,19,-41,-14,-43,8,-141
92,-54,-112,-9,-73,5,-41,118,-74
-21,-33,-15,-9,-37,-16,-38,35,-134
-61,-36,-49,-16,-48,1,-73,0,-282
-4,-65,-89,-12,-118,-75,-129,-5,-497
2,-12,-12,13,-7,-10,-45,30,-41
-56,-299,-511,-62,-740,-405,-785,167,-2691
-4,-31,-29,-10,-28,-10,-27,14,-125
59,-118,-119,31,-113,-44,-153,99,-358
73,-26,-257,20,-473,-56,-361,279,-801
-11,3,-9,-7,-13,-1,-23,-1,-62
50,-4,-1,49,-30,-20,-33,62,73
85,-135,-156,94,-237,4,-218,196,-367
26,-16,-54,5,-25,-48,-71,72,-111
-75,-76,-83,-42,-113,-11,-106,39,-467
-61,-86,-100,-47,-122,-34,-101,52,-499
-56,-93,-102,-49,-126,-43,-108,37,-540
-2,-52,-69,-21,-43,-43,-89,-2,-321
-70,-52,-55,-39,-109,-44,-150,-9,-528
-72,-54,-56,-31,-107,-30,-150,-5,-505
-75,-53,-49,-14,-121,-45,-153,12,-498
-57,-34,-47,-28,-89,-59,-157,-10,-481
-66,-34,-53,-36,-100,-67,-158,-13,-527
-37,-86,-144,-87,-66,-34,-115,35,-534
-84,-237,-222,-98,-279,-136,-281,72,-1265
-19,-47,-61,-9,-110,-75,-87,-12,-420
17,-28,-93,-21,-139,-50,-124,43,-395
-8,-62,-52,-17,-55,-26,-63,49,-234
-22,-44,-22,18,-63,-45,-66,-47,-291
-1,-130,-206,-13,-105,-67,-192,145,-569
10,-121,-147,-6,-114,-23,-110,11,-500
-31,-28,-34,-19,-43,-30,-50,-9,-244
-1,-76,-104,-47,-148,-85,-153,71,-543
-41,-54,-55,-26,-70,-55,-72,19,-354
-14,-20,-47,-4,-56,-43,-74,7,-251
-61,-72,-118,-28,-97,-88,-163,-10,-637
-62,-38,-91,-56,-73,-27,-105,9,-443
39,-15,-32,-3,-17,2,-7,30,-3
31,-59,-77,3,-97,-62,-58,39,-280
-40,-124,-138,-14,-206,-100,-151,8,-765
-49,-69,-59,-21,-85,-45,-100,16,-412
-25,-25,-58,-46,-37,-45,-84,34,-286
24,-13,-24,24,1,2,-9,38,43
-27,-60,-50,-14,-61,-59,-125,8,-388
-73,-93,-122,-55,-208,-52,-154,79,-678
-56,-103,-98,-39,-128,-68,-119,-8,-619
28,2,-2,12,16,-9,0,14,61
-7,-134,-116,-28,-121,-64,-155,63,-562
-33,-40,-48,-17,-39,-8,-27,28,-184
-10,-57,-124,4,-111,-113,-161,-11,-583
-17,-31,-42,-18,-26,-18,-48,4,-196
-15,-37,-31,-13,-36,-21,-32,17,-168
-62,-71,-88,-18,-125,0,-97,54,-407
-60,-87,-92,-6,-116,-13,-89,59,-404
3,-105,-57,-15,-39,-57,-81,42,-309
-108,-277,-265,-154,-381,-210,-345,94,-1646
19,-35,-56,-24,-80,-56,-62,21,-273
15,-147,-191,-129,-229,-284,-326,121,-1170
44,-138,-136,11,-145,-172,-238,73,-701
41,-59,-70,-25,-110,-46,-78,71,-276
3,-47,-67,-45,-55,-63,-79,15,-338
-43,-42,-63,-4,-99,2,-70,16,-303
-83,-24,-93,-47,-97,27,-180,65,-432
-2,-15,-36,6,-29,-25,-37,8,-130
-20,-142,-86,-7,-127,-101,-141,42,-582
-14,-30,-29,-16,-35,-13,-35,13,-159
-2,-23,-48,2,-66,-27,-93,6,-251
48,-174,-199,29,-232,40,-165,289,-364
-26,-58,-153,-30,-99,3,-159,58,-464
28,-49,-39,28,-106,-1,-87,42,-184
-103,-71,-164,-131,-150,-171,-259,-49,-1098
7,-36,-35,20,-58,-26,-29,47,-110
-16,-131,-137,-16,-203,-49,-138,159,-531
-88,-80,-122,-72,-226,-57,-174,28,-791
-12,-106,-67,-12,-104,-99,-97,10,-487
26,-36,-47,-11,-38,-27,-19,11,-141
1,-180,-244,-107,-309,-289,-359,19,-1468
-118,-193,-183,14,-240,-38,-319,101,-976
3,-22,-27,-13,-21,-19,-30,12,-117
63,-3,-27,113,-106,-34,-113,96,-11
73,-74,-111,28,-133,-164,-198,67,-512
-238,-328,-428,-200,-469,-217,-529,21,-2388
-126,-234,-279,-64,-381,-94,-343,164,-1357
22,-67,-68,32,-82,-97,-161,-41,-462
-14,-91,-181,-73,-176,-171,-310,106,-910
-45,-163,-191,-83,-310,-212,-294,34,-1264
-38,-104,-96,8,-117,-2,-118,115,-352
-82,-183,-197,-52,-285,-73,-202,38,-1036
98,-65,-96,-2,-65,-62,-79,157,-114
-29,-147,-108,-35,-187,-103,-158,14,-753
87,-31,-100,-40,-48,-116,-164,133,-279
-34,-212,-191,-22,-209,-91,-244,97,-906
233,-216,-302,-1,-202,-98,-229,199,-616
43,-172,-90,75,-126,-88,-185,152,-391
41,-198,-159,23,-156,82,-172,276,-263
15,-41,-58,5,-77,-37,-96,69,-220
30,-127,-106,6,-126,-111,-153,29,-558
-61,-112,-141,-59,-238,-82,-179,39,-833
38,-165,-122,22,-109,-78,-228,225,-417
-14,-54,-97,17,-133,-103,-141,41,-484
-19,-31,-113,5,-86,-68,-162,78,-396
66,-82,-182,-33,-106,-135,-249,201,-520
-116,-178,-204,-41,-250,-77,-255,40,-1081
-70,-189,-218,-99,-230,-167,-309,68,-1214
-7,-38,-65,0,-83,-37,-88,42,-276
25,-75,-75,49,-150,-40,-120,76,-310
-99,-75,-147,-45,-85,0,-61,39,-473
-42,-118,-143,23,-237,-7,-227,104,-647
100,-58,-53,57,7,-66,-66,111,32
7,-116,-133,-17,-197,-143,-168,87,-680
10,-21,-44,-18,-64,-30,-54,25,-196
8,-53,-58,4,-75,-28,-76,12,-266
21,-133,-117,-27,-180,-154,-244,-55,-889
-8,-19,-43,9,-34,-30,-59,48,-136
70,-289,-199,54,-230,-79,-378,245,-806
-185,-298,-354,-89,-432,-100,-422,155,-1725
59,-44,-111,47,-73,-53,-231,222,-184
-181,-404,-536,-133,-810,-291,-820,298,-2877
275,17,-180,217,-85,33,-41,446,682
-35,-71,-108,-36,-134,-54,-125,57,-506
-18,-94,-97,-18,-87,-29,-100,37,-406
6,-112,-97,37,-104,-11,-91,68,-304
32,-84,-92,14,-115,-80,-117,55,-387
-71,-58,-111,-133,-169,-196,-214,-45,-997
-7,-148,-92,36,-100,-24,-145,86,-394
-63,-136,-138,-23,-168,-33,-242,91,-712
0,-91,-97,-51,-85,-39,-98,72,-389
-58,-122,-94,-17,-155,-61,-156,15,-648
-12,-179,-159,-3,-172,-106,-194,129,-696
-36,-141,-136,-25,-191,-42,-144,65,-650
-61,-131,-162,-40,-186,-79,-180,102,-737
-29,-102,-202,-128,-261,-236,-429,15,-1372
74,-197,-220,-55,-248,-172,-291,168,-941
0,-102,-123,30,-170,-114,-176,66,-589
-29,-82,-143,-7,-202,-106,-235,66,-738
-10,-203,-160,-54,-256,-98,-216,90,-907
129,-140,-100,54,-149,-109,-206,163,-358
17,-163,-215,-73,-208,-239,-365,157,-1089
18,-119,-173,-18,-192,-17,-133,135,-499
-197,-91,-272,-157,-254,-240,-439,-101,-1751
-62,-100,-153,-62,-187,-111,-231,12,-894
15,-111,-154,-99,-123,-151,-244,142,-725
-46,-143,-125,-55,-166,-75,-206,122,-694
9,0,-16,9,-7,-56,-88,6,-143
80,-133,-110,-45,-61,-43,-148,182,-278
-52,-91,-107,-55,-139,-43,-117,32,-572
-78,-96,-92,-33,-142,-14,-120,31,-544
-53,-105,-93,-27,-144,-24,-110,57,-499
-63,-127,-88,14,-175,-38,-151,50,-578
-29,-48,-45,-12,-91,-11,-63,32,-267
-90,-97,-100,-64,-126,-36,-113,11,-615
43,-26,-48,15,-177,-98,-174,151,-314
-4,-34,-48,-27,-63,-58,-69,5,-298
-17,-9,-38,-23,-54,-9,-32,22,-160
-11,-27,-36,-2,-36,-23,-49,10,-174
-23,-86,-80,-19,-92,-34,-68,30,-372
-51,-84,-94,-42,-146,-8,-132,47,-510
5,-73,-65,18,-67,-72,-106,43,-317
62,-243,-389,25,-556,-301,-669,375,-1696
-99,-89,-95,-152,-126,-79,-207,13,-834
-47,-31,-45,-49,-63,-33,-73,-3,-344
22,-65,-22,32,-26,-66,-83,60,-148
94,-34,-34,70,-13,-19,-69,141,136
4,-62,-25,32,-49,-29,-49,77,-101
38,-49,-32,24,-24,-44,-58,27,-118
157,-101,-105,-41,-14,-145,-196,246,-199
-60,-93,-126,-89,-105,-77,-112,37,-625
-39,-86,-133,-74,-134,-63,-152,42,-639
-28,-28,-26,-26,-18,4,-12,8,-126
-51,-137,-138,-40,-209,-108,-175,72,-786
-4,-34,-39,-12,-60,-21,-31,40,-161
-12,-70,-60,6,-48,-36,-59,35,-244
-5,-42,-56,3,-49,-21,-44,36,-178
37,-65,-200,-129,-176,-286,-536,235,-1120
-13,-57,-63,3,-74,-59,-94,-9,-366
-44,-197,-225,-32,-276,-152,-370,128,-1168
-14,-68,-53,-18,-65,0,-34,52,-200
5,-52,-32,-13,-44,-23,-47,55,-151
14,-58,-63,8,-54,-37,-70,44,-216
4,-61,-45,-8,-47,-67,-102,18,-308
-39,-226,-259,-70,-320,-158,-285,112,-1245
-4,-8,-21,-4,-21,-2,-18,5,-73
-14,-28,-24,-8,-29,-5,-25,3,-130
14,-24,-14,-4,-12,-11,-11,22,-40
-35,-31,-20,-7,-24,-11,-44,-21,-193
14,-33,-2,21,9,-19,-25,21,-14
-56,-160,-126,-11,-204,-33,-139,57,-672
3,-34,-87,27,-51,33,-81,49,-141
7,-26,-41,6,-17,-21,-26,29,-89
-1,-10,-7,8,-23,-18,-24,22,-53
-53,-354,-438,-150,-542,-325,-700,427,-2135
-9,-27,-25,-2,-12,-9,-33,17,-100
-4,0,-25,-3,-30,-10,-34,12,-94
11,-150,-178,-47,-211,-73,-197,82,-763
-5,-27,-29,-21,-49,-23,-45,27,-172
76,-21,-56,48,-49,-56,-115,93,-80
51,-110,-207,4,-247,-39,-164,144,-568
9,-124,-105,9,-166,-59,-127,63,-500
13,-61,-77,11,-127,4,-91,89,-239
25,-67,-96,-6,-43,-92,-76,44,-311
-72,-110,-152,-169,-135,-106,-221,-26,-991
167,-103,-150,-10,-243,-177,-206,206,-516
67,-65,-84,46,-42,-51,-138,72,-195
53,-15,-28,24,-42,-22,-45,54,-21
-26,-27,-30,0,-57,-7,-42,8,-181
-22,36,-87,20,-31,8,-103,119,-60
-29,-75,-80,-26,-100,-67,-123,-7,-507
-82,-99,-107,-18,-123,-21,-122,39,-533
-45,-88,-81,-22,-128,-45,-107,21,-495
-3,-19,-36,-1,-30,-80,-74,-44,-287
11,-21,-34,8,-40,-54,-72,37,-165
-69,5,-83,-70,-77,-48,-139,-14,-495
-80,-71,-175,-83,-176,-121,-218,24,-900
-35,-64,-99,-18,-122,-39,-135,16,-496
-19,-41,-49,-26,-69,-16,-65,18,-267
-10,-62,-67,6,-61,-63,-73,10,-320
-92,-89,-192,-146,-169,-140,-309,-29,-1166
-37,-92,-133,-21,-96,-30,-109,41,-477
-7,-294,-364,-172,-475,-316,-454,239,-1843
-43,-30,-34,11,-65,-20,-74,-3,-258
-36,-90,-128,-14,-99,-60,-138,43,-522
-49,-251,-369,-134,-438,-300,-473,143,-1871
-47,-120,-125,-46,-155,-23,-138,82,-572
1,-16,-21,8,-43,-31,-43,9,-136
-27,-59,-59,-17,-107,-9,-88,31,-335
-34,-162,-175,-32,-302,-71,-209,125,-860
-15,-102,-75,11,-58,-55,-99,91,-302
-21,-166,-163,20,-284,-90,-186,96,-794
-9,-108,-103,-14,-154,-47,-126,66,-495
-65,-158,-156,-42,-171,-66,-209,46,-821
119,-172,-143,46,-231,-248,-293,36,-886
11,-51,-66,-7,-106,-70,-103,17,-375
46,-25,-35,27,-35,-20,-53,66,-29
-11,-40,-54,-4,-68,-48,-64,26,-263
9,-57,-79,-6,-96,-1,-123,88,-265
-8,-40,-41,-28,-39,-3,-24,29,-154
-20,-110,-141,-75,-208,-186,-215,33,-922
1,-13,-12,-21,-47,-32,-45,10,-159
25,-29,-55,12,-72,13,-42,59,-89
-35,-30,-22,-14,-35,-13,-52,-13,-214
-4,-58,-55,-7,-82,-34,-68,25,-283
2,-21,-47,10,-98,23,-41,124,-48
33,-49,-53,99,-81,-78,-98,32,-195
12,-49,-74,-32,-74,-62,-86,24,-341
-27,-97,-83,-44,-150,-77,-110,12,-576
-38,-181,-215,43,-399,-64,-277,185,-946
-1,-44,-33,18,-56,-24,-98,20,-218
-80,-138,-213,-114,-190,-144,-316,-136,-1331
10,-133,-110,2,-158,-121,-164,51,-623
569,-194,-348,128,-72,-443,-550,433,-477
-11,-95,-107,-23,-86,-66,-144,21,-511
-3,-99,-85,-10,-132,-76,-111,24,-492
104,-47,-45,85,-82,-118,-80,74,-109
-59,-55,-85,-35,-108,-36,-111,22,-467
-3,-46,-42,-12,-57,-45,-51,6,-250
-64,-139,-133,-24,-290,-137,-231,-20,-1038
-24,-88,-76,22,-96,-70,-101,17,-416
-27,-77,-75,-40,-98,-43,-75,27,-408
-10,-43,-36,-7,-55,-24,-51,-5,-231
-52,-177,-246,-113,-314,-254,-378,91,-1443
-16,-74,-59,25,-46,-31,-80,53,-228
-37,-50,-70,-11,-25,-14,-60,40,-227
-3,-66,-59,-10,-81,-62,-79,47,-313
-33,-96,-73,16,-10,-59,-92,0,-347
3,-34,-63,31,-104,-36,-100,33,-270
4,-65,-83,9,-135,-76,-102,18,-430
-27,-104,-80,-11,-103,-57,-99,6,-475
4,-73,-86,-40,-133,-103,-134,24,-541
-16,-42,-80,8,-75,-13,-83,5,-296
-52,-136,-184,-143,-273,-204,-268,38,-1222
-35,-28,-25,-15,-29,-15,-50,-17,-214
17,9,4,24,-40,-52,-58,38,-58
35,-71,-64,-17,-45,-113,-136,72,-339
122,-118,-187,91,-200,-53,-181,220,-306
-30,-47,-24,1,-41,-25,-66,-5,-237
-12,-35,-57,-37,-61,-50,-102,19,-335
89,-11,-61,115,-47,-63,-100,92,14
12,-22,-21,-4,-21,-20,-22,17,-81
-1,-35,-13,-6,-18,-3,-25,26,-75
5,-54,-32,5,-20,-30,-55,16,-165
8,-21,-15,4,-34,-27,-31,32,-84
79,-283,-381,-110,-392,-183,-388,201,-1457
-99,-244,-225,-70,-306,-89,-270,131,-1172
142,-102,-68,168,-142,-143,-278,243,-180
113,-30,26,70,43,-18,-91,143,256
6,-28,-56,-17,-45,0,-31,19,-152
-84,-122,-179,-87,-184,-14,-168,94,-744
-25,-30,-30,12,-34,-7,-42,3,-153
-46,-50,-125,-45,-79,-54,-138,0,-537
2,-148,-157,-19,-198,-101,-243,161,-703
-45,-61,-65,-27,-90,-10,-61,36,-323
-24,-118,-116,-9,-97,-23,-111,48,-450
0,-77,-62,-1,-72,15,-57,57,-197
-41,-67,-72,-27,-66,-16,-66,25,-330
-14,-57,-101,-1,-170,-102,-134,62,-517
-86,-179,-148,-47,-226,-105,-203,53,-941
-43,-167,-168,-94,-203,-209,-344,97,-1131
-21,-30,-45,-20,-21,-31,-73,10,-231
-3,-127,-106,-7,-128,-17,-114,58,-444
2,-25,-29,24,-42,-27,-58,21,-134
-7,-61,-54,12,-65,-30,-81,43,-243
-2,-53,-47,-7,-51,-47,-77,5,-279
-30,-60,-58,-46,-109,-42,-88,48,-385
-84,-341,-381,-96,-532,-153,-513,323,-1777
-47,-48,-69,-61,-25,2,-48,12,-284
1,-152,-134,-37,-208,-149,-242,43,-878
-12,-30,-63,-37,-70,-68,-90,-19,-389
46,-191,-147,18,-111,-57,-250,212,-480
116,-227,-161,150,-166,-115,-249,289,-363
-26,-244,-229,118,-291,31,-318,200,-759
21,-101,-94,45,-102,11,-95,88,-227
-14,-108,-95,16,-86,9,-88,62,-304
-23,-49,-76,1,-48,-20,-92,14,-293
19,-40,-64,-4,-110,-117,-158,-1,-475
25,-83,-63,-32,-65,-66,-126,93,-317
-148,-109,-117,-104,-135,-80,-198,-25,-916
-114,-85,-103,-75,-143,-93,-205,-12,-830
-26,-68,-129,-23,-142,-88,-203,76,-603
1,-62,-49,-1,-92,-11,-81,86,-209
-18,-45,-67,-5,-78,-11,-74,22,-276
-21,-35,-30,-19,-20,-14,-33,10,-162
-28,-45,-57,-17,-66,-24,-75,2,-310
3,-37,-27,3,-36,-17,-49,3,-157
-1,-47,-65,-36,-41,-52,-78,7,-313
-12,-64,-69,-29,-76,-14,-79,39,-304
-11,-24,-39,-28,-74,-32,-62,22,-248
-47,-111,-123,-15,-135,2,-163,55,-537
18,-50,-62,-2,-51,7,-57,86,-111
-113,-237,-293,-110,-341,-164,-331,73,-1516
-204,-202,-494,-486,-610,-816,-1139,-239,-4190
-35,-39,-42,-23,-39,-5,-40,-12,-235
-24,-61,-41,-7,-92,-32,-52,6,-303
-24,-199,-187,2,-346,-171,-325,131,-1119
-49,-160,-251,-75,-186,-133,-209,87,-976
-13,-4,-22,-9,-16,7,-45,-7,-109
53,-77,-77,41,-43,-9,-101,113,-100
-42,-58,-97,-73,-89,-58,-97,12,-502
-4,-108,-96,5,-89,-74,-94,54,-406
-2,-30,-44,-9,-39,-45,-54,40,-183
-5,-30,-43,-4,-12,-28,-48,32,-138
109,-171,-159,-24,-59,-105,-195,239,-365
-28,-27,-50,-38,-49,-21,-26,-6,-245
-20,-119,-127,-71,-139,-82,-168,63,-663
4,0,-10,-3,-18,-25,-22,-1,-75
20,-115,-117,-17,-157,-133,-156,-2,-677
-6,-144,-111,14,-197,-185,-242,0,-871
-79,-114,-87,-7,-147,16,-108,91,-435
82,-63,-37,125,-55,11,-130,152,85
-4,-7,-3,73,-127,-18,-140,68,-158
41,1,-58,-8,-56,-43,-82,45,-160
5,-65,-68,-32,-80,-62,-86,59,-329
-47,-132,-148,-86,-199,-149,-273,100,-934
39,-56,-73,28,-102,-81,-115,54,-306
-47,-57,-50,-41,-53,-33,-64,11,-334
-24,-17,-22,3,-38,-3,-39,18,-122
25,-524,-740,-212,-1196,-560,-1070,467,-3810
-26,-33,-36,-31,-22,-16,-36,5,-195
10,-23,-23,40,-61,-20,-36,42,-71
-39,-50,-65,-9,-102,-83,-145,15,-478
14,-27,-20,11,-31,-49,-55,4,-153
-44,-54,-101,-43,-85,18,-63,32,-340
12,-104,-112,-8,-130,-46,-96,90,-394
-17,-66,-86,-34,-66,-15,-46,22,-308
5,-54,-100,-37,-114,-64,-102,39,-427
-35,-53,-51,-13,-66,-27,-69,-16,-330
7,-30,-32,-21,-63,-35,-60,27,-207
2,-3,-8,-1,-33,-16,-43,14,-88
21,-126,-148,-64,-221,-126,-167,116,-715
18,-48,-68,2,-96,-44,-79,49,-266
2,-103,-154,12,-175,-65,-151,17,-617
13,-69,-73,30,-114,-43,-103,74,-285
-81,-198,-194,-75,-302,-174,-332,48,-1308
-15,-49,-63,2,-44,-18,-50,20,-217
-16,-34,-49,-11,-75,-15,-78,8,-270
5,-2,-14,1,-38,5,-20,25,-38
-110,-113,-162,-76,-61,-19,-99,-33,-673
18,-189,-145,-37,-249,-155,-245,77,-925
18,-179,-236,-109,-165,-284,-390,124,-1221
-107,-145,-149,-52,-203,-38,-206,-8,-908
-84,-248,-282,-24,-242,15,-309,145,-1029
18,-53,-93,-12,-38,-4,-88,86,-184
-32,-131,-135,-9,-146,-16,-107,141,-435
-23,-72,-50,4,-76,-51,-100,-5,-373
-85,-203,-165,-9,-201,-36,-181,69,-811
-11,-25,-32,18,-53,-7,-41,14,-137
32,-12,-87,-15,-66,-50,-82,50,-230
-22,-28,-52,-42,-36,-26,-36,17,-225
-15,-13,-27,-9,-45,-17,-74,5,-195
128,-66,-73,-5,-15,-79,-96,106,-100
-83,-78,-212,-104,-218,-48,-208,141,-810
-28,-55,-96,-47,-115,-88,-139,14,-554
-1,-35,-67,-21,-96,-52,-51,31,-292
18,-46,-89,-24,-121,-44,-111,66,-351
-19,-36,-45,7,-59,-31,-70,22,-231
-10,-55,-39,-18,-59,-55,-69,-3,-308
36,-86,-102,-22,-224,-37,-72,118,-389
136,-152,-98,68,-51,-36,-170,200,-103
-76,-76,-54,-19,-116,-6,-93,2,-438
-71,-94,-135,-63,-125,-76,-187,26,-725
-24,-62,-33,24,-63,3,-76,18,-213
-1,-10,-12,29,-30,-30,-29,-16,-99
-20,-39,-70,-20,-74,-41,-78,-3,-345
7,-27,-42,-2,-58,-36,-58,40,-176
-34,-28,-54,-11,-68,-18,-73,28,-258
-63,-60,-54,0,-103,-8,-80,15,-353
-48,-70,-63,-20,-89,-40,-76,21,-385
11,-47,-49,1,-79,-35,-68,19,-247
15,-62,-65,-2,-45,-46,-75,24,-256
-49,-113,-82,-13,-124,-51,-113,-3,-548
26,-10,-49,-32,-72,-55,-68,6,-254
-25,-33,-40,-46,-52,-36,-88,38,-282
-19,-21,-27,-10,-19,-15,-44,3,-152
1,-13,-30,0,-27,-19,-38,12,-114
-29,-102,-86,-16,-134,-67,-140,42,-532
12,-19,-48,-3,-52,-67,-100,8,-269
1,1,-56,-35,-36,-67,-90,7,-275
-122,-115,-138,-49,-221,-81,-247,23,-950
-13,-13,-29,8,-34,-19,-38,1,-137
100,-54,-44,51,-95,-147,-204,207,-186
7,-71,-62,27,-105,-39,-97,53,-287
-29,-44,-66,-32,-84,-76,-105,-23,-459
-3,-72,-99,6,-134,-65,-154,60,-461
22,-54,-106,-7,-146,-114,-186,57,-534
-48,-81,-105,-53,-120,-36,-121,48,-516
-39,-80,-96,-19,-97,1,-65,29,-366
-22,-8,-23,6,-14,-13,-15,-8,-97
-18,-32,-38,-7,-31,-31,-73,-30,-260
0,-48,-55,-44,-26,-27,-62,43,-219
-16,-101,-134,-45,-196,-68,-147,112,-595
65,-71,-40,70,-64,-50,-100,127,-63
115,-57,-35,144,-11,-18,-81,146,203
7,-70,-64,-26,-60,-30,-53,71,-225
29,-71,-40,12,-41,-77,-104,53,-239
15,-31,-59,26,-24,-74,-134,29,-252
13,-66,-88,-15,-141,-102,-186,31,-554
-34,9,-18,30,-35,21,-83,17,-93
-22,-74,-40,40,-76,-52,-100,75,-249
-6,-30,-21,-12,-23,-18,-40,-9,-159
-4,-26,-23,-15,-23,-14,-41,7,-139
-16,-108,-90,24,-130,29,-77,94,-274
-16,-6,-38,-4,-41,-10,-45,27,-133
-50,-51,-74,-40,-83,-40,-112,35,-415
-22,-49,-60,-34,-56,-13,-66,10,-290
-70,-74,-127,-38,-156,-90,-170,22,-703
-44,-159,-199,-35,-162,-89,-215,82,-821
-15,-36,-26,-3,-34,-48,-47,10,-199
-10,-137,-140,-35,-174,-100,-145,64,-677
0,-24,-19,-9,-37,-11,-20,31,-89
-3,-24,-31,-5,-35,3,-43,31,-107
-36,-19,-20,-37,-20,-24,-57,-28,-241
-35,-107,-77,-50,-95,-55,-78,18,-479
-20,-38,-36,-18,-31,-35,-39,-7,-224
-100,-50,-82,-76,-86,-86,-163,-78,-721
272,-261,-404,-120,-367,-494,-702,336,-1740
0,-38,-34,-15,-27,-35,-33,29,-153
-7,-47,-69,-38,-41,-33,-39,20,-254
-18,-29,-47,-29,-33,6,-70,16,-204
-13,-47,-23,6,-42,-37,-35,-6,-197
-11,-7,-15,-8,-23,-28,-3,-1,-96
-40,-58,-46,-4,-53,4,-59,22,-234
12,-21,-44,-10,-18,-60,-51,1,-191
11,-169,-104,21,-146,-28,-134,123,-426
9,-126,-142,-25,-143,-98,-169,12,-682
5,-42,-51,-13,-49,-1,-62,27,-186
27,-32,-62,10,-60,-31,-58,75,-131
-12,-35,-71,-19,-95,-20,-98,54,-296
-39,-29,-37,-32,-83,-49,-112,-1,-382
37,-50,-60,-6,-78,-93,-139,104,-285
-14,-58,-55,7,-76,-73,-92,14,-347
3,-3,-18,-5,-23,-5,-14,-8,-73
-10,-56,-114,-7,-103,-33,-126,62,-387
15,-48,-91,-33,-138,-119,-145,50,-509
16,-45,-32,18,-75,-11,-42,61,-110
-62,-88,-84,-42,-99,-31,-116,17,-505
-17,-62,-66,-31,-62,-69,-135,25,-417
-10,-194,-244,-18,-179,-81,-242,139,-829
3,-16,-15,-17,-31,-7,-25,9,-99
1,-5,-8,-6,-10,-5,-15,4,-44
-89,-89,-78,-11,-105,-19,-139,-2,-532
-9,-20,-30,-1,-26,-7,-33,3,-123
15,-50,-66,-15,-82,-11,-52,37,-224
8,-42,-71,-22,-85,-8,-60,44,-236
-12,-31,-42,-19,-90,-3,-69,34,-232
17,-60,-47,32,-94,14,-78,39,-177
10,-61,-47,34,-127,-1,-117,58,-251
1,-13,-24,-7,-18,6,-29,32,-52
-32,-31,-38,-32,-82,-32,-51,21,-277
15,-83,-67,-14,-121,-17,-73,80,-280
-43,-112,-70,24,-166,-28,-136,89,-442
-31,-47,-32,-17,-49,-9,-52,1,-236
-46,-78,-63,-18,-80,-22,-77,23,-361
-30,-86,-94,-17,-98,-37,-116,-14,-492
20,13,-2,17,-31,7,-19,25,30
17,-178,-121,114,-160,40,-119,135,-272
-71,-375,-400,83,-374,-43,-372,313,-1239
-13,-58,-62,2,-77,-40,-91,-3,-342
28,-93,-87,47,-145,26,-61,148,-137
16,-30,-19,8,-50,-23,-41,23,-116
0,-32,-40,-8,-63,-18,-23,22,-162
9,-65,-57,24,-83,-30,-91,25,-268
79,-152,-189,6,-137,-116,-247,145,-611
-31,-129,-157,-7,-212,-21,-211,106,-662
-13,-65,-65,-26,-98,-48,-105,38,-382
42,-40,-39,34,-80,-17,-66,18,-148
-9,-6,-34,-27,-39,-28,-25,17,-151
-25,-14,-23,4,-34,-11,-23,-10,-136
-10,-65,-78,10,-84,-31,-106,18,-346
-41,-91,-53,67,-65,-34,-109,84,-242
34,-78,-63,25,-60,-38,-47,32,-195
19,-76,-53,23,-58,-36,-49,29,-201
-16,-50,-64,21,-74,57,-63,62,-127
-18,-33,-64,13,-62,-6,-87,32,-225
6,-42,-39,-30,-72,-49,-76,29,-273
39,-119,-109,49,-3,21,-91,108,-105
-4,-110,-98,-27,-85,-113,-166,30,-573
-26,-53,-62,4,-46,-10,-71,38,-226
-8,-83,-71,51,-111,-43,-106,65,-306
7,-69,-93,16,-102,-3,-95,101,-238
-14,-48,-59,22,-93,32,-75,69,-166
22,-58,-58,-5,-79,-59,-82,9,-310
-75,-49,-63,-56,-84,-5,-99,2,-429
33,-52,-47,26,-41,-6,-36,27,-96
25,-41,-33,9,-34,-30,-30,14,-120
-2,-66,-73,-2,-69,-10,-74,36,-260
-39,-88,-65,-7,-78,-49,-87,18,-395
-10,-6,-14,1,-8,9,-19,-4,-51
-45,-80,-93,-4,-127,-21,-100,48,-422
5,-55,-86,4,-95,-30,-69,8,-318
-5,-81,-71,7,-111,-45,-94,19,-381
7,-78,-89,-10,-116,-83,-101,33,-437
55,-235,-311,-2,-310,-35,-237,256,-819
4,-230,-287,-63,-392,-94,-281,213,-1130
-7,-303,-325,-3,-406,-18,-275,238,-1099
-26,-44,-56,-12,-43,-16,-60,29,-228
16,-32,-27,1,-26,-22,-29,22,-97
-17,-24,-7,3,-27,-6,-43,7,-114
-15,-28,-13,-4,-27,-7,-47,4,-137
10,-12,-16,4,-7,-5,-3,3,-26
53,-32,-83,34,-67,14,-65,83,-63
31,-61,-68,24,-65,-44,-92,72,-203
18,-59,-71,7,-57,-42,-107,90,-221
-9,-18,-29,4,-52,-21,-17,4,-138
-14,-22,-25,9,-55,-28,-35,7,-163
-24,-35,-30,-13,-50,-17,-26,3,-192
-36,-41,-48,-47,-57,-25,-50,13,-291
3,-96,-138,42,-180,-35,-133,110,-427
-19,-142,-166,7,-243,-119,-224,122,-784
7,-50,-47,-27,-54,-40,-55,14,-252
-44,-79,-85,-56,-101,-48,-111,11,-513
6,-48,-48,1,-62,1,-37,36,-151
-12,-7,-12,-9,-11,-8,-27,-16,-102
9,-20,-16,-5,-25,-22,-50,15,-114
-3,-9,-18,12,-21,-33,-44,-2,-118
-1,-13,-23,17,-22,-31,-50,16,-107
8,-4,-7,16,3,-29,-48,22,-39
-32,-15,-41,4,-23,-43,-74,-25,-249
-15,-34,-48,-10,-31,-23,-78,2,-237
-10,-39,-25,-2,-21,-11,-16,19,-105
-30,-37,-27,-2,-18,-2,-28,0,-144
-21,-37,-30,-6,-28,-1,-32,-7,-162
-25,-27,-30,-35,-30,-16,-30,19,-174
-35,-32,-51,-39,-56,-30,-74,-7,-324
-30,-31,-51,0,-49,-18,-58,6,-231
-22,-43,-54,-7,-57,-29,-68,6,-274
3,-16,-23,4,-22,-16,-30,11,-89
71,-368,-443,110,-469,-216,-490,440,-1365
1,-23,-23,-2,-22,-23,-33,3,-122
11,-24,-18,23,-55,-15,-44,13,-109
3,-25,-14,5,-29,-17,-31,9,-99
-18,-17,-23,-10,-29,-17,-41,14,-141
-6,-23,-19,-7,-13,-24,-31,-5,-128
-18,-7,-15,1,-9,-15,-38,-1,-102
-6,-5,-17,-7,-18,-21,-32,0,-106
-19,-30,-36,-20,-41,-38,-54,16,-222
16,-4,-13,4,-8,-25,-30,9,-51
4,1,-1,3,-1,-2,2,3,9
-2,-44,-51,-7,-41,-40,-47,34,-198
-8,-38,-54,-17,-64,-30,-72,31,-252
-22,-26,-37,-2,-54,-33,-66,5,-235
-21,-25,-39,-18,-53,-30,-63,3,-246
-14,-25,-31,-7,-56,-21,-61,8,-207
-19,-30,-34,-11,-53,-26,-60,8,-225
-6,-18,-33,-7,-52,-18,-56,9,-181
-12,-22,-27,5,-56,-22,-51,11,-174
-24,-24,-32,11,-52,-30,-60,8,-203
-10,-20,-31,-3,-48,-20,-55,5,-182
-69,-37,-43,-15,-51,-16,-71,-18,-320
-26,-34,-37,1,-30,-15,-34,4,-171
-5,-43,-45,21,-60,8,-56,44,-136
10,-36,-32,17,-27,-10,-31,40,-69
-11,-34,-44,-29,-57,-42,-65,-14,-296
-19,-33,-55,-13,-19,-17,-35,28,-163
-18,-30,-33,-5,-48,-6,-37,5,-172
3,-4,-13,14,-27,-1,-25,22,-31
3,-4,-13,14,-27,-1,-25,22,-31
-6,-8,-21,9,-30,-5,-33,32,-62
1,-7,-18,4,-29,-6,-29,29,-55
0,-11,-21,14,-28,-6,-31,25,-58
-2,-12,-22,8,-28,-6,-28,32,-58
-2,-10,-19,16,-30,-7,-22,33,-41
0,-10,-11,7,-29,-3,-26,36,-36
-1,-8,-14,12,-25,-6,-30,33,-39
-6,-6,-15,8,-31,-10,-34,30,-64
-2,-12,-24,9,-22,1,-29,31,-48
16,-3,-21,25,-20,2,-33,42,8
15,-6,-20,23,-27,-4,-37,38,-18
3,-2,-17,16,-13,4,-24,27,-6
9,-7,-5,20,-17,1,-23,39,17
14,3,-18,31,-15,14,-23,49,55
10,2,-17,23,-18,6,-26,37,17
9,-4,-14,27,-11,11,-24,48,42
17,1,-17,27,-9,4,-20,48,51
8,-11,-11,9,-25,-5,-27,28,-34
5,-12,-24,26,-19,5,-17,30,-6
3,-9,-21,14,-23,-2,-22,30,-30
-2,-16,-24,10,-31,0,-25,35,-53
9,0,-13,28,-26,2,-27,40,13
-39,-55,-110,-49,-74,-42,-105,41,-433
-9,-61,-67,-30,-53,-30,-71,30,-291
-2,-18,-17,-3,-32,-6,-20,23,-75
2,-23,-31,-7,-22,-15,-28,17,-107
12,-18,-21,13,-26,-8,-13,37,-24
8,-26,-25,9,-18,-8,-8,42,-26
3,-13,-18,20,-28,-3,-27,32,-34
3,-8,-22,20,-27,-6,-34,31,-43
3,-3,-15,18,-25,-8,-24,35,-19
0,-8,-15,11,-20,-7,-26,24,-41
-1,-12,-19,14,-29,-3,-25,40,-35
5,-6,-22,12,-25,-10,-17,35,-28
2,-8,-23,12,-25,-9,-16,34,-33
7,-7,-21,13,-26,-14,-28,25,-51
1,-4,-12,20,-21,-5,-27,22,-26
-12,-39,-37,-8,-35,-10,-28,16,-153
-15,-31,-34,-10,-30,0,-28,7,-141
-9,-30,-21,19,-29,4,-47,34,-79
-4,-27,-27,10,-29,5,-41,41,-72
61,-76,-117,28,-149,-4,-125,116,-266
15,-23,-28,5,-21,-8,-14,21,-53
23,-30,-24,20,-36,-3,-6,35,-21
15,-38,-39,6,-37,-14,-34,27,-114
23,-92,-100,-12,-71,13,-40,84,-195
14,-63,-98,-19,-48,6,-38,86,-160
-1,-2,0,0,0,-1,0,-1,-5
17,-68,-84,-22,-40,25,-24,100,-96
9,-85,-111,-40,-46,-11,-61,100,-245
20,-67,-95,-17,-43,14,-44,95,-137
27,-94,-97,-14,-78,-2,-34,122,-170
35,-78,-97,-42,-68,-43,-69,69,-293
23,-70,-87,-38,-43,-37,-75,56,-271
-4,-88,-108,-41,-48,-36,-81,39,-367
24,-49,-41,18,-80,-66,-93,46,-241
22,-59,-44,10,-71,-54,-85,47,-234
-9,-44,-48,-9,-68,16,-53,53,-162
10,-32,-49,-4,-66,4,-41,57,-121
5,-31,-57,-20,-78,1,-52,52,-180
-6,-38,-61,-23,-66,-14,-43,59,-192
-11,-35,-59,-29,-59,0,-40,59,-174
-30,-62,-58,-28,-70,-10,-57,39,-276
7,-52,-39,-12,-49,-28,-42,10,-205
22,-29,-30,-4,-29,-34,-20,6,-118
19,-31,-36,-6,-28,-19,-34,5,-130
-2,1,-26,-15,-16,-32,-34,-28,-152
556,325,366,366,252,-157,-156,326,1878
526,336,377,392,249,-143,-134,291,1894
507,335,347,383,231,-143,-164,368,1864
495,418,527,218,302,-44,-158,569,2327
1,-43,-35,-8,-61,-22,-35,22,-181
-10,-32,-44,-32,-45,-5,-40,26,-182
-31,24,-3,59,-105,-38,-126,19,-201
-11,24,19,72,-117,-18,-150,35,-146
-39,-38,-82,-18,-149,-95,-216,26,-611
-108,-237,-325,-126,-575,-570,-754,-306,-3001
4,15,-1,22,-30,-28,-14,-2,-34
-15,-44,-59,-34,-48,-68,-98,-36,-402
-8,-23,-52,-43,-76,-100,-109,-33,-444
-2,-23,-31,-18,-13,-10,-30,1,-126
-10,-19,-24,-12,-17,-15,-27,-5,-129
1,-17,-19,3,-16,-15,-22,8,-77
17,-25,-21,10,-29,-23,-19,12,-78
108,22,-77,125,-69,79,-122,182,248
28,-40,-12,68,-8,-2,-36,33,31
8,-46,-47,81,-61,-18,-65,11,-137
58,1,-7,42,-13,-30,-22,45,74
-4,-11,-29,-10,-24,-1,-19,10,-88
-36,-98,-94,-51,-140,4,-107,94,-428
-7,-18,-40,-9,-47,6,-27,33,-109
5,5,-3,-2,-4,-5,-1,-3,-8
4,3,-2,0,-3,-3,0,-2,-3
-92,-142,-191,-99,-269,-148,-273,89,-1125
6,-40,-48,2,-56,28,-31,52,-87
-9,-43,-50,-5,-66,-4,-49,37,-189
8,9,-3,1,-15,10,-23,84,71
26,10,28,37,5,26,-34,59,157
16,-4,4,5,-3,-1,-37,73,53
-42,-75,-108,11,-121,-2,-106,57,-386
-2,-87,-71,-3,-10,28,-61,52,-154
-27,-29,-53,-25,-58,-80,-122,-10,-404
157,-277,-300,87,-245,265,-148,652,191
22,-31,-22,22,-43,-30,-33,26,-89
-3,-38,-27,16,-53,1,-50,49,-105
-15,-35,-34,15,-34,-11,-37,-9,-160
41,-80,-65,-17,-71,-71,-56,56,-263
3,-37,-44,-5,-38,-18,-32,13,-158
-22,-162,-156,-50,-141,-139,-163,-54,-887
-65,-106,-113,-20,-124,-90,-153,-24,-695
-6,-102,-118,-26,-74,-68,-115,4,-505
-18,-16,-30,-15,-28,-14,-32,-7,-160
-7,-17,-28,-21,-22,-15,-31,0,-141
-21,-16,-23,-23,-22,2,-32,4,-131
43,-121,-98,46,-144,-22,-134,93,-337
21,-91,-109,28,-112,-102,-118,9,-474
23,-80,-111,25,-108,-92,-127,54,-416
38,-87,-59,23,-46,-34,-91,42,-214
-9,-18,-38,-2,-42,-49,-60,-24,-242
-10,-33,-27,9,-42,-37,-44,-16,-200
-16,-13,-26,-3,-15,-22,-19,-10,-124
-8,-10,0,9,-2,-3,-7,16,-5
47,23,36,29,11,-43,-13,70,160
120,7,72,35,58,-162,-65,185,250
1,-18,-15,-7,-13,-25,-31,26,-82
-2,-18,-21,3,-17,-14,-39,9,-99
-17,-70,-58,19,-98,-80,-138,18,-424
-85,-94,-80,-32,-87,-32,-138,7,-541
-98,-85,-107,-34,-91,-16,-115,-3,-549
-36,-18,-22,-10,-27,-10,-55,-7,-185
-25,-15,-27,7,-38,-10,-41,7,-142
-126,-109,-128,-69,-140,-24,-178,-12,-786
-144,-163,-165,-20,-170,-27,-211,1,-899
-20,-14,-25,-3,-62,21,-50,53,-100
-18,-22,-16,-12,8,-3,-14,0,-77
-24,-8,-29,-13,-23,-13,-28,16,-122
-55,-127,-108,-7,-125,21,-82,88,-395
-48,-77,-107,21,-105,35,-95,84,-292
38,-96,-32,51,-70,-13,-39,53,-108
8,-56,-119,-102,-110,-165,-213,15,-742
-14,-18,-31,-10,1,-30,-26,7,-121
-18,-29,-29,4,-33,-7,-32,14,-130
-18,-41,-31,-7,-32,0,-23,-9,-161
-36,-85,-74,11,-111,0,-87,66,-316
-4,-102,-67,6,-107,-4,-100,87,-291
7,-105,-76,1,-112,-13,-94,81,-311
-29,-114,-85,-3,-62,32,-119,111,-269
29,-63,-42,56,-47,-36,-61,66,-98
-58,-129,-153,-20,-229,-25,-187,85,-716
47,-120,-26,66,-79,-12,-34,52,-106
-29,-114,-120,-7,-121,-25,-100,85,-431
-50,-98,-106,-34,-137,-63,-118,56,-550
5,-40,-20,31,-20,-11,-36,4,-87
2,-116,-87,9,-120,-51,-109,45,-427
8,-94,-80,4,-59,-13,-96,51,-279
-58,-56,-71,-19,-108,-55,-109,34,-442
19,-58,-55,-5,-73,-41,-70,-4,-287
8,-24,-23,2,-15,-1,-5,14,-44
-19,-36,-37,2,-89,-46,-69,-15,-309
-43,-45,-52,-65,-61,-20,-54,12,-328
-27,-37,-40,-36,-52,-29,-63,11,-273
-139,-717,-810,-69,-1033,-195,-989,163,-3789
-20,-12,-21,-2,-17,7,-28,9,-84
-14,-40,-35,-17,-27,-30,-49,6,-206
20,-66,-101,21,-98,-27,-122,105,-268
1,-9,-7,-1,-7,-2,-13,7,-31
12,8,29,49,-8,6,-25,66,137
-4,-33,-15,24,-37,-32,-45,7,-135
-19,-85,-64,3,-90,-48,-95,53,-345
3,-71,-58,-1,-106,-34,-99,26,-340
1,-54,-49,-3,-57,-34,-55,18,-233
54,-84,-71,-38,-77,-77,-110,76,-327
45,-49,-50,16,-50,-76,-112,65,-211
-78,-93,-109,-50,-139,-4,-104,64,-513
1,-22,-28,11,-17,1,-30,30,-54
-13,-28,-45,-8,-39,-4,-33,24,-146
-4,-75,-109,-32,-100,-71,-124,84,-431
-15,-37,-59,-28,-68,-10,-49,49,-217
-27,-37,-27,-8,-14,-46,-42,18,-183
-9,-23,-29,-20,-51,-22,-41,-5,-200
-12,28,20,78,-114,-23,-156,28,-151
18,153,51,179,-106,89,-130,81,335
-6,-6,-14,-12,-17,-15,-20,6,-84
-33,-389,-497,-111,-475,-196,-442,393,-1750
-10,-41,-70,-34,-81,-72,-110,11,-407
51,17,-43,52,-24,-27,-19,73,80
124,0,66,31,49,-158,-53,175,234
25,-51,-17,41,-74,-5,-50,63,-68
35,-35,-46,23,-83,-4,-20,46,-84
2,-65,-67,0,-136,-76,-126,6,-462
5,-8,-21,12,-27,-4,-30,34,-39
-6,-8,-21,9,-30,-5,-33,32,-62
-4,-13,-22,3,-29,-6,-37,25,-83
-15,-14,-19,3,-19,-8,-24,6,-90
7,-17,-26,10,-30,-6,-12,21,-53
23,-53,-42,27,-86,-61,-86,36,-242
-13,-46,-43,-17,-63,-20,-40,57,-185
-32,-13,-12,-23,-25,-9,-27,17,-124
-36,-17,-27,-45,-42,-24,-40,16,-215
-41,-183,-135,-63,-194,-175,-275,103,-963
-36,-55,-71,-25,-90,-46,-103,38,-388
-12,-79,-127,-34,-154,-106,-176,68,-620
-1,7,16,67,-49,9,-37,18,30
10,-44,-65,-7,-29,-55,-88,62,-216
-19,-10,-26,-2,-14,-15,-21,-7,-114
-17,-14,-23,-4,-11,-21,-19,-8,-117
-17,-11,-32,-8,-11,-22,-20,-5,-126
61,-62,7,89,-51,42,-52,87,121
58,-67,14,77,-56,43,-58,90,101
20,-31,-32,-11,-39,-24,-58,25,-150
-48,-77,-78,-36,-134,-20,-96,62,-427
-27,-34,-43,-46,-50,-22,-67,-3,-292
-30,-44,-45,-9,-55,-27,-61,9,-262
-61,-141,-145,-27,-169,-24,-165,53,-679
4,-125,-107,-48,-158,-32,-143,66,-543
37,-144,-156,0,-191,-54,-151,66,-593
-15,-59,-57,29,-91,-22,-55,-19,-289
-6,-3,-30,-12,-24,-28,-37,8,-132
-58,-147,-212,-144,-295,-215,-351,136,-1286
8,-27,-24,0,-19,-4,-22,22,-66
-44,-23,-46,-12,-57,-42,-48,-13,-285
-21,-28,-34,-10,-67,-24,-64,3,-245
-8,-23,-34,-5,-56,-26,-58,8,-202
-5,-23,-31,13,-60,-25,-57,0,-188
-33,-32,-34,0,-14,-15,-35,25,-138
-34,-100,-170,-29,-253,-22,-207,78,-737
-23,-37,-31,-2,-12,4,-46,16,-131
19,-10,-78,26,-17,-39,-115,1,-213
21,-38,-51,35,-72,-51,-85,5,-236
40,-61,-97,-4,-124,-71,-99,63,-353
-25,-21,-51,-24,-64,-1,-48,35,-199
-4,-46,-32,2,-27,6,-24,6,-119
43,-62,-44,46,-92,-23,-72,58,-146
-39,-77,-84,-44,-122,-47,-114,24,-503
-11,-60,-115,20,-145,-27,-126,73,-391
-70,-51,-114,-3,-119,-18,-133,34,-474
-47,-112,-68,-19,-135,-48,-123,24,-528
-3,-21,-12,-6,-23,-7,-19,-6,-97
-20,-75,-86,-66,-78,-83,-109,24,-493
-40,-31,-40,-17,-40,-33,-51,-25,-277
-22,-22,-26,-20,-29,-5,-40,-11,-175
25,-7,-14,11,8,-8,-5,8,18
-6,-64,-52,37,-83,-11,-79,32,-226
12,-66,-55,7,-97,-49,-45,49,-244
-27,-119,-99,-15,-141,-64,-124,91,-498
5,-54,-27,24,-81,-36,-59,22,-206
-23,-71,-90,8,-107,-31,-79,57,-336
24,-97,-117,-46,-101,-5,-88,74,-356
-11,-98,-90,23,-99,7,-76,72,-272
-56,-103,-143,17,-29,41,-110,40,-343
-6,-3,-33,-13,-34,-35,-28,28,-124
11,-9,-23,1,-23,5,-9,24,-23
-45,-129,-89,-28,-139,-89,-197,48,-668
18,-102,-108,-22,-219,-68,-114,89,-526
39,-95,-50,29,-156,-22,-90,100,-245
-43,-91,-90,-40,-129,-65,-122,35,-545
-66,-111,-92,-62,-122,-44,-113,11,-599
34,-67,-65,44,-96,-43,-86,37,-242
49,-57,-42,31,-101,-84,-101,46,-259
-16,-43,-46,-28,-84,-16,-65,17,-281
24,3,-7,16,22,-22,0,2,38
-17,-17,-26,3,-13,-4,-30,-1,-105
-9,-32,-43,-11,-40,-23,-61,-4,-223
-34,-30,-50,-20,-41,-24,-53,2,-250
9,-63,-114,-81,-77,-39,-100,90,-375
29,-6,-9,23,-19,-11,-24,23,6
21,4,-25,16,-25,-13,-27,9,-40
13,-39,-61,4,-80,-9,-46,34,-184
17,-18,-17,-2,-14,-36,-26,12,-84
20,-33,-26,21,-12,-58,-68,25,-131
-1,-20,-27,-8,-28,-6,-5,-13,-108
-36,-12,-76,-81,-36,-60,-57,15,-343
4,-23,-20,34,-26,7,-28,53,1
-9,-30,-32,7,-30,-31,-40,-11,-176
-17,-9,-68,-25,-28,-35,-64,-23,-269
-11,-26,-29,13,-39,-7,-43,34,-108
-8,-42,-51,-12,-70,-13,-53,37,-212
-12,-92,-77,12,-83,-12,-78,24,-318
-35,-67,-63,0,-117,11,-79,60,-290
51,-42,-67,-11,-60,-67,-91,37,-250
-43,-46,-121,37,-99,50,-106,68,-260
-44,-107,-94,-1,-103,-40,-101,62,-428
-24,-44,-33,24,-125,-40,-117,-18,-377
-26,-21,-18,45,-105,-18,-161,24,-280
7,-23,-15,39,-4,21,-21,24,28
12,-46,-40,-49,-3,-35,-35,39,-157
-25,-26,-28,3,-40,-48,-74,-50,-288
13,-21,-36,11,-17,-17,-28,-2,-97
4,-50,-51,5,-102,-46,-73,51,-262
455,350,405,330,234,-43,-126,358,1963
-25,-22,-33,-22,-40,13,-28,23,-134
5,-45,-54,-7,-74,-30,-89,39,-255
18,-71,-104,2,-74,-51,-116,69,-327
15,-57,-59,-12,-99,-81,-95,-4,-392
-38,-146,-120,-38,-154,-60,-125,36,-645
-82,-210,-238,-46,-270,-34,-338,162,-1056
-18,-61,-72,6,-80,-35,-107,25,-342
-14,-47,-66,12,-92,-45,-103,5,-350
-13,-91,-75,35,-90,28,-111,87,-230
-2,-70,-16,51,-87,-46,-106,13,-263
3,-6,-14,2,-24,-28,-29,-1,-97
2,-5,-13,6,-24,1,-19,45,-7
-1,-14,-22,12,-29,-2,-31,39,-48
8,-10,-5,20,-18,7,-20,28,10
-2,-29,-22,18,-31,-6,-35,22,-85
-5,-48,-39,-10,-56,-24,-50,45,-187
93,-77,-92,64,-125,-62,-86,127,-158
-106,-163,-181,-69,-199,-67,-255,82,-958
98,-131,-139,15,-127,-162,-266,158,-554
29,41,12,34,13,5,6,8,148
-28,-46,-43,-18,-73,-22,-55,-6,-291
36,-48,-80,-13,-123,-51,-102,65,-316
-14,-80,-75,44,-115,-18,-136,108,-286
-10,5,-17,-12,-9,-16,-26,-14,-99
-16,-13,-17,-1,-14,-19,-29,-13,-122
-24,-27,-65,-53,-69,-110,-123,-64,-535
-10,-60,-55,-56,-45,-34,-64,54,-270
-5,-44,-44,-8,-43,-13,-44,9,-192
49,-106,-104,47,-80,58,-100,189,-47
-9,-30,-60,-16,-52,-42,-52,13,-248
30,-56,-67,19,-82,-23,-67,26,-220
-13,-30,-45,1,-50,-44,-77,9,-249
-45,-156,-103,-17,-213,-46,-179,19,-740
10,-88,-70,17,-112,-20,-81,-1,-345
-35,-50,-51,-13,-69,-9,-69,-3,-299
51,5,-18,12,-28,-27,-29,61,27
-21,-11,-25,-32,-17,-33,-125,-68,-332
58,-126,-118,60,-212,-58,-158,161,-393
0,-18,-34,-30,-40,-55,-83,18,-242
2,-105,-76,6,-102,-18,-74,79,-288
2,-107,-89,5,-101,-9,-129,56,-372
21,-30,-34,6,-61,-28,-41,43,-124
-6,-9,-26,-12,-32,-18,-42,3,-142
-5,-32,-32,-4,-20,-6,-22,19,-102
1,-70,-86,0,-127,-8,-59,68,-281
22,-93,-43,45,-70,2,-49,70,-116
-47,-99,-72,-15,-111,-13,-101,29,-429
34,-116,-96,-24,-122,-110,-155,24,-565
6,-15,-8,14,0,1,-4,-11,-17
-2,-7,-26,-7,-23,22,-15,11,-47
8,-38,-47,-12,-95,-1,-65,47,-203
-12,-36,-85,-2,-64,-64,-183,-13,-459
-22,-62,-219,-149,-44,-39,-227,-8,-770
40,17,-59,4,-82,-91,-145,43,-273
19,-125,-111,2,-151,-128,-212,46,-660
45,-63,-67,14,-73,-106,-117,81,-286
36,-47,-40,21,-84,-24,-70,14,-194
-20,-86,-111,18,-108,-6,-121,63,-371
53,-57,-77,2,-86,-43,-97,5,-300
-6,-43,-54,-33,-75,-27,-58,32,-264
4,-56,-57,-25,1,-24,-15,37,-135
2,-35,-36,5,-21,-31,-69,18,-167
26,-40,-45,14,-43,-32,-50,14,-156
-7,-10,-18,8,-14,1,2,9,-29
-22,-36,-20,-5,-35,-15,-45,-2,-180
-26,-36,-24,6,-32,-11,-37,14,-146
-15,-28,-19,9,-43,-21,-33,16,-134
3,-39,-65,-16,-80,-8,-53,35,-223
-70,-74,-155,-123,-216,-188,-247,-27,-1100
52,-145,-134,21,-168,-86,-187,159,-488
21,-49,-57,30,-89,-18,-68,70,-160
-23,-43,-54,3,-92,-41,-72,-19,-341
-5,-51,-24,92,-101,-13,-89,67,-124
-18,-92,-80,34,-96,-35,-106,84,-309
-8,-130,-176,-106,-78,-55,-171,67,-657
10,-30,-39,-5,-58,-49,-41,23,-189
-57,-98,-99,7,-169,-50,-159,70,-555
25,-49,-23,42,-77,1,-49,66,-64
-19,-12,-25,-7,-12,-21,-19,-9,-124
7,-51,-40,3,-25,-21,-43,9,-161
-54,144,-26,-140,138,-111,-33,-134,-216
22,-23,-10,35,-40,12,-48,64,12
19,-11,-21,39,-53,0,-43,66,-4
11,7,-23,-17,-9,-26,-35,21,-71
9,-80,-23,-16,-5,12,-22,43,-82
-33,-109,-94,-62,-146,-81,-160,36,-649
-36,-85,-92,-15,-129,-7,-89,73,-380
-10,-33,-52,-10,-45,-17,-67,31,-203
-6,-83,-109,-63,-116,-66,-121,-9,-573
-19,-123,-118,-21,-125,-58,-144,33,-575
19,-37,-30,71,-25,-9,-47,35,-23
15,-9,-22,3,-25,3,-4,25,-14
-24,-28,-41,-9,-50,-19,-84,-11,-266
-12,-23,-32,-15,-44,-27,-64,9,-208
-3,2,-17,4,-19,-9,-38,46,-34
1,-236,-281,-93,-254,-155,-233,39,-1212
17,-37,-31,43,-33,5,-59,51,-44
-40,-34,-50,-36,-107,4,-81,37,-307
-111,-75,-106,-65,-131,-42,-151,-4,-685
31,-94,-49,-4,-62,-80,-74,12,-320
29,10,-14,25,-36,-28,-30,77,33
5,-99,-99,50,-132,-30,-112,83,-334
-23,2,-11,-26,-17,-17,-25,-8,-125
-25,-190,-162,78,-267,-136,-344,61,-985
-5,-92,-66,40,-72,-14,-95,15,-289
-15,-80,-70,-2,-83,-34,-80,14,-350
-8,-196,-223,-52,-278,-107,-256,157,-963
-17,-10,-16,-27,-13,-32,-98,-60,-273
58,-60,-65,37,-109,-26,-83,42,-206
-25,-44,-83,-62,-79,-107,-111,-5,-516
-3,-49,-59,-37,-56,-68,-71,22,-321
168,-5,36,204,-71,-74,-130,195,323
-3,-27,-20,-8,-13,6,-32,38,-59
-45,-71,-68,-49,-92,-25,-79,43,-386
159,100,-14,181,-51,61,-44,201,593
18,-93,-135,-17,-186,-74,-47,106,-428
-97,-213,-214,18,-223,13,-281,157,-840
-30,-95,-71,15,-98,-9,-87,55,-320
-13,-21,-34,-5,-18,8,-15,5,-93
446,320,319,361,227,-57,-161,268,1723
-35,-68,-90,-9,-182,-116,-156,-44,-700
-10,-33,-29,-15,-47,-22,-37,10,-183
33,-40,-91,0,-57,-48,-68,45,-226
105,-100,-61,84,-34,-88,-255,237,-112
-23,-96,-120,-17,-103,19,-77,111,-306
-25,-143,-137,-32,-111,-14,-128,85,-505
-2,-34,-77,-25,-12,41,-57,73,-93
-66,-182,-211,-16,-375,-48,-283,157,-1024
3,-80,-67,20,-117,-10,-77,59,-269
39,-54,-94,22,-133,-101,-164,42,-443
10,-35,-31,30,-55,-2,-62,63,-82
8,-24,-16,28,-43,4,-57,46,-54
56,-76,-129,104,-136,14,-200,254,-113
11,-128,-101,2,-139,-36,-138,81,-448
-4,-72,-88,4,-180,-29,-136,81,-424
-104,-77,-110,-65,-148,-58,-156,15,-703
-14,-62,-107,-13,-143,-62,-123,42,-482
-22,-111,-99,-5,-144,-68,-103,1,-551
-5,-21,-46,-27,-83,-38,-66,58,-228
46,-37,-24,58,-46,-17,-43,69,6
56,-82,-47,92,-36,-8,-97,68,-54
9,-99,-61,-12,-96,-36,-99,50,-344
-19,-36,-33,-22,-47,-21,-77,-13,-268
36,-25,-18,30,-59,-33,-59,37,-91
-47,-12,-31,-20,-72,-22,-55,29,-230
10,-38,-41,13,-87,6,-58,38,-157
-5,-40,-55,-20,-85,-51,-82,21,-317
-14,-92,-81,60,-128,-15,-150,31,-389
-21,-24,-52,-16,-73,-52,-100,19,-319
-14,-34,-18,-1,-32,1,-41,5,-134
51,-104,-147,-9,-209,-153,-239,166,-644
633,-890,-304,865,293,254,-247,1035,1639
-7,-43,-25,5,-89,-40,-77,21,-255
-33,-45,-55,-4,-62,-6,-59,26,-238
-2,-65,-80,-32,-88,-71,-118,23,-433
453,416,519,269,244,-40,-134,490,2217
11,-59,-67,-10,-79,-77,-80,58,-303
27,-180,-207,40,-165,33,-214,161,-505
9,-19,-25,5,-13,16,-19,19,-27
-40,-249,-262,-2,-340,20,-200,217,-856
69,-79,-111,40,-180,-79,-120,72,-388
17,-118,-125,-44,-157,-105,-185,84,-633
-10,-28,-23,-3,-13,-22,-31,-7,-137
-8,-115,-169,78,-51,85,-147,165,-162
-1,-13,-50,3,-34,-26,-43,18,-146
-52,19,-10,-28,-67,-83,-123,-12,-356
-3,-71,-81,13,-81,-15,-96,48,-286
-13,-53,-53,12,-60,-21,-46,40,-194
39,-116,-137,41,-215,-78,-224,148,-542
18,-76,-92,-14,-49,-40,-117,89,-281
-45,-57,-76,-3,-131,-94,-139,-3,-548
-47,-99,-85,-57,-112,-17,-82,33,-466
-57,-70,-98,-88,-133,-108,-162,-9,-725
1,-59,-108,-27,-101,-81,-106,24,-457
-24,-34,-16,-8,-27,-17,-48,-12,-186
-18,-21,-27,-35,-34,3,-19,10,-141
-35,-43,-77,-30,-87,-25,-107,49,-355
-8,-27,-6,66,-107,-38,-136,10,-246
-9,-38,-23,18,-118,-67,-167,22,-382
-31,-53,-66,17,-85,-1,-72,-10,-301
-15,-21,-47,-16,-96,-41,-75,-3,-314
-27,28,-12,63,-107,-37,-138,18,-212
5,-42,-61,-13,-47,-39,-67,16,-248
-38,-114,-68,17,-118,-41,-154,42,-474
15,-40,-17,29,-48,5,-57,64,-49
11,-63,-49,6,-47,-36,-45,15,-208
13,-87,-111,-29,-93,-54,-108,106,-363
-28,-86,-105,-37,-128,-48,-140,38,-534
-29,-81,-75,17,-95,-45,-108,31,-385
-48,-143,-142,-47,-118,-29,-124,63,-588
-11,-73,-70,-35,-113,-34,-138,105,-369
-89,-427,-455,18,-576,35,-511,389,-1616
-21,-11,-27,-20,-22,-26,-51,12,-166
-9,-45,-61,7,-63,-22,-74,37,-230
-14,-472,-604,-123,-994,34,-673,949,-1897
1,-30,-28,-5,-36,-13,-38,51,-98
7,-37,-8,-2,-20,3,-28,39,-46
34,-20,-11,27,-4,-43,-59,66,-10
11,-63,-24,2,-15,-33,-75,64,-133
5,16,-15,11,-22,-38,-30,55,-18
26,-45,-34,58,-42,-21,-77,60,-75
54,-50,-52,-13,-9,-70,-135,75,-200
21,-52,-17,28,-47,-4,-58,63,-66
34,-37,-50,34,-99,-45,-86,21,-228
12,-33,-37,-16,-52,-43,-51,1,-219
22,-27,-53,0,-97,-63,-71,29,-260
-72,-68,-93,-63,-149,-58,-163,70,-596
5,-16,-26,7,-23,-15,-8,14,-62
-27,-106,-94,-13,-128,-50,-94,83,-429
-21,-29,-27,-18,-46,-18,-70,-11,-240
-9,-34,-36,-2,-50,-32,-66,2,-227
-16,-20,-12,-9,-35,-13,-49,0,-154
15,-26,-3,7,13,-35,-13,44,2
18,-35,-16,20,-37,-20,-52,25,-97
14,-90,-60,24,-93,-43,-106,69,-285
-28,-44,-62,-36,-49,6,-47,32,-228
55,-100,-117,33,-126,-23,-96,82,-292
-4,-18,-20,-17,-29,-16,-32,4,-132
16,-14,-22,19,-27,-3,-15,16,-30
32,-27,-42,17,-41,-26,-54,33,-108
2,-18,-58,-8,13,-21,-30,-17,-137
-7,0,-11,-10,-3,-8,-9,19,-29
-4,-8,-14,-9,-20,-9,-7,5,-66
-42,-42,-29,-15,-43,-24,-40,-1,-236
14,-59,-47,10,-77,-36,-57,41,-211
-27,-37,-54,14,-92,-15,-59,0,-270
-12,-33,-45,-14,-52,-29,-45,-2,-232
-27,-48,-38,-13,-33,-17,-57,-24,-257
-15,-23,-21,-21,-33,-38,-113,-65,-329
41,-22,-13,45,-28,-40,-56,20,-53
37,-16,-14,33,-23,-11,-38,18,-14
-23,-19,-39,-1,-94,-38,-66,2,-278
10,-47,-42,-19,-101,-61,-98,65,-293
-22,-62,-71,-33,-79,-76,-100,11,-432
-16,-53,-61,12,-85,-41,-72,27,-289
14,-20,-48,1,-48,-28,-62,36,-155
-7,-22,-27,-12,-15,-24,-24,23,-108
-7,-53,-62,-26,-67,-63,-82,4,-356
12,-59,-109,-45,-40,-59,-128,109,-319
-28,-142,-192,-70,-279,-78,-250,192,-847
24,-28,-70,18,-112,12,-53,64,-145
-5,-24,3,46,-21,-5,-55,40,-21
2,-30,-3,44,-26,6,-54,32,-29
68,97,55,122,-25,54,13,93,477
-11,-26,-19,-27,-52,-26,-62,2,-221
26,-64,-28,72,-38,12,-53,43,-30
-3,-19,-16,2,-21,-16,-24,5,-92
-1,-21,-26,-8,-17,-29,-44,-6,-152
-4,-4,-20,-16,-22,-30,-37,2,-131
1,1,-25,22,-29,-18,-29,15,-62
-29,-46,-49,-39,-78,-55,-89,29,-356
-5,-73,-48,29,-102,-50,-114,22,-341
71,-403,-194,164,-436,-192,-436,250,-1176
26,-80,-57,60,-87,62,-99,124,-51
-17,-127,-197,-17,-147,-90,-155,53,-697
-30,-192,-195,-19,-277,-110,-216,122,-917
9,1,-17,27,-26,-21,-46,15,-58
-58,-55,-102,-19,-70,-74,-137,-51,-566
-45,-81,-69,-13,-94,-70,-132,-54,-558
-30,-141,-103,-8,-179,-58,-162,44,-637
-6,-32,-49,-11,-44,-70,-72,-14,-298
71,-69,-49,60,-102,-74,-100,52,-211
2,-16,-33,15,-32,-24,-40,-6,-134
71,-98,-88,50,-150,-97,-163,117,-358
-17,-140,-122,-19,-129,-70,-130,7,-620
22,-37,-46,15,-88,-28,-78,31,-209
-6,-61,-52,-29,-59,-42,-43,11,-281
-18,-32,-63,-60,-64,-71,-95,42,-361
34,-244,-332,-94,-538,-73,-301,405,-1143
-41,-55,-63,-36,-99,-37,-83,18,-396
6,-228,-288,-23,-395,-222,-370,235,-1285
4,-229,-295,-27,-396,-223,-376,232,-1310
-16,-22,-20,-13,-18,0,-22,21,-90
-2,0,-24,-16,-33,-27,-24,3,-123
-3,-1,-32,-9,-26,-28,-35,5,-129
-6,-14,-19,11,-29,-15,-28,23,-77
-4,-31,-110,-7,-95,-28,-123,40,-358
5,6,-12,-22,-32,-37,-77,33,-136
-193,-119,-142,-175,-153,-112,-269,-131,-1294
5,-31,-77,-23,-68,-97,-116,-14,-421
13,-42,-60,-53,-76,-95,-95,25,-383
-11,-30,-29,-12,-42,-16,-50,27,-163
-5,-20,-21,11,-17,1,-28,18,-61
13,-25,-41,31,-61,-37,-74,33,-161
74,9,-38,26,-20,-35,-58,27,-15
-17,-24,-85,-24,-44,-35,-77,9,-297
-5,-59,-78,-46,-110,-70,-93,-4,-465
2,-5,-10,3,-5,-7,-4,3,-23
-8,-37,-41,-10,-50,-21,-34,12,-189
-32,-12,-27,10,-33,-6,-39,6,-133
-4,-7,-21,-15,-39,-11,-28,26,-99
-5,-6,-22,-18,-40,-13,-29,24,-109
-80,-79,-102,-44,-132,-9,-85,57,-474
-51,-100,-106,-24,-142,4,-97,66,-450
-49,-94,-82,-35,-124,-7,-91,58,-424
-82,-99,-92,-32,-133,-30,-110,21,-557
-92,-102,-104,-16,-126,-23,-121,44,-540
-61,-88,-99,-54,-132,-3,-107,45,-499
-49,-103,-98,-69,-134,-14,-118,58,-527
-70,-92,-87,-29,-143,-22,-117,51,-509
13,-78,-133,-47,-75,-105,-141,41,-525
-61,-42,-61,-26,-76,0,-77,9,-334
-16,-36,-46,-33,-13,-63,-49,43,-213
-7,-48,-88,-32,-93,-75,-111,65,-389
-32,-34,-33,-18,-44,-7,-45,-8,-221
-34,-109,-125,-98,-160,-85,-211,37,-785
-1,-12,-11,-2,-13,-4,-12,8,-47
-8,-40,-54,-16,-60,-60,-29,32,-235
-50,-43,-56,-43,-27,3,-44,7,-253
18,-91,-107,-11,-108,-96,-103,35,-463
12,-87,-101,-4,-98,-97,-94,33,-436
-26,-9,-52,-40,-39,-58,-82,-7,-313
-12,-12,-21,3,-19,-4,-30,3,-92
-9,-14,-23,-18,-32,-13,-19,9,-119
25,3,-10,12,-20,-39,-62,41,-50
-33,-29,-26,-28,-59,-46,-54,-6,-281
-32,-108,-90,-35,-120,-11,-87,73,-410
-12,-47,-46,-22,-42,-17,-62,18,-230
-76,-105,-86,-18,-135,-23,-105,43,-505
-41,-2,-69,-77,-79,-117,-146,-28,-559
-65,-91,-78,-11,-109,-20,-92,33,-433
-54,-80,-99,-11,-127,-2,-112,59,-426
-4,-26,-29,-21,-31,-19,-20,7,-143
63,-30,-4,109,0,-60,-122,92,48
-10,-31,-37,-12,-33,-1,-36,32,-128
-123,-182,-221,-123,-237,-100,-205,48,-1143
16,-67,-68,-5,-79,-23,-54,41,-239
0,-13,-20,-7,-28,-10,-27,19,-86
-34,-57,-112,-54,-117,-66,-127,36,-531
-29,-56,-106,-45,-120,-86,-135,41,-536
-55,-93,-91,-30,-135,-32,-94,29,-501
-94,-95,-93,-59,-134,-28,-124,23,-604
-4,-7,-9,0,-10,1,-15,10,-34
119,-89,-113,-7,-66,-72,-141,170,-199
31,-14,-33,-21,-13,-71,-108,76,-153
-7,-28,-49,-32,-62,-42,-77,28,-269
5,-129,-152,2,-162,-106,-261,103,-700
-9,-28,-36,-10,-40,-9,-15,21,-126
-45,-82,-84,-22,-108,-32,-68,51,-390
-23,-54,-65,-14,-81,-66,-103,27,-379
26,-43,-55,-12,-26,-46,-87,75,-168
44,-37,-79,-26,-22,-85,-102,61,-246
105,-78,-111,-29,-62,-122,-151,140,-308
-34,-25,-28,-23,-46,-11,-36,12,-191
38,-30,-82,23,-126,-14,-84,116,-159
-22,-22,-34,6,-65,-55,-52,-8,-252
16,-43,-28,-27,-9,-58,-48,42,-155
-66,-22,-29,-49,-31,-21,-91,-43,-352
44,-35,-80,-21,-17,-85,-101,61,-234
46,-36,-77,-26,-23,-85,-101,61,-241
44,-30,-79,-15,-17,-89,-100,58,-228
-13,-82,-71,-15,-72,-98,-124,27,-448
4,-39,-41,-32,-21,-50,-47,35,-191
-30,-67,-91,-25,-92,-61,-106,13,-459
-12,-22,-33,-15,-37,-38,-65,-9,-231
-62,-86,-95,-12,-94,-33,-102,50,-434
-2,-1,-3,4,0,8,-3,13,16
-7,-5,-4,15,-15,0,-22,7,-31
-8,-30,-31,-25,-23,-15,-20,-3,-155
-32,-30,-44,-29,-36,-9,-47,18,-209
-5,-9,-25,2,-11,-16,-34,20,-78
-15,-53,-66,-24,-47,-30,-50,40,-245
-23,-78,-99,-35,-78,-28,-106,52,-395
44,44,36,43,2,23,-29,66,229
17,-20,-34,-9,-39,-40,-64,22,-167
-3,-47,-44,-14,-58,-27,-55,42,-206
-8,-146,-139,-70,-172,-122,-217,33,-841
37,-88,-63,0,-58,-54,-83,20,-289
-33,-163,-211,-96,-188,-93,-238,143,-879
-36,-75,-65,-41,-51,-23,-83,-15,-389
13,-27,-29,-6,2,-24,-38,42,-67
1,-26,-41,-29,-17,-38,-42,26,-166
-25,-99,-90,54,-114,-1,-173,75,-373
-28,-15,-23,-12,-11,-1,-24,-4,-118
-88,-38,-82,-64,-84,-78,-123,-37,-594
-3,-17,-58,-4,-63,-38,-94,16,-261
7,-8,-17,-16,9,-29,-28,14,-68
-83,-90,-106,-23,-37,5,-56,-6,-396
-17,-21,-49,22,-108,-42,-68,42,-241
-38,-56,-67,-25,-11,-41,-76,4,-310
-31,-53,-53,-18,-21,-50,-68,-3,-297
-16,-17,-15,-7,-16,-7,-19,-4,-101
17,-8,-7,27,-20,-13,-16,16,-4
14,-8,-6,26,-20,-12,-13,13,-6
-29,-36,-33,-14,-34,-10,-32,-11,-199
18,-31,-24,6,-8,-2,-8,24,-25
0,-56,-53,15,-99,-29,-56,48,-230
-106,-120,-157,-75,-193,-26,-189,9,-857
-35,-73,-77,-23,-71,-47,-80,44,-362
-15,-39,-29,9,-41,-11,-35,12,-149
10,-36,-26,3,-12,-3,-3,16,-51
-119,-110,-110,-39,-185,5,-150,70,-638
121,-9,44,124,52,-3,-118,147,358
-17,-24,-29,-22,-33,-6,-36,0,-167
70,-82,-58,-30,-11,-115,-169,97,-298
13,16,-10,12,-18,-14,-19,17,-3
-3,-37,-67,-28,-82,-49,-76,17,-325
-62,70,-13,-51,-6,-176,-30,24,-244
-102,-97,-118,-27,-23,-8,-49,-29,-453
-18,-29,-48,-28,-63,-53,-77,-21,-337
-18,-27,-47,-28,-63,-52,-77,-20,-332
-58,-109,-136,-18,-67,-58,-93,13,-526
-12,-34,-51,-15,-88,-41,-104,42,-303
-61,-3,-87,-84,-65,-122,-177,-50,-649
0,-8,-4,-4,2,-1,1,-8,-22
0,-8,-4,-4,2,-1,1,-8,-22
-20,-32,-54,-38,-41,-47,-79,-7,-318
-22,-32,-51,-39,-44,-48,-79,-8,-323
-56,-60,-117,-11,-159,-68,-192,25,-638
-47,-59,-118,-11,-154,-65,-188,26,-616
94,-59,-61,149,-76,-61,-107,97,-24
-5,-98,-92,-71,-67,-67,-243,19,-624
-19,-57,-42,-47,-45,-75,-73,39,-319
-26,-62,-44,-45,-51,-72,-69,35,-334
-21,-3,-28,-32,-45,-10,-35,-11,-185
-63,3,-89,-104,-135,-28,-101,-28,-545
-20,-31,-53,-7,-63,-14,-55,29,-214
-40,-52,-69,-8,-51,-23,-61,6,-298
-44,-54,-67,-7,-49,-20,-57,7,-291
-83,-93,-83,-55,-78,-55,-136,63,-520
-101,-100,-99,-31,-106,-41,-119,-22,-619
-103,-96,-102,-31,-108,-39,-121,-22,-622
-6,-7,-6,-5,-8,-4,-7,5,-38
-5,-10,-9,-7,-11,-5,-9,6,-50
-6,-10,-7,-6,-11,-3,-13,5,-51
-5,-5,-3,-1,-4,-1,-6,2,-23
-7,-7,-5,-3,-8,-1,-8,3,-36
-8,-7,-8,-8,-7,-6,-5,0,-49
-10,0,0,-1,-7,-1,-7,-1,-27
-6,-7,-6,-5,-8,-4,-7,3,-40
-6,-6,-9,-7,-8,-6,-6,0,-48
-13,-4,-3,-7,-9,0,-9,0,-45
107,-127,-153,42,-114,-217,-270,143,-589
-113,-172,-191,-34,-95,-41,-113,-15,-774
75,-33,-29,24,-24,-98,-123,57,-151
75,-33,-29,24,-24,-98,-123,57,-151
71,-32,-29,19,-20,-95,-122,55,-153
75,-33,-29,24,-24,-98,-123,57,-151
75,-33,-29,24,-24,-98,-123,57,-151
75,-33,-29,24,-24,-98,-123,57,-151
-18,-23,-64,-56,-30,-127,-156,-39,-513
-15,-93,-118,-41,-140,-47,-106,90,-470
-17,-40,-71,-45,-67,-30,-76,55,-291
28,2,-2,12,16,-9,0,14,61
28,2,-2,12,16,-9,0,14,61
28,2,-2,12,16,-9,0,14,61
-42,-42,-50,-32,-66,-34,-69,-9,-344
-30,-37,-32,-25,-50,-11,-37,5,-217
-29,-34,-31,-21,-47,-9,-40,0,-211
7,-49,-45,-5,-72,-42,-78,27,-257
12,-52,-48,-8,-73,-42,-79,33,-257
4,-51,-51,-6,-79,-42,-85,23,-287
7,-49,-45,-5,-72,-42,-78,27,-257
12,-79,-106,-51,-106,-143,-222,46,-649
8,-19,-22,10,-26,-8,-26,-4,-87
8,-19,-22,10,-26,-8,-26,-4,-87
-5,-8,-6,-4,-11,-10,-10,-7,-61
8,1,-7,6,-9,-4,-7,4,-8
22,-15,-66,-35,-111,-103,-131,5,-434
-10,-53,-87,-69,-121,-131,-175,32,-614
6,-11,-17,-8,-4,-30,-46,18,-92
-19,-18,-29,-10,-23,-40,-59,-6,-204
-6,-4,-13,-5,-12,-2,-19,-2,-63
0,-40,-23,14,-39,-6,-26,11,-109
0,-40,-23,14,-39,-6,-26,11,-109
-3,-25,-41,-65,-53,-16,-22,75,-150
-22,-9,-7,-12,-16,5,-26,-3,-90
-11,-16,-29,-23,-37,-16,-32,13,-151
50,-206,-295,19,-303,-144,-369,122,-1126
50,-211,-299,23,-302,-147,-374,134,-1126
60,-33,-7,109,-5,-59,-122,91,34
60,-34,-5,110,-4,-59,-122,93,39
19,-12,-18,66,-81,61,-71,117,81
16,-14,-19,66,-81,61,-70,117,76
19,-12,-20,65,-80,61,-67,115,81
-13,-108,-88,-51,-69,-47,-111,44,-443
-15,-26,-40,-28,-45,-17,-41,15,-197
16,-21,-1,32,-31,-25,-28,6,-52
16,-23,-4,29,-29,-20,-31,2,-60
-46,-72,-84,-16,-93,-69,-90,-23,-493
-18,-18,-41,-11,-54,-33,-60,4,-231
-7,-29,-64,-16,-93,-113,-167,-15,-504
-2,-41,-15,21,-29,-23,-32,13,-108
-18,-16,-28,1,-18,-1,-18,1,-97
30,-183,-246,-83,-143,-181,-254,208,-852
-104,-166,-201,-62,-63,3,-119,-37,-749
-15,-32,-31,-20,-27,-4,-13,6,-136
-3,-8,-26,-7,-21,-21,-28,15,-99
-16,-10,-23,2,-11,-22,-22,-5,-107
-40,-92,-78,-59,-83,-69,-120,3,-538
16,-37,-43,-24,-46,-29,-63,50,-176
3,-17,-23,-8,-4,-6,-8,17,-46
-20,-18,-12,-12,-16,-7,-21,16,-90
27,10,-12,21,-20,-11,-48,59,26
-23,-38,-43,5,-55,-31,-53,0,-238
-21,-37,-44,6,-55,-30,-53,0,-234
-11,-61,-58,-15,-49,-27,-43,14,-250
-11,-61,-58,-15,-49,-27,-43,14,-250
-3,-6,-6,-5,-7,-4,-6,6,-31
-51,-72,-86,-23,-95,-71,-92,-25,-515
45,-17,-15,29,1,-25,-32,31,17
-22,-32,-44,-29,-27,-18,-43,-5,-220
42,16,-14,29,-28,-30,-24,62,53
-4,-3,-13,-1,-14,-19,-23,-2,-79
-33,-19,-33,-24,-10,-23,-50,24,-168
-80,-105,-104,-65,-134,-21,-113,47,-575
-25,-51,-43,-17,-63,-4,-42,33,-212
-19,-13,-17,-20,-20,6,-20,3,-100
-79,-102,-102,-28,-129,-17,-128,34,-551
-3,-11,-51,-14,-32,-19,-30,17,-143
0,-21,-10,-3,-23,-24,-33,2,-112
0,-21,-10,-3,-23,-24,-33,2,-112
4,-15,-6,1,-23,-21,-27,7,-80
0,-21,-10,-3,-23,-24,-33,2,-112
1,-23,-8,-3,-21,-25,-26,1,-104
1,-23,-8,-3,-21,-25,-26,1,-104
41,-62,-70,10,-145,-26,-105,35,-322
41,-62,-70,10,-145,-26,-105,35,-322
4,-6,-5,5,-8,-7,-11,3,-25
-6,-27,-21,4,-23,-12,-28,12,-101
5,-21,-23,5,-31,-10,-39,17,-97
5,-21,-23,5,-31,-10,-39,17,-97
21,-16,-18,-3,8,-23,-19,35,-15
-32,-38,-61,-12,-90,-17,-70,10,-310
1,-9,-11,19,-21,11,-9,16,-3
3,-11,-13,19,-19,15,-4,23,13
-21,-8,-20,7,-53,0,-51,26,-120
7,-105,-76,1,-112,-13,-94,81,-311
7,-105,-76,1,-112,-13,-94,81,-311
-28,-38,-89,-19,-125,-71,-107,27,-450
-82,-87,-96,-46,-130,-27,-112,18,-562
-46,-99,-81,-15,-127,-22,-90,49,-431
-90,-114,-95,-28,-131,-36,-117,19,-592
-11,-9,-13,-12,-20,0,-18,4,-79
-19,-27,-37,-34,-31,-23,-42,33,-180
-21,-32,-38,-34,-35,-21,-41,33,-189
1,-20,-18,8,-14,-18,-25,1,-85
-24,-16,-44,-65,-33,-58,-61,-3,-304
37,-86,-104,-29,-69,-43,-98,93,-299
-2,-101,-97,0,-53,-6,-104,92,-271
47,-105,-117,1,-90,20,-44,137,-151
26,-75,-110,0,-73,3,-51,125,-155
21,-116,-108,-1,-110,-1,-50,173,-192
19,-28,-41,20,-42,2,-21,60,-31
42,-31,-35,36,-28,17,-14,71,58
18,-38,-29,3,-13,-4,-11,22,-52
18,-37,-31,2,-12,-4,-11,21,-54
-2,0,-2,-1,0,1,2,-2,-4
16,-21,-21,23,-15,-3,-10,34,3
3,-7,-27,12,-28,-12,-18,34,-43
5,-6,-22,12,-25,-10,-17,35,-28
10,-6,-21,18,-27,-7,-25,32,-26
-4,-27,-22,12,-30,7,-39,44,-59
-4,-28,-21,13,-30,8,-37,40,-59
-5,-28,-21,16,-31,4,-40,42,-63
3,-8,-18,4,-29,-8,-37,28,-65
1,-2,2,29,-23,-12,-7,3,-9
1,-2,2,29,-23,-12,-7,3,-9
1,-2,2,29,-23,-12,-7,3,-9
-34,-53,-75,-23,-83,-23,-75,21,-345
-13,-7,-17,3,-27,-22,-29,1,-111
-15,-32,-19,10,-13,-10,-25,-1,-105
-13,-11,-22,-8,-15,-10,-25,10,-94
33,-124,-170,-76,-155,-127,-166,117,-668
-16,-10,-21,-19,-17,-10,-17,4,-106
-16,-10,-21,-19,-17,-10,-17,4,-106
11,-5,-7,14,-8,-26,-31,40,-12
10,-124,-144,-6,-153,-90,-173,150,-530
34,-40,-37,54,-83,-35,-87,90,-104
0,-36,-56,-25,-29,-70,-55,42,-229
65,6,-25,37,-49,-75,-92,71,-62
-20,-12,-17,2,11,-6,-18,-4,-64
-2,-13,-19,1,-17,0,-24,-1,-75
-69,-122,-153,-31,-49,2,-76,-17,-515
-8,-82,-109,55,-149,-78,-191,60,-502
22,-56,-33,11,-61,-39,-51,57,-150
13,-117,-131,54,-179,-102,-203,54,-611
19,-40,-67,-33,-65,-98,-126,8,-402
0,-20,-32,8,-25,-10,-29,1,-107
-564,181,-902,-377,-818,-852,-1497,724,-4105
-137,-29,-175,-72,-155,-147,-303,84,-934
-10,-8,-17,9,-24,1,-21,17,-53
28,-20,-35,-9,-14,-40,-50,47,-93
26,-15,-37,-10,-15,-40,-51,45,-97
-6,-16,-23,10,-11,-6,-20,24,-48
16,-68,-46,28,-100,-19,-66,49,-206
16,-68,-46,28,-100,-19,-66,49,-206
-10,2,-29,-12,7,-8,-11,22,-39
37,-42,-62,-17,-78,-47,-53,20,-242
-3,-52,-54,-36,-95,-62,-76,54,-324
0,2,-1,0,0,0,1,-1,1
-20,-31,-19,-19,-33,-34,-49,-10,-215
-11,-16,-36,13,-18,-6,-37,7,-104
0,-12,-33,17,-17,3,-22,8,-56
-23,-30,-23,-22,-36,-40,-52,-14,-240
-9,-9,-10,-7,-12,-3,-14,1,-63
43,-5,-17,3,2,-30,-29,64,31
-41,-33,-62,-19,-65,-2,-81,12,-291
-8,-5,-6,-4,-9,-1,-12,4,-41
0,0,0,0,0,0,0,0,0
-53,-98,-124,-69,-139,-44,-122,48,-601
27,-36,-44,21,-63,7,-22,68,-42
13,-50,-56,16,-52,-16,-53,54,-144
-7,-13,-20,0,-30,-7,-28,32,-73
-48,-50,-42,-20,-66,-40,-108,13,-361
239,-120,-130,141,-117,-226,-311,292,-232
199,-136,-142,150,-129,-125,-263,341,-105
-67,-62,-155,-72,-112,-41,-109,60,-558
2,-95,-125,6,-62,-64,-111,23,-426
-38,-96,-146,-53,-120,-101,-155,39,-670
-9,-44,-71,6,-40,-66,-86,46,-264
-5,-20,-24,-18,-24,-29,-30,2,-148
3,-15,-27,4,-28,-18,-37,11,-107
7,9,-25,12,-54,-36,-43,19,-111
-11,-34,-25,3,-41,-3,-32,26,-117
-2,10,11,22,-19,-8,-41,21,-6
-9,-35,-31,-15,-42,-18,-44,18,-176
-11,-23,-29,-19,-22,-8,-31,-6,-149
-1,-31,-25,9,-23,-11,-11,26,-67
-3,-26,-33,-4,-7,5,-22,26,-64
-37,-84,-90,-52,-134,-61,-117,-32,-607
109,16,28,7,59,-99,-47,125,198
-19,-14,-27,-23,-27,-15,-31,0,-156
12,-99,-121,-47,-80,-36,-96,63,-404
-21,-62,-91,-17,-74,-10,-119,33,-361
-19,-89,-127,-90,-96,-75,-137,24,-609
61,-177,-149,-23,-169,-106,-211,136,-638
3,-4,-7,3,-10,-6,-7,16,-12
-40,-203,-172,-62,-181,-30,-157,62,-783
36,-73,-107,74,-104,-136,-180,101,-389
-45,-55,-68,-28,-73,-42,-116,54,-373
0,-26,-32,5,-49,-31,-48,30,-151
24,-33,-50,9,-70,-73,-95,33,-255
4,-98,-55,-5,-52,-20,-85,89,-222
-13,-117,-94,-9,-127,-58,-86,97,-407
58,-63,-72,1,25,-38,-36,27,-98
6,-41,-46,1,-56,-47,-67,15,-235
94,2,-25,47,-56,-26,-22,89,103
68,-109,-99,-22,-99,-38,-110,109,-300
11,-67,-88,-24,-96,-19,-49,54,-278
14,-329,-267,-21,-390,-93,-298,337,-1047
34,-42,-67,15,-113,-92,-118,37,-346
9,-67,-42,10,-68,-67,-109,57,-277
2,-28,-19,12,-18,0,-20,22,-49
-49,-64,-55,-43,-86,-43,-84,8,-416
0,-11,-15,1,-22,-28,-25,9,-91
-12,-73,-51,47,-74,-33,-94,51,-239
-26,-38,-30,-4,-55,-20,-55,11,-217
-54,-94,-89,-49,-117,1,-88,43,-447
-2,-81,-95,-62,-135,-106,-124,33,-572
144,-17,-70,41,-10,-61,-71,176,132
7,-107,-145,42,-100,25,-172,136,-314
-3,-42,-50,-26,-111,-29,-91,60,-292
-1,50,-67,-48,-22,-51,-110,11,-238
-35,-46,-24,42,-10,28,-67,30,-82
51,-59,-52,33,-103,-88,-96,44,-270
-14,-22,-27,-23,-28,-20,-34,-6,-174
-19,-203,-205,17,-211,-11,-176,132,-676
24,-203,-232,-59,-341,-216,-287,123,-1191
8,-38,-53,-2,-55,-21,-70,4,-227
-3,-52,-49,-9,-46,-2,-47,57,-151
-14,-13,-52,-6,-48,-12,-47,41,-151
22,-52,-28,44,-41,-21,-31,26,-81
30,-1,-70,-29,-129,-48,-97,12,-332
-57,-60,-74,-48,-71,-39,-104,29,-424
-19,-47,-79,-35,-109,-68,-104,15,-446
-44,-76,-107,-44,-118,-57,-106,-9,-561
-43,-70,-65,-35,-92,-45,-106,33,-423
-103,-129,-142,-45,-207,-84,-251,-34,-995
11,-81,-89,16,-114,-2,-81,97,-243
2,-37,-57,12,-36,-13,-49,54,-124
29,-67,-37,16,-71,-32,-73,50,-185
2,-25,-11,13,-20,-8,-6,4,-51
-33,-38,-49,-39,-57,-23,-57,30,-266
-8,-13,-17,-1,-17,-3,-18,13,-64
-17,-62,-100,-31,-97,3,-86,43,-347
65,-128,-150,113,-209,-131,-323,-17,-780
-77,-54,-78,-21,-105,-31,-114,10,-470
-218,-239,-278,-204,-317,-243,-565,-198,-2262
7,-56,-46,7,-64,-58,-58,28,-240
-17,-66,-70,-31,-74,-77,-77,25,-387
220,-141,-273,-50,-202,-107,-264,209,-608
23,-60,-90,22,-128,-21,-89,34,-309
-36,-75,-80,-22,-129,-14,-113,73,-396
55,-87,-27,45,-35,-29,-101,108,-71
-67,-65,-122,-20,-152,-17,-133,87,-489
-60,-93,-129,-10,-174,-28,-162,82,-574
-63,-50,-102,-33,-140,10,-129,73,-434
13,-129,-156,-74,-128,-66,-136,49,-627
-11,-54,-97,-46,-154,-56,-111,17,-512
41,-49,-30,5,-83,-7,-56,45,-134
-14,-71,-64,-23,-108,-12,-77,74,-295
-7,-129,-189,-4,-271,-15,-196,233,-578
-40,-163,-115,-27,-209,-85,-181,26,-794
-48,-160,-93,10,-224,-74,-192,10,-771
39,-3,-9,10,-7,-3,-37,29,19
-89,-104,-118,-34,-97,-43,-147,56,-576
-53,-87,-85,-73,-144,-51,-162,87,-568
-10,-29,-17,11,-48,-17,-42,26,-126
-16,-24,-34,-2,-44,-12,-47,28,-151
-62,-36,-41,-10,-61,8,-58,13,-247
-15,-180,-165,-15,-203,-132,-303,142,-871
-43,-229,-312,-106,-559,-474,-618,-222,-2563
16,-57,-79,20,-89,-5,-82,83,-193
38,-103,-26,38,-19,-24,-65,54,-107
-31,-40,-40,-32,-102,-40,-82,23,-344
-1,-40,-23,30,-90,-33,-74,6,-225
3,-129,-143,-17,-161,-93,-156,80,-616
-105,-110,-145,-103,-54,-79,-165,-112,-873
-21,-159,-254,-61,-203,-40,-199,159,-778
-24,-102,-64,13,-107,-21,-102,29,-378
-3,-22,-28,-24,-40,-31,-49,-2,-199
-53,-78,-80,-11,-64,29,-90,58,-289
-20,-68,-54,19,-54,27,-79,62,-167
-26,-59,-51,-21,-97,-28,-110,36,-356
3,-46,-84,-50,-56,-93,-141,44,-423
-21,-21,-46,-28,-42,-36,-79,50,-223
-32,-45,-50,5,-88,-14,-72,-1,-297
44,-175,-161,-18,-285,-154,-205,109,-845
-52,-51,-78,-10,-108,-9,-85,60,-333
-118,-92,-70,-29,-138,-32,-121,1,-599
-403,-458,-554,-416,-755,-603,-952,-296,-4437
-20,-89,-115,-50,-226,-33,-184,60,-657
-16,-65,-99,-15,-157,-18,-97,84,-383
-68,-137,-94,-22,-185,-112,-204,41,-781
-8,-20,-22,-2,-18,-21,-32,-1,-124
-14,-35,-37,-16,-43,-23,-42,26,-184
-80,-83,-105,-80,-125,-23,-131,20,-607
38,-374,-420,188,-388,-1,-368,393,-932
19,-48,-73,-14,-94,-5,-77,53,-239
-34,-95,-64,-35,-122,-42,-98,55,-435
-7,-66,-41,-29,-80,-66,-65,18,-336
91,-19,-46,80,-40,23,-39,150,200
-71,-21,-48,-1,-43,36,-87,46,-189
-22,-35,-19,1,-38,-25,-30,2,-166
4,-56,-40,-13,-124,-30,-69,36,-292
3,-2,-22,9,-38,-20,-46,39,-77
35,-68,-49,44,-130,-26,-74,77,-191
46,-92,-66,49,-93,-80,-81,59,-258
11,-12,-34,20,-65,-17,-57,37,-117
-19,-22,-23,3,-24,-20,-39,33,-111
7,-26,-72,19,-40,-12,-56,87,-93
46,103,86,184,-93,16,-120,60,282
99,-137,-225,-180,-14,-127,-273,-201,-1058
2,-18,-28,-14,-26,-16,-20,17,-103
-42,-41,-63,-65,-110,-76,-115,-11,-523
2,-14,-22,10,-17,11,-27,3,-54
538,370,360,374,191,-63,-147,400,2023
176,29,49,65,-85,-74,-132,172,200
138,30,40,64,-115,-52,-120,174,159
232,-268,-319,40,-683,-143,-458,582,-1017
12,-58,-43,31,-89,-45,-63,25,-230
6,-52,-37,24,-89,-27,-53,31,-197
34,-293,-350,132,-305,-12,-403,337,-860
7,-55,-50,23,-145,-52,-83,38,-317
-60,-69,-287,-251,-296,-259,-525,19,-1728
-1,-33,-51,-12,-68,-39,-73,11,-266
-15,-13,-42,-22,-29,-22,-46,23,-166
-8,-36,-22,-6,-36,-5,-28,9,-132
21,-35,-35,10,-75,-42,-72,31,-197
-48,-66,-86,-47,-71,-23,-96,41,-396
12,-52,-46,12,-50,4,-38,69,-89
-7,-49,-56,6,-42,14,-35,46,-123
-26,-39,-52,-2,-107,-47,-82,-9,-364
12,-57,-33,0,-40,-50,-95,48,-215
-6,-60,-41,0,-57,-59,-89,19,-293
-32,-42,-58,-35,-101,-53,-97,5,-413
-26,-32,-33,-19,-44,-11,-45,25,-185
10,-71,-80,-45,-98,-54,-92,52,-378
-21,-49,-74,-28,-99,-47,-66,46,-338
-49,-82,-89,-39,-79,-35,-124,58,-439
-8,-51,-41,45,-90,-46,-88,51,-228
-21,-43,-34,-21,-22,-10,-31,19,-163
-12,-132,-164,-57,-116,-150,-225,14,-842
-77,-84,-142,-70,-103,-95,-144,10,-705
-57,-134,-82,28,-208,-129,-203,-75,-860
20,-296,-188,14,-221,-195,-315,16,-1165
3,-33,-26,11,-16,-21,-29,15,-96
60,-108,-123,14,-150,15,-117,158,-251
-4,-3,-19,-9,-35,-12,-24,22,-84
-6,-10,-14,-2,-17,-13,-30,8,-84
-216,-216,-254,-133,-294,-208,-532,-196,-2049
-184,-158,-227,-155,-302,-264,-546,-198,-2034
16,-88,-80,25,-85,-43,-93,29,-319
11,-77,-77,4,-141,-19,-103,66,-336
-55,-72,-112,-50,-104,-55,-118,17,-549
23,-51,-47,-34,-22,-55,-65,39,-212
-29,-105,-110,-11,-171,-68,-145,75,-564
21,-54,-48,-11,-49,-54,-58,24,-229
-40,-89,-112,8,-141,-27,-111,43,-469
-1,-55,-35,-13,-35,-20,-37,11,-185
-25,-35,-35,-18,-53,-12,-38,16,-200
37,-102,-88,16,-137,-71,-91,91,-345
-25,-30,-59,-46,-41,-75,-102,-29,-407
-42,-18,-31,-24,-35,-25,-42,-6,-223
1,-37,-29,0,-27,-16,-29,24,-113
-19,-42,-44,-24,-42,-40,-63,12,-262
7,-36,-56,-7,-52,-32,-64,45,-195
41,-45,-28,28,6,-53,-64,39,-76
-28,-37,-41,-11,-34,-29,-52,25,-207
43,-65,-62,53,-73,46,-45,103,0
-49,-31,-77,-46,-126,-98,-178,-5,-610
21,-119,-117,98,-160,-27,-142,201,-245
-10,-19,-36,-7,-25,-20,-48,24,-141
-2,-25,-14,-5,-20,-10,-9,14,-71
-2,-34,-27,3,-22,-5,-30,21,-96
6,-4,-44,32,-34,-34,-120,17,-181
-173,-155,-225,-154,-297,-254,-543,-203,-2004
-150,-228,-281,-153,-299,-234,-540,-198,-2083
-199,-240,-307,-117,-465,-65,-441,149,-1685
-35,-111,-89,-25,-142,-83,-124,34,-575
50,-87,-133,42,-134,34,-94,143,-179
-22,-46,-73,-41,-69,-29,-55,53,-282
248,-406,-612,24,-472,271,-312,616,-643
-54,-119,-108,47,-238,24,-179,189,-438
-52,-44,-48,-18,-49,-34,-99,33,-311
-32,-99,-163,-43,-250,-26,-178,61,-730
-28,-111,-123,-19,-210,-83,-155,55,-674
-18,-16,-30,-2,-14,-20,-22,-7,-129
-2,164,66,205,-87,74,-147,38,311
-38,-1,0,55,-105,1,-122,-12,-222
1,42,34,117,-109,-10,-132,58,1
32,-88,-99,-9,-115,-42,-77,87,-311
-49,-87,-154,55,-110,-11,-177,74,-459
-15,-92,-64,-11,-107,-70,-117,0,-476
-62,-63,-135,-33,-47,-18,-96,20,-434
2,-60,-40,8,-77,-43,-48,43,-215
56,-68,-82,39,-32,48,-72,109,-2
-15,-8,-20,0,-33,7,-25,10,-84
13,-49,-57,-5,-94,-78,-84,2,-352
-43,-14,-45,-28,-48,-48,-73,-4,-303
-5,-48,-81,-8,-54,16,-27,57,-150
-17,-20,-34,-6,-49,-2,-49,24,-153
32,-51,-65,0,-80,-54,-78,51,-245
1,-41,-60,-24,-64,-16,-38,44,-198
-5,-34,-54,-26,-65,-19,-39,53,-189
-16,-43,-59,-14,-58,-18,-58,41,-225
-5,-41,-56,-21,-74,-16,-56,38,-231
-48,-62,-62,24,-119,-40,-142,12,-437
-14,-75,-79,28,-134,-60,-142,-15,-491
39,-101,-108,-12,-196,-76,-131,126,-459
34,-56,-59,4,-95,-37,-64,24,-249
-47,-14,-35,-55,-9,-43,-78,-23,-304
-22,-145,-114,14,-179,-77,-218,78,-663
6,-41,-60,-23,-111,-31,-71,45,-286
-156,-127,-132,-50,-223,-23,-228,57,-882
-22,-30,-52,-1,-84,-46,-85,-14,-334
21,-51,-50,32,-82,-41,-63,18,-216
451,344,332,241,199,-168,-210,376,1565
-20,-105,-131,-66,-110,-109,-149,38,-652
-7,-30,-50,-8,-38,-22,-38,6,-187
28,-48,-51,-36,-31,-70,-71,48,-231
-4,-34,-35,-3,-26,-20,-37,-4,-163
-24,-60,-56,-5,-50,-53,-98,13,-333
31,-39,-49,-35,-94,-9,-70,45,-220
-20,-76,-72,-22,-78,-7,-110,31,-354
5,-40,-66,-28,-103,-83,-84,20,-379
21,-18,4,47,-71,31,-63,124,75
-28,-69,-53,-20,-111,-82,-169,-46,-578
4,-14,-45,-4,-21,-20,-32,28,-104
-34,-58,-57,31,-41,30,-79,14,-194
-4,-11,-19,8,-20,-12,-18,18,-58
-7,-54,-49,19,-30,-36,-57,-12,-226
58,10,5,35,-16,-9,-28,55,110
-62,-124,-59,39,-71,30,-112,59,-300
7,-103,-98,-30,-131,-104,-118,71,-506
2,-27,-59,-10,-9,-58,-129,19,-271
11,-29,-59,-7,-45,14,-36,66,-85
56,-29,-40,33,-34,-56,-60,53,-77
-30,-69,-76,-11,-122,-94,-122,-2,-526
-57,-66,-70,-42,-101,-60,-120,3,-513
-7,-73,-56,18,-66,-6,-73,43,-220
-7,-9,-17,-6,-17,-4,-24,10,-74
56,-341,-128,200,-251,107,-192,222,-327
6,-51,-7,40,-24,13,-22,44,-1
-71,-118,-114,-54,-142,-40,-122,65,-596
95,-139,-116,105,-181,40,-145,251,-90
8,-55,-56,-18,-69,-57,-69,7,-309
-23,-25,-22,8,-23,-10,-33,7,-121
-10,-67,-69,-30,-65,-35,-80,37,-319
-63,-181,-228,-84,-286,-174,-334,95,-1255
9,-58,-83,-20,-149,-37,-89,54,-373
0,-13,-21,8,-18,17,-9,29,-7
-49,-76,-139,-78,-163,-68,-162,27,-708
-8,-99,-68,-29,-66,-53,-72,36,-359
7,-38,-38,-3,-29,-43,-43,-7,-194
79,-35,17,117,31,-12,-106,95,186
37,-64,-53,-8,-39,-76,-107,76,-234
46,-44,-5,58,22,-33,-76,66,34
-62,-54,-108,-54,-162,-38,-190,59,-609
-7,11,-15,-6,-9,-49,-41,27,-89
1,-92,-39,61,-75,-17,-128,55,-234
-111,-213,-189,-53,-219,-102,-245,-24,-1156
-2,-30,-50,-18,-38,-62,-76,-19,-295
-55,-115,-124,-50,-131,29,-112,69,-489
63,-115,-65,49,-122,-67,-123,100,-280
10,-119,-100,-30,-94,-85,-133,68,-483
2,-22,-5,12,-3,-2,-1,3,-16
117,-58,-187,44,-115,-54,-187,132,-308
97,-46,7,105,-60,-30,-90,134,117
-18,-108,-109,-25,-119,-5,-95,50,-429
3,-79,-58,-1,-126,-53,-89,53,-350
-2,-80,-67,-6,-86,-62,-96,13,-386
-24,-50,-38,-22,-70,-24,-88,6,-310
9,-71,-67,37,-71,-51,-68,28,-254
-3,-103,-109,0,-163,-87,-165,37,-593
-12,-19,-11,-2,-11,-5,-36,-16,-112
-4,-38,-38,-9,-28,-13,-51,2,-179
12,-27,-69,45,-75,-36,-76,65,-161
11,-90,-106,32,-155,-56,-114,115,-363
-14,-71,-52,34,-97,-18,-66,46,-238
-9,-103,-66,45,-82,-1,-88,35,-269
-48,-83,-62,18,-69,1,-72,7,-308
2,-15,-30,-11,-38,10,-5,34,-53
17,-44,-18,42,-51,-6,-48,29,-79
-20,-59,-66,-32,-72,-29,-65,21,-322
30,-214,-136,70,-193,10,-211,109,-535
21,-59,-87,-27,-82,-3,-64,99,-202
-7,-51,-34,-23,-44,-20,-34,6,-207
10,-77,-47,10,-81,-33,-86,46,-258
-22,-17,-82,-52,-70,-24,-78,1,-344
36,-68,-25,16,-42,-66,-96,42,-203
-11,-43,-38,-30,-43,-45,-61,7,-264
-26,-25,-34,-13,-8,-4,-35,2,-143
-10,-41,-42,-8,-30,-25,-71,-29,-256
3,-60,-111,-1,-108,35,-69,128,-183
35,-66,-72,-6,-87,-109,-116,43,-378
15,-56,-25,22,-74,-25,-81,88,-136
-55,-77,-86,-43,-69,-43,-102,12,-463
-70,-72,-73,-32,-89,-80,-136,-48,-600
-21,-58,-42,2,-118,-17,-62,51,-265
-14,-76,-43,17,-26,-19,-61,12,-210
66,-73,-103,-27,-74,-21,-49,106,-175
-3,-40,-37,-15,-44,-17,-37,8,-185
-5,-25,-36,-1,-32,-6,-28,9,-124
29,-6,-62,16,-37,-60,-135,90,-165
-17,-25,-43,-32,-22,-33,-77,32,-217
5,-25,-51,-27,-45,-6,-83,69,-163
-19,-11,-25,-2,-37,7,-27,23,-91
10,-10,-25,18,-58,-24,-45,9,-125
-90,-108,-107,-31,-146,-101,-213,4,-792
229,153,49,175,21,-73,-109,205,650
-48,-82,-88,-12,-88,9,-68,65,-312
9,-4,-47,21,-23,-7,-54,49,-56
-6,-10,-11,-3,-18,-4,-16,9,-59
-13,-13,-18,-5,-14,-10,-12,3,-82
-2,-82,-88,-11,-42,2,-80,96,-207
-3,-1,-15,-10,-38,1,-23,17,-72
-44,-109,-95,-53,-136,-101,-139,26,-651
8,-31,-39,23,-50,-17,-61,16,-151
-7,-88,-77,38,-64,-19,-91,73,-235
-81,-132,-161,-8,-71,-19,-108,-6,-586
-60,-94,-134,-35,-74,-52,-72,19,-502
-38,-42,-44,-24,-38,-31,-48,9,-256
-31,-74,-71,-52,-123,-80,-127,14,-544
-42,-60,-66,-16,-85,-43,-109,56,-365
-12,-45,-75,-8,-67,-48,-74,35,-294
10,-16,-38,-1,-21,-6,-34,54,-52
199,-284,-476,-14,-298,-85,-431,562,-827
-18,-82,-78,-23,-69,-76,-120,37,-429
82,-53,-32,29,-41,-68,-130,103,-110
5,-5,-24,-11,-46,-5,-24,47,-63
-64,-87,-69,-15,-101,-40,-105,-25,-506
119,8,39,122,-36,-21,-134,156,253
-11,-80,-64,12,-68,-15,-100,56,-270
-74,-208,-222,-87,-229,-110,-259,22,-1167
117,11,1,105,-36,-51,-159,128,116
-405,-227,-349,-160,-627,-310,-757,-230,-3065
36,-32,-18,36,-49,1,-36,69,7
426,-210,52,204,176,-155,-158,388,723
-8,-17,-20,-7,-17,-8,-17,8,-86
27,-43,-40,28,-20,-46,-91,59,-126
-13,-45,-22,6,-41,-22,-35,12,-160
-28,-112,-107,-79,-161,-109,-174,4,-766
-76,-149,-187,-88,-282,-176,-291,53,-1196
102,-30,-88,128,-62,88,-60,143,221
15,-33,-44,-1,-47,-14,-29,24,-129
4,-2,-33,-4,-27,-28,-37,13,-114
11,-108,-112,94,-55,-17,-154,115,-226
443,73,-355,122,-388,43,-243,651,346
-52,-90,-89,-13,-124,-35,-117,16,-504
2,-184,-238,-42,-326,-140,-335,262,-1001
65,5,-64,-4,-27,40,-62,130,83
6,-31,-51,-40,-64,-30,-33,13,-230
130,-160,-276,-83,-389,-237,-322,113,-1224
15,-43,-56,35,-110,-50,-110,2,-317
38,-36,-42,3,-54,-11,-36,67,-71
23,-64,-25,57,-60,25,-42,121,35
-38,-164,-206,-49,-267,-2,-219,126,-819
-20,-67,-62,3,-75,-48,-79,24,-324
-6,-114,-49,14,-104,-32,-136,69,-358
15,-97,-162,-35,-168,17,-101,116,-415
-10,-97,-79,-16,-112,-44,-131,52,-437
15,-47,-35,14,-38,-7,-47,67,-78
-68,-81,-136,-70,-203,-73,-215,45,-801
-64,-77,-99,3,-139,18,-118,84,-392
57,-63,-70,1,30,-38,-38,7,-114
37,-58,-69,-6,17,-40,-23,40,-102
44,-56,-67,-9,16,-43,-26,42,-99
-9,-43,-54,-4,-54,-18,-37,46,-173
-58,-133,-155,-17,-57,-35,-94,-23,-572
-4,-43,-50,6,-55,-27,-64,35,-202
-12,-108,-116,19,-166,-85,-148,47,-569
-20,-88,-61,-45,-99,-58,-62,35,-398
24,-65,-54,12,-116,-57,-104,34,-326
-29,-95,-123,-35,-146,-55,-154,50,-587
12,-20,-24,2,-31,-43,-45,-2,-151
18,-117,-81,11,-61,-30,-110,80,-290
-77,-178,-163,-25,-196,-39,-208,59,-827
-72,-170,-114,-7,-199,-99,-188,-26,-875
33,-67,-26,99,-87,-29,-88,61,-104
6,-38,-35,42,-97,-13,-50,56,-129
-7,-47,-25,31,-25,-27,-69,13,-156
18,-67,-102,66,-46,32,-110,98,-111
-107,-97,-136,-71,-151,-105,-201,-51,-919
-36,-159,-167,-57,-276,-26,-222,122,-821
-2,-28,-23,5,-23,-14,-13,21,-77
-21,-127,-78,12,-155,-34,-94,59,-438
-25,-80,-94,-1,-111,23,-82,85,-285
-23,-7,-24,-22,-28,-25,-37,21,-145
18,-34,-49,38,-74,-11,-104,46,-170
-21,-60,-97,-40,-95,-23,-86,70,-352
-144,-271,-205,-25,-288,-72,-254,53,-1206
3,-61,-23,31,-54,-19,-55,58,-120
-9,-3,-31,-28,1,-18,-46,-25,-159
74,-38,-15,32,27,-21,-27,91,123
39,-74,-127,-7,-184,-46,-36,106,-329
-101,-117,-183,-3,-92,-18,-118,3,-629
-112,-149,-195,-16,-48,-4,-113,13,-624
-114,-140,-186,-55,-34,10,-52,-26,-597
-31,-107,-136,7,-89,-43,-95,57,-437
-118,-137,-162,-29,-104,-48,-115,20,-693
-39,-42,-81,-22,-71,-67,-108,4,-426
-54,-83,-78,6,-50,-11,-46,17,-299
-67,-101,-141,6,-60,3,-79,-11,-450
-87,-119,-170,-39,-52,-15,-65,1,-546
-38,-38,-58,-11,-19,-19,-32,20,-195
-83,-77,-123,16,-41,8,-62,28,-334
-22,-37,-57,-49,-63,-36,-67,13,-318
-54,-43,-105,-25,-50,-36,-123,8,-428
-63,-114,-140,-31,-24,-30,-61,-48,-511
-85,-108,-141,-23,-76,-26,-113,30,-542
-87,-102,-135,-27,-41,27,-62,-3,-430
-141,-186,-186,-41,-99,-33,-117,-39,-842
-56,-76,-83,11,-53,-2,-87,17,-329
-177,-240,-265,-79,-35,19,-127,-78,-982
-103,-105,-191,-47,-78,-37,-96,3,-654
-27,-100,-191,-11,-120,-119,-252,19,-801
-26,-45,-63,-22,-49,-35,-37,29,-248
-6,-51,-12,46,-85,-35,-81,16,-208
32,-77,-97,-11,-152,-49,-119,33,-440
-15,-38,-40,-12,-43,-22,-29,-1,-200
-14,14,-23,-19,28,6,-7,34,19
-85,-110,-145,-15,-92,-44,-122,18,-595
-29,-47,-106,-14,-54,-50,-80,44,-336
-19,-51,-51,-6,-68,-35,-71,2,-299
6,-93,-64,11,-87,-15,-64,31,-275
-19,-109,-120,-7,-118,29,-94,94,-344
8,-99,-100,-7,-92,-22,-77,103,-286
-19,-93,-70,-2,-107,-50,-84,56,-369
37,-12,14,63,-3,-28,-62,50,59
47,-126,-134,161,-244,87,-158,239,-128
1,-68,-58,3,-70,-17,-89,58,-240
2,-50,-79,28,-146,-38,-124,62,-345
-10,-117,-81,-48,-151,-110,-206,48,-675
-80,-47,-123,-24,-52,-113,-176,-37,-652
14,-31,-16,28,-19,-19,-52,19,-76
11,-42,-38,0,-11,-32,-67,36,-143
8,-64,-28,-14,-28,-55,-85,69,-197
-5,-29,-14,39,4,-9,-66,35,-45
-10,-66,-50,-6,-69,-45,-50,14,-282
67,-43,-28,17,-33,-83,-119,20,-202
28,-31,-39,26,-63,9,-36,55,-51
-12,-50,-58,-25,-94,-45,-82,19,-347
45,-17,-27,29,-40,-55,-64,38,-91
29,-75,-78,-55,-39,-37,-96,108,-243
-15,-22,-18,-18,-26,-43,-37,-15,-194
156,-65,-15,86,-37,-99,-135,192,83
-24,-47,-44,-6,-66,-10,-55,10,-242
1,-86,-54,25,-64,-7,-97,74,-208
-53,-92,-73,40,-152,-27,-186,8,-535
-42,-47,-44,13,-129,-10,-131,93,-297
-32,-43,-47,-1,-121,-75,-148,-11,-478
85,-59,-40,32,-7,-77,-123,35,-154
81,-2,-29,47,-2,-32,-15,-9,39
5,-62,-49,11,-77,-67,-70,29,-280
-41,-61,-58,-7,-75,-18,-80,9,-331
4,-60,-31,14,-60,-6,-38,53,-124
-31,-79,-66,-7,-110,-27,-96,45,-371
-17,-84,-90,-16,-90,-42,-91,12,-418
-35,-109,-101,-67,-156,-47,-108,84,-539
-15,-78,-94,-35,-149,-29,-85,83,-402
-17,-96,-163,-53,-168,-60,-154,119,-592
21,-45,-21,57,-98,-49,-75,33,-177
9,-81,-110,21,-201,-55,-161,85,-493
13,-30,-60,-37,-44,-57,-79,-9,-303
-11,-24,-41,-26,-38,0,-50,40,-150
29,-256,-191,78,-215,76,-265,461,-283
58,-23,19,52,1,-8,-25,68,142
-9,-33,-74,-36,-47,-44,-62,39,-266
-5,-23,-38,1,-24,-59,-54,36,-166
-117,-234,-257,-33,-315,-32,-243,113,-1118
-7,-43,-40,-16,-89,-43,-79,-3,-320
7,-63,-71,-27,-162,-53,-143,19,-493
-42,-69,-73,-25,-76,-26,-99,21,-389
-31,-135,-93,-30,-172,-126,-183,7,-763
-20,-7,-49,-41,-18,-62,-75,-4,-276
-72,-114,-139,-64,-247,-127,-208,-12,-983
1,-86,-74,4,-120,-49,-96,60,-360
-6,-19,-16,-8,-25,-1,-28,15,-88
-59,-86,-129,1,-158,-47,-161,52,-587
-29,-14,-34,-15,-46,-2,-38,-2,-180
-60,-77,-106,-39,-132,-56,-146,72,-544
-50,-46,-43,-31,-49,-11,-69,-1,-300
78,-88,-58,91,-25,13,-104,164,71
83,-139,-158,-27,-245,-210,-256,-48,-1000
-30,-69,-63,8,-75,-43,-90,11,-351
-13,-78,-111,-23,-148,-38,-117,77,-451
-34,-125,-125,-8,-129,30,-142,119,-414
-54,-47,-48,-10,-66,8,-63,18,-262
-45,-113,-76,-1,-136,-3,-94,70,-398
-48,-117,-102,-5,-127,24,-79,83,-371
22,-17,-12,20,-36,-37,-48,21,-87
-13,-25,-32,1,-37,-10,-27,23,-120
-3,-1,-3,0,-6,6,-13,22,2
-59,-40,-130,-8,-144,-13,-137,56,-475
-33,-102,-116,-25,-159,-73,-147,61,-594
173,-262,-507,-128,-341,-132,-435,518,-1114
15,-2,-50,14,-62,-50,-109,48,-196
-19,-36,-30,-14,-13,-24,-37,3,-170
8,-56,-84,-30,-75,-81,-163,100,-381
-6,-37,-31,-2,-33,-30,-77,-10,-226
50,-9,-47,8,-78,-26,-29,97,-34
8,-88,-90,-11,-153,-78,-156,122,-446
62,-29,-47,18,-8,-37,-48,33,-56
19,-12,-44,10,-36,14,-28,56,-21
-24,-26,-41,-31,-37,-16,-43,1,-217
20,-18,-53,-6,-20,-65,-67,31,-178
7,-75,-110,-4,-97,-28,-92,141,-258
-10,-102,-179,-118,-156,-132,-228,41,-884
-10,-24,-19,-9,-22,-6,-26,14,-102
64,-72,-74,1,-70,-78,-113,131,-211
-30,17,5,85,-106,-18,-122,-18,-187
1,37,18,62,-102,2,-108,40,-50
32,-120,-113,-3,-203,17,-109,200,-299
70,-106,-59,43,-159,13,-113,163,-148
-47,-25,-52,-5,-83,-9,-89,18,-292
-47,-69,-63,1,-117,0,-94,-8,-397
-34,-53,-48,-2,-87,-18,-85,0,-327
-52,-115,-98,-63,-149,-113,-149,13,-726
-6,-21,-12,30,-20,-21,-4,-7,-61
-41,-130,-132,-25,-163,-84,-149,53,-671
-37,-221,-167,12,-258,-94,-279,71,-973
-23,-128,-113,-30,-142,-63,-131,50,-580
22,-99,-105,-36,-103,-78,-157,88,-468
-17,-32,-38,-36,-41,-38,-52,-20,-274
-39,-42,-72,-7,-66,9,-45,35,-227
-45,-91,-144,-41,-153,40,-140,96,-478
128,86,-55,136,-30,-29,-42,126,320
-59,-59,-139,-58,-249,-55,-158,54,-723
5,-50,-46,-9,-53,-16,-59,36,-192
-35,-30,-26,-43,-52,-31,-38,4,-251
-46,-36,-59,-12,-69,-5,-94,20,-301
12,-41,-32,-11,-35,-11,-35,25,-128
36,-58,-68,-22,-34,-38,-98,98,-184
-33,-34,-33,-22,-45,-48,-67,-18,-300
-37,-75,-81,-43,-71,-50,-130,22,-465
28,-59,-97,9,-163,-67,-161,64,-446
-47,-141,-139,-32,-191,-67,-137,86,-668
-39,-41,-66,-41,-100,-62,-117,9,-457
27,-46,-42,0,-41,-91,-102,45,-250
-26,-44,-97,-1,-75,-16,-113,29,-343
-23,-68,-48,-19,-107,-48,-89,21,-381
26,-50,-94,-26,-119,-91,-169,71,-452
43,-77,-45,50,-16,-44,-62,97,-54
21,26,12,67,-1,-48,-65,39,51
-12,-56,-46,-2,-83,-39,-52,50,-240
-123,-148,-227,-137,-270,-75,-240,110,-1110
-17,-39,-36,16,-21,-9,-45,-4,-155
-35,-91,-45,-13,-84,-45,-78,3,-388
-4,-54,-68,-1,-94,-47,-130,38,-360
18,-185,-113,1,-127,-54,-130,107,-483
2,-143,-127,-18,-227,16,-129,184,-442
48,-106,-113,9,-215,-51,-134,167,-395
119,-114,-21,84,-73,-18,-78,154,53
40,-80,-112,40,-180,-85,-142,43,-476
-11,-21,-26,-19,-24,-19,-33,-6,-159
-9,-22,-25,-19,-26,-17,-33,1,-150
-12,-87,-84,-38,-46,-58,-98,44,-379
-34,-19,-55,15,-34,-7,-62,25,-171
-1,2,-24,-19,-14,9,-1,35,-13
62,-66,12,84,-56,40,-48,93,121
39,-26,-80,-37,-117,-143,-143,9,-498
-44,-115,-200,-98,-299,-28,-260,117,-927
22,-131,-134,37,-72,47,-145,223,-153
9,-49,-51,-17,-64,-16,-45,16,-217
-9,-42,-62,-26,-67,2,-43,63,-184
-32,-16,-54,-14,-29,-8,-17,49,-121
12,-45,-66,39,-72,28,-82,50,-136
-27,-58,-91,-35,-93,-102,-118,-23,-547
33,-45,1,70,-65,-79,-61,80,-66
20,-47,-64,-27,-82,-52,-83,25,-310
10,-59,-71,-16,-49,1,-49,79,-154
19,-32,-45,88,-55,10,-62,99,22
1,-47,-52,-13,-60,-31,-65,23,-244
-15,-13,-13,-14,-11,2,-24,12,-76
3,-11,-32,12,-51,-17,-67,52,-111
-36,-9,-54,1,-10,-49,-28,49,-136
9,-55,-21,-11,-46,-22,-50,54,-142
-9,-77,-75,-24,-67,-71,-82,28,-377
106,3,-26,84,-27,-102,-89,100,49
58,17,-45,31,-47,-98,-53,68,-69
8,-93,-141,1,-113,6,-110,162,-280
17,-3,-17,-1,-18,-20,-21,14,-49
-21,-35,-41,-6,-51,-2,-45,29,-172
-32,-132,-138,11,-140,-4,-148,113,-470
76,-39,-78,13,-55,-10,-76,121,-48
4,-33,-24,36,-61,-15,-23,36,-80
6,-31,-25,34,-64,-14,-24,31,-87
-19,-15,-20,19,-51,-13,-57,9,-147
13,-28,-33,19,-32,-15,-40,30,-86
-7,-31,-25,-2,-57,5,-26,27,-116
6,-14,-20,9,-22,-17,-33,12,-79
0,-10,-27,21,-18,7,-22,19,-30
69,-75,-77,21,-93,-57,-153,128,-237
-22,0,-30,-33,-27,-62,-59,8,-225
12,-8,-9,19,-16,-20,-8,-8,-38
-11,-194,-228,-49,-288,-94,-272,93,-1043
-78,-92,-110,-62,-180,-73,-155,-5,-755
-68,-101,-109,-66,-154,-49,-164,12,-699
-72,-149,-167,-29,-284,-158,-285,70,-1074
4,-35,-28,33,-61,-11,-44,21,-121
5,-15,-52,-13,-60,-16,-68,27,-192
-46,-162,-175,-21,-273,-76,-250,78,-925
-4,-2,-31,-10,-23,-28,-36,8,-126
8,-25,-24,-11,-48,-26,-33,-1,-160
-36,-49,-85,-45,-125,-66,-182,-11,-599
-7,-111,-189,6,-270,-81,-216,197,-671
9,-159,-188,33,-279,-58,-224,223,-643
-22,-100,-75,14,-125,-83,-133,22,-502
-24,-35,-41,-13,-40,-19,-52,25,-199
35,-29,4,62,-31,-22,-69,75,25
25,-231,-298,-5,-340,16,-233,283,-783
15,-62,-82,-40,-93,-122,-129,66,-447
-34,-46,-44,-13,-54,-11,-81,5,-278
-36,-41,-38,-27,-59,-5,-56,23,-239
3,-86,-116,1,-40,-27,-95,95,-265
-20,-40,-50,-37,-40,-36,-51,14,-260
-25,-121,-112,53,-164,-33,-129,77,-454
-6,-37,-41,-48,-62,-80,-120,-13,-407
80,-49,-140,-32,-17,-92,-93,28,-315
-69,-109,-96,-49,-128,-58,-130,4,-635
-71,-107,-96,-45,-108,-20,-95,17,-525
64,-55,-112,-1,-74,-79,-131,108,-280
-5,-52,-41,-9,-54,-31,-47,8,-231
14,-39,-52,14,-148,-41,-78,68,-262
-31,-92,-101,-14,-129,-50,-78,0,-495
186,179,170,48,58,-93,-119,232,661
1,-32,-28,13,-25,-6,-46,18,-105
-48,-55,-84,-5,-120,-22,-86,62,-358
527,306,389,349,229,-107,-197,382,1878
12,-88,-126,-27,-121,-24,-127,111,-390
136,-1419,-1088,298,-1135,-592,-902,-352,-5054
1069,674,-197,1425,-614,-315,-552,1440,2930
22,-55,-19,28,-68,-15,-44,40,-111
-67,-142,-161,-6,-199,-95,-248,96,-822
-40,-21,-39,-6,-42,-8,-61,8,-209
6,23,-10,0,27,14,-22,1,39
-15,-7,-10,18,-16,-33,-37,-17,-117
0,-50,-40,-20,-126,-23,-64,34,-289
-70,-12,-134,-91,-64,-55,-183,-39,-648
-4,-83,-75,44,-85,-31,-97,21,-310
-13,-49,-56,-12,-74,-8,-59,24,-247
-7,-121,-59,-14,-89,-78,-103,28,-443
-12,-25,-35,4,10,-2,-16,1,-75
-25,-48,-34,0,-38,-32,-58,-25,-260
-23,-63,-55,9,-113,-22,-81,50,-298
-5,-62,-78,-2,-99,-55,-85,20,-366
17,5,-21,13,-5,-14,-22,15,-12
379,-263,-185,124,-366,188,-134,717,460
-210,-558,-584,-196,-777,-386,-748,189,-3270
-39,-77,-74,-8,-110,3,-103,33,-375
25,-124,-97,27,-200,-38,-147,126,-428
-24,-165,-209,37,-361,-66,-314,150,-952
-49,-117,-103,-5,-138,-47,-124,34,-549
-95,-105,-121,-53,-150,-31,-161,45,-671
-31,-102,-91,-41,-143,2,-112,72,-446
-79,-96,-155,-23,-108,-38,-113,-1,-613
-15,-59,-64,-9,-90,-55,-97,18,-371
-58,-118,-124,-24,-174,-30,-124,64,-588
-11,-60,-93,-49,-54,-22,-52,9,-332
-65,-111,-132,-39,-102,-71,-174,20,-674
-16,-46,-59,-16,-77,-9,-57,50,-230
13,-82,-75,-3,-148,2,-97,65,-325
-23,-37,-23,1,-36,-6,-46,1,-169
-21,-155,-187,-11,-222,-158,-318,198,-874
-7,-23,-38,-30,-73,-39,-58,18,-250
-43,-120,-120,-45,-185,-140,-234,110,-777
-29,-118,-133,-20,-161,-12,-143,82,-534
-42,-105,-102,-75,-144,-53,-124,30,-615
-37,-66,-112,-48,-126,-71,-119,31,-548
-3,-10,-18,7,9,-9,-21,12,-33
13,-83,-98,-40,-111,-52,-87,68,-390
-17,-5,-16,5,-57,-14,-84,40,-148
-20,-41,-38,4,-25,1,-35,4,-150
16,-28,-37,52,-15,18,-33,24,-3
3,-138,-127,-10,-144,-52,-124,88,-504
-35,-39,-45,-8,-61,-29,-73,10,-280
26,53,-2,70,47,63,-26,53,284
-259,-623,-779,-224,-1012,-617,-1327,210,-4631
-24,-61,-66,-16,-73,-56,-104,20,-380
-39,-125,-163,0,-201,-98,-272,135,-763
-25,-58,-46,-15,-50,-33,-67,-24,-318
27,-100,-88,-53,-127,-133,-131,86,-519
-2,-115,-81,13,-153,-21,-121,94,-386
-53,-27,-45,2,-65,-2,-70,10,-250
24,-82,-86,1,-146,-38,-93,93,-327
19,-80,-44,11,-101,-19,-87,62,-239
-17,-26,-49,-24,-72,-56,-72,10,-306
7,-90,-84,-9,-133,-24,-129,79,-383
-45,-91,-104,13,-129,-10,-171,102,-435
1,-82,-71,-1,-111,-27,-97,69,-319
18,-73,-97,-19,-94,-103,-115,83,-400
-1,-77,-71,10,-163,-54,-163,23,-496
-37,-110,-83,27,-131,-47,-174,22,-533
13,-18,-22,16,-53,-35,-30,8,-121
-17,-132,-87,-24,-106,-85,-167,38,-580
41,-123,-93,-6,-102,-116,-175,87,-487
29,24,5,38,-62,7,-12,63,92
-12,-45,-41,-45,-73,18,-38,35,-201
44,-89,-163,-33,-233,-108,-225,68,-739
2,2,0,0,1,-3,0,-2,0
170,-245,-578,-120,-419,-39,-509,841,-899
55,-80,-103,-12,-171,-34,-99,146,-298
0,-59,-74,-3,-85,-41,-104,8,-358
-29,-26,-27,5,-37,-19,-66,-5,-204
40,-126,-79,-8,-144,-83,-152,103,-449
31,-120,-50,9,-80,-48,-105,63,-300
28,-50,-54,48,-86,-31,-73,42,-176
-4,-116,-108,-28,-134,-87,-128,43,-562
-8,-137,-107,-31,-138,-73,-122,33,-583
49,-168,-163,17,-236,-101,-217,127,-692
-18,-21,-22,-14,-28,-11,-29,6,-137
5,-11,-15,-16,-40,0,-22,10,-89
-30,-135,-132,14,-127,-23,-182,77,-538
49,-12,-13,25,-30,-15,-11,45,38
4,-82,-136,-53,-195,-137,-235,74,-760
-44,-53,-120,-9,-152,-34,-165,102,-475
-21,-63,-79,-24,-127,-53,-166,92,-441
6,-9,-15,18,-24,-17,-49,-1,-91
6,-41,-61,-24,-22,-26,-28,54,-142
-6,-28,-24,-26,27,-9,-6,29,-43
-11,-26,-25,-23,4,-29,-20,15,-115
-6,-25,-22,-21,5,-28,-17,18,-96
5,-85,-100,-13,-141,-87,-97,49,-469
-12,-62,-80,-61,-112,-61,-95,72,-411
41,-99,-139,-27,-187,-99,-159,124,-545
-33,-64,-45,-1,-67,-22,-59,32,-259
53,94,54,89,-15,16,-3,56,344
132,-113,-134,61,-136,-108,-177,214,-261
-3,-77,-82,-44,-86,-92,-118,24,-478
-33,-26,-36,26,-29,-50,-74,-43,-265
-89,-101,-73,-2,-112,-44,-150,-38,-609
28,-121,-124,18,-78,-119,-207,153,-450
-11,-12,-32,-15,-37,-59,-55,13,-208
-23,-56,-53,-8,-69,-21,-53,4,-279
58,-82,-77,41,-110,-61,-91,66,-256
-64,-94,-94,-41,-168,-46,-154,51,-610
39,-51,-71,62,-150,18,-78,194,-37
41,-99,-80,3,-107,-98,-188,101,-427
-1,-45,-57,-9,-50,-39,-79,20,-260
-22,-16,-33,-18,-43,-33,-40,-6,-211
-23,-83,-62,-11,-119,-30,-109,49,-388
-44,-89,-113,-16,-105,-87,-183,2,-635
9,-18,-51,5,-32,17,-26,28,-68
-42,-85,-71,-18,-89,-54,-102,15,-446
-116,-166,-166,-53,-190,-12,-205,60,-848
-21,-52,-77,-41,-68,-24,-87,47,-323
14,-88,-29,64,-67,-15,-94,82,-133
49,-244,-187,223,-116,54,-268,154,-335
-29,-33,-24,14,-22,7,-23,10,-100
-13,-31,-40,-18,-31,-34,-70,-12,-249
12,-24,-13,17,-12,-7,-4,26,-5
-57,-176,-126,29,-160,-60,-142,49,-643
25,-107,-85,-15,-93,-63,-120,37,-421
-56,-49,-96,32,-133,-8,-117,106,-321
-13,-39,-49,-5,-33,-16,-60,-3,-218
-58,-117,-84,-12,-123,-73,-144,49,-562
6,-133,-111,43,-191,29,-157,158,-356
26,12,33,70,-8,-130,-126,125,2
-12,-63,-50,12,-113,-28,-76,46,-284
-54,-154,-147,-37,-186,-151,-248,54,-923
14,-62,-31,13,-37,-9,-45,30,-127
23,-17,-19,6,-30,15,-21,26,-17
2,-7,-13,4,-17,-18,-18,-2,-69
46,126,-73,-1,-89,-127,-77,103,-92
13,-163,-176,-52,-129,-45,-101,137,-516
-51,-89,-76,-7,-146,-24,-120,36,-477
0,-136,-105,42,-246,-137,-176,66,-692
27,-92,-38,47,-101,-20,-64,51,-190
-10,-16,-48,-40,-62,-20,-50,30,-216
-17,-19,-43,-28,-45,-47,-79,23,-255
-51,-88,-57,16,-105,-9,-112,51,-355
-53,-100,-72,2,-108,-19,-98,37,-411
-3,-32,-39,-8,-35,-14,-53,28,-156
8,-13,-32,11,-45,14,-24,50,-31
-12,-59,-48,2,-57,-15,-75,55,-209
-151,-219,-195,-72,-203,-82,-203,0,-1125
36,-366,-375,11,-411,133,-280,449,-803
-23,-302,-263,-39,-362,7,-265,361,-886
-68,-105,-90,-40,-136,-24,-141,47,-557
11,-207,-179,84,-260,14,-222,271,-488
211,-274,-401,160,-437,76,-345,512,-498
23,158,76,219,-40,74,-39,92,563
-15,-49,-142,-22,-65,-47,-153,93,-400
-40,-31,-148,-53,-178,-113,-279,-35,-877
-21,-22,-45,-23,-47,5,-30,27,-156
72,22,2,20,-25,35,11,98,235
-21,-89,-97,-10,-69,35,-89,45,-295
12,-52,-45,9,-114,-30,-62,-13,-295
-6,-34,-33,-5,-22,-7,-22,17,-112
-6,-30,-49,-15,-25,-15,-37,-1,-178
-19,-26,-43,-10,-49,-17,-50,29,-185
0,0,-15,-1,-9,-26,-30,13,-68
103,10,29,109,-2,-68,-114,80,147
50,-32,-76,-12,-75,-117,-152,-11,-425
-79,-131,-216,-108,-302,-34,-229,141,-958
-14,-36,-80,-45,-107,-88,-134,29,-475
-53,-95,-107,-41,-163,-62,-138,8,-651
31,-50,-32,3,-53,-39,-97,91,-146
14,-66,-61,-27,-57,-20,-89,102,-204
4,-18,-19,0,-32,-14,-38,18,-99
81,-65,-52,60,-30,-57,-89,66,-86
65,-56,-50,25,-35,-39,-88,97,-81
2,-132,-89,20,-148,-70,-147,35,-529
-5,-42,-36,-8,-47,-46,-57,-11,-252
-50,-132,-117,31,-146,-37,-158,5,-604
-26,-65,-60,7,-61,-13,-105,18,-305
-109,-166,-139,-30,-247,-19,-195,78,-827
-22,-43,-44,-18,-57,-16,-44,18,-226
-64,-148,-135,8,-190,-40,-171,88,-652
4,-39,-44,4,-42,-67,-65,-8,-257
-84,-264,-276,138,-452,-38,-544,188,-1332
-50,-132,-89,-17,-156,-31,-87,78,-484
-14,-57,-47,12,-60,-24,-71,41,-220
13,-29,-29,-17,-71,-20,-49,57,-145
-22,-62,-78,-7,-86,-16,-62,66,-267
14,-98,-64,-30,-109,-100,-117,37,-467
-12,-15,-16,0,-23,-7,-19,19,-73
2,-18,-19,1,-22,-4,-6,10,-56
38,-104,-54,-3,-85,-97,-113,59,-359
-49,-67,-63,-44,-70,-50,-92,-5,-440
-33,-96,-103,23,-146,6,-131,84,-396
-18,-41,-51,-7,-80,-7,-73,58,-219
-43,-77,-74,-24,-91,-22,-81,17,-395
24,-133,-162,-53,-79,-97,-219,129,-590
-73,-114,-94,-58,-105,4,-87,32,-495
-12,-82,-51,-13,-79,-59,-102,59,-339
3,-23,-22,-3,-52,-32,-37,14,-152
-93,-108,-130,-48,-117,-50,-160,24,-682
41,-23,-29,13,-43,-42,-31,34,-80
-16,-46,-50,-7,-56,-37,-68,9,-271
-32,-112,-105,-50,-144,-80,-158,14,-667
12,-7,-48,12,-46,-5,-73,40,-115
8,13,-38,-9,-10,-57,-42,19,-116
-27,-23,-59,-34,-44,-40,-48,13,-262
5,-27,-15,14,-31,-15,-12,12,-69
-47,-109,-102,-17,-156,-44,-108,74,-509
25,-40,-41,27,-87,-20,-76,61,-151
38,-145,-270,69,-382,10,-291,290,-681
-3,-14,-9,28,-25,-18,-7,3,-45
45,-60,-43,26,-64,-33,-47,56,-120
-40,-70,-62,-35,-77,-51,-81,2,-414
-15,-67,-61,-26,-115,-77,-118,13,-466
-42,-76,-77,-43,-140,-54,-152,28,-556
-10,-393,-198,54,-370,-82,-319,415,-903
-24,-68,-55,-36,-81,-39,-63,-17,-383
-63,-85,-103,-31,-144,-30,-121,43,-534
-79,-85,-94,-44,-140,-51,-122,37,-578
-86,-81,-95,-48,-153,-43,-151,25,-632
243,-90,-443,231,-286,-48,-481,545,-329
12,0,-25,6,-4,-1,-33,17,-28
203,144,182,109,86,-65,-117,175,717
-64,-90,-96,-40,-141,13,-101,61,-458
-55,-102,-106,-44,-131,-6,-111,60,-495
-97,-173,-171,-36,-239,-26,-241,54,-929
-63,-104,-92,-41,-147,-97,-154,3,-695
16,-100,-133,-4,-172,-97,-173,114,-549
-64,-100,-113,-18,-136,-16,-119,48,-518
-37,-148,-111,-10,-162,-7,-110,79,-506
-64,-101,-98,-53,-135,-22,-87,64,-496
-41,-127,-123,-40,-160,-2,-119,80,-532
-48,-127,-142,11,-171,-24,-161,91,-571
-6,-35,-72,-14,-78,-21,-49,49,-226
5,-129,-104,-6,-191,-79,-162,75,-591
17,-3,-16,35,-40,-5,-24,19,-17
30,-64,-45,20,-43,-37,-43,25,-157
14,-45,-43,-12,-79,-52,-77,20,-274
35,-262,-344,89,-559,-148,-594,364,-1419
4,-11,-23,-9,-29,-17,-36,-17,-138
25,-98,-158,-47,-52,-107,-201,105,-533
-40,-49,-67,-48,-58,-7,-72,-3,-344
32,7,5,26,-43,-18,-19,69,59
-5,-18,-16,0,-29,9,-26,21,-64
39,-24,-21,47,-58,-5,-66,54,-34
28,-56,-79,0,-169,-55,-134,46,-419
-9,-13,-22,-3,-12,-24,-22,-18,-123
27,-41,-43,34,-28,0,-57,17,-91
-2,-38,-25,14,-55,-45,-52,29,-174
10,-37,-40,12,-42,-15,-39,26,-125
17,-40,-25,30,-68,-19,-57,7,-155
-3,-28,-33,3,-36,-20,-62,-20,-199
-28,-27,-22,-8,-49,-30,-48,-1,-213
-19,-24,-21,9,-27,-23,-32,-3,-140
5,-7,-13,3,-15,-16,-21,5,-59
-9,-56,-82,-17,-82,-15,-62,42,-281
-46,-97,-86,-16,-135,-10,-98,54,-434
415,384,306,201,218,-143,-208,352,1525
-20,-38,-60,-36,-44,-18,-40,33,-223
-5,-4,-44,-19,-49,-53,-58,2,-230
-24,-144,-111,-18,-225,-107,-224,145,-708
-20,-55,-131,-28,-179,-122,-199,59,-675
-49,-81,-130,2,-163,-18,-127,80,-486
-2,-16,-55,-8,-90,-30,-110,12,-299
-42,-52,-71,-31,-68,-64,-131,-60,-519
-19,-141,-159,8,-202,-72,-169,126,-628
-51,-37,-54,-28,-107,-4,-76,14,-343
37,-148,-180,-22,-272,-148,-238,24,-947
-102,-190,-245,-43,-215,-122,-324,134,-1107
32,-29,-28,26,-31,28,-71,96,23
24,-49,-55,-16,-73,-6,-46,84,-137
-33,4,-57,43,-77,-37,-79,9,-227
-15,-50,-41,-50,-46,-32,-46,29,-251
-36,-95,-109,15,-141,3,-130,67,-426
16,-39,-26,43,-48,27,-41,64,-4
28,35,-37,41,-21,-4,-40,53,55
-16,-80,-68,-16,-79,-15,-113,33,-354
3,-37,-44,18,-101,-54,-111,19,-307
-23,-37,-35,-9,-63,-39,-60,-17,-283
-3,-16,-12,-4,-16,-13,-19,-5,-88
2,-98,-78,-31,-118,-100,-108,26,-505
-20,-16,-46,-7,17,-15,-30,0,-117
40,-49,-84,49,-102,-43,-81,64,-206
-47,-101,-105,-7,-132,-39,-146,-8,-585
18,-211,-227,-109,-269,-255,-348,43,-1358
8,-98,-94,5,-77,-58,-88,24,-378
21,-43,-45,22,-33,-32,-118,109,-119
-22,-10,-8,-8,-21,0,-29,1,-97
-31,-36,-58,11,-57,-6,-62,21,-218
-31,-42,-53,-2,-48,-4,-59,19,-220
-27,-44,-46,9,-32,7,-47,24,-156
-32,-67,-72,-30,-52,-51,-90,2,-392
-13,-10,-21,-25,-22,-15,-33,25,-114
-17,-132,-88,-10,-86,-88,-104,59,-466
-30,-96,-48,0,-96,-37,-75,52,-330
30,-99,-86,-13,-75,-33,-81,52,-305
24,-20,-27,9,-34,-18,-27,13,-80
-21,-79,-88,4,-111,-38,-100,41,-392
-12,-46,-43,-8,-99,-11,-78,18,-279
-3,-20,-42,-40,-56,-26,-40,15,-212
0,-58,-57,4,-66,-3,-60,42,-198
-7,-25,-39,-1,-71,-61,-85,-32,-321
-42,-98,-55,-45,-86,-39,-125,6,-484
-11,-34,-32,12,-53,-28,-65,-12,-223
-7,-45,-83,27,-67,13,-67,60,-169
-43,-62,-27,-16,-94,-41,-85,10,-358
-9,-83,-97,-17,-146,-10,-147,120,-389
-8,-5,-43,18,-55,-9,-59,31,-130
6,-4,-27,-7,-18,-37,-34,-4,-125
2,-14,-9,16,-32,-20,-12,5,-64
14,-155,-102,90,-176,44,-117,121,-281
-1,-69,-85,-58,-105,-120,-133,34,-537
77,-46,-90,75,-65,-4,-76,169,40
-17,-98,-69,10,-113,-77,-138,8,-494
-14,-35,-38,-28,-52,-35,-36,11,-227
199,117,186,71,117,-79,-98,167,680
37,-65,-66,55,-121,-3,-92,117,-138
9,-36,-51,2,-34,-54,-63,5,-222
-26,-32,-55,5,-67,-11,-87,36,-237
-23,-47,-42,-2,-47,-15,-66,-2,-244
32,-352,-399,-163,-532,-311,-473,266,-1932
38,7,-29,56,-6,-20,-49,41,38
15,-132,-118,19,-185,-157,-219,101,-676
242,-135,-169,-34,-77,-82,-110,161,-204
28,-26,-52,22,-29,-61,-75,41,-152
-22,-39,-37,13,14,-4,-106,68,-113
-38,-88,-96,-46,-101,-20,-81,31,-439
-50,-115,-108,-38,-139,-54,-170,25,-649
40,-26,-101,-8,-99,-91,-219,178,-326
-6,-86,-99,12,-95,-61,-96,42,-389
23,-29,4,67,-44,-23,-44,34,-12
22,-24,-29,26,-65,-17,-53,25,-115
5,-34,-40,7,-52,-10,-41,11,-154
7,-36,-42,-3,-63,-23,-61,47,-174
-4,-47,-46,-8,-42,-17,-64,31,-197
-19,-54,-49,-7,-49,-36,-83,12,-285
-5,-34,-15,30,-61,-12,-45,48,-94
26,-20,-20,48,-57,-14,-43,30,-50
17,-29,-10,58,-61,-33,-70,27,-101
-27,-46,-41,-1,-32,-27,-57,-19,-250
-70,-106,-106,-40,-160,-30,-162,20,-654
-39,-123,-120,-57,-145,-23,-127,64,-570
-48,-78,-115,-4,-136,-10,-114,78,-427
-87,-102,-153,-54,-196,-65,-171,31,-797
1,-27,-41,-13,-46,-13,-74,-9,-222
43,-83,-220,28,-194,-61,-257,235,-509
59,-93,-7,62,-31,-37,-66,73,-40
8,-74,-102,-11,-68,-2,-90,99,-240
1,-30,-18,15,-15,-4,-32,14,-69
-36,-68,-78,-21,-68,-23,-75,29,-340
-15,-109,-114,-41,-169,-105,-201,30,-724
11,-35,-47,16,-109,-28,-101,30,-263
13,-95,-85,-23,-192,-65,-126,55,-518
0,-32,-77,-25,-78,4,-85,50,-243
-88,-91,-107,-52,-166,19,-119,84,-520
-63,-87,-112,-25,-138,-11,-119,58,-497
-61,-147,-159,-135,-300,-215,-276,68,-1225
15,-65,-65,15,-78,-29,-58,70,-195
54,-25,-22,77,-28,-24,-86,85,31
-10,-63,-53,0,-9,13,-60,56,-126
42,-45,-57,0,-25,-87,-82,31,-223
-139,-183,-152,-104,-193,-95,-275,-5,-1146
-51,-95,-65,-17,-153,-17,-100,62,-436
-40,-146,-102,-26,-157,-22,-89,91,-491
-46,-64,-30,-21,-94,-30,-85,-9,-379
19,-60,-79,18,-103,-38,-105,41,-307
-78,-103,-110,-54,-141,-31,-154,26,-645
3,-20,9,37,-46,-21,-33,36,-35
-51,-64,-114,-96,-86,-103,-151,58,-607
8,-33,-43,-10,-100,-94,-153,63,-362
17,-65,-177,-8,-212,-115,-232,106,-686
-67,-178,-188,-73,-258,-78,-230,97,-975
2,-78,-93,-2,-76,-106,-123,30,-446
1,-274,-169,46,-251,36,-215,248,-578
22,-66,-69,46,-105,-57,-89,40,-278
-27,-72,-63,1,-93,-27,-100,30,-351
30,-12,-84,-9,-29,22,-51,56,-77
-19,-68,-59,-37,-69,-15,-51,22,-296
27,-106,-109,-12,-50,-70,-134,105,-349
0,-26,-42,10,-81,-26,-81,58,-188
-13,-36,-60,-23,-89,-29,-87,56,-281
-42,-64,-61,-32,-78,-10,-62,31,-318
-2,-14,-17,1,-13,-22,-19,3,-83
-16,-153,-142,21,-152,-38,-164,146,-498
9,-65,-42,7,-89,-42,-89,35,-276
-17,-27,-48,-9,-50,-21,-52,22,-202
58,-89,-56,106,-104,-32,-131,79,-169
19,-146,-117,68,-159,-99,-178,118,-494
-20,-170,-153,34,-253,-77,-225,99,-765
1,-26,-30,11,-77,-1,-32,43,-111
-21,-64,-92,-22,-132,-56,-127,46,-468
-18,-80,-89,-20,-105,-39,-86,39,-398
-31,-54,-69,-27,-33,-25,-58,44,-253
-24,-175,-160,10,-199,-56,-192,143,-653
-30,-150,-182,22,-200,12,-146,141,-533
-17,-172,-160,-2,-259,-112,-220,135,-807
1,-138,-123,66,-192,-9,-149,190,-354
-29,-42,-66,10,-97,-30,-111,51,-314
60,-74,-32,-13,-57,-82,-125,89,-234
-42,-140,-105,12,-139,-14,-146,94,-480
11,-44,-49,-11,-58,-47,-75,52,-221
-13,-29,-36,-22,-20,8,-13,15,-110
-74,-18,-226,-92,-143,-30,-219,121,-681
-106,-247,-304,-163,-312,-256,-419,87,-1720
-19,-55,-77,26,-150,-142,-237,106,-548
-3,-8,-7,3,-5,-11,-14,-6,-51
542,385,536,139,270,-179,-276,551,1968
16,-98,-84,36,-152,-76,-145,37,-466
-30,-53,-45,-21,-50,-25,-69,-1,-294
4,-64,-81,-15,-69,-5,-66,62,-234
-23,-37,-68,-6,-89,-12,-62,35,-262
-17,-202,-178,-91,-209,-195,-350,161,-1081
-7,-197,-180,-30,-258,-107,-288,154,-913
-21,-56,-77,10,-76,-3,-54,15,-262
-12,-27,-112,-84,-22,-90,-103,-42,-492
67,-49,-25,66,-3,-20,-26,66,76
5,-155,-161,-34,-211,-170,-293,78,-941
-107,-192,-214,-85,-279,-207,-297,40,-1341
-34,-99,-104,-6,-125,-42,-100,26,-484
16,-16,-30,4,-53,-49,-59,41,-146
-79,-140,-131,-61,-145,-70,-176,21,-781
-2,-28,-27,-9,-33,-3,-24,14,-112
-10,-44,-29,12,-93,-44,-86,25,-269
-30,-24,-56,3,-56,3,-64,25,-199
163,-18,-62,95,8,-38,-71,49,126
-10,-31,-46,14,-91,-31,-82,48,-229
-102,-111,-116,-49,-147,-9,-174,36,-672
-55,-77,-57,-12,-112,-27,-94,-3,-437
36,-95,-92,13,-136,-57,-110,52,-389
-1,-46,-49,-6,-70,-33,-66,19,-252
4,-36,-39,-7,-28,-35,-52,1,-192
-9,-44,-42,-32,-47,-9,-42,3,-222
18,-38,-44,-29,-63,-35,-39,25,-205
35,-12,-40,16,-56,-30,-43,35,-95
-6,-16,-27,-1,-34,-18,-35,11,-126
-16,-10,-13,-6,-13,-8,-13,7,-72
15,-52,-61,-8,-72,-23,-46,44,-203
26,-35,-32,12,-50,-19,-38,24,-112
-11,-8,-26,-17,-47,-9,-32,12,-138
14,-49,-36,10,-60,-32,-62,8,-207
0,-2,-26,1,-34,-14,-28,-4,-107
10,-25,-31,2,-26,-25,-35,38,-92
14,-67,-79,37,-80,-7,-79,29,-232
2,-101,-110,-79,-190,-101,-196,-10,-785
22,-84,-86,-50,-179,-100,-194,-4,-675
89,-59,-116,45,-88,-71,-188,142,-246
5,-136,-161,24,-136,-40,-181,66,-559
-18,-18,-18,-12,-21,-12,-31,-3,-133
-36,-52,-45,-30,-81,-67,-75,-32,-418
-34,-54,-58,-31,-87,-78,-111,-21,-474
-14,-73,-91,-17,-109,-73,-183,122,-438
-6,-61,-53,2,-82,-43,-87,47,-283
-22,-44,-104,-12,-72,-44,-128,52,-374
-14,-75,-108,-36,-116,-81,-173,61,-542
-36,-40,-75,-12,-64,-38,-107,16,-356
21,-9,-12,14,-36,4,-34,43,-9
-31,-21,-42,16,-49,-20,-74,4,-217
-78,-89,-113,-52,-143,-25,-139,55,-584
4,-78,-375,48,-194,-31,-263,427,-462
-12,-89,-76,-20,-62,-40,-66,44,-321
23,-46,-51,-4,-74,-75,-81,28,-280
-32,-76,-104,-41,-121,-84,-148,43,-563
0,-45,-58,26,-43,-47,-74,-21,-262
2,-13,-39,10,-73,-4,-57,59,-115
20,-99,-135,-39,-126,-135,-178,126,-566
-55,-121,-112,53,-158,-4,-157,108,-446
-30,-89,-101,-37,-154,-5,-129,71,-474
-33,-23,-73,-72,-75,-77,-110,-42,-505
-5,-34,-42,-11,-30,-33,-50,4,-201
-47,-96,-90,-55,-133,-45,-128,43,-551
-62,-105,-111,-36,-161,-22,-133,62,-568
-92,-98,-110,-46,-152,-12,-133,23,-620
-37,-108,-126,-63,-155,-78,-158,58,-667
-42,-86,-72,-27,-123,-73,-104,-2,-529
14,-66,-101,-37,-193,-44,-132,84,-475
-78,-94,-250,-160,-154,-182,-388,-90,-1396
11,-19,-1,36,-23,-26,-8,29,-1
-45,-84,-82,-6,-98,-31,-88,-5,-439
-5,-58,-35,-31,-59,-55,-61,-10,-314
-6,-59,-68,17,-75,1,-85,32,-243
-5,-31,-34,-8,-51,-22,-55,35,-171
-42,-82,-127,8,-193,-35,-191,100,-562
36,-72,-52,10,-97,-24,-71,33,-237
-40,-54,-51,-15,-90,-29,-100,33,-346
-15,-78,-95,-31,-142,-35,-114,98,-412
-54,-73,-89,-28,-129,17,-99,86,-369
-112,-133,-121,4,-258,-62,-214,77,-819
-12,-126,-108,-37,-139,-32,-114,103,-465
-62,-91,-108,-53,-159,-31,-141,31,-614
-68,-73,-86,-20,-122,-50,-108,22,-505
-66,-98,-104,-56,-141,-8,-98,54,-517
-87,-102,-80,-25,-100,-29,-104,36,-491
-49,-137,-109,-11,-106,-13,-116,48,-493
-15,-134,-104,-25,-152,-37,-116,94,-489
-33,-35,-35,-11,-43,-16,-52,-14,-239
-2,-13,-43,-15,-41,-22,-37,1,-172
3,-69,-64,24,-146,-55,-115,61,-361
-9,-52,-74,-39,-117,-28,-60,66,-313
-12,-66,-68,9,-85,-23,-65,33,-277
-9,-7,-19,13,-13,-12,-9,-9,-65
1,-92,-69,-7,-140,-117,-158,13,-569
32,-29,-33,0,-98,-56,-69,23,-230
-36,-64,-61,3,-71,-27,-85,14,-327
79,-61,-6,88,6,-40,-94,99,71
48,-10,3,89,-16,-56,-106,86,38
14,-30,-9,47,-12,-26,-65,44,-37
14,-22,-1,55,-19,-30,-71,30,-44
28,-56,-40,13,-18,-47,-55,32,-143
27,-57,-43,51,-38,-28,-85,50,-123
91,-54,-54,80,-26,-81,-98,54,-88
16,-21,-17,28,-3,0,-51,40,-8
22,-67,-19,18,-26,-33,-62,24,-143
11,-15,6,24,7,-41,-80,55,-33
30,-59,-25,28,-24,-32,-74,80,-76
51,-28,1,84,-14,-56,-82,65,21
9,-23,-9,53,-27,-50,-62,35,-74
-16,-49,-62,-49,-124,-9,-76,50,-335
16,-34,-27,28,-96,-14,-79,56,-150
37,-214,-200,1,-363,-42,-224,172,-833
-44,-95,-63,-11,-113,-24,-103,29,-424
-16,-4,-18,7,-22,6,-24,22,-49
-8,-13,-37,-2,-22,-13,-28,23,-100
-30,-89,-115,-64,-139,-77,-142,50,-606
13,-35,-31,12,-88,-35,-60,53,-171
9,-5,-21,-10,-40,-23,-35,49,-76
75,-24,-18,65,-6,19,-13,81,179
-42,-96,-107,-26,-129,-18,-111,43,-486
-16,-86,-61,18,-105,22,-98,81,-245
171,-197,-379,30,-200,-179,-441,534,-661
-65,-125,-127,-25,-202,-88,-228,112,-748
-84,-140,-131,-3,-150,-16,-162,105,-581
-10,-90,-91,6,-97,54,-75,76,-227
-60,-116,-130,6,-193,27,-155,81,-540
-32,-5,-13,-32,-54,-17,-29,5,-177
-42,-70,-84,-32,-83,-39,-86,1,-435
-29,-93,-72,-38,-99,-51,-93,-4,-479
-31,-76,-75,-9,-48,-26,-98,39,-324
5,-76,-73,30,-140,-59,-119,29,-403
25,-23,-22,61,-63,-18,-72,63,-49
28,-106,-102,-11,-184,-86,-133,73,-521
-4,-44,-17,10,-51,-36,-44,8,-178
43,70,86,114,-8,13,-8,43,353
45,-3,26,98,-34,2,-51,94,177
-21,-25,-35,-26,-61,-33,-55,2,-254
-2,-19,-35,16,-39,-33,-65,-6,-183
2,-34,-32,19,-44,-33,-66,-9,-197
-34,-80,-95,18,-53,-119,-123,-107,-593
1,-19,-17,13,-16,-15,-21,-3,-77
20,-52,-62,2,-51,-3,-59,71,-134
18,-57,-65,7,-48,4,-43,75,-109
20,-68,-48,32,-33,44,-61,89,-25
52,-159,-186,14,-197,-14,-149,204,-435
-30,-131,-107,4,-200,-85,-207,75,-681
8,-16,-35,-2,-57,-25,-27,17,-137
7,-77,-82,-46,-81,-45,-57,91,-290
-27,-69,-100,3,-137,-19,-102,62,-389
-73,-94,-100,-31,-108,-13,-132,69,-482
-53,-97,-113,-105,-140,-84,-162,104,-650
-75,-97,-103,-23,-135,-48,-145,58,-568
67,-21,-40,83,-32,-67,-87,114,17
25,-30,-27,43,-24,-17,-48,78,0
-72,-73,-103,-36,-159,-11,-121,50,-525
-82,-108,-115,-80,-151,-26,-120,18,-664
-56,-99,-124,-36,-138,-2,-121,66,-510
-72,-117,-110,-49,-168,-31,-143,52,-638
-85,-97,-101,-41,-124,-2,-104,47,-507
-60,-126,-119,-37,-137,-14,-139,49,-583
-55,-88,-84,-46,-101,-49,-117,39,-501
-64,-106,-124,-64,-140,-62,-153,29,-684
20,-43,-63,44,-70,-11,-98,55,-166
1,-25,-22,7,-20,-16,-23,-1,-99
6,-28,-20,26,-37,-15,-27,20,-75
16,-38,-72,-13,-97,-59,-78,22,-319
-82,-167,-199,-66,-298,23,-230,165,-854
-60,-53,-98,-22,-111,-77,-131,14,-538
-41,-59,-101,-29,-93,-76,-132,-7,-538
82,-65,-112,15,-115,17,-29,185,-22
-22,-88,-119,-65,-128,-38,-114,126,-448
-19,-61,-53,-24,-76,-24,-59,25,-291
9,-87,-96,13,-105,-37,-118,21,-400
-36,-28,-42,-42,-89,-23,-79,6,-333
-18,-35,-41,-6,-66,-31,-68,10,-255
35,-43,-92,90,-173,34,-125,197,-77
82,-127,-109,-13,-98,-131,-197,214,-379
-2,-65,-81,-1,-96,-39,-71,39,-316
8,-71,-131,-44,-128,-46,-111,116,-407
-8,-35,-29,-24,-51,2,-24,46,-123
-27,-22,-53,-24,-59,-35,-48,2,-266
-16,-47,-45,-6,-59,-21,-33,44,-183
-77,-82,-95,-25,-145,-32,-121,57,-520
31,-110,-201,-69,-242,-230,-322,43,-1100
-41,-110,-99,-34,-150,-59,-147,51,-589
19,-90,-87,22,-171,-5,-113,121,-304
-63,-104,-143,-87,-165,-113,-214,-56,-945
65,11,16,28,-26,-71,-67,84,40
30,1,-34,11,-21,-48,-60,32,-89
-59,-77,-91,-39,-123,-26,-115,21,-509
-95,-81,-96,-89,-127,-18,-113,21,-598
19,-20,-25,21,-50,-43,-52,28,-122
-62,-104,-155,-49,-184,-76,-168,38,-760
-130,-302,-329,-105,-493,-129,-476,188,-1776
-8,-16,-14,-9,-15,-12,-17,-3,-94
-33,-52,-64,-34,-80,10,-61,31,-283
-17,-14,-11,-5,-12,-7,-25,-5,-96
-12,-31,-26,-11,-29,-24,-34,-3,-170
-10,-31,-35,-7,-22,-3,-22,20,-110
-56,-113,-145,-74,-214,-142,-222,18,-948
-25,-86,-86,26,-141,-99,-200,-24,-635
-44,-71,-77,-21,-91,-18,-76,15,-383
-1,-89,-138,13,-127,-17,-128,64,-423
-78,-130,-111,-42,-213,-85,-181,80,-760
-59,-100,-88,-26,-192,-86,-161,53,-659
-27,-84,-83,-41,-195,-90,-157,68,-609
20,-89,-60,19,-82,-68,-117,20,-357
-30,-18,-20,-18,-29,-6,-25,10,-136
-9,-23,-47,-20,-60,-43,-84,27,-259
1,-27,-38,9,-40,-24,-46,20,-145
34,-62,-65,8,-53,20,-58,70,-106
-11,-66,-57,-32,-109,-100,-114,54,-435
-6,-79,-67,13,-106,-61,-115,8,-413
-21,-82,-85,3,-134,-93,-134,23,-523
-8,-121,-99,-12,-129,19,-96,66,-380
44,-53,-65,26,-28,44,-51,123,40
-23,-81,-89,-20,-123,-83,-147,8,-558
-38,-117,-143,-42,-176,-71,-166,40,-713
16,-67,-84,7,-135,-21,-104,15,-373
9,-112,-160,-34,-149,-50,-131,85,-542
-36,-69,-74,-40,-79,-44,-112,25,-429
-1,-76,-77,-22,-83,-40,-72,29,-342
-55,-125,-105,-53,-143,-47,-132,58,-602
-35,-83,-110,-30,-134,-68,-136,18,-578
-51,-109,-107,-24,-136,-5,-98,80,-450
-66,-101,-102,-43,-135,-22,-96,33,-532
-13,-59,-116,-47,-129,-123,-195,28,-654
-49,-127,-101,-34,-150,-24,-130,86,-529
25,-3,-22,23,-55,-22,-50,50,-54
-21,-60,-70,-19,-144,-120,-168,21,-581
-53,-22,-50,-39,-41,-17,-44,16,-250
11,-8,-14,14,-29,-7,-15,23,-25
17,-143,-165,31,-185,-103,-282,153,-677
-25,-64,-65,-46,-66,-36,-100,48,-354
-3,-81,-52,13,-41,-18,-65,40,-207
-22,-33,-42,-25,-64,-6,-58,11,-239
82,-121,-133,1,-242,-180,-225,6,-812
32,-84,-98,3,-189,-149,-170,31,-624
-16,-25,-30,-21,-37,-27,-53,6,-203
-27,-53,-48,-14,-65,-7,-55,31,-238
-10,-70,-74,-12,-52,-39,-77,14,-320
-40,-219,-204,-68,-241,-146,-246,77,-1087
7,-38,-57,-29,-96,-31,-75,29,-290
-36,-55,-53,-26,-71,-48,-79,27,-341
-24,-46,-68,20,-85,-31,-65,34,-265
-70,-69,-103,-65,-95,-86,-169,-58,-715
-62,-76,-83,-45,-57,-69,-137,-48,-577
-15,-29,-28,1,-19,2,-20,-5,-113
-4,-14,-17,-11,-40,-2,-23,12,-99
114,41,29,70,15,-32,-44,55,248
1,-45,-65,-32,-93,-44,-90,32,-336
-12,-43,-35,-3,-99,-43,-68,9,-294
9,-121,-229,-16,-168,-71,-172,117,-651
-8,-15,-23,-1,-13,5,-21,21,-55
16,-11,-74,14,-24,-17,-66,80,-82
-3,-30,-52,-9,-57,-68,-77,9,-287
-6,-27,-29,0,-33,-29,-37,28,-133
-2,-27,-20,-21,32,-9,-6,33,-20
-7,-27,-22,-20,6,-28,-15,18,-95
-4,-27,-24,-18,8,-26,-15,17,-89
-13,-90,-98,-33,-121,-65,-106,96,-430
-63,-94,-141,-59,-159,-38,-135,97,-592
-22,-113,-87,23,-88,-20,-90,53,-344
-50,-111,-123,-26,-143,-47,-137,50,-587
-46,-82,-143,-26,-122,-62,-177,84,-574
-67,-108,-95,-16,-125,18,-96,63,-426
-37,-72,-88,-10,-117,-47,-121,46,-446
-40,-83,-125,-50,-156,-66,-182,83,-619
-59,-108,-119,-66,-147,-53,-113,53,-612
-29,-85,-87,10,-113,-19,-106,57,-372
170,-44,-3,167,-85,-1,-83,217,338
140,-3,1,114,-121,-66,-94,230,201
28,-33,-28,31,-11,-48,-66,23,-104
84,-41,-33,67,-45,-38,-60,93,27
-34,-98,-105,-55,-130,-23,-129,72,-502
32,-151,-105,-35,-146,-129,-153,82,-605
-243,-337,-375,-44,-538,26,-466,327,-1650
-212,-301,-277,-7,-444,-88,-519,207,-1641
-4,-135,-112,-31,-150,-75,-127,29,-605
-10,-127,-110,-29,-150,-84,-129,27,-612
-28,-38,-89,-19,-125,-71,-107,27,-450
-28,-149,-162,-59,-210,-100,-250,141,-817
21,205,115,249,-46,61,-104,59,560
2,-11,-17,22,-34,-14,-26,15,-63
3,-6,-10,0,-14,-13,-17,2,-55
8,-47,-42,-24,-19,-37,-63,32,-192
-181,-77,-100,407,-142,141,-336,312,24
-156,4,-59,503,-111,163,-309,409,444
-19,-32,-70,-10,-104,-30,-81,42,-304
-17,-64,-65,24,-89,-17,-100,28,-300
151,-87,-78,206,-115,-68,-277,319,51
-91,-255,-219,-3,-314,-85,-323,60,-1230
-28,-86,-100,-14,-122,-38,-107,59,-436
-269,-108,-260,-192,-294,-345,-549,-258,-2275
-267,-143,-246,-174,-303,-337,-600,-249,-2319
-47,-127,-163,-43,-238,-134,-281,142,-891
12,-126,-138,25,-235,-48,-174,70,-614
-102,-130,-75,35,-247,-115,-237,-79,-950
-91,-173,-151,-37,-184,-25,-188,78,-771
29,-91,-106,-17,-64,-78,-130,68,-389
6,-107,-131,-30,-98,-60,-96,43,-473
26,-37,-63,8,-92,-44,-69,63,-208
-27,-34,-37,-1,-29,-14,-43,17,-168
-88,-108,-109,-39,-144,-76,-149,-2,-715
162,191,158,289,77,97,12,157,1143
3,-4,-29,-4,-18,-7,-44,16,-87
487,-203,-264,363,-208,12,-347,646,486
-45,-31,-106,-74,-10,-19,-75,31,-329
-46,-20,-191,-44,11,-21,-67,13,-365
103,-190,-235,-62,-416,-80,-293,217,-956
60,-53,-86,54,-86,-68,-106,118,-167
11,-39,-91,-3,-76,-113,-121,52,-380
12,-33,-97,30,-42,-69,-124,70,-253
60,-83,-46,-1,-37,-111,-159,48,-329
85,-14,2,108,-39,-59,-90,101,94
-224,-106,-250,-138,-275,-320,-550,-222,-2085
-11,-15,-10,-8,-25,-4,-13,4,-82
-101,-165,-209,-39,-61,-5,-121,-21,-722
-47,-86,-59,-19,-82,-58,-154,9,-496
-1,-30,-52,0,-89,-35,-48,45,-210
-41,-66,-106,-51,-123,-112,-248,-23,-770
6,-90,-110,80,-101,-28,-99,104,-238
-46,-48,-42,-16,-100,-44,-119,-16,-431
44,114,50,163,-113,51,-117,76,268
-37,-161,-140,-26,-214,-99,-198,30,-845
16,-37,-48,16,-66,-24,-59,40,-162
0,-214,-261,-53,-335,-147,-277,119,-1168
-43,-172,-278,-48,-299,-27,-250,180,-937
-26,-56,-51,-28,-103,-62,-76,3,-399
-59,-66,-85,-5,-150,-47,-160,91,-481
11,-51,-36,39,-62,-23,-79,54,-147
14,-58,-112,5,-166,-69,-158,34,-510
36,-61,-74,-36,-131,-78,-152,79,-417
-9,-68,-57,-29,-80,-27,-73,55,-288
-31,-62,-70,7,-73,-21,-99,25,-324
41,-29,-29,22,-14,-69,-105,18,-165
-33,-22,-24,-7,-49,-11,-60,-5,-211
-11,-14,-24,-12,-38,-14,-43,2,-154
-41,-76,-110,-78,-165,-114,-141,-11,-736
-28,-49,-43,-36,-72,-17,-80,25,-300
32,-76,-93,-13,-84,-42,-65,77,-264
-40,-129,-80,2,-148,-41,-128,42,-522
-15,-49,-55,5,-84,-18,-90,15,-291
-18,-15,-18,-9,-51,-34,-48,-15,-208
-26,-101,-83,-33,-132,-49,-116,79,-461
6,-37,-46,9,-93,-74,-95,23,-307
4,-59,-77,-36,-103,-38,-69,68,-310
-7,-78,-74,-28,-49,-42,-86,16,-348
12,4,-8,-10,-19,-11,-24,29,-27
-17,-98,-133,-86,-225,-128,-218,24,-881
20,-76,-46,45,-137,-25,-105,52,-272
-36,-48,-39,-6,-67,-22,-71,-8,-297
-71,-157,-191,47,-214,-33,-201,166,-654
-74,-78,-87,-7,-119,-25,-138,29,-499
-55,-88,-90,-30,-141,-42,-107,31,-522
-44,-90,-107,-40,-141,-21,-126,49,-520
-21,-49,-88,-50,-109,-61,-133,88,-423
-2,-65,-61,-9,-22,-62,-94,42,-273
-12,-49,-66,-3,-70,18,-38,42,-178
-4,-18,-23,2,-26,-11,-23,7,-96
-14,-75,-90,-32,-105,-36,-98,31,-419
85,-183,-199,-51,-229,-260,-387,125,-1099
45,-90,-60,-31,-98,-39,-61,83,-251
9,-40,-35,10,-95,2,-52,54,-147
-14,-36,-55,10,-24,27,-46,43,-95
-24,-63,-115,-61,-123,-54,-119,27,-532
-43,-65,-81,-50,-107,-42,-119,0,-507
-18,-71,-68,-7,-109,-46,-97,6,-410
-23,-116,-117,31,-82,-46,-135,128,-360
1,-28,-40,10,-9,-13,-17,9,-87
-56,-58,-119,-43,-145,-37,-114,15,-557
77,-46,-57,93,-34,39,-80,63,55
-30,-85,-71,-12,-139,-32,-101,29,-441
-25,-31,-27,7,-43,-12,-28,-1,-160
-23,-68,-69,-1,-124,-49,-107,32,-409
66,-23,-164,52,-32,5,-127,176,-47
-48,-99,-105,-54,-165,-26,-107,56,-548
-20,-100,-93,-3,-111,-16,-103,83,-363
7,12,-7,33,-16,-21,-18,1,-9
-3,-55,-62,3,-91,-49,-92,-9,-358
40,1,-18,23,1,2,-7,19,61
2,-45,-45,-59,-46,-39,-51,-1,-284
99,29,38,128,3,-38,-85,106,280
48,-115,-326,15,-212,3,-278,254,-611
-41,-70,-40,-2,-90,-17,-59,-5,-324
28,-30,-106,-1,-66,-15,-103,94,-199
-104,-170,-169,-69,-209,-122,-225,48,-1020
-3,-83,-55,12,-88,-11,-52,71,-209
-45,-117,-101,3,-118,-17,-117,61,-451
-10,-137,-209,-22,-325,-111,-257,216,-855
11,-80,-73,31,-79,-13,-83,49,-237
3,-64,-68,5,-142,-6,-111,68,-315
61,-49,-96,19,-124,-63,-93,49,-296
-46,-54,-35,-14,-129,-30,-73,19,-362
13,-125,-190,-83,-243,-171,-273,62,-1010
3,-12,-10,-3,-18,-25,-36,29,-72
15,-14,-11,8,-20,-29,-21,11,-61
-42,-64,-76,-68,-68,-22,-40,54,-326
252,78,57,132,-73,-60,-229,289,446
432,32,43,74,-77,-265,-359,383,263
-77,-142,-175,5,-222,-42,-214,53,-814
5,-37,-24,-11,-53,-27,-50,8,-189
2,-76,-65,-2,-122,-9,-91,110,-253
-6,55,-12,11,-7,-1,-49,17,8
-22,-48,-77,-35,-66,-49,-92,0,-389
-26,-31,-17,15,-4,-2,-34,-8,-107
63,-132,-205,-13,-176,-216,-403,146,-936
-6,-102,-42,53,-73,-8,-78,47,-209
0,-21,-29,-8,-56,-42,-57,30,-183
19,-34,-51,7,-60,-47,-61,22,-205
29,-59,-72,-2,-93,-1,-111,70,-239
-24,-96,-63,13,-88,-55,-105,47,-371
-129,-163,-179,-25,-377,-104,-360,78,-1259
34,-171,-162,25,-174,28,-107,158,-369
-56,-63,-99,-63,-121,-116,-221,8,-731
1,-43,-52,9,-41,-26,-54,34,-172
27,-54,-43,15,-28,39,-54,80,-18
3,-92,-132,3,-101,59,-98,113,-245
-4,-5,-15,-12,-15,-3,-29,7,-76
-58,5,-67,-74,-39,-109,-146,-43,-531
-27,-47,-82,-74,-44,-65,-117,35,-421
-1,-52,-78,-61,-154,-78,-141,-12,-577
-25,-124,-119,-26,-126,-86,-176,71,-611
-20,-15,-37,-3,-47,-12,-41,13,-162
-17,-43,-68,-24,-58,-50,-85,0,-345
17,-9,-40,14,-50,-17,-49,41,-93
19,-18,-47,-22,-64,-26,-52,42,-168
10,-35,-46,9,-61,22,-37,75,-63
1,4,-18,-8,-33,-13,-36,33,-70
-5,-36,-57,-10,-74,27,-31,62,-124
31,-26,-22,64,-80,-41,-91,35,-130
18,0,-6,65,-63,-27,-105,46,-72
39,-25,-22,70,-61,-40,-101,40,-100
-29,-45,-43,-55,-26,-38,-59,4,-291
-20,-23,-40,-2,-51,-6,-38,12,-168
-25,-25,-45,-35,-50,6,-48,9,-213
-58,-102,-146,-31,-199,-47,-193,53,-723
-51,-99,-106,-31,-150,-56,-151,8,-636
-23,-161,-168,-37,-116,-67,-195,2,-765
18,-7,-38,10,-25,-66,-77,-2,-187
-60,-143,-146,-76,-251,-15,-177,130,-738
21,-51,-46,-2,-78,-10,-56,54,-168
22,-41,-64,-8,-79,-16,-62,39,-209
-39,-30,-39,-13,-51,-5,-47,11,-213
-42,-54,-43,-30,-94,-23,-82,7,-361
-46,-61,-71,-50,-99,-74,-108,-26,-535
-14,-77,-133,-46,-174,-83,-147,56,-618
70,-77,-112,-26,-120,-1,-99,155,-210
-34,-125,-175,-64,-225,-136,-237,74,-922
-27,-45,-84,-44,-118,-38,-101,43,-414
-4,-21,-33,-9,-37,-26,-38,13,-155
-36,-93,-96,-20,-134,-57,-123,61,-498
-45,-104,-93,-33,-154,-2,-108,81,-458
-50,-101,-118,-60,-151,-42,-129,65,-586
-13,-24,-43,-18,-54,-30,-49,10,-221
59,-91,-5,31,-17,-53,-87,88,-75
27,-75,-36,15,-21,-10,-91,115,-76
-79,-194,-241,-20,-296,-17,-282,163,-966
-5,-58,-63,-15,-95,-55,-99,22,-368
-37,-162,-129,8,-101,-48,-186,96,-559
-19,-3,-26,-12,-19,-14,-24,-3,-120
-52,-77,-64,-32,-65,-38,-103,22,-409
-36,-65,-106,-60,-114,-73,-112,41,-525
-5,-46,-74,-28,-70,4,-37,59,-197
-9,-71,-72,-33,-33,12,-46,27,-225
-46,-48,-87,-57,-127,-82,-189,-34,-670
-19,-37,-42,9,-22,-20,-46,3,-174
-16,-64,-60,25,-76,-34,-80,42,-263
13,-29,-27,23,-26,-27,-40,20,-93
-32,-25,-34,-27,-33,-18,-32,-17,-218
101,-40,-39,76,-29,-105,-119,37,-118
22,-168,-177,-61,-237,-235,-258,55,-1059
0,-21,-27,30,-47,-33,-58,12,-144
-128,-208,-277,-186,-320,-302,-476,-10,-1907
-42,-101,-115,-43,-139,-65,-133,48,-590
-22,-67,-61,-14,-106,-64,-109,36,-407
5,0,-11,31,-23,-15,-32,11,-34
-38,-67,-63,-27,-72,-25,-76,10,-358
0,-71,-71,-10,-96,-47,-52,27,-320
-15,-52,-53,-9,-70,-28,-71,7,-291
-19,-121,-116,-23,-177,-73,-158,35,-652
-84,-220,-237,-109,-308,-77,-258,70,-1223
19,-18,-32,-8,-31,-26,-24,24,-96
5,-48,-79,-18,-75,-80,-100,20,-375
-44,-73,-69,-23,-92,-47,-92,28,-412
-6,-38,-47,37,-23,-9,-53,13,-126
-18,-130,-175,-51,-198,-110,-183,94,-771
0,-6,-9,3,-22,-14,-13,3,-58
-19,-90,-101,-12,-140,-8,-123,112,-381
-96,-103,-139,-51,-128,-39,-148,48,-656
-16,-163,-210,48,-286,-34,-261,210,-712
-70,-95,-121,-37,-150,-5,-122,71,-529
-87,-77,-91,-46,-136,13,-115,51,-488
-35,-45,-56,14,-62,-5,-71,24,-236
-16,-80,-43,-2,-125,-32,-92,91,-299
-65,-91,-99,-38,-141,-26,-120,55,-525
1,-89,-116,-18,-78,-32,-130,57,-405
2,-58,-41,-11,-106,-27,-84,20,-305
-31,-28,-71,-5,-68,3,-43,60,-183
8,-29,-51,-12,-88,-64,-85,20,-301
-12,-44,-49,-32,-31,-22,-56,27,-219
40,-59,-127,-13,-114,-63,-139,65,-410
7,-46,-87,-57,-59,-5,-67,72,-242
-70,-117,-113,-65,-141,-50,-160,8,-708
-20,-74,-141,-72,-165,-124,-201,41,-756
-3,-114,-103,-43,-172,-129,-162,9,-717
-42,-129,-109,65,-210,-24,-169,97,-521
-34,-123,-137,63,-202,28,-191,122,-474
-39,-172,-115,74,-202,-15,-190,136,-523
-50,-144,-180,-60,-260,-74,-193,34,-927
-9,-74,-55,-1,-78,-48,-59,8,-316
-7,-74,-91,-6,-76,-68,-125,46,-401
-169,-179,-180,-75,-253,-106,-265,-49,-1276
-118,-214,-207,-83,-290,-97,-248,18,-1239
-205,-448,-490,-176,-738,-453,-726,-79,-3315
-160,-385,-360,-51,-566,-267,-528,112,-2205
-9,-107,-127,-58,-183,-74,-187,13,-732
75,-103,-102,38,-99,-56,-175,66,-356
7,-8,-168,3,-76,18,-111,118,-217
-20,-27,-29,27,-69,3,-50,31,-134
-23,-60,-81,-42,-108,-120,-107,3,-538
-7,-136,-99,14,-186,-13,-155,94,-488
-7,-23,-27,-26,-15,-2,-16,19,-97
12,-92,-117,-47,-111,-98,-114,33,-534
-38,-120,-112,-7,-98,-2,-117,63,-431
-60,-110,-99,-24,-139,-19,-148,30,-569
97,-141,-175,24,-134,-106,-186,179,-442
-33,-92,-81,7,-129,-31,-116,25,-450
26,-271,-281,-76,-272,-194,-440,201,-1307
-143,-244,-334,-189,-445,-190,-418,114,-1849
-21,-35,-72,-54,-42,-12,-77,64,-249
24,-101,-108,20,-103,-81,-163,115,-397
-26,-169,-192,4,-208,68,-135,188,-470
-119,-196,-239,-99,-372,-221,-422,-59,-1727
40,-29,-44,5,-90,-51,-72,33,-208
-33,-35,-30,-36,-11,-21,-33,-5,-204
54,-30,-7,-3,-26,-123,-128,99,-164
21,-17,-22,-2,-47,-45,-52,-1,-165
14,1,-11,-5,-37,-39,-41,-11,-129
8,-2,-15,10,-33,-28,-32,-8,-100
8,-86,-67,49,-105,-30,-118,51,-298
-9,-23,-34,-17,-26,-16,-36,7,-154
8,-48,-52,-7,-31,-5,-34,36,-133
-142,-524,-697,-332,-943,-504,-913,281,-3774
9,-156,-115,36,-134,-47,-154,62,-499
-37,-97,-92,-21,-123,-39,-162,32,-539
-71,-64,-115,-47,-168,-11,-135,65,-546
-38,-70,-126,-41,-186,-56,-148,50,-615
-52,-73,-117,-26,-187,-21,-141,69,-548
-10,-48,-150,-24,-160,-49,-160,58,-543
-22,-72,-72,-34,-75,-82,-133,64,-426
16,-71,-86,-23,-101,-14,-44,52,-271
0,-23,-19,14,-44,-12,-34,4,-114
-67,-78,-108,-25,-141,-36,-118,36,-537
-53,-81,-93,-30,-123,-51,-135,32,-534
-76,-62,-89,-48,-146,-78,-132,36,-595
-25,-68,-110,-19,-112,-106,-145,56,-529
-32,-59,-127,-79,-92,-51,-127,99,-468
73,-199,-221,-35,-210,7,-232,391,-426
-6,-131,-100,7,-169,-83,-125,55,-552
7,-54,-52,4,-47,6,-26,62,-100
-80,-118,-116,-22,-145,-61,-176,29,-689
21,-67,-35,47,-74,-28,-75,58,-153
19,-34,-35,40,-24,-6,-59,37,-62
34,-30,-65,73,-76,-69,-142,55,-220
-11,-98,-125,-5,-196,-71,-184,44,-646
-61,-72,-86,-66,-94,-72,-129,4,-576
-3,-122,-90,4,-135,-39,-90,66,-409
49,-57,-6,55,-24,-59,-81,76,-47
23,-131,-114,-10,-212,-91,-172,38,-669
-1,-2,-30,-8,-54,-11,-42,74,-74
10,-41,-24,13,-49,-14,-41,42,-104
17,-23,-18,22,-15,9,-11,31,12
33,-55,-55,3,-61,-64,-61,26,-234
-9,-54,-44,-7,-117,-50,-109,52,-338
32,-90,-77,14,-80,-49,-116,119,-247
1,-37,-69,-33,-67,-41,-98,37,-307
-2,-31,-57,-29,-76,-39,-100,25,-309
5,-29,-53,-15,-55,-32,-103,35,-247
6,-37,-64,-10,-50,-25,-92,29,-243
18,-10,-18,2,-14,-17,-29,24,-44
4,-27,-54,-4,-49,-28,-89,37,-210
7,-26,-61,-16,-63,-45,-82,30,-256
10,-30,-52,10,-63,-30,-70,47,-178
10,-21,-78,2,-69,-37,-97,71,-219
14,-34,-58,8,-76,-29,-93,64,-204
11,-32,-70,-24,-67,-38,-111,29,-302
5,-61,-71,-20,-50,-42,-73,24,-288
-45,-110,-99,-45,-126,-43,-142,55,-555
-2,-136,-101,-3,-117,-112,-178,-7,-656
7,-98,-80,35,-77,-40,-124,19,-358
-15,-16,-20,-13,-15,-19,-33,-19,-150
18,-12,-32,-19,-11,-20,-68,33,-111
-12,-77,-80,0,-80,17,-69,37,-264
5,-64,-72,5,-66,-16,-77,84,-201
5,-63,-81,20,-58,-18,-76,85,-186
8,-57,-67,2,-58,-18,-73,84,-179
15,-96,-66,12,-84,-20,-91,123,-207
-5,-72,-74,-12,-94,-27,-92,126,-250
18,-48,-58,26,-48,-13,-57,72,-108
15,-39,-51,23,-54,-9,-53,74,-94
-83,-151,-139,-46,-118,-52,-122,-6,-717
-57,-122,-97,-21,-138,36,-69,84,-384
-23,-151,-142,-84,-143,-81,-166,108,-682
-32,-51,-34,-26,-106,-40,-83,29,-343
86,-15,-32,119,-35,-68,-103,96,48
74,-16,6,81,-35,-95,-63,45,-3
0,-34,-66,-21,-52,-47,-81,24,-277
-49,-15,-29,-35,-17,-51,-78,-58,-332
-42,12,-33,-51,-15,-33,-99,-25,-286
-48,-66,-53,-17,-81,-11,-86,-10,-372
11,-85,-40,34,-84,-42,-79,56,-229
-75,-115,-141,-21,-202,-75,-176,74,-731
14,-5,-18,12,-42,25,-18,43,11
24,-13,-22,69,-20,27,-16,37,86
-13,-42,-64,29,-85,-15,-89,28,-251
-4,-16,-30,-10,-11,-3,-37,-6,-117
21,-105,-63,7,-157,-80,-142,98,-421
-29,-67,-67,-15,-98,-31,-80,13,-374
-19,-60,-74,-16,-112,-52,-68,26,-375
-9,-55,-62,-3,-87,-35,-72,43,-280
19,-410,-602,-338,-181,-202,-329,358,-1685
-65,-143,-213,-6,-311,-96,-290,121,-1003
-86,-176,-220,-20,-295,-154,-318,74,-1195
-20,-120,-151,34,-185,4,-133,137,-434
20,-28,-108,-37,-101,-82,-181,8,-509
-37,-80,-108,14,-145,-41,-124,23,-498
50,-31,-125,-24,-84,-64,-105,134,-249
-39,-82,-102,-21,-125,-63,-129,37,-524
-73,-118,-122,-48,-142,-35,-134,43,-629
-10,-59,-113,-55,-120,-105,-179,29,-612
-27,-111,-102,2,-133,-48,-122,35,-506
-106,-129,-130,-64,-158,-59,-167,53,-760
1,-87,-117,-21,-144,-78,-142,43,-545
-79,-104,-114,-66,-145,-42,-153,68,-635
-38,-92,-406,-86,-312,-110,-366,285,-1125
33,-30,-16,1,-51,-27,-48,60,-78
34,-35,-19,8,-26,-18,-29,58,-27
0,-71,-120,-102,-172,-82,-133,38,-642
111,-108,-86,13,-90,-156,-241,235,-322
-27,-48,-36,-21,-38,-33,-70,-33,-306
-38,-60,-83,-27,-166,-48,-135,56,-501
27,-16,-24,25,3,-25,-15,18,-7
228,-133,-165,320,-139,-182,-456,293,-234
-9,-46,-62,6,-87,-47,-72,9,-308
-62,-102,-102,-56,-154,-47,-153,49,-627
6,-40,-36,-23,-31,-25,-49,37,-161
-139,-99,-157,-13,-167,26,-172,69,-652
-9,-47,-41,-22,-80,-22,-45,42,-224
-15,-51,-66,-31,-90,-16,-66,30,-305
-6,-26,-29,-12,-21,-20,-25,30,-109
-6,-68,-43,17,-37,-14,-41,28,-164
-16,-15,-31,-34,-15,6,-4,22,-87
-26,-35,-35,-17,-37,1,-28,34,-143
-41,-24,-18,-39,-52,-26,-55,3,-252
-5,-38,-41,-8,-62,-19,-55,1,-227
-10,-12,-22,-10,-20,-32,-27,-2,-135
259,-271,-473,-10,-164,0,-305,363,-601
-11,-54,-45,4,-74,-8,-61,32,-217
5,-153,-165,75,-168,3,-204,206,-401
79,-39,-23,77,1,-48,-43,82,86
-301,-383,-499,-363,-794,-582,-884,-228,-4034
-67,-230,-224,20,-369,-201,-405,-64,-1540
-10,-27,-38,-20,-53,-34,-54,31,-205
25,-89,-69,15,-89,-43,-67,52,-265
-83,-183,-136,30,-241,-31,-163,98,-709
-56,-96,-127,-44,-118,-37,-123,58,-543
0,-6,-15,-5,-27,-14,-25,19,-73
1,-27,-14,21,-19,-7,-49,10,-84
-19,-133,-105,14,-142,-23,-122,111,-419
32,-76,-75,29,-104,-12,-91,107,-190
1,-59,-28,8,-57,6,-31,19,-141
-1,-15,-16,12,-61,-27,-55,15,-148
-68,-101,-103,-22,-136,-34,-124,21,-567
-24,-55,-74,0,-81,-37,-94,18,-347
2,23,3,12,-24,-3,-16,15,12
-2,-103,-88,18,-112,21,-97,65,-298
-54,-127,-66,0,-156,-2,-103,63,-445
-41,-112,-107,-27,-125,-78,-165,27,-628
-88,-88,-102,-40,-149,-53,-147,47,-620
4,-23,-13,-1,-28,-13,-31,10,-95
-53,-87,-75,-35,-121,-33,-107,47,-464
-34,-55,-86,-13,-120,-35,-125,54,-414
-64,-91,-92,-32,-118,-32,-98,36,-491
-60,-81,-88,-27,-125,-48,-106,20,-515
-29,-75,-77,-16,-115,-42,-96,37,-413
-75,-87,-106,-24,-120,-12,-102,31,-495
-45,-71,-76,-24,-111,-42,-102,24,-447
14,-63,-92,-1,-107,-38,-102,1,-388
-5,-174,-154,-48,-177,-102,-169,4,-825
-39,-96,-121,-34,-143,-46,-127,51,-555
-50,-108,-96,1,-143,-12,-115,65,-458
-52,-84,-97,-63,-127,-67,-136,21,-605
46,-64,-14,30,3,-66,-62,57,-70
-1,-43,-47,-21,-10,-30,-29,7,-174
21,-27,-33,-4,-23,-45,-50,11,-150
15,-7,-25,-10,-37,-14,-29,38,-69
-24,-15,-15,-2,-14,-16,-16,-10,-112
11,-44,-60,-27,-74,-64,-101,18,-341
73,-71,-67,76,-47,-95,-184,88,-227
16,-63,-69,-5,-76,-26,-54,46,-231
-12,-196,-206,-35,-259,-78,-215,105,-896
-10,-18,-30,-17,-36,2,-13,17,-105
-11,-68,-74,-17,-39,-45,-76,70,-260
-54,-134,-129,30,-163,-38,-181,97,-572
-65,-111,-100,-27,-147,-22,-114,70,-516
-9,-52,-58,-38,-59,-16,-45,40,-237
-57,-91,-98,-28,-135,8,-84,60,-425
-31,-76,-84,-2,-101,-44,-111,68,-381
-46,-65,-90,-36,-112,17,-76,43,-365
17,-48,-49,29,-89,-21,-75,57,-179
-62,-146,-155,15,-240,-28,-211,127,-700
-27,-59,-68,-17,-56,-32,-70,-25,-354
12,-72,-42,19,-52,6,-48,56,-121
-17,-26,-23,-22,-26,-15,-30,7,-152
-81,-124,-149,-2,-164,-27,-161,88,-620
-82,-123,-140,15,-160,-15,-162,52,-615
-56,-139,-121,40,-186,-54,-162,100,-578
-30,-107,-116,-47,-150,-72,-138,49,-611
-25,-95,-106,-59,-128,-48,-106,78,-489
7,-94,-92,45,-139,-63,-81,70,-347
-15,-81,-71,-12,-142,-42,-111,40,-434
-25,-57,-103,-57,-85,-10,-96,44,-389
-42,-117,-92,-1,-115,-5,-96,67,-401
-18,-117,-105,21,-109,35,-90,143,-240
28,-141,-162,17,-244,-42,-162,136,-570
-8,-25,-25,18,-45,-2,-46,36,-97
-23,-10,-19,16,-48,-14,-54,15,-137
12,-30,-25,44,-9,3,-40,43,-2
-20,-59,-14,29,-15,3,-55,21,-110
-54,-229,-276,-25,-255,29,-190,219,-781
60,-127,-105,44,-169,-133,-153,113,-470
21,-98,-76,62,-155,-37,-109,111,-281
41,-40,-57,-5,-67,-81,-149,70,-288
-14,-88,-65,-6,-76,-26,-75,37,-313
39,-18,16,74,4,-10,-33,62,134
104,-80,-33,34,8,-44,-70,104,23
-2,-50,-72,-3,-101,-49,-105,47,-335
0,-42,-68,-20,-90,-4,-72,40,-256
-5,-60,-43,17,-78,-1,-68,58,-180
-35,-133,-97,18,-165,-127,-179,-18,-736
-26,-101,-67,-16,-119,-7,-123,38,-421
-35,-111,-83,-14,-133,-20,-133,49,-480
-8,-39,-63,-20,-82,-50,-58,17,-303
-41,-49,-67,-21,-89,-30,-84,-11,-392
16,4,2,16,8,-2,3,7,54
-36,-32,-72,-15,-97,-8,-66,28,-298
-98,-81,-113,-63,-162,-97,-197,-15,-826
-32,-111,-78,-16,-134,-44,-136,88,-463
-42,-89,-87,-5,-99,-17,-69,62,-346
-13,-71,-80,2,-102,3,-103,116,-248
110,-100,-208,51,-97,-49,-206,133,-366
-21,-253,-272,-69,-329,-134,-296,151,-1223
-47,-54,-53,-5,-71,-22,-122,14,-360
-21,-61,-89,10,-71,-5,-58,16,-279
-28,-73,-69,31,-89,-7,-85,3,-317
416,-131,-71,30,172,-263,-509,515,159
-10,-74,-90,-16,-118,-86,-128,1,-521
-25,-44,-56,-28,-146,-74,-114,-2,-489
-19,-17,-39,-16,-36,-31,-41,8,-191
-110,-146,-122,-25,-158,-24,-124,52,-657
-89,-44,-120,-46,-200,-52,-179,61,-669
-10,27,18,77,-123,-28,-160,28,-171
87,72,-155,-111,-78,-215,-436,35,-801
-4,-50,-80,-17,-104,-23,-79,47,-310
17,-49,-65,-34,-89,-51,-72,50,-293
-30,-52,-53,10,-60,-31,-53,-2,-271
-54,-59,-53,-4,-79,-24,-91,38,-326
1,-78,-54,13,-100,-35,-56,19,-290
-113,-209,-207,-100,-308,-131,-241,27,-1282
-25,-49,-46,1,-38,-24,-39,8,-212
-42,-112,-92,36,-106,-3,-101,97,-323
46,-64,-55,7,-92,-38,-48,25,-219
35,-68,-27,21,-50,-45,-92,59,-167
-53,-49,-81,-33,-26,-15,-65,48,-274
-76,-172,-242,-183,-264,-219,-379,155,-1380
-70,-152,-220,-104,-280,-53,-241,139,-981
-70,-52,-74,-28,-74,-32,-118,2,-446
-24,-17,-25,-31,-23,-21,-43,-23,-207
-61,-120,-162,-8,-170,-51,-222,111,-683
-118,-143,-188,-42,-227,-71,-239,51,-977
20,-86,-66,-21,-99,-59,-115,73,-353
63,9,-17,46,27,-5,-21,33,135
-64,-102,-103,-48,-138,-28,-124,43,-564
64,-66,-94,45,-46,-59,-109,85,-180
-2,-22,-56,-9,-69,-29,-73,36,-224
-16,-80,-103,3,-166,-26,-122,61,-449
-20,-94,-58,-29,-67,-48,-89,19,-386
-48,-101,-96,-49,-126,-19,-125,52,-512
7,-73,-63,-33,-96,-51,-73,46,-336
22,-60,-46,20,-94,3,-63,38,-180
-37,-104,-115,8,-161,-38,-135,83,-499
-20,-25,-28,-25,-23,-16,-29,34,-132
-4,-89,-95,5,-134,28,-82,100,-271
-20,-15,-4,3,-7,7,-26,-3,-65
-57,-101,-91,-19,-143,-4,-112,63,-464
39,-16,-8,29,-76,-16,-40,50,-38
0,-48,-40,-3,-77,-14,-102,69,-215
-64,-107,-127,-18,-192,-72,-209,31,-758
-36,-88,-136,-13,-188,-32,-166,104,-555
-49,-106,-101,-28,-139,-43,-147,55,-558
96,12,-110,16,-52,-40,-145,32,-191
-32,-90,-81,-19,-125,-10,-91,67,-381
54,-343,-443,-112,-670,-391,-599,227,-2277
28,-41,-60,1,-41,-53,-61,58,-169
-6,-96,-58,0,-73,-54,-63,11,-339
-1,-64,-51,4,-96,-65,-93,3,-363
-27,-77,-75,-12,-104,-74,-110,20,-459
3,-24,-44,34,-68,-10,-72,22,-159
-66,-42,-65,-46,-158,-52,-115,10,-534
-30,-57,-44,-24,-50,-17,-49,24,-247
-7,-65,-76,-43,-76,-41,-65,53,-320
-29,-47,-58,-67,-108,-32,-103,0,-444
105,-92,-92,-14,-64,-92,-116,68,-297
7,-46,-65,22,-122,-1,-107,56,-256
13,-31,-14,7,-28,-9,-36,44,-54
1,-46,-58,4,-75,-10,-85,27,-242
-23,-57,-73,-8,-77,-45,-92,19,-356
1,-65,-51,26,-122,0,-101,59,-253
-23,-30,-31,-27,-40,-37,-59,5,-242
-462,-91,-457,-442,-353,-432,-953,-350,-3540
-4,-24,-12,-9,-17,-19,-13,-2,-100
4,-24,-19,6,-18,3,-27,27,-48
12,-77,-43,-9,-70,-19,-49,63,-192
55,-116,-114,23,-231,-150,-201,24,-710
-20,-116,-131,-47,-140,-106,-163,-21,-744
-32,-58,-87,-49,-131,-63,-116,12,-524
-36,-69,-78,-12,-116,-61,-96,14,-454
38,-33,-72,-22,-103,-117,-101,37,-373
-32,-105,-112,-10,-125,-80,-130,82,-512
-22,-58,-57,-20,-94,-29,-75,3,-352
28,-21,-28,53,-13,-16,-66,71,8
48,-58,-34,45,-57,-82,-107,85,-160
18,-223,-174,-19,-281,-144,-262,128,-957
-29,-87,-68,-24,-103,-13,-78,6,-396
-65,-62,-76,-20,-96,-50,-133,4,-498
-35,-58,-70,-15,-93,-40,-82,10,-383
-39,-72,-44,-1,-81,-29,-96,37,-325
-7,-28,-50,-20,-70,-47,-66,8,-280
-28,-72,-106,-48,-134,-99,-149,40,-596
-44,-127,-121,-92,-164,-69,-142,60,-699
-69,-120,-122,-45,-146,-32,-135,52,-617
-3,-27,-39,-29,-51,-36,-49,12,-222
-15,-70,-105,-27,-55,-36,-53,87,-274
67,-52,-11,29,-41,-81,-102,35,-156
55,-26,-34,-1,-10,-65,-86,38,-129
-9,-17,-20,8,-47,-14,-22,14,-107
-13,-38,-35,3,-56,-32,-42,-4,-217
-33,-91,-115,-10,-226,-70,-188,74,-659
147,9,10,115,-85,-81,-91,189,213
141,21,49,130,-58,-103,-37,167,310
22,-39,-95,16,-143,-75,-173,66,-421
194,-197,-68,16,-16,-326,-473,326,-544
-19,-70,-81,-34,-115,-76,-128,48,-475
-99,-115,-156,-74,-218,-67,-210,-1,-940
-41,-34,-47,-26,-58,-26,-72,2,-302
-81,-24,-138,-150,-81,-75,-248,-48,-845
114,-130,-94,16,-73,-46,-90,101,-202
-33,-89,-55,-10,-104,-45,-78,26,-388
-53,-104,-110,-25,-120,-67,-124,29,-574
-80,-102,-98,-43,-152,-48,-124,77,-570
-110,-95,-122,-51,-135,-94,-197,52,-752
-12,-38,-51,-29,-41,-37,-38,41,-205
33,-35,-41,-7,-35,-35,-30,45,-105
-28,-90,-85,7,-58,-25,-79,31,-327
-66,-95,-112,-30,-161,-41,-144,72,-577
-26,-38,-77,-37,-99,-52,-105,4,-430
-46,-47,-65,-55,-51,-54,-89,15,-392
4,-6,-8,-14,-40,-16,-6,18,-68
-26,-49,-64,-43,-59,-48,-58,13,-334
8,-41,-35,-18,-40,-21,-17,35,-129
285,-30,-228,269,-85,198,-147,462,724
203,-365,-506,151,-432,-62,-469,449,-1031
3,-57,-44,2,-51,-30,-54,9,-222
-1,-106,-181,-71,-150,-180,-284,130,-843
-25,-40,-57,-10,-41,-26,-69,-1,-269
-26,-93,-71,-12,-73,-43,-102,23,-397
-63,-83,-98,-28,-130,-42,-140,64,-520
-29,-320,-398,-157,-517,-247,-539,180,-2027
-10,-24,-55,-17,-105,-27,-96,42,-292
-8,-56,-63,6,-102,-5,-106,65,-269
-3,-102,-83,-22,-105,-12,-52,55,-324
-3,-41,-46,-44,-96,-72,-77,40,-339
39,-120,-138,-44,-103,-75,-162,83,-520
9,-41,-39,-18,-32,-27,-38,38,-148
-17,-51,-43,-7,-59,9,-28,40,-156
-38,-62,-57,-23,-51,3,-46,12,-262
0,-1,-24,-6,8,-26,-10,6,-53
-46,-93,-61,17,-132,-33,-98,41,-405
-13,-45,-45,-5,-79,-41,-54,15,-267
-64,-40,-89,-44,-84,-29,-113,1,-462
-16,-25,-29,-28,-36,-21,-41,1,-195
-12,-18,-14,-8,-34,-9,-45,35,-105
-49,-75,-104,-94,-169,-1,-128,68,-552
-8,-173,-170,-41,-193,-113,-185,65,-818
-77,-152,-131,4,-212,-90,-196,24,-830
64,-59,-62,-12,-46,-80,-91,87,-199
1,-38,-75,14,-136,-37,-94,120,-245
-32,-88,-111,11,-106,-17,-99,42,-400
-68,-102,-97,-23,-132,-17,-122,55,-506
9,-27,-50,-21,-80,-46,-41,48,-208
12,-15,-16,7,-19,8,-1,8,-16
-35,-29,-43,11,-63,-28,-60,4,-243
-40,-81,-47,0,-108,-27,-78,11,-370
7,-22,-17,1,-9,-4,-13,-1,-58
6,-7,-10,7,-7,-18,-14,6,-37
21,-39,-27,17,-93,-7,-58,27,-159
79,-16,-18,83,-46,-124,-80,43,-79
23,-36,-15,11,-24,-32,-62,49,-86
22,-4,-61,9,-40,-59,-70,44,-159
-6,-60,-58,-10,-55,-22,-51,18,-244
-11,-65,-55,-12,-59,-23,-51,10,-266
-1,-3,-21,0,-8,-10,-11,-6,-60
28,-89,-41,51,-73,-23,-116,83,-180
-7,-47,-120,-65,-147,-118,-157,39,-622
-53,-98,-124,-69,-139,-44,-122,48,-601
-37,-65,-72,-23,-85,-5,-77,21,-343
19,-33,-37,38,-47,-14,-78,60,-92
-28,-103,-116,-57,-122,-95,-188,42,-667
-59,-146,-133,0,-209,-67,-180,58,-736
-4,-101,-59,4,-95,-21,-82,32,-326
-65,-139,-179,-66,-229,-42,-197,93,-824
-6,-74,-71,10,-91,-47,-74,32,-321
-24,-87,-84,-5,-91,-45,-107,19,-424
16,-77,-78,13,-89,-58,-108,19,-362
20,-74,-84,17,-74,-54,-103,10,-342
6,-17,-13,19,-9,-12,-18,13,-31
21,-22,-45,-3,-39,-59,-82,38,-191
22,-30,-16,15,-31,-66,-79,9,-176
-31,-10,-45,-19,-45,-18,-69,11,-226
59,-80,-57,75,-127,-159,-162,4,-447
62,-72,-44,19,-33,-80,-151,136,-163
41,-88,-24,35,-30,-32,-55,72,-81
46,-32,-35,15,-9,-73,-80,50,-118
54,-10,-27,22,-22,-43,-42,52,-16
-82,-122,-93,-54,-191,-68,-192,76,-726
7,-24,-42,1,-66,-39,-55,34,-184
-9,-13,-18,-2,-36,-22,-48,-1,-149
-36,-38,-61,10,-60,-4,-59,37,-211
44,-38,-61,43,-80,-26,-57,106,-69
-24,-49,-39,-24,-84,-41,-93,3,-351
34,-18,-21,61,-1,18,-34,91,130
-7,-57,-128,-62,-177,-60,-139,80,-550
-267,-415,-492,-251,-631,-282,-708,-49,-3095
-41,-38,-41,-25,-43,-7,-67,25,-237
-34,-72,-53,-39,-73,-40,-89,6,-394
-24,-390,-480,19,-757,-173,-613,326,-2092
-43,-75,-63,-30,-55,-63,-75,-18,-422
29,-40,-114,-21,-110,-74,-97,127,-300
-1,-38,-44,2,-70,-30,-79,35,-225
52,-65,-42,6,-29,-57,-30,-6,-171
13,-60,-84,4,-144,-52,-126,24,-425
-37,-52,-83,-58,-166,-52,-140,23,-565
-43,-79,-159,-34,-233,-22,-197,58,-709
7,-47,-18,12,-61,-81,-99,70,-217
17,-126,-155,-36,-154,-12,-143,88,-521
15,-34,-68,17,-113,-7,-114,84,-220
30,8,-33,35,-81,-1,-137,119,-60
-12,-29,-58,-31,-77,-51,-61,38,-281
23,-31,-30,27,-39,-30,-42,22,-100
6,-49,-31,23,-45,-8,-28,22,-110
10,-44,-28,15,-56,-21,-30,30,-124
-23,-20,-33,12,-36,-8,-35,1,-142
-9,-27,-32,-4,-50,-5,-36,30,-133
-15,-16,-29,19,-58,-28,-34,3,-158
-55,-167,-161,-53,-181,-65,-164,-3,-849
22,-6,-12,15,-13,25,5,28,64
10,-63,-41,22,-30,-30,-42,26,-148
-27,-105,-96,32,-105,-19,-126,48,-398
-49,-130,-119,-3,-138,-36,-152,66,-561
-4,-128,-156,-45,-157,-136,-237,92,-771
-5,-103,-89,12,-146,-113,-163,54,-553
20,-15,-19,-6,-10,-20,6,16,-28
-34,-60,-73,-13,-68,-43,-83,-20,-394
-54,-75,-106,-46,-115,-88,-160,20,-624
-29,-82,-89,-27,-97,-57,-127,17,-491
-2,-15,-20,23,-40,-20,-38,13,-99
-24,-24,-39,-35,-31,-43,-55,-19,-270
-23,-39,-69,1,-19,-5,-24,10,-168
-55,-102,-148,-21,-84,-10,-89,9,-500
51,-78,-7,35,-87,-65,-147,115,-183
13,-100,-39,22,-83,-8,-77,93,-179
76,-28,-74,50,-62,-7,-100,61,-84
-100,-131,-150,-6,-62,5,-66,-18,-528
-87,-140,-167,-35,-81,-2,-108,14,-606
-101,-142,-199,-128,-270,-57,-243,72,-1068
-141,-103,-194,-137,-210,-241,-348,82,-1292
-78,-103,-188,-86,-220,-236,-359,88,-1182
18,-68,-45,-11,-104,-9,-68,47,-240
15,-43,-55,-12,-114,-84,-109,44,-358
8,-38,-26,10,-47,8,-38,40,-83
-18,-39,-54,-39,-56,-38,-76,-21,-341
-24,-70,-63,-12,-94,-6,-70,77,-262
-21,-30,-51,4,-40,-17,-41,4,-192
-58,-105,-131,-61,-170,-78,-151,50,-704
-9,-442,-700,24,-557,56,-540,377,-1791
-50,-104,-97,-37,-96,-39,-129,0,-552
-22,-48,-66,-9,-103,-115,-102,0,-465
26,-36,-110,-67,-4,-60,-76,128,-199
291,-302,-404,-22,-285,58,-259,502,-421
68,-94,-122,-41,-145,-136,-228,104,-594
-4,-50,-45,-7,-62,-23,-33,25,-199
-59,-76,-68,-42,-109,-6,-129,35,-454
44,-74,-105,-4,-138,-69,-105,25,-426
-46,-97,-88,-23,-130,-74,-150,57,-551
23,-86,-88,39,-163,-54,-151,89,-391
-8,-47,-65,-35,-71,-19,-52,16,-281
3,-40,-5,4,-21,-14,-35,19,-89
-8,-22,-20,2,-17,-14,-23,-5,-107
-52,-53,-61,12,-82,-18,-71,-3,-328
-89,-115,-116,-65,-160,-22,-141,39,-669
-93,-119,-115,-33,-121,-22,-131,38,-596
-90,-99,-99,-34,-140,-10,-127,49,-550
-65,-91,-113,-32,-134,-6,-116,85,-472
-66,-126,-102,-38,-152,-25,-117,62,-564
-48,-121,-106,-24,-147,-20,-106,57,-515
58,-85,-96,-25,-112,-38,-94,80,-312
-1,-111,-62,-9,-96,-64,-91,61,-373
32,-56,-39,19,-118,-72,-114,68,-280
-25,-77,-74,-32,-146,-69,-148,53,-518
13,-103,-90,-20,-150,-104,-140,24,-570
-22,-29,-72,-57,-104,-135,-160,30,-549
16,-123,-131,-7,-194,-86,-201,95,-631
-79,-83,-120,-26,-53,-4,-77,-11,-453
-51,-144,-143,-73,-193,-76,-189,133,-736
-72,-175,-197,-84,-281,-146,-276,82,-1149
-70,-143,-144,14,-248,-51,-215,94,-763
-59,-153,-172,-42,-236,-76,-202,75,-865
-86,-142,-168,-45,-246,-55,-231,44,-929
-74,-124,-198,-50,-219,-64,-197,141,-785
-39,-139,-162,-44,-251,-82,-219,145,-791
-38,-159,-169,-21,-225,-81,-185,85,-793
-41,-159,-166,-25,-216,-86,-198,94,-797
-39,-322,-345,-113,-502,-204,-437,246,-1716
15,-18,-18,10,-29,9,-14,17,-28
-21,-33,-53,-12,-75,-21,-64,10,-269
-50,-67,-97,-21,-118,-60,-128,27,-514
-115,-121,-138,-66,-171,-63,-175,42,-807
-26,-134,-106,8,-157,-79,-129,18,-605
6,-123,-133,26,-123,-38,-99,91,-393
-86,-160,-176,-31,-68,-37,-96,-8,-662
-70,-95,-117,-62,-53,-50,-99,0,-546
98,-195,-242,-4,-93,-4,-205,194,-451
-19,-69,-61,-34,-77,-45,-55,8,-352
166,-111,-206,-14,-72,-128,-260,282,-343
167,-97,-217,128,-96,-93,-241,214,-235
-112,-193,-246,-114,-301,-152,-317,69,-1366
-89,-157,-182,-25,-301,-84,-252,131,-959
-17,-64,-79,-28,-58,-97,-118,45,-416
-3,-97,-83,21,-176,-30,-125,82,-411
-13,-61,-47,-18,-79,-20,-69,18,-289
17,10,-35,6,17,-1,-37,7,-16
-42,-18,10,19,-62,-20,-68,29,-152
-23,-36,-36,-13,-36,-31,-55,17,-213
-68,-77,-99,-51,-117,-42,-100,9,-545
-32,-65,-47,-10,-61,-9,-99,9,-314
-42,-53,-41,-39,-71,-19,-106,29,-342
23,-10,-27,48,-9,-5,-21,14,13
-42,-72,-70,-32,-78,-46,-90,-4,-434
-63,-42,-46,-46,-40,-45,-62,-21,-365
-65,-49,-72,-52,-82,-53,-135,-27,-535
-46,-30,-80,-22,-81,-29,-114,28,-374
-35,-60,-155,-61,-189,-71,-202,73,-700
-68,-67,-65,-57,-86,-40,-94,-3,-480
-3,-36,-24,7,-35,4,-47,38,-96
-18,-41,-36,-20,-20,-33,-42,-14,-224
56,98,64,90,-11,40,13,65,415
-2,-106,-53,8,-76,-73,-93,32,-363
124,-251,-284,9,-321,-57,-288,270,-798
0,-30,-44,-15,-58,-31,-39,33,-184
11,-34,-51,38,-110,-45,-97,19,-269
-21,75,64,108,-57,-14,-99,40,96
3,-67,-95,-16,-132,-30,-95,33,-399
-34,-60,-81,-15,-138,-35,-124,42,-445
-9,-4,-5,20,-19,-10,-16,-13,-56
-2,-44,-91,-17,-153,-109,-180,-39,-635
-55,-173,-227,-123,-321,-247,-316,61,-1401
-60,-75,-68,-24,-107,-53,-110,19,-478
-6,-15,-13,16,-33,-12,-25,16,-72
-14,-15,-22,-11,-22,1,-22,-7,-112
-3,-40,-50,-12,-69,-27,-38,32,-207
4,-22,-30,2,-28,-11,-30,28,-87
1,-31,-26,-23,-27,-17,-15,15,-123
-59,-123,-149,14,-202,-78,-215,87,-725
175,-60,-26,167,-29,13,-54,171,357
19,-20,-29,60,-62,-27,-50,73,-36
-107,-105,-132,-114,-149,-114,-222,3,-940
51,16,-35,40,-38,-43,3,84,78
-8,-13,-18,-5,-33,-7,-21,9,-96
-69,-215,-239,-63,-283,-81,-299,116,-1133
-91,-115,-195,-123,-222,-56,-235,-16,-1053
-53,-145,-125,-14,-175,-87,-206,27,-778
-67,-41,-108,-73,-74,-51,-94,83,-425
-91,-113,-151,-40,-84,-16,-73,4,-564
-64,-115,-132,-17,-90,-12,-73,1,-502
4,-64,-103,-25,-119,-62,-108,22,-455
-68,-156,-188,-13,-108,-42,-129,32,-672
-45,-93,-115,-10,-60,-42,-62,-1,-428
-79,-134,-183,-49,-73,-44,-96,-9,-667
-35,-62,-63,-10,-45,-24,-38,9,-268
-49,-70,-69,-20,-19,-2,-31,0,-260
-38,-338,-350,-181,-160,-326,-376,54,-1715
72,-61,-79,41,-110,-22,-33,101,-91
41,-69,-63,111,-93,-85,-146,83,-221
-38,-82,-77,-21,-118,-24,-101,11,-450
13,-28,-28,5,-42,-18,-30,22,-106
-13,-32,-48,3,-74,-33,-63,15,-245
-62,-54,-121,-58,-234,-72,-161,31,-731
18,-46,-152,-47,-280,-163,-219,89,-800
-3,-51,-34,20,-28,-8,-49,61,-92
-21,-26,-40,-27,-40,-14,-68,35,-201
0,-32,-59,0,-65,10,-65,50,-161
-2,-61,-40,23,-47,-7,-29,60,-103
3,-27,-44,-32,-51,-41,-71,-15,-278
-10,-50,-51,12,-75,-24,-63,35,-226
38,-125,-171,-92,-264,-180,-224,165,-853
-56,-187,-171,-26,-193,-103,-218,31,-923
-75,-175,-146,-68,-179,-111,-220,66,-908
-32,-118,-95,-22,-161,-139,-163,-49,-779
-2,-60,-62,-17,-73,-41,-65,9,-311
14,-54,-21,14,-52,-2,-34,26,-109
13,5,-15,1,29,-14,0,34,53
-3,-26,-32,21,-2,-9,-36,10,-77
43,-47,-34,-19,-4,-70,-77,30,-178
152,-104,-140,201,-196,-8,-284,261,-118
46,-57,-54,6,-31,-47,-72,73,-136
23,-71,-40,19,-38,-66,-98,22,-249
10,-14,-27,5,-38,-71,-89,6,-218
4,-62,-59,14,-73,-70,-89,33,-302
-32,-23,-71,-32,-66,-27,-88,12,-327
-15,-54,-64,-26,-60,-27,-65,28,-283
-2,-72,-63,31,-88,-44,-127,-3,-368
-60,-119,-111,-64,-149,-71,-156,34,-696
-62,-192,-242,-78,-357,-171,-283,84,-1301
-12,-15,-31,-5,-65,-36,-85,-19,-268
7,-56,-60,-15,-59,-41,-89,-3,-316
-8,-29,-47,-3,-70,-41,-91,4,-285
-6,-13,-29,-5,-81,-29,-41,60,-144
-4,-152,-122,32,-232,-32,-164,129,-545
506,327,437,225,241,-214,-232,486,1776
47,-18,-44,0,-34,-28,-86,78,-85
18,1,-9,0,-17,-15,-22,15,-29
19,-60,-42,21,-63,-20,-60,37,-168
12,-10,-26,12,-58,5,-57,55,-67
13,-58,-67,-6,-130,-69,-81,43,-355
-17,-45,-52,35,-78,-29,-88,27,-247
-21,-37,-48,13,-74,-51,-93,6,-305
-74,-178,-161,-89,-298,-119,-265,2,-1182
-13,-206,-196,-46,-293,-134,-209,33,-1064
19,-86,-53,67,-65,-9,-74,58,-143
-45,-73,-106,-43,-145,-66,-159,33,-604
-66,-106,-130,-44,-135,-55,-153,38,-651
24,-14,-16,32,-30,-7,-22,44,11
17,-23,-22,22,-27,-4,-21,22,-36
32,-36,-17,38,-22,17,-18,67,61
-99,-327,-281,-16,-501,-240,-461,14,-1911
-3,-71,-86,-33,-97,18,-36,91,-217
-14,-30,-24,2,-57,-2,-39,25,-139
12,-56,-41,20,-22,-27,-58,7,-165
52,-137,-129,48,-233,-17,-159,156,-419
-15,-67,-57,-19,-97,-64,-80,17,-382
-13,-81,-81,-11,-115,-39,-73,34,-379
-103,-126,-141,-26,-240,-48,-238,83,-839
-45,-28,-53,-32,-38,-25,-55,-8,-284
-13,-13,-4,-5,-12,-4,-9,0,-60
-115,-314,-369,-123,-373,-150,-453,66,-1831
0,-44,-44,7,-45,-42,-53,36,-185
67,-73,-173,-21,-144,-97,-235,93,-583
4,-28,-23,-5,-51,-20,-35,25,-133
-38,-71,-92,20,-124,-28,-119,72,-380
44,-39,-14,19,-45,-21,-80,38,-98
108,-162,-88,76,-144,-129,-213,242,-310
2,-10,-21,5,-18,-6,-12,30,-30
-16,-193,-179,-38,-207,-245,-272,43,-1107
27,2,-17,28,-41,-32,-35,40,-28
-17,-65,-35,24,-38,11,-54,26,-148
15,-71,-28,39,-27,-23,-65,22,-138
0,-191,-242,20,-288,-70,-228,208,-791
-81,-100,-92,-36,-178,-53,-151,-18,-709
24,-151,-197,-57,-245,-119,-206,109,-842
-22,-78,-89,15,-146,-44,-114,68,-410
-35,-7,-45,12,-71,-56,-77,-4,-283
101,-101,-115,19,-76,-82,-116,167,-203
-33,-45,-77,-44,-97,-96,-191,30,-553
291,-152,-82,67,3,-244,-342,260,-199
-48,-51,-80,-14,-96,-36,-92,33,-384
-37,-123,-150,-16,-182,-13,-165,44,-642
-8,-96,-126,17,-190,-36,-127,148,-418
7,-64,-58,-17,-131,-81,-111,65,-390
3,-164,-115,87,-210,-22,-171,161,-431
39,-245,-240,4,-357,-52,-230,219,-862
-5,-81,-70,38,-84,-10,-63,72,-203
6,-62,-53,30,-80,-10,-61,88,-142
-5,-30,-30,-5,-69,-24,-68,35,-196
-9,-73,-104,-51,-96,-66,-117,2,-514
-9,-48,-86,-2,-82,-47,-75,31,-318
-26,-96,-96,-21,-114,-23,-73,39,-410
-27,-97,-97,-7,-151,-63,-109,53,-498
18,-52,-78,10,-135,-3,-102,17,-325
-15,-46,-49,-7,-74,-19,-61,25,-246
-76,-132,-186,-49,-296,1,-234,77,-895
-13,-57,-43,5,-36,-16,-35,11,-184
-9,-4,-1,1,-12,2,-16,12,-27
37,-17,-41,11,-49,-19,-81,49,-110
83,-26,-49,46,-48,1,-56,47,-2
-39,-121,-99,10,-171,-54,-129,-3,-606
11,-181,-145,-9,-218,-81,-204,187,-640
-35,-148,-213,12,-217,-62,-175,127,-711
28,-166,-165,-27,-189,-101,-231,148,-703
-15,-194,-154,50,-222,-10,-190,186,-549
-16,-158,-153,40,-216,-3,-154,144,-516
79,-57,-48,35,-124,-61,-136,178,-134
-16,-69,-73,-27,-114,-55,-128,58,-424
51,-170,-99,47,-178,-133,-222,59,-645
9,-92,-82,89,-113,20,-114,119,-164
-27,-26,-47,-24,-60,-43,-59,-10,-296
30,-26,-29,24,-29,-19,-48,34,-63
12,14,7,63,-49,-85,-99,28,-109
-15,-103,-94,-46,-88,-71,-150,70,-497
-30,-150,-100,-21,-182,-64,-158,43,-662
11,-8,-18,-4,-36,-44,-75,17,-157
-23,-43,-49,-5,-73,-10,-59,36,-226
-37,-41,-32,-3,-74,1,-58,24,-220
-41,-40,-51,-20,-57,-16,-75,9,-291
-57,-125,-116,-3,-145,-30,-144,29,-591
4,-83,-69,45,-93,-58,-87,25,-316
-5,-90,-129,-78,-252,-63,-184,84,-717
2,-59,-39,56,-76,-49,-100,-27,-292
22,-28,-29,67,-52,-67,-91,19,-159
-14,-29,-29,-6,-28,-8,-32,9,-137
0,-39,-24,-1,-20,-34,-38,28,-128
-18,-4,-19,-3,-14,-24,-31,-21,-134
-11,-51,-71,-37,-60,-30,-87,23,-324
-5,-142,-207,58,-313,-81,-287,142,-835
-98,-188,-177,1,-291,-22,-258,140,-893
37,-15,-34,37,-61,-40,-53,15,-114
-41,-51,-71,-26,-99,-33,-87,26,-382
-11,-22,-47,-4,-88,-21,-55,45,-203
35,6,-40,8,-83,-49,-71,63,-131
-23,-55,-46,-6,-94,-83,-109,58,-358
-14,-26,-24,-17,-24,-24,-37,-3,-169
-33,-103,-96,-35,-137,-56,-125,53,-532
-101,-194,-179,-27,-273,-91,-277,13,-1129
-55,-54,-60,1,-81,-29,-89,4,-363
-17,-45,-43,5,-80,-22,-89,28,-263
-15,-45,-53,-12,-233,-81,-140,52,-527
-35,-22,-51,-20,-36,-21,-46,32,-199
-27,-11,-65,-48,-41,-28,-81,32,-269
1,-50,-50,11,-113,-22,-90,55,-258
16,-43,-8,65,-34,-13,-48,51,-14
25,-97,-80,7,-96,-59,-81,34,-347
-58,-103,-130,-38,-166,-1,-110,85,-521
-22,-39,-58,1,-103,-18,-73,55,-257
-11,9,-19,-13,-16,-28,-49,8,-119
-22,-50,-48,-15,-83,-61,-81,18,-342
30,-90,-59,-31,-82,-95,-113,72,-368
-27,-25,-28,-24,-45,-29,-49,-28,-255
-31,-105,-187,-41,-224,-53,-224,77,-788
-146,-228,-257,-120,-347,-135,-366,1,-1598
-26,-164,-202,14,-249,-207,-411,103,-1142
120,-16,-176,124,-94,-23,-149,241,27
138,-40,-180,89,-96,-139,-287,183,-332
40,-65,-77,-1,-92,-110,-160,64,-401
-17,-97,-183,-12,-164,-181,-221,159,-716
2,-9,-26,-2,-37,-13,-49,31,-103
11,-35,-28,21,-59,-21,-45,24,-132
-28,-44,-46,-20,-93,-26,-93,55,-295
-8,-55,-50,-10,-79,-30,-54,15,-271
-11,-70,-70,3,-110,-31,-100,67,-322
9,-64,-48,6,-87,-31,-72,5,-282
-14,-129,-219,-25,-152,-82,-245,124,-742
24,-199,-170,25,-323,-393,-458,13,-1481
20,-5,-20,-13,-42,-47,-35,2,-140
93,-95,-65,59,-152,7,-116,207,-62
72,-77,-77,34,-148,-4,-111,113,-198
12,-75,-64,22,-177,8,-135,147,-262
71,-72,-49,49,-175,-4,-90,140,-130
13,-111,-88,8,-184,-7,-133,148,-354
37,-90,-87,-4,-159,14,-55,129,-215
45,-85,-105,-28,-193,-172,-200,101,-637
72,-26,-61,39,13,-57,-102,109,-13
79,-31,19,143,12,-18,-86,94,212
27,-40,-4,47,4,-2,-76,85,41
0,-21,-40,-6,-19,-21,-49,13,-143
-40,-51,-42,8,-75,-19,-61,24,-256
9,-89,-67,-16,-92,-40,-71,40,-326
25,-44,-58,11,-59,-28,-58,99,-112
44,-53,-40,38,-84,1,-33,50,-77
0,-14,-20,-9,-27,-5,-36,2,-109
57,-64,-19,38,-40,-21,-61,89,-21
-14,-30,-31,-8,-29,-19,-24,19,-136
-18,-21,-26,-10,-13,-9,-14,11,-100
9,-170,-156,-1,-237,-99,-202,55,-801
-1,-35,-31,-5,-31,-58,-35,-16,-212
42,-12,23,100,-30,6,-50,94,173
49,-14,9,29,-16,-12,-17,44,72
28,-49,-29,26,-114,-9,-75,50,-172
21,11,-18,23,-13,-8,-43,7,-20
5,-60,-54,15,-83,-36,-61,55,-219
3,-1,-3,2,-12,-7,-6,9,-15
59,-81,-99,11,-155,-41,-125,76,-355
4,-63,-48,32,-82,47,-70,137,-43
-16,-38,-67,8,-56,-68,-110,27,-320
-1,-62,-52,-7,-85,-27,-39,53,-220
-15,-16,-36,-11,-64,-30,-68,-8,-248
-19,-25,-22,-1,-17,3,-25,14,-92
-16,-85,-94,4,-79,-32,-108,48,-362
36,-23,-4,51,-16,-18,-54,71,43
38,-60,-25,64,6,-27,-78,73,-9
14,-24,-19,11,-14,-27,-29,25,-63
-97,-143,-123,-62,-207,-43,-141,64,-752
10,-8,-23,6,0,-18,-17,19,-31
-46,-24,-38,-48,-87,-88,-103,3,-431
-28,-149,-146,-44,-184,-141,-196,11,-877
-16,-129,-167,43,-256,78,-155,231,-371
-1,-49,-47,7,-70,-41,-67,27,-241
18,-21,-14,6,7,-19,-1,5,-19
105,-92,-135,31,-67,-116,-89,73,-290
-7,-14,-11,0,-4,-8,-13,-1,-58
3,-16,-13,-10,-28,-23,-27,-3,-117
-17,-27,-19,-20,-35,-25,-34,-8,-185
-16,-117,-65,-9,-102,-6,-117,63,-369
-10,-75,-74,-1,-100,36,-65,76,-213
-29,-27,-26,-30,-40,-17,-67,-2,-238
-6,-16,-7,3,-8,3,-15,3,-43
3,-17,-16,0,-11,-4,-11,5,-51
-10,-16,-11,-8,-10,-11,-33,-3,-102
30,-66,-9,10,-45,13,-59,87,-39
32,-105,-136,-100,-154,-201,-230,62,-832
5,-37,-42,-19,-86,-3,-41,50,-173
-24,-54,-34,-12,-56,9,-35,13,-193
-5,-62,-55,-37,-121,-57,-100,23,-414
-5,-22,-27,-13,-32,-17,-40,1,-155
-12,-37,-28,-24,-40,-15,-16,0,-172
-14,-40,-32,18,-54,-9,-45,23,-153
-25,-26,-43,-19,-45,-3,-47,4,-204
-51,-56,-82,-51,-100,-43,-101,19,-465
-25,-50,-42,-7,-60,-13,-61,-13,-271
59,-182,-172,22,-142,-44,-287,226,-520
110,-47,12,63,-31,-76,-84,96,43
-23,-127,-117,-45,-195,-95,-226,148,-680
-41,-51,-66,-7,-71,-23,-89,7,-341
-37,-71,-53,9,-82,-34,-79,29,-318
-25,-58,-69,-15,-108,-35,-82,55,-337
-26,-61,-57,1,-66,-14,-76,30,-269
88,-188,-337,126,-318,73,-331,369,-518
46,-51,-99,13,-149,-76,-134,97,-353
-18,-35,-43,8,-49,-7,-70,17,-197
-1,-42,-63,-13,-70,-41,-86,12,-304
-24,-45,-54,-7,-81,-8,-63,28,-254
-35,-78,-65,-6,-83,-26,-83,31,-345
-49,-45,-55,-9,-69,-24,-78,10,-319
-5,-56,-73,18,-107,-22,-105,75,-275
-29,-41,-41,7,-37,-7,-36,7,-177
-10,-41,-35,39,-57,-9,-49,47,-115
-18,-35,-43,2,-70,-10,-56,27,-203
11,-31,-21,11,-32,-44,-52,48,-110
-39,-53,-71,-4,-75,-32,-100,14,-360
191,-122,-79,-6,-73,-184,-171,165,-279
-18,-32,-43,-22,-57,-42,-82,-22,-318
56,-114,-165,25,-95,-15,-153,165,-296
32,-30,-47,42,-19,-11,-43,61,-15
-8,-32,-33,-8,-18,-8,-19,22,-104
-25,-43,-44,-8,-46,-8,-56,21,-209
33,10,-10,16,-9,-26,-25,42,31
-48,-89,-110,8,-166,-30,-157,70,-522
-45,-79,-95,-48,-125,-77,-166,53,-582
-4,-85,-131,-45,-163,-147,-229,92,-712
-1,-44,-49,3,-54,-11,-60,40,-176
-24,-227,-265,-62,-206,-127,-217,163,-965
106,-55,6,81,-6,-89,-86,81,38
-25,-143,-134,-29,-168,-102,-169,6,-764
-22,-25,-42,-30,-44,-61,-69,-24,-317
-19,-27,-43,-22,-42,-42,-76,6,-265
6,-86,-168,-90,-218,-170,-206,42,-890
1,-58,-91,-20,-125,-86,-108,58,-429
50,-95,-83,28,-64,-43,-88,86,-209
-1,-36,-40,-4,-32,-37,-60,12,-198
-3,-48,-70,5,-64,-10,-64,61,-193
-42,-78,-66,-18,-87,-40,-112,16,-427
-85,-154,-188,-69,-290,-46,-223,118,-937
13,2,-6,14,-31,-5,-15,18,-10
-110,-236,-253,-181,-323,-231,-371,-34,-1739
-108,-72,-164,-90,-223,-263,-323,-52,-1295
5,-57,-61,-19,-11,-4,-38,102,-83
1,-33,-53,-7,-55,11,-71,48,-159
32,-32,-77,-24,-73,-27,-95,77,-219
8,-65,-64,20,-121,-52,-81,54,-301
-10,-44,-38,-3,-62,-11,-45,8,-205
-9,-8,-6,-3,-22,-6,-20,7,-67
-9,-36,-44,2,-63,-15,-60,16,-209
56,-132,-171,-95,-211,-171,-178,124,-778
2,-12,-9,-1,-13,-16,-29,1,-77
-31,-38,-60,4,-67,-16,-81,33,-256
-55,-144,-150,-60,-245,-137,-281,22,-1050
21,-21,-88,-38,-83,-85,-144,43,-395
2,-46,-48,20,-36,0,-79,52,-135
-6,-43,-36,-7,-43,-30,-49,16,-198
-22,-76,-93,-57,-132,-62,-120,75,-487
-67,-60,-84,-51,-105,-17,-118,49,-453
-35,-76,-65,-26,-127,-50,-103,48,-434
-41,-79,-95,-13,-127,-5,-154,61,-453
8,1,-9,-4,-42,-43,-56,28,-117
-35,-84,-84,-29,-115,-100,-155,4,-598
-51,-88,-79,-16,-133,-38,-101,24,-482
78,-69,-20,54,16,-80,-104,44,-81
-9,-18,-29,-13,-24,-7,-20,12,-108
161,-546,-897,-392,-1481,-1209,-1252,-19,-5635
-44,-51,-80,-66,-77,-76,-113,11,-496
-63,-92,-94,-34,-115,-26,-97,34,-487
-64,-98,-104,-74,-129,-31,-115,34,-581
-66,-86,-67,-64,-116,-26,-87,45,-467
-63,-92,-93,-35,-109,5,-96,52,-431
-97,-105,-103,-41,-132,-23,-115,29,-587
39,-75,-97,27,-154,-56,-106,80,-342
-26,-13,-29,-28,-28,-15,-29,1,-167
10,-17,-56,-1,-59,-58,-95,19,-257
-41,-88,-115,4,-40,11,-61,-1,-331
-33,-47,-98,-62,-103,-20,-129,60,-432
2,-10,-20,28,-38,-6,-19,47,-16
-44,-162,-227,30,-141,31,-250,192,-571
12,1,-35,67,-93,-2,-94,90,-54
73,-75,-73,-19,-75,-52,-125,144,-202
-6,-66,-48,-6,-54,4,-15,42,-149
-41,-63,-65,4,-63,-11,-58,27,-270
-9,-42,-28,24,-36,3,-58,33,-113
-6,-46,-43,-59,-19,-95,-107,28,-347
-6,-12,-5,-4,-1,-8,-15,-14,-65
10,-20,-37,2,-16,-30,-48,13,-126
-10,-15,-14,-9,-23,-10,-18,3,-96
11,-9,-15,3,-25,-31,-16,-14,-96
-9,-21,-17,-2,-10,-6,-19,11,-73
-1,-32,-26,-5,-23,-12,-29,13,-115
-22,-15,-20,-20,-40,-11,-33,7,-154
-44,-68,-96,-20,-100,-50,-120,62,-436
-27,-136,-170,-20,-228,-24,-150,138,-617
4,-41,-53,-10,-32,-53,-69,43,-211
-26,-95,-111,-21,-130,-65,-135,61,-522
-9,-34,-34,-9,-21,-6,-18,23,-108
-14,-16,-22,-12,-15,-26,-48,16,-137
-7,-26,-30,-8,-24,-18,-28,16,-125
-34,-70,-71,-17,-70,-27,-79,9,-359
-18,-11,-21,-16,-18,-13,-27,7,-117
-8,-17,-23,-10,-11,-15,-17,-3,-104
-82,-100,-195,-143,-236,-248,-333,-36,-1373
-188,-195,-226,-90,-300,-108,-304,32,-1379
-168,-148,-193,-107,-262,-204,-365,-65,-1512
-114,-182,-230,-125,-302,-192,-311,10,-1446
-14,-11,-33,-44,-8,-19,-29,17,-141
10,-5,-24,-7,-17,-26,-20,22,-67
-4,-10,-17,-15,-10,-25,-29,-8,-118
-6,-13,-13,-10,-4,-17,-19,-2,-84
6,-30,-31,-24,-19,-46,-28,2,-170
-8,-35,-39,24,-46,14,-31,46,-75
-12,-28,-30,-4,-22,-15,-52,-8,-171
-34,-19,-33,5,-42,-12,-46,-3,-184
17,-5,-28,25,-14,6,4,8,13
-40,-216,-266,171,-220,-19,-300,258,-632
-79,-121,-114,-50,-166,-39,-136,43,-662
-93,-94,-92,-10,-142,-1,-128,16,-544
-66,-82,-84,-10,-130,5,-104,36,-435
-83,-107,-103,-42,-125,-26,-130,37,-579
-74,-114,-101,-35,-129,-13,-115,47,-534
-78,-110,-98,-55,-125,-25,-117,45,-563
-69,-112,-105,-51,-115,-22,-104,54,-524
-76,-112,-100,-41,-125,-14,-132,45,-555
-92,-114,-104,-77,-137,-33,-119,45,-631
-82,-106,-98,-57,-132,-33,-128,41,-595
-102,-100,-104,-56,-130,-20,-128,33,-607
-94,-105,-96,-61,-138,-22,-130,25,-621
-68,-98,-112,-65,-121,-26,-109,35,-564
-4,-7,-16,5,-11,-12,-26,1,-70
5,-11,-19,-2,-30,-14,-38,7,-102
6,-11,-19,0,-27,-15,-42,6,-102
5,-15,-13,12,-11,-6,-19,-2,-49
-21,-43,-33,-21,-33,-13,-53,8,-209
-21,-13,-29,4,-67,-9,-57,13,-179
19,-76,-110,-11,-68,-25,-48,103,-216
-10,-59,-120,-102,-137,-88,-145,53,-608
-26,-20,-66,-31,-147,-77,-163,73,-457
-13,-21,-19,-3,-24,-2,-23,2,-103
-20,-75,-92,13,-70,-22,-115,96,-285
-32,-27,-36,-5,-41,13,-43,22,-149
-53,-76,-80,-44,-120,-29,-90,30,-462
-124,-205,-215,-41,-150,-146,-218,38,-1061
-16,-6,-22,-19,-1,-36,-43,-6,-149
-12,-35,-44,-4,-28,-4,-27,30,-124
-10,-53,-75,-11,-45,-4,-44,57,-185
-29,-42,-31,-32,-52,0,-52,18,-220
-4,-13,-18,-7,-11,3,-6,12,-44
2,21,1,35,-11,-10,3,23,64
-14,-56,-65,-44,-44,-35,-44,35,-267
-28,-69,-113,-2,-59,-12,-82,71,-294
-21,-9,-11,2,-11,-5,-25,-1,-81
-27,-42,-59,2,-86,-29,-67,18,-290
-19,-20,-16,-7,-27,-1,-14,11,-93
-38,-35,-43,-25,-40,-6,-43,8,-222
33,-31,-28,6,-58,-11,-60,36,-113
-24,-66,-71,19,-80,-20,-69,35,-276
-34,-98,-56,2,-120,-49,-105,-7,-467
5,-7,-17,-4,-17,-17,-30,20,-67
-7,-18,-23,-5,-24,-27,-41,12,-133
-26,-37,-41,-21,-35,-5,-32,20,-177
-24,-41,-48,-26,-33,-19,-31,11,-211
-41,-84,-126,-5,-80,-31,-97,77,-387
-29,-55,-117,11,-67,-12,-90,75,-284
-35,-70,-102,-20,-54,-22,-79,60,-322
-39,-84,-120,-6,-76,-20,-97,67,-375
-31,-82,-160,1,-99,-19,-127,102,-415
-41,-99,-173,-13,-111,-12,-133,119,-463
-34,-96,-158,-3,-97,-17,-116,100,-421
-34,-76,-111,-10,-74,-21,-93,71,-348
-32,-88,-126,0,-64,-6,-96,91,-321
-34,-85,-145,-3,-83,-13,-108,95,-376
-40,-58,-109,-27,-68,-20,-96,66,-352
-7,-7,-15,5,-19,6,-17,33,-21
-4,-77,-64,25,-72,10,-57,49,-190
-29,-134,-109,-14,-119,-23,-175,85,-518
-24,-71,-102,9,-76,0,-121,51,-334
-26,-85,-72,5,-94,-29,-111,49,-363
-5,-48,-18,1,-88,4,-65,32,-187
-6,-25,-24,-17,-34,-2,-3,11,-100
-50,-35,-34,-25,-36,-8,-54,-2,-244
-13,8,-1,10,-13,-2,-3,14,0
6,-28,-16,12,-13,-8,-31,19,-59
-12,-23,-18,-15,-21,-20,-35,10,-134
-8,-102,-96,14,-71,-23,-137,56,-367
2,-11,-24,5,-26,-14,-11,0,-79
4,5,-18,-27,-50,-38,-30,5,-149
-5,-48,-50,2,-95,-9,-63,33,-235
-4,-46,-39,-20,-40,-23,-25,6,-191
4,-23,-42,-5,-55,-59,-54,32,-202
-47,-49,-24,2,-125,-23,-54,37,-283
20,-104,-107,-7,-102,-63,-125,101,-387
-20,-23,-23,-29,-32,6,-18,3,-136
-20,12,-3,31,-26,-19,-36,-7,-68
3,-50,-39,-17,-121,-23,-69,26,-290
-66,-110,-98,-29,-131,-46,-107,51,-536
20,12,11,23,-1,-7,1,9,68
-7,-49,-48,1,-71,-3,-32,20,-189
-8,-2,-9,5,-14,-14,-14,-3,-59
-5,-50,-46,-29,-36,-10,-28,19,-185
-15,-43,-44,-23,-35,-8,-43,-9,-220
-16,-20,-18,-11,-32,-1,-33,12,-119
-2,-30,-24,1,-22,-12,-37,-2,-128
-30,-22,-28,13,-54,0,-43,6,-158
-10,-28,-32,-1,-50,3,-27,28,-117
14,-33,-34,30,-98,-47,-81,19,-230
-20,-22,-28,9,-50,-12,-52,18,-157
-18,-6,-18,26,-49,-7,-37,5,-104
11,-38,-32,22,-42,-36,-42,18,-139
-9,-20,-17,-6,-13,-10,-15,6,-84
-30,-17,-21,10,-39,10,-33,3,-117
-53,-95,-93,-18,-150,-15,-111,62,-473
-3,-39,0,5,-20,-1,-38,17,-79
-20,-23,-23,4,-16,5,-40,18,-95
9,-41,-21,-8,-29,-17,-42,13,-136
-9,-31,-16,-7,-25,-13,-44,-4,-149
-7,-14,-26,27,-43,-19,-43,6,-119
94,-50,-53,74,-20,-76,-150,237,56
-35,-64,-64,-16,-114,-12,-87,39,-353
-35,-46,-64,-38,-104,-14,-66,-1,-368
-12,-54,-55,-18,-110,-14,-90,19,-334
-17,-29,-28,-9,-28,-7,-17,8,-127
-58,-54,-54,4,-91,-54,-98,-39,-444
-25,-15,-25,-6,-42,3,-45,-13,-168
-3,7,5,-1,-19,-7,-14,10,-22
-67,-95,-101,-32,-146,-40,-111,47,-545
-13,-20,-20,12,-41,-18,-16,24,-92
-5,-28,-25,10,-40,-7,-36,23,-108
0,-29,-17,7,-30,-10,-30,-4,-113
18,-18,-17,31,-35,-29,-38,4,-84
-8,-32,-47,-7,-43,-27,-3,-4,-171
-21,-26,-24,-33,-28,1,-14,21,-124
-23,-40,-41,-22,-84,-22,-72,3,-301
-2,-22,-20,9,-20,-25,-36,-7,-123
-36,-49,-36,-42,-67,-7,-62,6,-293
14,-24,-28,5,-24,-38,-46,-1,-142
-35,-48,-38,-33,-42,-29,-41,24,-242
-25,-23,-31,-7,-39,-7,-22,6,-148
4,-15,-53,-5,-38,-15,-37,69,-90
2,-36,-32,-9,-20,-20,-13,25,-103
-8,-20,-29,-25,-43,-10,-19,29,-125
9,-55,-53,-11,-73,-57,-64,37,-267
-25,-70,-53,5,-100,-39,-109,3,-388
4,-24,-18,5,-30,-6,-20,6,-83
-12,-24,-18,-2,-9,3,-12,18,-56
-35,-109,-123,-29,-118,-42,-155,69,-542
-25,-125,-113,-43,-139,-31,-124,89,-511
-19,-91,-105,-42,-137,-23,-103,70,-450
-24,-96,-105,-40,-137,-21,-103,74,-452
-3,-27,-35,0,-35,-33,-49,13,-169
-27,-134,-113,-38,-130,-18,-122,74,-508
-6,-19,-20,-10,-5,-15,-14,1,-88
-7,-20,-20,-6,-4,-13,-12,0,-82
-7,-20,-20,-6,-4,-13,-12,0,-82
-9,-20,-18,-5,-4,-11,-12,0,-79
-7,-18,-22,-5,-7,-15,-16,0,-90
-10,-21,-22,-11,-7,-11,-14,-4,-100
-7,-16,-14,3,-4,-10,-16,1,-63
-7,-20,-20,-6,-4,-13,-12,0,-82
-6,-8,-18,-14,-8,-13,-12,13,-66
-6,-8,-17,-14,-8,-15,-13,11,-70
-6,-4,-16,-14,-5,-16,-7,8,-60
-4,-9,-18,-13,-9,-16,-16,10,-75
-4,-26,-29,-4,-42,-27,-24,11,-145
6,-53,-46,-9,-45,-14,-32,40,-153
-15,-38,-40,-7,-50,-20,-43,3,-210
-24,-29,-30,10,-38,-19,-32,-5,-167
12,-2,-18,-11,-23,-2,-16,22,-38
-89,-58,-97,-23,-149,-21,-140,59,-518
7,-26,-11,8,-30,-19,-34,5,-100
-26,-70,-90,2,-67,-3,-87,14,-327
-13,-19,-32,-4,-26,-40,-26,-19,-179
-52,-113,-96,-24,-150,-69,-142,18,-628
3,-31,-27,-7,-35,1,-27,14,-109
-25,-33,-29,0,-45,-13,-43,18,-170
-40,-104,-81,-24,-90,-32,-126,28,-469
10,-20,-33,7,-19,-2,-23,52,-28
-7,-28,-39,-11,-47,-24,-44,8,-192
11,1,-7,20,-8,-4,-9,7,11
-21,-14,-28,-8,-8,-9,-17,20,-85
-7,0,-9,-14,-2,1,-15,-14,-60
3,3,1,6,-10,-7,1,12,9
-3,-23,-19,-7,-25,-1,-17,18,-77
-14,-54,-40,10,-83,-20,-59,23,-237
34,-58,-69,20,-81,7,-40,41,-146
-24,-30,-22,-14,-38,-28,-55,6,-205
-11,-28,-30,13,-35,-21,-42,11,-143
1,-13,-10,15,-30,-12,-9,7,-51
39,-2,25,45,-38,-10,-73,60,46
0,-35,-31,8,-59,-38,-63,0,-218
-42,-52,-67,-12,-73,-22,-88,19,-337
-25,-32,-27,-5,-47,-19,-26,-9,-190
-7,-16,-11,9,-11,-26,-18,-6,-86
-38,-42,-40,26,-88,11,-72,31,-212
-15,-28,-34,-35,-44,-19,-40,31,-184
-23,-44,-33,2,-63,-26,-74,3,-258
-32,-54,-35,-9,-65,-27,-59,4,-277
2,-33,-26,17,-35,-12,-24,-3,-114
-33,-26,-58,-52,-94,-61,-55,13,-366
-34,-22,-37,-43,-97,-35,-77,-6,-351
-45,-32,-41,-32,-26,-8,-48,14,-218
-25,-12,-17,-8,-36,-1,-24,8,-115
-7,-29,-23,-24,-39,-17,-42,16,-165
-5,-20,-16,-9,-26,-6,-27,19,-90
11,-30,-23,14,-26,-4,-35,16,-77
-6,-34,-22,23,-67,-34,-73,6,-207
-2,4,-25,-18,-25,-19,-10,13,-82
4,-8,-21,-10,-23,-17,-17,23,-69
-24,-10,-34,-38,-44,-25,-28,-8,-211
-15,-8,-12,-2,-16,-10,-12,5,-70
-20,-31,-44,-31,-39,-25,-49,-2,-241
-24,-35,-27,-17,-30,12,-19,20,-120
-22,-8,-8,-2,-23,-1,-17,21,-60
-4,7,-13,0,-8,1,-17,4,-30
-3,4,-8,-3,-12,-4,-8,12,-22
-5,-4,-6,-9,-33,5,-17,9,-60
-9,-6,-10,7,-17,1,-9,9,-34
-10,7,-19,-20,-21,-14,-1,22,-56
-17,-7,-30,-24,-15,1,-16,19,-89
-4,5,-2,1,-21,5,-14,17,-13
-23,-32,-32,2,-33,-22,-39,17,-162
6,-2,3,3,9,2,1,-9,13
-25,-20,-24,-11,-33,4,-35,-4,-148
-39,-57,-44,-49,-108,-61,-92,-19,-469
-9,-40,-39,-25,-59,5,-49,31,-185
-23,-63,-52,-61,-42,-57,-45,-1,-344
-9,-18,-22,-7,-48,20,-21,42,-63
-11,-31,-32,10,-63,-6,-47,18,-162
-11,-32,-51,-9,-102,-14,-72,28,-263
4,-17,-34,-5,-40,-14,-39,19,-126
-6,-67,-60,14,-81,-55,-114,35,-334
-13,5,-14,33,-21,-20,-22,6,-46
32,-57,-69,0,-32,-52,-77,83,-172
34,-57,-70,-9,-37,-59,-79,71,-206
16,-60,-79,-11,-43,-50,-81,64,-244
-6,-14,-25,-12,-37,-2,-21,13,-104
-26,-35,-33,-32,-65,19,-22,20,-174
-7,-47,-16,8,-60,-30,-52,26,-178
-4,-46,-39,11,-90,-2,-72,31,-211
6,-34,-29,-16,-57,-26,-30,1,-185
-2,-49,-30,-25,-17,-23,-30,9,-167
-32,-33,-62,-63,-42,-29,-66,12,-315
-9,-22,-20,15,-39,-18,-30,-5,-128
-14,2,-17,-19,-26,-19,-17,4,-106
-7,-31,-34,-7,-20,-7,-20,22,-104
-11,-27,-32,25,-45,-9,-28,14,-113
-1,-47,-25,-2,-42,-3,-20,32,-108
-2,4,-26,-1,-30,-10,-12,37,-40
-20,-30,-21,1,-38,-21,-16,15,-130
-6,-37,2,4,-19,0,-42,13,-85
-27,-21,-15,-20,-24,-7,-31,21,-124
-18,-29,-21,-16,-13,0,-17,11,-103
-3,-10,-25,-13,-18,-28,-22,-2,-121
-9,-42,-35,-26,-29,-19,-28,22,-166
-5,-2,-9,-13,-19,-2,-12,13,-49
-2,0,-18,-8,0,-4,7,19,-6
11,-36,-26,56,-98,-15,-35,50,-93
-12,-10,-8,-8,-18,-10,-22,-9,-97
4,-24,-17,5,-26,-15,-16,10,-79
2,-33,-16,44,-106,-21,-38,49,-119
-18,-18,-15,5,-21,-8,-24,4,-95
-18,-14,-9,-12,-6,-2,-11,6,-66
-12,-23,-27,-14,-29,-2,-22,14,-115
-11,-48,-49,-35,-48,-29,-52,12,-260
-20,-37,-25,-22,-27,-4,-18,28,-125
-19,-5,-21,-10,-43,5,-40,6,-127
-8,-30,-34,-25,-49,-11,-26,45,-138
9,-5,-9,18,-20,13,-14,23,15
2,-6,-7,-5,-16,-6,-10,16,-32
-11,-6,-2,-6,-3,-4,-10,6,-36
-24,-31,-30,-20,-34,-22,-37,2,-196
-21,-61,-81,-7,-83,-16,-78,48,-299
-26,-26,-35,-25,-21,-12,-26,1,-170
-24,-18,-22,-21,-24,-12,-23,-5,-149
21,-26,-15,17,-37,-5,-16,16,-45
-25,-15,-25,20,-49,-14,-76,100,-84
-14,-48,-42,-24,-35,-13,-29,7,-198
-13,-140,-144,-55,-219,-87,-204,49,-813
5,-21,-21,-6,-27,-18,-42,12,-118
-27,-62,-35,0,-92,-36,-59,-1,-312
-23,-50,-64,18,-87,-20,-74,-25,-325
-5,-10,-6,12,-34,-5,-11,18,-41
0,-24,-34,19,-55,-42,-64,-13,-213
6,-1,-11,-1,-9,-2,-8,15,-11
1,-4,-13,-1,-15,-7,-15,9,-45
6,-1,-13,-5,-13,-6,-7,21,-18
-2,-7,-10,3,-8,-5,-10,16,-23
5,-1,-17,-5,-17,-6,-13,8,-46
8,-2,-9,2,-7,-4,-5,16,-1
7,-3,-11,1,-9,-6,-6,14,-13
28,-58,-71,-15,-42,-50,-79,83,-204
2,-6,-9,2,-9,-5,-11,14,-22
12,-114,-115,-40,-91,-78,-159,137,-448
2,-2,-10,3,-8,-5,-10,13,-17
35,-60,-73,-10,-43,-54,-77,70,-212
5,-1,-9,1,-9,-6,-6,16,-9
-40,-196,-171,-45,-191,-50,-163,27,-829
-38,-197,-169,-50,-200,-54,-152,32,-828
-78,-279,-254,-96,-304,-51,-252,96,-1218
-43,-199,-172,-52,-198,-50,-159,20,-853
35,-64,-69,-8,-34,-54,-83,78,-199
1,-18,-19,11,-13,6,-27,32,-27
-35,-84,-52,14,-100,19,-63,50,-251
-6,-2,-23,-18,-11,-43,-48,33,-118
2,-1,-10,3,-10,-3,-13,-4,-36
-3,-13,-13,-2,-14,-1,-15,-2,-63
15,-12,-22,13,-20,0,-20,26,-20
-13,-14,-19,-27,-11,-8,-21,3,-110
-2,-16,-13,-1,-18,-8,-22,8,-72
-10,-10,-11,-13,-9,-5,-9,-11,-78
-7,-22,-16,1,-8,-2,-17,0,-71
11,-11,-17,7,-16,-13,-10,19,-30
6,-6,-8,8,-26,-5,-5,18,-18
0,1,-17,9,-24,2,-22,22,-29
-6,-32,-49,8,-87,-2,-22,31,-159
-25,-85,-77,-7,-135,-8,-80,77,-340
-10,-48,-49,0,-89,-1,-66,29,-234
-5,-49,-40,7,-91,-2,-72,28,-224
-1,-22,-12,10,-30,-8,-8,21,-50
-3,-26,-16,-3,-2,-1,-21,12,-60
2,-5,1,3,4,3,-1,-9,-2
-7,7,0,30,-33,-19,-13,2,-33
-9,-50,-18,5,-62,-26,-58,24,-194
48,5,18,48,50,11,-22,87,245
-34,-26,-31,-20,-59,-4,-44,25,-193
-15,-22,-19,17,-31,-26,-34,18,-112
-7,14,-13,-21,-24,-39,-104,-51,-245
-4,-47,-41,7,-94,-5,-69,30,-223
-4,-31,-18,-4,-2,-7,-18,-6,-90
28,-43,-64,-26,-82,6,-33,61,-153
-2,6,-5,2,-9,2,-9,20,5
-1,-49,-40,8,-92,-5,-66,29,-216
17,-64,-46,29,-104,-6,-64,48,-190
7,-67,-49,30,-106,-9,-68,49,-213
20,-50,-21,41,-71,2,-48,66,-61
-13,-102,-40,2,-88,-36,-72,31,-318
-17,-24,-25,-17,-48,-18,-34,-2,-185
-21,-30,-21,-16,-39,-26,-42,2,-193
11,-16,-33,3,-32,2,-42,36,-71
22,-32,-39,-13,-34,-37,-23,5,-151
-2,0,-2,-4,-4,-4,-3,2,-17
8,-134,-212,-6,-259,42,-165,253,-473
11,-31,-35,-7,-38,-24,-27,3,-148
10,-29,-35,-7,-37,-23,-25,4,-142
27,-49,-36,-3,-39,-39,-31,3,-167
-15,-47,-74,3,-60,-15,-83,66,-225
50,-140,-193,15,-92,-105,-268,179,-554
49,-127,-99,-2,-33,-57,-123,150,-242
-91,-81,-152,-98,-131,-146,-214,-33,-946
-5,-18,-36,-31,-51,-3,-32,42,-134
-32,-36,-41,-7,-58,-59,-91,-19,-343
40,-94,-104,7,-92,-44,-48,92,-243
34,-107,-123,-23,-119,-120,-156,134,-480
-68,-138,-104,-73,-139,-80,-163,13,-752
-2,-31,-19,-13,-65,-14,-54,28,-170
76,-34,3,98,-56,-65,-111,69,-20
-43,-76,-103,-14,-127,-65,-125,47,-506
-62,-128,-124,-14,-127,36,-126,96,-449
37,-29,4,70,-8,-19,-65,82,72
-71,-90,-93,-40,-121,-99,-214,-5,-733
-52,-55,-64,-74,-72,-36,-81,7,-427
-16,-76,-73,-43,-93,-28,-76,24,-381
7,-156,-183,-93,-157,8,-122,142,-554
-30,-91,-72,11,-113,-49,-101,38,-407
15,-77,-84,7,-197,-34,-146,90,-426
3,-90,-80,-22,-90,-17,-70,65,-301
29,-264,-108,127,-280,-62,-238,264,-532
7,19,5,36,-22,-42,-42,19,-20
7,-60,-91,-14,-124,-86,-156,66,-458
-205,-369,-364,-130,-577,-187,-573,235,-2170
183,-69,-145,61,-75,-149,-138,196,-136
40,-40,-48,35,-56,-73,-104,43,-203
-41,-72,-53,-9,-72,-33,-73,-1,-354
-3,-35,-48,29,-56,24,-42,35,-96
13,-46,-91,-21,-159,-94,-149,-16,-563
-10,-44,-41,12,-45,-34,-77,2,-237
5,-63,-105,-13,-121,-94,-140,79,-452
-26,-63,-97,-21,-119,-39,-101,41,-425
-63,-74,-87,-23,-103,-23,-105,41,-437
-32,-25,-64,-20,-135,-43,-160,-8,-487
-18,-30,-72,-1,-141,-66,-181,32,-477
-70,-110,-106,-87,-164,-118,-177,10,-822
-4,-81,-79,-26,-120,-81,-113,13,-491
41,-61,-18,51,-55,10,-27,55,-4
-5,-38,-62,9,-78,-29,-78,37,-244
103,-69,-1,88,18,-63,-119,72,29
10,-58,-86,5,-33,-76,-133,57,-314
75,-60,-72,60,-41,-100,-136,36,-238
118,-48,-25,73,-16,-98,-115,53,-58
74,-38,-65,33,-19,-109,-150,51,-223
-25,-32,-44,-19,-40,-26,-54,-10,-250
47,-36,-73,-4,-35,-27,-83,56,-155
127,-30,-127,19,-38,-114,-140,139,-164
67,-31,-61,68,-28,-58,-120,68,-95
6,-55,-76,205,-49,39,-210,111,-29
-38,-76,-103,-53,-113,-25,-103,40,-471
-27,-448,-328,349,-672,29,-566,656,-1007
-12,-161,-224,-80,-193,-153,-348,211,-960
-399,-764,-809,-310,-1069,-610,-1202,31,-5132
14,-133,-125,31,-139,-25,-111,107,-381
-7,-20,-26,-1,-38,-46,-43,-2,-183
-44,-73,-63,-15,-68,-39,-87,49,-340
11,-42,-51,-11,-106,-25,-77,66,-235
-14,-21,-40,-15,-40,-29,-45,18,-186
19,-24,-23,46,-51,-54,-84,29,-142
-6,-38,-50,-37,-76,-82,-82,26,-345
-23,-68,-70,-8,-70,2,-85,45,-277
-20,-35,-26,-18,-25,-14,-27,4,-161
321,-239,-420,-238,-118,-360,-580,178,-1456
-18,-20,-31,-20,-43,-41,-58,-5,-236
-29,-171,-131,-7,-155,-43,-152,17,-671
65,-86,-86,17,-122,-39,-148,125,-274
-4,-39,-55,-25,-64,-14,-47,51,-197
8,-9,3,2,20,-23,-44,37,-6
-14,-18,-13,-8,-20,-4,-12,3,-86
-16,-29,-23,-4,-12,-7,-12,-3,-106
8,-95,-106,62,-199,-24,-163,157,-360
-10,-22,-40,-32,-27,-29,-29,13,-176
-7,-27,-42,2,-36,-3,-44,32,-125
-19,-111,-180,-89,-137,-100,-306,158,-784
-23,-26,-48,-59,-62,-36,-49,39,-264
-16,-10,-28,-1,-11,-22,-22,-8,-118
-21,-13,-26,-2,-15,-20,-19,-8,-124
-77,-61,-42,-63,-58,-93,-91,-78,-563
-46,-55,-90,-73,-117,-86,-143,3,-607
-4,-28,-50,-4,-38,-24,-64,35,-177
-37,-78,-37,2,-120,-30,-102,48,-354
-4,-17,-16,-9,-16,-9,-21,-9,-101
97,-1,-45,44,37,-31,-31,2,72
10,-8,-24,14,-30,2,-18,44,-10
43,-137,-144,39,-173,-77,-164,96,-517
-17,-7,-16,-6,-20,-11,-22,2,-97
21,-37,-102,59,-137,-67,-171,10,-424
-14,-5,-13,-15,-14,-13,-29,12,-91
-5,-120,-172,-104,-145,-118,-215,150,-729
-26,-13,-15,-18,-20,-11,-22,7,-118
24,-6,-12,6,-13,-31,-24,8,-48
74,6,22,98,23,-29,-55,95,234
-44,-40,-203,-86,-163,-63,-301,14,-886
-89,-109,-120,-44,-160,1,-157,75,-603
-19,-79,-155,172,-183,84,-239,196,-223
-23,-74,-67,-23,-86,-37,-72,5,-377
-29,-17,-30,-23,-19,1,-29,11,-135
-9,-40,-45,-21,-44,-18,-41,4,-214
-12,-59,-78,-56,-36,-36,-68,24,-321
-40,-37,-65,-43,-69,-73,-96,39,-384
-1,-14,-21,-8,-20,-15,-12,24,-67
16,-16,-31,7,-35,-18,-27,22,-82
-37,-67,-45,-62,-55,-66,-74,-8,-414
-24,-22,-13,-10,-21,-4,-35,-2,-131
-21,-43,-33,-28,-40,-43,-54,-8,-270
-9,-23,-19,-11,-30,-14,-30,-4,-140
-48,-77,-58,-41,-90,-52,-88,-5,-459
12,92,-36,0,59,16,-12,-22,109
-5,-3,-32,-29,-20,-18,-40,-8,-155
-7,-17,-26,-19,-31,-14,-21,6,-129
-9,-213,-256,-1,-196,-77,-265,198,-819
12,-41,-67,-30,-98,-39,-97,78,-282
2,-38,-65,-34,-104,-40,-100,80,-299
-14,-66,-91,3,-61,-39,-125,56,-337
14,-26,-53,-16,-54,-53,-84,80,-192
0,-144,-139,-13,-199,-162,-229,-27,-913
-3,-37,-43,-15,-14,-32,-28,16,-156
-8,8,-27,-3,-23,-21,-35,5,-104
-12,-25,-18,5,-35,-1,-16,23,-79
-16,-14,-27,-23,-7,-16,-17,19,-101
6,2,-25,-5,-12,-16,-27,0,-77
-9,-71,-62,-17,-60,-36,-78,50,-283
-25,-25,-29,17,-41,-9,-30,-7,-149
-20,-7,-26,-2,-45,3,-45,-5,-147
-19,-17,-31,-16,-49,-7,-32,7,-164
-9,-20,-17,4,-16,-12,-14,-3,-87
-9,-50,-42,-8,-36,-31,-29,5,-200
-57,-37,-34,-49,-41,-24,-59,-21,-322
1,6,-4,7,11,-7,2,-5,11
-21,-19,-27,-30,-29,-12,-50,37,-151
44,4,-27,7,14,-39,-56,17,-36
-23,-26,-19,-15,-36,-18,-39,2,-174
4,-3,-1,5,-6,-3,-3,2,-5
144,-16,-14,127,-51,-153,-246,123,-86
-5,-115,-115,-107,-48,-129,-214,136,-597
104,-113,-142,32,-121,-108,-196,193,-351
-67,-96,-118,-65,-124,-57,-132,24,-635
8,-31,-73,-22,-87,-55,-84,50,-294
-13,-38,-41,-30,-55,-19,-35,20,-211
15,-19,-17,16,0,-11,-38,15,-39
-24,-167,-172,1,-257,-81,-189,146,-743
42,0,-16,-12,1,-38,-40,45,-18
42,0,-16,-12,1,-38,-40,45,-18
42,0,-16,-12,1,-38,-40,45,-18
42,0,-16,-12,1,-38,-40,45,-18
42,0,-16,-12,1,-38,-40,45,-18
-71,-81,-83,-8,-100,-18,-102,21,-442
-71,-81,-83,-8,-100,-18,-102,21,-442
31,-60,-68,8,-45,-56,-87,75,-202
12,-33,-23,40,-53,-13,-45,41,-74
20,-108,-98,108,-166,46,-164,187,-175
72,-65,-68,2,-103,-145,-138,64,-381
159,-60,-44,105,3,-9,-77,179,256
291,-1179,-1525,644,-331,948,-490,1561,-81
37,-114,-149,84,-139,-146,-214,123,-518
31,-82,-63,12,-89,-81,-101,88,-285
4,-62,-92,76,-155,-21,-141,94,-297
226,-376,-544,16,-765,-370,-768,940,-1641
365,-728,-860,-134,-1165,-602,-1127,878,-3373
114,-480,-424,480,-755,-18,-661,617,-1127
81,-96,-117,32,-100,-101,-170,120,-351
82,-95,-108,40,-95,-98,-169,127,-316
-26,-86,-57,23,-90,-1,-86,24,-299
9,-89,-172,-95,-208,-183,-260,66,-932
-7,-30,-52,-16,-63,-12,-74,34,-220
-1,-37,-45,-6,-57,-9,-50,42,-163
-21,-121,-158,-118,-133,-152,-266,106,-863
47,-30,-45,104,-56,-94,-173,88,-159
20,-49,-90,2,-45,-46,-142,110,-240
36,26,31,60,-4,5,-2,33,185
-38,-53,-83,-51,-40,-41,-62,43,-325
-81,-130,-97,-58,-155,-74,-146,13,-728
-32,-131,-149,-74,-260,-16,-158,129,-691
-131,-207,-231,-60,-334,-43,-311,124,-1193
-82,-227,-218,-11,-336,-66,-274,128,-1086
-5,-2,-7,4,9,9,-3,0,5
-44,-95,-64,10,-116,20,-70,48,-311
-7,-66,-73,-3,-70,-31,-70,42,-278
37,-52,-17,8,-5,-64,-78,64,-107
-50,-51,-64,-29,-48,-35,-77,-15,-369
-15,-52,-48,-12,-34,-31,-42,-13,-247
27,-46,-32,-4,-109,-43,-56,42,-221
-12,-78,-85,2,-77,-47,-105,39,-363
-67,-118,-208,-154,-304,-62,-234,72,-1075
1,-49,-37,14,-86,-25,-63,28,-217
11,-44,-11,31,-1,-18,-51,20,-63
-40,-65,-48,-38,-74,-28,-80,-9,-382
-62,-83,-61,-54,-88,-50,-60,-25,-483
-21,-72,-61,-31,-91,-58,-74,14,-394
-23,-61,-37,-21,-61,-51,-61,-8,-323
-56,-55,-69,-35,-113,-51,-125,-3,-507
-47,-48,-73,-19,-101,-26,-121,55,-380
9,15,-18,36,-38,-8,-59,28,-35
73,-37,-22,58,-21,-32,-108,101,12
-69,-103,-89,-62,-168,-124,-197,-39,-851
-21,-32,-46,-27,-45,-24,-44,22,-217
-81,-342,-252,-21,-462,-210,-433,23,-1778
60,-65,-83,-7,-103,-86,-128,82,-330
24,-61,-116,-7,-137,-165,-198,80,-580
3,-26,-45,-15,-19,8,-25,21,-98
-69,-151,-189,-48,-169,-122,-260,25,-983
-21,-42,-45,-1,-52,-23,-58,2,-240
-6,-51,-53,-29,-77,-22,-69,34,-273
91,40,-10,115,28,-30,-62,117,289
1,-193,-172,-32,-182,7,-140,124,-587
-59,-85,-79,-14,-78,21,-98,51,-341
-50,-86,-80,7,-73,21,-101,65,-297
-64,-97,-62,2,-61,29,-98,54,-297
-110,-211,-195,-69,-257,-94,-260,4,-1192
-8,-111,-101,-53,-150,-79,-130,94,-538
-152,-369,-393,-70,-563,-219,-628,327,-2067
16,-31,-59,5,-57,-44,-81,71,-180
11,-8,-103,-9,-85,-15,-82,93,-198
-11,18,12,6,-10,-6,-18,-5,-14
53,-53,-86,-53,-135,-138,-142,15,-539
-4,-2,-8,-2,-9,-15,-16,11,-45
-33,-108,-96,-43,-163,-60,-109,20,-592
-21,-8,-20,7,-53,0,-51,26,-120
-119,-275,-341,-110,-578,-429,-655,-233,-2740
51,-34,-29,57,-12,20,-15,73,111
11,-37,-66,-14,-90,-80,-121,54,-343
62,-98,-67,-6,-43,-140,-156,46,-402
3,3,-25,18,-19,-16,-51,34,-53
-20,-60,-91,-18,-89,-70,-146,65,-429
-337,-354,-385,-115,-508,-60,-472,152,-2079
-29,0,-46,-21,-53,-26,-54,97,-132
-15,-42,-38,-26,-23,-23,-45,14,-198
99,-79,-71,19,-77,-33,-114,176,-80
47,-97,-25,19,-49,-27,-108,122,-118
20,-57,-65,-23,-91,-80,-135,93,-338
-34,-94,-88,-18,-113,-10,-100,48,-409
-29,-37,-53,-6,-81,-6,-87,42,-257
-17,-79,-72,-16,-102,-46,-108,18,-422
-34,-194,-129,-6,-145,-94,-197,24,-775
-71,-160,-157,-68,-230,-152,-228,46,-1020
0,-15,-19,22,-35,-21,-25,2,-91
-28,-35,-44,-16,-64,-3,-58,31,-217
29,-81,-23,43,-53,-26,-65,34,-142
-9,-15,-31,-10,-19,-5,-12,-15,-116
228,-281,-752,-192,-596,-230,-530,456,-1897
40,-77,-82,-23,-81,-20,-103,54,-292
-4,-2,-21,5,-25,-14,-32,10,-83
7,-17,-23,12,-30,-17,-28,13,-83
10,-47,-45,-3,-70,-36,-75,27,-239
39,3,-133,37,-50,-61,-266,160,-271
58,-100,-32,63,-26,-21,-68,69,-57
48,91,21,188,-109,16,-146,90,199
41,-55,-69,76,-101,-40,-80,52,-176
-8,-41,-30,-10,-45,-3,-38,27,-148
-16,-33,-28,-4,-45,-5,-33,31,-133
-33,-99,-102,19,-125,-19,-113,64,-408
-64,-118,-136,-51,-163,-39,-166,60,-677
3,1,-25,4,-39,-34,-54,17,-127
-29,-20,-68,-59,-62,-55,-85,16,-362
-158,-340,-362,-49,-483,-111,-535,324,-1714
-93,-74,-77,-48,-122,16,-102,43,-457
-51,-79,-106,-49,-144,-58,-143,27,-603
-33,-126,-75,-8,-117,2,-104,77,-384
1,-154,-145,-27,-144,-122,-168,41,-718
111,-129,-162,13,-92,-91,-168,202,-316
-2,-71,-65,44,-193,-53,-142,79,-403
-16,-127,-199,-54,-269,-35,-234,118,-816
10,-69,-132,-29,-88,-108,-136,58,-494
-25,-113,-167,-81,-127,-83,-178,97,-677
210,105,137,274,127,19,-7,193,1058
-11,-60,-83,-52,-70,-91,-117,-18,-502
60,-20,-63,51,-68,-67,-122,38,-191
4,-18,-44,-9,-32,-44,-80,47,-176
32,-53,-48,7,-27,-59,-75,40,-183
5,-121,-186,-38,-168,-43,-171,157,-565
472,342,426,204,247,-89,-210,489,1881
-39,-132,-129,4,-203,-40,-181,103,-617
-105,-120,-127,-41,-189,-50,-201,59,-774
-67,-135,-180,-46,-200,-168,-282,60,-1018
-2,-105,-142,52,-130,-6,-193,184,-342
38,-128,-80,43,-136,-61,-183,166,-341
-1,2,-14,7,-9,-29,-18,7,-55
-61,-35,-92,-94,-105,-87,-186,-20,-680
8,-11,-12,26,-30,-21,-19,0,-59
79,-27,-32,32,12,-10,-61,125,118
6,-53,-41,-16,-6,-67,-122,66,-233
-3,-70,-57,-12,-107,-27,-88,49,-315
72,-78,-98,6,-58,-12,-42,161,-49
-39,-57,-78,24,-127,-36,-107,71,-349
-37,-98,-147,-58,-157,-46,-157,65,-635
4,-29,-42,-32,-101,-62,-99,25,-336
-95,-53,-99,-43,-160,-20,-135,43,-562
-18,-85,-93,-25,-142,-82,-114,61,-498
-24,-90,-105,-5,-152,-61,-145,68,-514
-19,-205,-142,-45,-238,-87,-182,81,-837
-3,-23,-16,-7,-15,-20,-31,1,-114
-21,-24,-43,-4,-35,-1,-55,0,-183
-516,-197,-375,-511,-361,-259,-769,-372,-3360
-54,-126,-120,-47,-148,-21,-142,87,-571
74,-154,-108,34,-180,-26,-174,188,-346
34,-62,-63,27,-80,-12,-66,59,-163
32,-63,-126,-13,-81,45,-121,132,-195
-40,-101,-97,-30,-113,-102,-139,-3,-625
-8,-10,-21,-4,-14,-6,-25,10,-78
-22,-54,-75,-10,-91,-19,-91,25,-337
-14,-20,-29,-8,-41,-7,-25,17,-127
61,33,-61,69,-27,-20,-18,92,129
-66,-113,-134,19,-92,-67,-90,41,-502
658,387,266,118,25,-209,-421,726,1550
53,-33,-80,47,-164,-89,-184,98,-352
29,-25,-77,98,-194,123,-125,255,84
138,23,-114,82,-67,36,-37,205,266
124,32,-55,134,-80,27,-9,180,353
-34,-96,-119,20,-159,75,-126,145,-294
185,-698,-1289,101,-242,1315,-196,1061,237
-35,-80,-94,-31,-95,-74,-114,36,-487
-11,-21,-21,-15,-30,-22,-39,9,-150
34,-59,-75,-12,4,-25,-27,55,-105
-25,-55,-39,-23,-52,-12,-22,28,-200
35,-57,-8,23,-57,18,-56,96,-6
1,-37,-60,-13,-75,-36,-66,54,-232
-14,-10,-5,4,-29,-14,-53,4,-117
-4,-27,-34,-14,-43,-21,-52,4,-191
38,-60,-66,-2,-62,-63,-118,92,-241
-26,-115,-119,-55,-149,-45,-139,55,-593
-46,-114,-72,-34,-119,-28,-101,42,-472
-4,-13,-24,-9,-16,-7,-22,12,-83
-17,-54,-57,-27,-59,-38,-72,43,-281
-28,-165,-176,-35,-242,-70,-212,100,-828
67,-98,-136,-66,-109,-151,-265,132,-626
-4,-29,-57,12,-58,-38,-104,-9,-287
-46,-127,-86,3,-176,-84,-136,43,-609
-657,-2108,-2285,-313,-12,944,498,699,-3234
-48,-45,-70,-65,-77,-126,-111,-65,-607
22,-27,-65,-38,-56,-104,-138,19,-387
-25,-132,-189,-126,-302,-234,-324,66,-1266
-36,-64,-76,-84,-40,-22,-41,25,-338
83,-142,-250,24,-230,-83,-182,179,-601
-81,-107,-93,-52,-144,-96,-146,-7,-726
28,-50,-78,-14,-21,-54,-59,84,-164
281,-29,-278,-39,-133,-116,-179,225,-268
56,-59,-12,23,-58,2,-59,93,-14
-34,-60,-62,-10,-75,-30,-76,20,-327
-15,-39,-49,33,-20,34,-45,59,-42
-444,-779,-1134,-529,-1527,-1029,-1773,-288,-7503
-18,-45,-32,-6,-44,-22,-49,-18,-234
12,-53,-37,-1,-18,-46,-59,31,-171
72,-2,-18,86,-46,-143,-97,26,-122
25,-35,-42,-7,-69,-13,-51,60,-132
73,-46,-121,-17,-34,-35,-106,127,-159
49,-153,-169,69,-147,-68,-182,141,-460
-51,-62,-63,-35,-117,-40,-84,18,-434
-20,-48,-33,-5,-66,-1,-33,11,-195
33,-87,-85,-3,-110,-57,-63,36,-336
225,-297,-732,-59,-382,-95,-668,976,-1032
18,-110,-153,-2,-149,-26,-154,156,-420
-23,-83,-135,-65,-172,-167,-259,-45,-949
-27,-64,-80,-15,-94,-49,-106,7,-428
-40,-86,-198,-39,-137,9,-137,161,-467
-26,-33,-84,-55,-144,-91,-195,1,-627
9,-21,-25,-2,-29,-4,-14,23,-63
-6,-47,-72,-25,-70,-107,-123,-8,-458
-5,-15,-13,-1,-16,-8,-25,23,-60
-52,-29,-58,-15,-59,-38,-74,-4,-329
-8,-43,-64,-43,-104,-85,-101,15,-433
-48,-135,-128,-26,-136,-57,-167,77,-620
-8,-143,-216,-18,-225,-126,-255,135,-856
-22,-94,-190,-70,-189,-139,-254,84,-874
-30,-75,-138,-50,-202,-154,-215,43,-821
-20,-47,-78,3,-32,26,-57,49,-156
225,79,167,137,82,-13,-83,199,793
-13,-136,-135,-9,-172,-126,-175,119,-647
-37,-84,-100,-6,-160,-78,-173,73,-565
79,-48,-66,127,-84,-78,-148,62,-156
-131,-156,-195,-61,-35,7,-92,-44,-707
-99,-128,-159,-45,-48,-5,-103,-40,-627
24,-35,-82,-12,-109,-5,-77,97,-199
-102,-154,-181,-33,-37,10,-96,-36,-629
-107,-164,-199,-60,-97,-24,-143,-36,-830
29,-100,-94,-34,-21,-105,-121,28,-418
105,24,41,10,50,-84,-42,127,231
45,-80,-58,-15,-55,-41,-70,139,-135
-14,11,-46,-33,-29,-60,-98,-19,-288
1,-119,-61,65,-164,-57,-147,66,-416
28,-121,-81,64,-130,-18,-160,107,-311
4,-141,-170,-100,-166,-187,-406,147,-1019
-22,-174,-294,-90,-463,22,-263,242,-1042
-98,-146,-203,-112,-291,-145,-314,37,-1272
-37,-5,-22,20,-103,-56,-130,-10,-343
181,-136,-125,241,-158,-167,-382,313,-233
70,-109,-97,24,-128,-75,-130,104,-341
54,-98,-127,-22,-152,-83,-158,137,-449
79,-105,-100,38,-142,-78,-122,93,-337
66,-102,-115,27,-136,-62,-131,110,-343
8,-34,-27,-3,-32,-46,-50,24,-160
8,-78,-49,-12,-48,-44,-54,36,-241
27,-110,-94,26,-97,-74,-137,78,-381
-72,-122,-101,-24,-122,-45,-134,9,-611
1,-24,-28,13,-33,-24,-29,-14,-138
-30,-66,-92,-26,-98,-39,-89,55,-385
-4,-61,-60,-20,-71,-35,-65,10,-306
-14,-20,-27,-14,-44,-6,-23,29,-119
-36,-96,-98,-49,-146,-33,-140,81,-517
59,-42,-36,83,-39,9,-62,148,120
25,-51,-67,-6,-19,41,-16,56,-37
32,-195,-243,-117,-329,-192,-315,250,-1109
-1,-33,-32,14,-54,-40,-71,-1,-218
-23,-44,-53,-13,-64,-19,-53,20,-249
-5,-68,-60,18,-143,-19,-74,57,-294
-10,-40,-37,14,-21,-26,-37,4,-153
-6,-78,-79,-2,-68,-89,-108,-29,-459
-65,-121,-128,-2,-154,-39,-181,21,-669
-53,-103,-103,-17,-172,-80,-165,77,-616
-22,0,-32,-5,-50,-25,-56,-3,-193
19,-100,-103,3,-98,20,-126,100,-285
77,-87,-78,-16,-68,-142,-189,89,-414
1,-30,-24,5,-33,0,-9,37,-53
4,-98,-74,32,-126,-78,-97,14,-423
-77,-179,-143,-48,-224,-117,-231,43,-976
38,-125,-174,3,-213,-172,-273,123,-793
-280,-338,-437,-152,-101,-45,-283,-124,-1760
-52,-77,-51,-1,-137,-67,-113,57,-441
-22,-101,-128,-5,-118,-115,-123,37,-575
-52,-36,-139,-85,-94,-42,-112,69,-491
-48,-159,-158,8,-237,-35,-191,137,-683
10,-44,-63,-29,-80,14,-40,62,-170
-55,-102,-90,10,-132,-33,-119,46,-475
-75,-9,-124,-114,25,-27,-178,-69,-571
122,-132,-168,46,-285,27,-224,378,-236
-53,-96,-135,-52,-169,-113,-173,-27,-818
-29,-110,-112,-55,-136,-16,-106,67,-497
-4,-39,-60,-22,-92,-67,-107,42,-349
70,-28,-23,34,-21,-83,-87,36,-102
-7,-77,-120,-57,-133,-113,-165,44,-628
-49,-84,-77,39,-150,-23,-129,84,-389
-7,-19,-36,-4,1,-9,-26,29,-71
46,-132,-118,2,-155,-23,-95,155,-320
27,-104,-71,33,-90,-45,-101,104,-247
0,-5,-8,-1,-9,-12,-7,16,-26
-34,-239,-260,3,-583,-109,-246,278,-1190
-79,-126,-125,-86,-101,10,-117,25,-599
-11,-61,-60,-21,-87,-16,-106,61,-301
-107,-64,-60,-56,-53,-71,-155,-85,-651
-64,-162,-179,-59,-220,-134,-267,42,-1043
34,-129,-131,-11,-173,-2,-108,132,-388
-8,-36,-38,2,-54,-9,-53,38,-158
-13,-73,-87,-26,-114,-34,-98,30,-415
-17,-40,-48,-11,-81,-13,-78,63,-225
6,-39,-36,13,-41,-9,-49,43,-112
-54,-116,-121,-15,-128,-16,-126,57,-519
-26,-120,-169,6,-230,-51,-208,114,-684
-6,-54,-110,-36,-118,-19,-74,52,-365
-75,-89,-104,-45,-195,-62,-131,40,-661
-4,-3,-19,-19,-20,-19,-23,14,-93
-16,-25,-53,-46,-105,-11,-73,39,-290
-49,-153,-183,-11,-275,-67,-275,101,-912
-40,-35,-40,-30,-45,-32,-54,-14,-290
-15,-82,-80,8,-90,-15,-71,97,-248
29,-35,-46,39,-29,-10,-98,100,-50
0,-22,-41,-6,-35,-45,-84,47,-186
39,-112,-129,-21,-167,-83,-184,117,-540
-28,-52,-58,-14,-75,-19,-69,26,-289
26,-86,-81,-18,-70,-74,-139,17,-425
-30,-71,-110,-32,-116,-75,-141,44,-531
-54,-131,-175,-112,-211,-70,-189,77,-865
-17,-56,-60,1,-69,-13,-60,20,-254
-14,-58,-51,-17,-105,-46,-80,15,-356
43,-26,-60,1,-91,-25,-48,39,-167
14,-9,-4,40,-38,-11,-78,31,-55
-5,-31,-32,10,-90,-43,-54,5,-240
9,0,-34,-3,-36,-46,-46,24,-132
46,-53,-47,41,-51,-18,-93,115,-60
-86,-147,-193,6,-71,-9,-112,-6,-618
-85,-144,-183,-5,-64,-5,-113,-26,-625
26,-34,-56,41,-88,-21,-72,91,-113
9,-61,-34,24,-28,-19,-98,39,-168
14,-28,-25,3,-44,-14,-12,22,-84
24,-73,-34,4,-20,-25,-73,53,-144
130,3,-10,175,-51,-22,-118,105,212
-31,-126,-101,-61,-123,-17,-130,70,-519
-58,-75,-73,-37,-85,-36,-133,25,-472
-13,-20,-41,5,-25,-8,-45,31,-116
-40,-20,-45,-47,-57,-20,-38,39,-228
-4,-18,-42,-6,-49,-17,-68,36,-168
46,-39,-91,-17,-142,-150,-180,6,-567
16,-170,-173,43,-196,-48,-196,97,-627
374,298,296,117,190,-146,-182,402,1349
0,-37,-53,29,-37,10,-32,41,-79
161,-207,-221,39,-201,-123,-313,314,-551
-688,400,-125,-476,-90,-252,-718,-382,-2331
-29,-15,-30,-32,-10,-5,-18,4,-135
-61,-72,-88,-44,-91,-13,-88,10,-447
-24,-93,-118,24,-163,-81,-142,73,-524
11,-52,-54,19,-61,-26,-108,57,-214
-31,-32,-56,2,-66,-11,-72,18,-248
-1,-44,-10,43,-11,6,-35,31,-21
-20,-46,-35,-3,-24,14,-28,1,-141
-49,-99,-140,-4,-124,-115,-230,-95,-856
-39,-13,-40,6,-47,0,-54,19,-168
-1,-20,-21,2,-12,-12,-28,5,-87
38,-41,-26,11,14,-50,-74,72,-56
52,-17,-1,94,3,-31,-68,100,132
-18,-25,-44,-1,-71,7,-54,27,-179
-6,-24,-29,-10,-49,-38,-57,-2,-215
24,-35,-44,24,-53,-21,-72,39,-138
0,-16,-47,-13,-61,-46,-89,33,-239
-7,-87,-81,75,-114,15,-114,72,-241
-163,-451,-382,-104,-616,-252,-532,162,-2338
-1,-26,-79,19,-87,-99,-153,-63,-489
-31,-56,-63,-2,-116,-41,-117,33,-393
-107,-238,-241,-154,-256,-114,-364,131,-1343
-87,-263,-237,-156,-274,-135,-405,108,-1449
62,-177,-104,-68,-98,-192,-246,150,-673
128,-398,-416,385,-741,-184,-666,555,-1337
4,-14,-11,20,-45,-2,-22,65,-5
-5,-88,-80,-36,-102,-67,-104,13,-469
-44,-96,-91,-47,-97,-71,-123,-14,-583
-45,-125,-85,18,-213,-148,-230,-64,-892
-13,-99,-137,-54,-87,-45,-182,124,-493
-6,-41,-32,9,-34,-17,-32,-7,-160
-10,-11,-37,-3,-42,-44,-49,-6,-202
-43,26,-125,-52,-92,-33,-144,205,-258
99,-69,-139,12,-180,-61,-166,188,-316
27,-61,-43,87,-138,49,-85,144,-20
-7,-85,-65,22,-115,-21,-118,37,-352
6,-73,-95,54,-206,-18,-234,139,-427
3,-35,-39,9,-73,-5,-59,23,-176
65,-77,-108,18,-138,-84,-139,120,-343
9,-63,-69,-2,-55,-14,-66,48,-212
31,-114,-74,-23,-154,-130,-213,107,-570
-29,-90,-126,1,-218,-32,-174,108,-560
-67,-30,-162,-92,-184,-357,-436,-67,-1395
-85,-28,-116,-102,-106,-226,-284,-63,-1010
21,-100,-115,23,-129,-86,-143,50,-479
115,-90,-11,83,-23,-73,-103,146,44
-7,-111,-117,-31,-152,-85,-174,53,-624
25,-75,-58,22,-54,-10,-72,45,-177
-149,-212,-241,-89,-348,-85,-307,58,-1373
-84,-141,-109,-59,-142,-84,-166,2,-783
-27,-67,-110,-3,-161,-143,-197,38,-670
-13,-45,-74,-30,-29,-17,-98,60,-246
12,-98,-119,-6,-168,-129,-170,105,-573
-16,-95,-92,25,-181,3,-126,126,-356
11,-41,-41,-10,-55,-36,-47,17,-202
24,-68,-52,38,-45,-60,-84,20,-227
-9,-22,-25,-28,-35,-24,-35,14,-164
-6,-37,-48,-27,-38,0,-55,51,-160
-21,-48,-93,-41,-98,18,-85,52,-316
11,-37,-28,3,-52,-19,-53,8,-167
-119,-163,-258,-100,-343,-190,-306,118,-1361
23,-37,-27,54,-27,1,-45,39,-19
-27,-130,-123,-25,-120,-28,-110,43,-520
-18,-51,-132,1,-102,-9,-97,111,-297
-90,-146,-206,-59,-199,-45,-257,146,-856
-4,-162,-252,-44,-216,-116,-259,137,-916
-57,-113,-166,-75,-150,-62,-231,73,-781
-88,-148,-170,-45,-179,-73,-201,58,-846
-6,8,-25,-34,-14,-82,-102,1,-254
-76,-132,-142,-38,-61,-17,-96,13,-549
7,-1,-15,11,-17,-2,-28,-2,-47
-15,-102,-106,-46,-121,-12,-86,43,-445
-6,-76,-89,-2,-126,-46,-103,47,-401
-48,-91,-102,-23,-161,27,-99,82,-415
-14,-62,-91,-53,-138,-97,-148,16,-587
-71,-134,-142,-87,-221,-122,-261,15,-1023
-145,-181,-239,-80,-111,-43,-137,45,-891
-35,-15,-19,-23,-30,-20,-18,-11,-171
-95,-115,-140,-34,-75,-17,-99,-6,-581
-22,-33,-76,-15,-67,-16,-100,63,-266
-22,-97,-108,-48,-96,-62,-108,35,-506
18,-58,-72,-41,-158,-124,-177,33,-579
59,-56,-70,33,-86,-85,-153,99,-259
46,-58,-56,36,-89,-18,-37,47,-129
-90,-167,-162,-83,-223,-127,-220,18,-1054
-37,-110,-67,-26,-72,-43,-115,61,-409
-52,-131,-122,-22,-148,-43,-151,33,-636
-195,-311,-359,-152,-567,-217,-498,131,-2168
-63,-89,-102,-9,-146,9,-117,87,-430
258,-158,-108,122,52,-254,-226,449,135
1043,229,-99,-184,-97,307,807,1300,3306
-89,-137,-153,-32,-89,-21,-80,44,-557
-104,-152,-241,-20,-171,46,-209,88,-763
-5,5,-29,-41,-14,-82,-104,-7,-277
-26,-23,-44,-11,-103,-101,-171,25,-454
-39,-99,-77,12,-37,-3,-61,5,-299
-42,-106,-129,-35,-169,-30,-159,92,-578
70,-116,-90,6,-129,-89,-133,40,-441
12,-15,-33,16,-22,-19,-39,12,-88
-15,-14,-27,11,-17,-14,-43,9,-110
-80,-64,-105,-55,-129,-2,-124,44,-515
-103,-210,-245,-51,-280,-108,-324,15,-1306
-6,7,-36,-16,-24,-22,-53,25,-125
55,-117,-164,17,-130,-18,-162,109,-410
-5,-9,-17,-2,-29,-11,-16,20,-69
-18,-13,-37,-20,-40,-26,-48,1,-201
-25,-24,-22,-23,-18,-27,-31,-16,-186
-8,-34,-36,-6,-43,-12,-48,4,-183
-24,-65,-64,-8,-81,-26,-82,42,-308
23,-98,-57,-17,-33,-83,-132,87,-310
0,-52,-68,-6,-119,-106,-110,19,-442
-51,-55,-83,-12,-122,-153,-136,-1,-613
-95,-167,-152,-56,-213,-26,-181,80,-810
-12,-44,-63,-21,-77,-54,-75,29,-317
-28,-41,-72,-10,-103,-14,-100,28,-340
-29,-73,-62,-27,-72,-38,-78,33,-346
3,-25,-36,11,-19,-30,-46,1,-141
-46,-32,-73,-48,-28,-46,-90,-4,-367
-65,-120,-90,-5,-132,-57,-146,-4,-619
-11,-20,-30,-11,-20,2,-31,16,-105
189,129,-90,87,-70,-152,-228,23,-112
6,-29,-26,-18,-19,-39,-60,20,-165
0,-12,-11,-5,-16,-10,-18,5,-67
124,-4,-11,47,-31,-98,-114,116,29
-424,-662,-673,-309,-908,-198,-868,166,-3876
-13,-15,-27,-10,-19,-10,-29,3,-120
12,-38,-93,10,-144,-42,-118,47,-366
-11,-58,-66,-10,-99,-30,-93,7,-360
-34,-59,-69,-33,-88,-27,-69,28,-351
-23,-76,-179,-64,-55,-167,-277,15,-826
-108,-10,-164,-129,-139,-188,-337,-24,-1099
1,-4,-24,10,-27,-19,-37,39,-61
-114,-50,-95,-115,-72,-88,-189,-116,-839
19,-106,-176,-82,-232,-210,-257,123,-921
4,-18,-22,12,-26,-2,-14,18,-48
77,2,-36,20,-14,-89,-119,70,-89
-129,-148,-176,-50,-89,-23,-103,-8,-726
-1,-7,-27,-11,-30,-9,-26,23,-88
14,-90,-96,-13,-124,-107,-105,39,-482
-3,-20,-22,-6,-23,5,-18,14,-73
-141,-9,-107,-120,-49,-32,-193,-56,-707
-21,-71,-55,-30,-117,-19,-49,67,-295
-20,-131,-76,-21,-110,-56,-112,41,-485
-4,-80,-41,27,-116,-65,-89,53,-315
-48,-110,-59,-23,-116,-15,-91,68,-394
3,-154,-158,-57,-232,-119,-237,36,-918
-17,-220,-246,-98,-364,-135,-290,146,-1224
325,82,78,314,71,-181,-170,329,848
35,-56,-41,-15,-39,-71,-83,48,-222
20,-37,-59,-15,-30,-22,-69,21,-191
-10,-43,-52,-5,-74,-45,-81,14,-296
-8,-18,-34,-13,-49,-29,-67,-10,-228
-19,-69,-66,-23,-150,-70,-136,46,-487
15,-41,-25,-4,0,-23,-28,30,-76
-22,-85,-45,-5,-112,-10,-84,34,-329
10,-114,-45,10,-77,-71,-90,46,-331
-10,-84,-83,-21,-100,-73,-103,29,-445
-27,-77,-56,-14,-84,-9,-62,39,-290
-21,-67,-61,-7,-100,-39,-111,26,-380
-41,-83,-55,-20,-62,-18,-80,22,-337
-82,-284,-301,-114,-378,-164,-389,155,-1557
16,-61,-67,25,-88,-45,-101,52,-269
27,-215,-296,-140,-248,-125,-343,285,-1055
-96,-224,-318,-148,-358,-210,-403,106,-1651
-175,-242,-204,-79,-343,-136,-341,-38,-1558
-117,-271,-281,-69,-408,-189,-411,33,-1713
-72,-211,-249,-144,-331,-163,-390,176,-1384
56,-152,-231,-61,-285,-177,-277,120,-1007
142,-152,-235,-67,-156,-134,-337,274,-665
136,-82,-42,125,-13,-30,-126,205,173
23,-144,-175,-63,-254,-199,-197,36,-973
-110,-224,-314,-141,-452,-232,-477,239,-1711
-53,-178,-219,50,-322,-48,-308,197,-881
-22,-53,-58,-7,-92,-32,-83,12,-335
30,-89,-52,26,-68,-52,-99,36,-268
43,-68,-62,-31,-4,-49,-84,52,-203
22,-28,-88,16,-113,-68,-110,52,-317
-13,-8,-22,-8,-28,-19,-20,6,-112
26,-9,-35,4,-19,-65,-65,21,-142
-43,-64,-73,-8,-88,-21,-91,46,-342
179,-135,-422,-61,-397,-192,-474,372,-1130
-18,-64,-44,78,-59,-1,-56,84,-80
-24,-170,-170,-43,-290,-144,-313,178,-976
-27,-105,-170,-124,-64,-99,-221,152,-658
195,-25,-11,438,-188,92,-239,395,657
-33,-34,-48,-14,-75,-26,-59,36,-253
-23,-52,-53,-28,-90,-43,-66,36,-319
95,-218,-548,-113,-304,47,-370,485,-926
52,-65,-76,49,-103,-57,-107,76,-231
19,-94,-101,-31,-100,-33,-87,108,-319
40,-27,-54,40,-44,-58,-116,62,-157
-40,-92,-124,-59,-156,-48,-250,-13,-782
-13,-37,-50,-5,-41,-20,-54,-11,-231
-36,-29,-48,-47,-80,-25,-83,20,-328
-8,-52,-95,3,-102,-44,-107,37,-368
-36,-116,-132,-116,-185,-137,-201,46,-877
-20,-52,-94,-64,-114,-131,-226,109,-592
33,-95,-86,-23,-46,-21,-116,146,-208
35,-180,-95,52,-179,37,-160,151,-339
18,-84,-113,41,-168,33,-102,162,-213
-10,-161,-139,-9,-222,-31,-191,174,-589
12,-5,-21,9,-57,-41,-50,36,-117
55,-140,-192,16,-89,-142,-231,123,-600
-71,-210,-269,-87,-196,-216,-460,118,-1391
-64,-56,-64,14,-60,-64,-135,-75,-504
15,-215,-224,69,-305,-33,-194,265,-622
-20,-134,-164,19,-195,-27,-144,106,-559
-15,-153,-98,100,-173,8,-128,114,-345
-67,-96,-98,-42,-119,-43,-123,45,-543
156,-41,-274,6,-239,-44,-211,387,-260
1,-115,-122,-23,-117,15,-114,81,-394
10,-125,-88,-11,-132,-83,-105,55,-479
-21,-68,-88,-53,-115,-87,-121,50,-503
-8,-52,-113,-30,-125,-123,-170,21,-600
-76,-20,-108,-80,-99,-68,-131,-4,-586
-64,-95,-108,-14,-64,-39,-98,17,-465
-13,-3,-38,-34,-36,-16,-38,11,-167
-8,-39,-50,-30,-73,-19,-75,25,-269
131,11,46,129,-9,-78,-135,133,228
-13,-23,-47,3,-57,-14,-46,39,-158
-42,-50,-83,-22,-116,6,-78,57,-328
-29,-56,-115,-25,-107,-45,-154,43,-488
100,-214,-211,72,-236,124,-117,290,-192
-26,-42,-48,-18,-45,-2,-70,22,-229
9,-205,-423,-64,-480,-113,-483,365,-1394
-2,-34,-22,46,-38,14,-34,44,-26
83,-127,-113,36,-138,-80,-135,103,-371
-67,-127,-122,-56,-196,-117,-197,12,-870
-33,-72,-109,-30,-111,-84,-127,-3,-569
-12,-47,-105,-80,-123,-87,-190,-12,-656
37,-29,15,84,-1,-34,-92,91,71
69,-42,-44,103,-50,-80,-126,127,-43
124,-23,-14,143,-13,-73,-120,145,169
20,-62,-56,-23,-74,-93,-139,59,-368
45,-56,-9,47,4,6,-88,104,53
40,-28,-23,41,-29,-61,-90,57,-93
334,-436,-830,-69,-643,-88,-612,584,-1760
34,-73,-99,-11,-192,11,-137,165,-302
23,-29,-20,40,-25,-28,-42,34,-47
-40,-168,-127,42,-166,-62,-218,119,-620
24,-141,-188,-24,-199,-109,-226,142,-721
102,-101,-147,18,-147,-88,-233,275,-321
-2,-33,-34,3,-34,-22,-68,58,-132
-13,-38,-40,-29,-32,-24,-39,-1,-216
-66,-152,-170,-65,-181,-82,-174,41,-849
-26,-119,-116,-40,-174,-86,-181,44,-698
-40,-32,-50,-33,-60,-43,-81,-23,-362
-17,-18,-31,-8,-72,-11,-62,44,-175
1,-2,-41,7,-30,-13,-60,43,-95
-44,-147,-240,-108,-114,-109,-201,135,-828
-15,-22,-20,-19,-41,-19,-40,2,-174
-50,-146,-114,-8,-165,-82,-163,-30,-758
-33,-42,-61,-8,-76,-27,-62,22,-287
-55,-150,-171,8,-224,-46,-210,75,-773
-46,-155,-149,4,-255,-84,-230,72,-843
-5,-50,-45,-11,-62,-34,-59,15,-251
35,-211,-296,-30,-339,-198,-367,171,-1235
26,-52,-46,6,-113,-53,-68,55,-245
0,-21,-11,16,-21,-7,-19,9,-54
-73,-282,-241,-49,-285,-128,-315,70,-1303
-51,-273,-243,78,-224,4,-319,96,-932
-36,-66,-60,-6,-76,-23,-62,20,-309
117,-93,-384,108,-421,-110,-459,221,-1021
70,-219,-403,-11,-142,-71,-307,309,-774
55,-42,-74,62,-137,-104,-136,83,-293
-31,-140,-117,8,-144,-108,-171,-23,-726
-26,-41,-42,1,-71,-23,-72,27,-247
-85,-161,-236,-38,-269,-165,-338,41,-1251
-30,-87,-74,4,-57,29,-96,71,-240
-27,-74,-130,-63,-183,-64,-160,58,-643
-22,-116,-104,-85,-153,-101,-171,40,-712
-44,-99,-202,-190,27,-43,-71,-40,-662
14,-55,-40,46,-71,-65,-130,69,-232
29,6,-1,14,15,-10,1,15,69
23,4,-3,8,18,-7,0,12,55
31,4,-2,13,15,-8,-2,14,65
30,4,-4,11,11,-8,-3,15,56
3,-4,-6,2,-11,-7,-12,6,-29
-98,-251,-248,-46,-372,-129,-355,62,-1437
-13,-63,-63,-22,-87,-78,-104,22,-408
-32,-50,-42,-43,-46,-25,-79,-11,-328
-85,-394,-305,-52,-657,-147,-451,231,-1860
28,-84,-95,-3,-109,-110,-132,18,-487
-24,-70,-54,30,-99,-25,-92,12,-322
64,-64,-49,-2,15,-29,-120,103,-82
-20,-122,-85,-6,-141,-110,-145,8,-621
-6,-141,-102,78,-172,-87,-201,25,-606
-5,-31,-37,21,-61,0,-48,53,-108
9,-83,-161,0,-139,-118,-124,13,-603
-38,-70,-134,-26,-83,-9,-84,42,-402
49,-144,-133,49,-143,-73,-198,135,-458
32,-30,-95,-42,-56,-65,-164,68,-352
37,-77,-107,-10,-117,-18,-74,105,-261
2,-12,-24,3,-23,-7,-28,19,-70
-59,-117,-122,-50,-122,-55,-102,16,-611
-21,-56,-70,-14,-116,-51,-126,42,-412
143,-227,25,116,115,62,16,232,482
52,-146,-99,-28,-68,-9,-74,130,-242
-35,-64,-84,-25,-50,-65,-112,-19,-454
-20,-40,-40,-22,-70,-6,-49,30,-217
75,-82,-154,-5,-18,-46,-68,170,-128
-99,-271,-400,-57,-337,-196,-428,111,-1677
-69,-95,-95,-37,-143,-57,-108,32,-572
-44,-95,-67,-37,-115,-80,-136,35,-539
-64,-72,-173,-122,-226,-208,-357,-27,-1249
-77,-36,-42,-18,-38,-33,-62,-12,-318
25,-87,-75,-8,-180,-50,-137,111,-401
-29,-26,-55,-12,-65,-54,-62,-8,-311
59,43,11,96,-33,-3,-26,110,257
53,41,31,115,-29,28,-22,80,297
-8,-61,-80,-26,-56,-4,-72,54,-253
-8,-55,-35,-6,-61,-52,-67,30,-254
9,-41,-45,-12,-80,-14,-29,32,-180
-8,-16,-24,-16,-62,-38,-75,6,-233
-20,-40,-56,-27,-67,-34,-56,-3,-303
-15,-55,-63,-9,-106,-30,-85,66,-297
40,-115,-62,-38,-121,-146,-225,120,-547
-10,-16,-13,-3,-22,-5,-21,-1,-91
-17,-69,-87,-36,-66,-31,-66,36,-336
-68,-114,-150,-32,-160,-60,-183,41,-726
5,2,-24,7,-16,-15,-29,0,-70
-28,-57,-54,-10,-58,-13,-85,27,-278
-10,-43,-48,-12,-102,-43,-112,49,-321
30,-152,-120,-65,-114,-128,-235,147,-637
-52,-80,-138,-20,-213,-134,-218,8,-847
-88,-130,-150,-9,-212,13,-255,97,-734
66,-81,-65,9,-82,-117,-213,95,-388
26,-86,-95,-17,-82,-35,-80,87,-282
-60,-105,-144,-93,-144,-128,-170,19,-825
77,-106,-119,34,-85,-133,-193,41,-484
16,-145,-139,-33,-210,-128,-176,117,-698
4,-43,-66,14,-95,1,-36,83,-138
-20,-75,-78,-12,-98,-94,-135,-31,-543
45,-237,-199,50,-280,-100,-276,249,-748
60,-211,-179,128,-313,-1,-217,280,-453
-11,-21,-15,13,-2,-56,-56,13,-135
10,-54,-69,-38,-85,-35,-89,51,-309
44,-71,-51,64,-49,-54,-77,53,-141
-6,-20,-31,-32,-63,-37,-58,16,-231
29,-164,-258,15,-275,-112,-326,203,-888
-73,-81,-141,-77,-162,-70,-170,-16,-790
-28,-57,-63,-11,-62,-21,-70,53,-259
-30,-33,-35,27,-23,4,-49,13,-126
-10,-22,-10,24,-34,-17,-23,11,-81
-34,3,-58,-36,-76,-27,-76,95,-209
-47,10,-83,-23,-81,-17,-95,125,-211
-30,-30,-39,-16,-40,-46,-54,18,-237
-33,-184,-214,-49,-295,-49,-256,195,-885
-25,-34,-45,-31,-66,0,-48,24,-225
-81,-89,-102,-52,-134,-74,-143,26,-649
13,-39,-81,-15,-48,-17,-62,55,-194
75,-95,-112,25,-145,-160,-162,98,-476
8,-46,-64,-37,-90,-28,-63,41,-279
30,-152,-103,9,-149,-107,-137,125,-484
-52,-36,-35,-37,-79,-19,-85,-3,-346
-14,-23,-41,-14,-49,-5,-40,16,-170
25,-26,-18,-2,-48,-11,-31,109,-2
-10,-66,-51,-27,-47,-105,-135,5,-436
-21,-75,-120,-7,-158,-79,-184,43,-601
-20,-26,-43,-16,-55,15,-40,20,-165
-28,-51,-82,-22,-64,-3,-82,47,-285
-5,-11,-17,2,-19,-14,-22,1,-85
-37,-38,-44,-5,-77,-36,-101,17,-321
-57,-105,-122,-62,-138,-63,-132,29,-650
23,-156,-189,-32,-217,-119,-226,132,-784
-49,-52,-96,-37,-120,-51,-116,21,-500
57,-69,-76,31,-99,-89,-119,54,-310
-423,-512,-627,-237,-851,-371,-863,-60,-3944
142,122,-2,155,-42,17,-72,178,498
19,-50,-53,-8,-36,-91,-98,34,-283
-21,-77,-98,-18,-121,-89,-130,64,-490
-22,-19,-16,-15,-41,-28,-59,0,-200
-77,-128,-109,-32,-155,-27,-134,34,-628
-63,-107,-99,3,-104,-81,-152,-29,-632
-19,-48,-66,-22,-75,-9,-59,22,-276
-2,-132,-86,-1,-120,-86,-187,60,-554
9,-320,-267,-51,-366,-79,-344,390,-1028
-48,-80,-86,5,-90,-30,-93,21,-401
-6,-49,-108,10,-87,-26,-144,101,-309
22,-45,-18,51,-65,12,-25,49,-19
24,-134,-190,6,-283,-107,-226,235,-675
36,-53,-28,36,-23,-73,-100,40,-165
-29,-33,-50,-21,-27,-8,-47,3,-212
-11,-80,-67,19,-72,18,-53,34,-212
-38,-81,-131,8,-58,7,-58,30,-321
-16,-35,-34,-16,-34,-27,-34,15,-181
-86,-134,-112,-58,-125,-83,-154,-28,-780
14,-52,-57,-35,-141,-107,-117,8,-487
7,-136,-201,-28,-244,-115,-270,117,-870
-2,-78,-122,-78,-158,-126,-152,20,-696
-59,-112,-175,27,-209,-97,-340,125,-840
-40,2,-44,-2,-59,-37,-78,25,-233
95,-8,-82,73,-114,-92,-218,203,-143
-106,-207,-158,-16,-285,-74,-218,78,-986
-25,-86,-65,-26,-76,-43,-102,14,-409
-142,-261,-375,-180,-480,-261,-539,29,-2209
-69,-83,-151,10,-81,-17,-101,65,-427
25,-13,-27,9,-43,-15,-13,16,-61
-179,-372,-408,-152,-514,-222,-510,39,-2318
-4,-5,-17,-11,-13,10,-22,31,-31
-3,-24,-20,-21,-17,-26,-25,14,-122
79,-103,-76,15,-94,14,-61,125,-101
-35,-63,-102,-40,-124,-30,-131,77,-448
-67,-177,-176,-112,-216,-113,-239,53,-1047
-29,-47,-87,-17,-124,-41,-142,71,-416
7,-65,-48,-11,-78,-56,-64,4,-311
-35,-99,-108,-91,-157,-161,-206,-29,-886
1,-34,-65,16,-79,-55,-107,50,-273
40,-139,-135,65,-228,-96,-235,112,-616
11,-49,-83,-12,-88,-90,-139,51,-399
25,-57,-74,-38,-138,-105,-174,24,-537
-8,-33,-57,-11,-61,-15,-80,20,-245
-76,-1,-168,-87,-78,23,-158,105,-440
421,-108,-241,122,-56,-165,-203,326,96
-9,-34,-16,5,-40,-9,-40,49,-94
-24,-83,-188,-7,-188,-94,-168,97,-655
22,-36,-60,51,-39,-16,-94,58,-114
-5,-73,-111,-122,-20,-148,-171,69,-581
-49,-27,-71,-35,-64,-94,-151,23,-468
-426,-118,-304,-465,-187,-342,-645,-354,-2841
-17,6,-26,-24,-3,-40,-33,-30,-167
-6,-73,-80,41,-113,-23,-154,110,-298
3,-83,-96,-72,-112,-157,-244,111,-650
5,-23,-34,-13,-54,-30,-56,38,-167
8,-41,-58,-18,-78,17,-33,64,-139
-1,4,-59,26,-40,-35,-74,-21,-200
-44,-61,-53,1,-87,-36,-85,78,-287
-141,-269,-425,-276,-409,-300,-571,60,-2331
55,-62,-49,-8,-26,-73,-118,64,-217
-149,-145,-176,-82,-217,-151,-305,-88,-1313
-35,-136,-126,-41,-136,-72,-163,57,-652
87,-139,-110,19,-89,-77,-150,229,-230
-7,-61,-91,-85,-129,-103,-189,51,-614
-28,-131,-151,-54,-184,-131,-215,74,-820
-5,-133,-161,-18,-223,-188,-249,40,-937
54,-39,-78,-39,-51,-64,-78,83,-212
-71,-99,-144,-95,-152,10,-109,44,-616
99,-93,-79,50,-53,-18,-107,199,-2
73,-78,-77,24,-79,-48,-101,61,-225
12,-60,-70,-48,-54,-76,-112,14,-394
-82,-146,-169,-81,-270,-171,-264,48,-1135
-29,-105,-90,14,-124,-16,-129,61,-418
-36,-92,-97,12,-115,-29,-128,55,-430
-26,-43,-56,15,-75,-4,-56,23,-222
66,-90,-89,26,-92,-26,-92,104,-193
117,-87,-154,-6,-47,-85,-137,190,-209
-59,-134,-116,-24,-176,-55,-125,36,-653
39,-25,-50,21,-48,-56,-100,56,-163
16,-12,-16,25,-32,-27,-37,-7,-90
-18,-73,-79,-38,-73,-75,-130,50,-436
0,-78,-102,-1,-100,-88,-155,-6,-530
-97,-179,-176,-53,-243,-59,-269,81,-995
6,-52,-45,33,-56,-8,-94,24,-192
8,-60,-24,49,-78,-15,-62,70,-112
-24,-85,-71,4,-83,3,-71,25,-302
-5,-34,-70,-9,-102,-81,-147,-7,-455
47,-8,-45,37,-64,-69,-106,55,-153
-27,-28,-31,-16,-35,-32,-56,21,-204
-2,-50,-59,-6,-97,-35,-77,43,-283
-12,-11,-30,-10,-20,-15,-15,8,-105
-150,-61,-172,-134,-157,-84,-223,108,-873
0,-7,-19,5,-22,0,-39,23,-59
-54,-128,-131,-9,-160,-30,-141,104,-549
-313,-492,-571,-246,-778,-396,-795,-36,-3627
0,-28,-36,18,-30,-21,-47,25,-119
13,-9,-9,3,-12,6,-20,24,-4
17,-11,-5,13,-22,0,-10,27,9
-3,-56,-63,41,-92,-17,-131,54,-267
-18,-49,-25,35,-56,-2,-63,44,-134
2,-128,-83,-22,-127,-83,-158,47,-552
-15,-103,-88,-27,-119,-64,-117,26,-507
-19,-92,-69,-9,-114,-46,-95,1,-443
8,-42,-56,-39,-77,-95,-92,-40,-433
19,-37,-46,26,-30,-33,-76,67,-110
-72,-116,-144,0,-268,-102,-282,167,-817
-29,-56,-79,-11,-130,-16,-132,29,-424
-22,-80,-69,-52,-52,-71,-123,37,-432
12,-30,-49,30,-18,-13,-44,61,-51
-64,-82,-75,-40,-93,-19,-117,27,-463
4,-43,-70,-13,-101,-45,-86,42,-312
17,-53,-30,3,-46,-66,-78,10,-243
-36,-182,-191,-95,-213,-155,-291,165,-998
-106,-247,-228,-63,-355,-128,-380,-27,-1534
25,-178,-123,7,-187,-31,-125,139,-473
9,-100,-113,-57,-148,-108,-162,19,-660
-5,-45,-35,0,-59,-10,-42,17,-179
-26,-186,-116,109,-125,30,-228,167,-375
-21,-13,-23,3,-51,13,-74,93,-73
-21,-50,-69,-29,-100,-83,-149,12,-489
-39,-76,-74,-61,-37,-30,-98,-10,-425
-90,-111,-98,-42,-140,-4,-116,36,-565
-44,-96,-109,-45,-141,-43,-112,35,-555
-4,-80,-199,-153,-270,-222,-335,84,-1179
-27,-85,-71,-16,-89,1,-42,67,-262
30,-45,-64,36,-128,-50,-83,92,-212
-4,-131,-126,-5,-164,-45,-135,49,-561
-46,-130,-120,-22,-160,-48,-155,45,-636
31,-170,-226,-48,-250,-139,-285,128,-959
-81,-114,-144,-11,-180,-113,-201,-16,-860
-67,-150,-144,-5,-191,-70,-163,-3,-793
-99,-103,-131,-39,-179,-62,-159,-16,-788
-81,-113,-135,-86,-180,-110,-178,-36,-919
-50,-91,-178,-29,-203,-81,-237,2,-867
-75,-157,-175,44,-313,-38,-264,150,-828
104,-91,-112,-28,-78,-119,-173,180,-317
70,-49,-72,65,-70,-26,-71,117,-36
29,-57,-24,17,-69,-9,-45,51,-107
4,-97,-96,4,-197,-10,-125,133,-384
33,-263,-243,2,-302,-179,-351,165,-1138
-8,-20,-32,2,-42,-7,-38,7,-138
0,-37,-36,11,-56,-25,-42,8,-177
-60,-109,-93,-39,-136,-25,-110,49,-523
-14,-77,-94,-12,-109,-80,-143,24,-505
-1,-96,-82,-22,-34,-18,-34,24,-263
-11,-53,-45,32,-33,-22,-57,49,-140
8,-47,-122,-9,-105,-45,-128,105,-343
25,-30,-25,11,-31,-29,-51,35,-95
-18,-83,-135,-87,-132,-170,-254,30,-849
39,-111,-157,-32,-304,-189,-251,137,-868
51,-24,-64,10,-95,-35,-47,63,-141
23,-61,-55,18,-71,-67,-72,39,-246
-245,-345,-326,-104,-523,-150,-550,173,-2070
-43,-45,-86,-8,-103,-96,-150,-42,-573
-30,-81,-88,-43,-110,-64,-136,19,-533
55,-91,-136,-41,-161,-173,-209,56,-700
-90,-131,-202,-69,-261,-21,-233,73,-934
-14,-93,-106,-6,-111,27,-102,86,-319
-15,-118,-113,19,-209,-249,-305,23,-967
30,-92,-78,73,-173,-176,-283,19,-680
65,-75,-41,37,-44,10,-46,130,36
23,-12,-30,15,-25,-15,-27,35,-36
-38,-110,-127,-39,-167,-132,-149,-22,-784
-32,-52,-116,-8,-74,-62,-143,4,-483
-4,-21,-51,11,-61,-68,-93,8,-279
-9,-12,-8,0,-10,-5,-20,5,-59
-21,-39,-45,-6,-45,-25,-46,1,-226
119,-159,-246,-42,-169,-306,-420,162,-1061
9,-96,-128,19,-234,-28,-209,204,-463
0,-286,-310,7,-606,-592,-684,-345,-2816
-45,-185,-137,-2,-158,-16,-136,87,-592
-31,-84,-128,-68,-111,-46,-82,99,-451
0,-40,-48,-10,-77,-48,-127,24,-326
-30,-31,-71,-26,-76,-27,-54,1,-314
-10,-47,-79,79,-109,-42,-170,90,-288
-20,-52,-45,-28,-129,-44,-76,50,-344
-2,-78,-90,8,-97,-33,-75,29,-338
-30,-26,-45,-42,-66,2,-62,27,-242
18,-106,-171,11,-123,-6,-154,148,-383
-26,-38,-40,-36,11,-31,-54,56,-158
-23,-115,-87,-40,-131,-92,-130,18,-600
26,-48,-89,0,-107,-55,-141,38,-376
20,-46,-14,53,-70,1,-50,72,-34
3,-44,-49,-14,-37,-28,-59,29,-199
40,-132,-80,-14,-20,-46,-73,64,-261
-44,-72,-90,-50,-104,-36,-98,12,-482
-7,-56,-48,-13,-71,-31,-71,12,-285
-28,-69,-87,-49,-135,-105,-132,-6,-611
0,-21,-24,0,-26,-21,-35,6,-121
8,-172,-146,-52,-186,-155,-265,134,-834
-32,-36,-35,-5,-42,-5,-62,-28,-245
-173,-337,-392,-99,-579,-132,-616,281,-2047
19,-20,-40,1,-60,-75,-55,25,-205
-9,-131,-95,12,-158,13,-91,94,-365
-41,-99,-78,0,-152,-72,-122,45,-519
-62,-103,-99,-69,-162,-124,-262,-63,-944
118,-69,-70,14,-47,-10,-66,179,49
-16,-29,-29,-5,-41,-22,-34,-5,-181
54,-17,-51,7,-48,-17,-17,91,2
-1,-1,-10,-3,-2,1,-9,21,-4
-123,-213,-232,-65,-309,-90,-347,108,-1271
-65,-89,-100,-18,-145,-34,-153,4,-600
5,-48,-51,11,-43,0,-41,42,-125
48,-116,-51,35,-121,-115,-191,166,-345
86,-125,-190,31,-165,-179,-381,221,-702
66,-100,-262,-12,-192,-137,-368,238,-767
-66,-268,-386,-182,-425,-268,-492,-24,-2111
38,37,32,81,-15,8,-9,55,227
-6,-58,-57,-1,-81,-53,-83,1,-338
10,-18,-18,4,-30,3,-31,12,-68
16,-180,-185,-119,-125,-150,-271,125,-889
376,413,475,225,236,-22,-204,514,2013
-13,-66,-47,-11,-99,-53,-100,29,-360
215,222,193,100,130,-101,-114,149,794
246,205,220,125,131,-30,-60,200,1037
-8,-9,-15,-7,-4,-12,-14,-11,-80
-9,-34,-34,-3,-49,-1,-35,13,-152
23,27,-83,-3,15,-36,-15,-35,-107
-44,-86,-87,-52,-102,-67,-111,14,-535
46,20,12,65,11,3,-10,47,194
46,-29,-6,60,-32,3,-67,90,65
-25,-83,-63,-20,-121,21,-86,61,-316
138,-175,-130,121,-189,-34,-169,198,-240
9,-83,-136,32,-171,-114,-185,59,-589
-11,-14,-16,23,-41,15,-41,29,-56
48,-85,-75,10,-135,-37,-71,63,-282
51,-180,-160,-86,-127,-10,-106,195,-423
-12,-89,-133,-60,-66,10,-48,89,-309
-8,-109,-128,-5,-153,-49,-153,27,-578
56,-104,-168,-11,-236,25,-153,211,-380
-22,-20,-29,-20,-43,-69,-69,-36,-308
12,-39,-69,36,-47,-18,-102,42,-185
36,-51,-50,2,-48,-53,-77,42,-199
15,-109,-105,-75,-170,-112,-120,132,-544
-126,-177,-170,-17,-264,-147,-279,-1,-1181
25,-36,-50,4,-38,-37,-61,50,-143
-37,-53,-63,-37,-68,-45,-65,-2,-370
-23,-81,-93,-53,-127,-110,-131,-7,-625
-15,-93,-68,41,-150,-60,-110,85,-370
-153,-287,-372,-201,-502,-342,-540,28,-2369
-30,-185,-199,-94,-290,-199,-320,53,-1264
-29,-106,-114,-3,-160,-41,-119,90,-482
34,45,-55,-9,-79,-107,-207,22,-356
-170,-1,-110,-132,-226,-238,-459,-188,-1524
20,-37,-53,10,-70,-48,-111,96,-193
32,-75,-103,38,-114,-93,-187,51,-451
-28,-110,-183,-41,-132,-75,-210,73,-706
-79,-124,-159,-69,-263,-63,-226,30,-953
332,30,-83,231,29,27,-126,318,758
-66,-108,-197,-104,-197,-90,-190,121,-831
29,-84,-198,-181,-264,-289,-520,139,-1368
40,-126,-111,13,-146,-94,-166,106,-484
34,-29,-108,40,-51,-71,-185,126,-244
-49,-113,-139,-83,-204,-126,-216,19,-911
-12,-26,-56,-11,-50,-15,-42,35,-177
-16,-145,-111,-60,-148,-108,-134,22,-700
-7,-94,-92,-56,-127,-73,-133,52,-530
-33,-49,-122,-41,-130,-10,-137,109,-413
-17,-53,-53,-5,-80,-52,-95,35,-320
5,-71,-56,-7,-56,-56,-92,18,-315
-176,-304,-344,-188,-447,-189,-432,48,-2032
12,-27,-37,37,-62,15,-48,77,-33
-23,-28,-76,16,-80,22,-76,67,-178
24,-162,-158,-17,-118,-128,-204,67,-696
-114,-159,-242,-68,-295,-89,-266,64,-1169
-31,-52,-46,17,-32,-23,-37,-14,-218
67,-67,-39,11,-116,-20,-86,94,-156
59,-66,-34,33,-115,5,-64,94,-88
-21,-36,-30,-15,-57,-27,-68,12,-242
2,-46,-49,-17,-24,-23,-47,27,-177
-32,-196,-238,-37,-155,-121,-260,195,-844
-58,-121,-218,-126,-241,-254,-394,-21,-1433
-383,-840,-754,-380,-1259,-659,-1126,12,-5389
-6,-54,-46,-14,-42,-19,-33,49,-165
153,-78,-261,54,-200,63,-193,321,-141
13,-71,-85,-31,-32,-69,-108,60,-323
-2,-27,-45,-10,-30,-13,-38,14,-151
-5,-59,-51,-15,-53,-35,-63,51,-230
-2,-49,-72,-18,-89,-37,-91,8,-350
-30,-30,-28,-12,-38,-26,-30,6,-188
-61,-42,-29,-4,-119,-30,-61,11,-335
24,-121,-143,-40,-75,-101,-114,60,-510
68,-68,-72,6,-24,-51,-51,23,-169
4,-74,-105,-98,-68,-71,-182,49,-545
-84,-144,-181,33,-178,24,-190,133,-587
108,-24,-25,104,-34,-48,-21,69,129
15,-43,-36,-1,-66,-38,-77,19,-227
6,-63,-59,-22,-105,-69,-122,-42,-476
7,-16,-6,31,-40,-45,-56,2,-123
-38,-163,-145,-67,-131,-96,-155,21,-774
-27,-107,-104,29,-57,6,-135,41,-354
-103,-160,-181,-85,-199,-113,-260,30,-1071
-83,-81,-106,-132,-120,-135,-191,14,-834
21,-57,-57,42,-38,-3,-96,39,-149
339,-232,-199,79,-434,156,-178,703,234
23,-39,-55,-20,-62,-72,-141,33,-333
-55,-31,-73,-50,-36,-59,-84,-33,-421
-21,-170,-217,-89,-216,-33,-158,180,-724
-93,-99,-96,-46,-120,-15,-106,39,-536
-23,-21,-36,-20,-38,-8,-51,9,-188
-62,-127,-125,-31,-174,-70,-145,41,-693
-41,-65,-55,-21,-115,-25,-70,15,-377
-6,-45,-33,15,-51,-29,-47,6,-190
7,-49,-24,28,-72,-44,-85,8,-231
27,-28,-29,12,-43,-3,-36,54,-46
-64,-92,-91,-53,-163,-112,-257,5,-827
2,-100,-87,-7,-144,-95,-146,58,-519
-29,-108,-107,-41,-192,-72,-170,26,-693
-22,-34,-49,6,-56,-31,-57,-3,-246
-27,-71,-93,4,-135,-23,-106,51,-400
-21,-73,-89,0,-130,-35,-113,45,-416
-9,-184,-168,-10,-256,-112,-249,102,-886
37,-148,-207,27,-233,-144,-280,151,-797
-60,-143,-102,-33,-115,-28,-151,45,-587
-22,-154,-150,-72,-174,-20,-112,128,-576
-35,-40,-51,-15,-69,-19,-68,7,-290
119,-26,-22,97,-7,-60,-62,117,156
-19,-82,-92,12,-117,-50,-108,45,-411
-38,-82,-129,-57,-145,-104,-175,47,-683
-36,-31,-56,10,-62,-42,-93,16,-294
26,-38,-35,2,-25,-38,-62,27,-143
-7,-45,-41,-6,-54,-28,-60,52,-189
66,-17,-103,64,-131,-92,-179,65,-327
-29,-59,-71,6,-142,-48,-132,81,-394
-33,-68,-60,3,-122,-38,-92,58,-352
-43,-46,-43,-1,-49,4,-52,-2,-232
-7,3,-24,5,-6,-26,-19,7,-67
48,-86,-78,53,-83,-87,-129,89,-273
-10,-49,-64,-24,-41,-27,-38,10,-243
50,-2,-77,67,-47,-27,-66,16,-86
360,-628,-665,168,-1119,81,-583,997,-1389
4,-87,-61,28,-49,-11,-82,73,-185
-185,-355,-372,-41,-539,-144,-580,258,-1958
-66,-59,-54,-31,-94,-44,-144,-5,-497
82,-80,-58,47,-66,-187,-224,25,-461
-42,-146,-140,-61,-177,-63,-197,16,-810
-58,-69,-74,-4,-106,-69,-162,6,-536
-34,-7,-61,-1,-134,-36,-168,9,-432
-44,-98,-136,-23,-169,-69,-168,83,-624
-36,-51,-62,-15,-104,-51,-80,30,-369
-71,-94,-133,-33,-148,-67,-174,55,-665
42,-34,-45,-5,-18,-52,-91,66,-137
-7,-133,-114,-36,-85,-73,-99,21,-526
-12,-56,-59,-22,-117,-33,-84,19,-364
-89,-181,-200,-128,-264,-120,-248,85,-1145
-40,-122,-85,37,-150,-53,-101,73,-441
-16,-40,-27,-7,-84,-31,-62,15,-252
-47,-122,-122,-57,-238,-63,-180,64,-765
-48,-19,-43,2,-38,-1,-48,2,-193
-319,-412,-447,-121,-686,-195,-632,84,-2728
-266,-402,-484,-153,-705,-275,-658,65,-2878
-34,-97,-106,5,-197,3,-138,145,-419
5,-36,-24,59,-63,-17,-45,48,-73
-4,2,-17,-22,-49,-46,-46,4,-178
-54,-94,-152,5,-76,-13,-67,16,-435
-85,-56,-109,25,-22,-11,-59,-38,-355
-125,-175,-227,-28,-87,-26,-155,-3,-826
-143,-172,-227,-35,-97,-22,-115,58,-753
-86,-152,-169,-40,-92,-32,-85,21,-635
-37,-100,-143,52,-85,-35,-54,69,-333
-51,-86,-125,-7,-79,-5,-78,11,-420
-97,-151,-178,-52,-39,-23,-68,8,-600
8,-89,-159,-72,-142,-87,-191,110,-622
-3,-10,-4,-1,-12,-3,-6,6,-33
9,-69,-77,-40,-116,-77,-99,58,-411
26,-157,-144,-23,-216,-82,-149,133,-612
44,-71,-79,-39,-63,-82,-106,79,-317
-44,-87,-81,14,-74,-3,-84,25,-334
-31,-15,-42,-31,-23,-6,-35,4,-179
5,-102,-80,11,-106,-43,-78,35,-358
-315,-408,-468,-137,-713,-221,-668,91,-2839
-36,-165,-157,-19,-190,-65,-176,89,-719
-38,-82,-98,-8,-139,1,-163,13,-514
29,-45,-55,-18,-60,-68,-103,53,-267
-36,-73,-76,-51,-137,-29,-106,57,-451
-4,-77,-78,-25,-89,-76,-87,4,-432
18,-5,-8,9,-42,-36,-36,26,-74
-166,-379,-419,-216,-540,-300,-539,162,-2397
-22,-244,-340,1,-405,-201,-425,227,-1409
219,-25,-78,213,-158,-137,-209,200,25
-99,-300,-450,-248,-554,-519,-768,4,-2934
221,-139,-358,-249,-115,-18,-245,496,-407
73,-26,-26,116,-42,23,-64,131,185
24,-70,-189,30,-220,-69,-199,173,-520
25,-203,-242,5,-226,-87,-268,247,-749
-44,-96,-102,-25,-104,-68,-113,29,-523
-10,7,-9,11,-33,-9,-53,22,-74
-165,-111,-198,-133,-170,-159,-337,-148,-1421
-19,-57,-104,-51,-82,-65,-140,74,-444
492,-20,-68,209,171,-42,-118,668,1292
22,-149,-220,-134,-142,-209,-337,110,-1059
30,-273,-342,-148,-435,-229,-332,215,-1514
-80,-287,-445,-282,-399,-188,-380,157,-1904
-33,-21,-29,-16,-52,-33,-60,-7,-251
-52,-102,-144,-9,-180,-85,-201,110,-663
38,-106,-155,27,-147,-56,-140,146,-393
49,-72,-94,14,-109,-27,-103,169,-173
-5,-9,-22,-13,-19,-11,-34,21,-92
-12,-12,-30,-5,-27,-17,-33,18,-118
16,-154,-96,-10,-197,-111,-150,111,-591
50,-8,-84,-1,-68,-39,-84,68,-166
30,-189,-91,35,-161,-45,-198,218,-401
-34,-43,-74,-28,-77,-51,-61,21,-347
-36,-131,-174,-14,-180,-62,-212,83,-726
-29,-43,-63,-21,-86,-37,-108,14,-373
-38,-84,-119,-42,-143,-110,-185,42,-679
-76,-146,-124,-85,-96,-72,-188,-1,-788
-104,-137,-157,-59,-185,-44,-182,71,-797
-76,-120,-136,-73,-200,-83,-209,32,-865
16,-51,-39,7,-83,-56,-62,28,-240
22,6,-29,17,-49,-72,-55,14,-146
41,-130,-139,-117,-224,-151,-177,79,-818
-70,-123,-126,-52,-168,-44,-162,39,-706
47,-144,-203,105,-69,-69,-162,306,-189
81,-121,-143,119,-82,-134,-302,307,-275
-12,-56,-83,-28,-69,-44,-83,61,-314
89,-51,-64,78,-57,-63,-128,77,-119
80,-32,-86,11,-22,-55,-107,105,-106
-515,-94,-439,-508,-477,-517,-946,-393,-3889
-65,-32,-63,-26,-117,-26,-106,21,-414
-72,-98,-146,-1,-57,-38,-85,-43,-540
-14,-37,-45,-28,-61,-29,-65,-13,-292
22,-48,-55,-1,-71,-53,-95,42,-259
-6,-5,-18,4,-15,-18,-18,7,-69
-37,-76,-94,-44,-132,-102,-183,-1,-669
70,-34,-67,-3,-22,-57,-107,111,-109
-40,-119,-146,14,-200,-25,-180,96,-600
-68,-171,-157,17,-242,-32,-204,111,-746
-72,-135,-151,-46,-229,-34,-210,111,-766
-82,-225,-268,-107,-217,-194,-399,173,-1319
30,-12,-11,23,-8,-16,-10,33,29
-42,-100,-111,-35,-158,-32,-156,61,-573
13,-62,-71,-29,-42,-32,-63,60,-226
-4,-166,-223,-14,-153,-132,-260,98,-854
71,-81,-143,13,-84,-34,-126,155,-229
31,-68,-76,-15,-99,-32,-61,64,-256
62,-216,-190,-54,-252,-107,-196,227,-726
4,-33,-49,-19,-56,-20,-54,16,-211
-78,-83,-109,-27,-148,-4,-149,80,-518
45,-6,8,10,-7,-30,-29,35,26
-84,-44,-124,-84,-107,-90,-104,58,-579
136,-101,-23,38,-48,-83,-217,245,-53
26,-73,-78,3,-77,-28,-96,126,-197
-41,-151,-251,-111,-259,-146,-250,146,-1063
-10,-84,-58,8,-78,-16,-86,104,-220
15,-54,-53,18,-52,-10,-63,73,-126
5,-46,-57,12,-54,-6,-65,72,-139
9,-47,-66,14,-57,-13,-61,67,-154
47,-102,-76,27,-75,34,-85,152,-78
52,-197,-201,-16,-317,-197,-347,209,-1014
-37,-44,-46,-16,-58,-7,-47,20,-235
45,-159,-341,-43,-239,-29,-247,342,-671
-72,-55,-96,-46,-92,-8,-95,40,-424
-9,-131,-139,13,-240,-153,-240,10,-889
202,-51,-169,35,-6,-68,-86,232,89
-90,-131,-330,-214,-323,-488,-709,-214,-2499
3,-57,-55,3,-83,24,-42,81,-126
-48,-74,-56,-43,-78,-44,-90,35,-398
238,217,221,117,85,-25,-151,217,919
-59,-71,-71,-40,-83,-68,-90,-18,-500
19,-37,-71,71,-88,-13,-100,100,-119
-282,-318,-366,-292,-479,-268,-529,-42,-2576
-153,-221,-299,-145,-414,-302,-468,56,-1946
-83,-273,-322,-148,-472,-323,-449,68,-2002
-222,-278,-343,-177,-425,-202,-392,65,-1974
-115,-79,-137,-129,-135,-120,-232,-91,-1038
9,-177,-243,-21,-362,-190,-362,123,-1223
26,-120,-150,-28,-259,-56,-168,219,-536
-68,-47,-72,-47,-96,-63,-102,1,-494
67,-107,-174,27,-198,-93,-227,169,-536
48,-144,-135,39,-195,18,-147,190,-326
-15,-37,-36,14,-119,-76,-166,7,-428
-18,-31,-46,-4,-66,-21,-79,41,-224
22,-4,-59,28,-37,-13,-73,77,-59
-42,-126,-157,-51,-190,-141,-195,35,-867
-143,-162,-195,-102,-236,-143,-295,-59,-1335
8,-37,-48,-11,-49,-21,-68,43,-183
-102,-136,-167,-102,-190,-103,-202,-16,-1018
-20,-51,-85,-45,-87,-16,-104,85,-323
-95,-117,-160,-73,-203,-57,-226,9,-922
42,-18,-59,9,-73,-39,-112,97,-153
85,-125,-166,-3,-254,-22,-154,225,-414
77,-99,-85,62,-96,-76,-107,84,-240
3,-10,-25,9,-7,-6,-16,22,-30
0,-28,-37,12,-59,-21,-48,7,-174
-7,-57,-39,21,-65,-48,-90,-20,-305
22,18,-43,12,-31,-37,-65,39,-85
-40,-75,-63,-8,-127,-59,-128,-33,-533
34,-82,-25,23,-41,-50,-74,71,-144
-41,-75,-66,-11,-79,-9,-79,39,-321
-14,-60,-70,-33,-59,-49,-83,19,-349
6,-41,-42,-4,-20,-38,-58,26,-171
38,-59,-43,28,-71,-29,-75,92,-119
-46,-28,-36,-34,-95,-29,-62,12,-318
-3,-143,-156,-33,-189,-173,-258,5,-950
-153,-192,-272,-137,-362,-274,-378,-39,-1807
-24,-83,-105,16,-91,-13,-116,78,-338
1,-38,-62,-35,-96,-33,-57,45,-275
-42,-54,-91,-86,-3,-134,-166,-52,-628
-22,-79,-128,-46,-199,-175,-258,-1,-908
-1,-146,-139,-54,-246,-53,-129,121,-647
-10,-198,-143,-38,-207,-141,-179,32,-884
78,-98,-102,67,-83,-41,-177,273,-83
-73,-135,-165,-18,-238,-88,-212,69,-860
-87,-108,-119,-48,-121,-31,-127,20,-621
-20,-76,-84,-35,-135,-77,-116,70,-473
50,-15,1,9,14,-15,-18,58,84
-4,-42,-27,-12,-26,-26,-41,-4,-182
-29,-43,-53,-31,-55,-23,-67,2,-299
-35,-134,-185,-59,-186,-101,-217,34,-883
-44,-43,-103,7,-143,-46,-147,37,-482
-58,-103,-72,-25,-110,-20,-91,-5,-484
81,-122,-152,76,-169,-88,-192,231,-335
-40,-82,-102,-77,-159,-129,-185,-11,-785
-24,-90,-112,-40,-123,-30,-114,54,-479
-27,-6,-17,-41,-3,-74,-66,-5,-239
-118,-89,-123,-99,-165,-102,-213,-49,-958
-84,-70,-177,-60,-140,-40,-190,55,-706
-43,-25,-35,-31,-10,-8,-36,-5,-193
58,-62,-86,-9,-45,-32,-69,89,-156
40,7,32,55,-18,-9,-21,53,139
-9,-86,-123,11,-160,-107,-170,19,-625
-129,-185,-309,-51,-351,-79,-403,69,-1438
48,-127,-152,-17,-31,-88,-119,83,-403
-25,-80,-137,-37,-149,-61,-111,64,-536
-87,-75,-121,-112,-176,56,-165,66,-614
-30,-122,-85,-3,-143,-44,-144,19,-552
-38,-100,-117,-47,-119,-94,-105,31,-589
-37,-56,-87,-11,-22,10,-28,7,-224
-205,-22,-192,-263,-148,-223,-386,-228,-1667
-39,-87,-104,-39,-109,-81,-121,3,-577
6,-65,-78,-20,-63,-46,-81,50,-297
-24,-79,-54,-31,-106,-37,-72,26,-377
37,-24,-41,28,-87,-38,-65,47,-143
-5,-25,-21,-24,-56,-31,-38,10,-190
-13,-21,-59,-27,-53,-24,-76,84,-189
-65,-133,-139,15,-224,-71,-207,86,-738
31,-58,-66,-7,-38,-3,-76,123,-94
13,-52,-59,-31,-37,-27,-72,71,-194
-2,-62,-55,19,-102,-47,-91,58,-282
-14,-84,-47,8,-92,-39,-87,42,-313
-31,-86,-66,-18,-86,-44,-89,26,-394
-21,-21,-18,-19,-34,-2,-42,-8,-165
-21,-69,-43,14,-149,-22,-123,60,-353
-34,-53,-77,-46,-88,-51,-75,2,-422
-6,-14,-29,-6,-53,-18,-39,18,-147
-47,-71,-70,-52,-67,-21,-80,-2,-410
-15,-127,-147,-22,-213,-80,-162,143,-623
-92,-176,-161,-32,-174,-50,-201,4,-882
-257,-496,-669,-405,-964,-986,-1428,-347,-5552
48,-69,-253,68,-207,-113,-341,200,-667
3,-130,-211,-6,-258,41,-170,247,-484
-2,-65,-51,-2,-95,-15,-76,39,-267
7,-66,-65,-16,-90,-22,-75,43,-284
-39,-16,-39,-29,-23,-19,-54,26,-193
-90,-99,-111,-57,-130,-55,-163,17,-688
-69,-99,-118,-92,-126,-92,-154,28,-722
33,-53,-35,21,-49,-11,-25,31,-88
25,-8,-3,21,-31,-21,-12,23,-6
-3,-14,-19,-4,-16,-9,-26,10,-81
-2,-57,-82,-16,-81,-10,-29,86,-191
-50,-64,-66,-28,-89,-23,-93,-1,-414
38,-49,-57,14,-67,11,-49,84,-75
-51,-14,-43,-9,-27,-55,-77,15,-261
-41,-58,-62,1,-59,29,-76,45,-221
-39,-114,-121,-36,-149,-32,-135,81,-545
1,-60,-61,-7,-73,-39,-94,23,-310
-29,-280,-130,35,-279,-40,-237,196,-764
10,-117,-158,3,-268,-68,-172,128,-642
87,-14,0,67,-19,-78,-84,77,36
60,-54,-59,6,-83,-74,-75,20,-259
-75,-47,-97,-92,-160,-184,-222,-95,-972
-52,-139,-175,-26,-193,-35,-168,83,-705
-19,-28,-35,4,-43,13,-30,28,-110
-4,9,-94,0,-23,4,-86,101,-93
30,-16,-79,17,-114,-29,-58,106,-143
-8,-31,-40,1,-63,-44,-45,-8,-238
-55,-192,-126,45,-190,-11,-236,101,-664
-7,-72,-58,14,-54,-52,-94,9,-314
-90,-66,-117,-122,-60,-69,-163,-34,-721
28,-56,-65,-9,-71,-63,-78,38,-276
-82,-81,-61,-53,-107,-41,-152,4,-573
-71,-105,-114,-52,-87,-52,-103,6,-578
-30,-48,-44,-36,-51,-45,-88,-39,-381
5,-4,-27,15,-38,-40,-54,62,-81
78,-197,-185,-51,-275,-160,-256,161,-885
-16,-109,-182,-57,-223,-178,-306,61,-1010
-41,-132,-118,-24,-188,-97,-156,35,-721
-37,-125,-169,-62,-128,-44,-141,142,-564
-18,-30,-34,1,-56,-9,-47,25,-168
4,-8,-39,26,-74,-2,-64,41,-116
10,-8,-47,20,-64,8,-74,65,-90
-1,-8,-17,13,-16,6,-14,11,-26
3,-7,-17,5,-25,-17,-22,16,-64
-43,-148,-166,32,-204,-15,-178,122,-600
-3,-20,-32,3,-49,12,-38,32,-95
-139,-192,-211,-83,-325,-95,-321,80,-1286
-11,-19,-28,-23,-34,-35,-44,-2,-196
-54,-25,-41,31,-59,-29,-118,-4,-299
19,-44,-63,-43,-55,-56,-82,38,-286
-80,-111,-111,-37,-147,-2,-114,59,-543
-75,-108,-126,-38,-146,-54,-126,34,-639
8,-160,-198,-19,-322,-56,-239,205,-781
-63,-110,-149,-87,-145,-91,-156,-12,-813
-28,-94,-139,-43,-97,-25,-109,49,-486
-105,-142,-175,-73,-232,-12,-201,53,-887
-33,-33,-31,-17,-25,-4,-64,1,-206
-44,-63,-55,23,-84,-53,-139,35,-380
-457,-677,-861,-215,-1067,-434,-1238,106,-4843
63,-33,-3,110,-1,-60,-115,89,50
47,-8,-14,75,-12,-14,-29,32,77
-23,-132,-122,-38,-148,-92,-140,28,-667
100,78,-41,65,-120,-99,-188,79,-126
65,-53,10,27,-55,-107,-90,84,-119
38,-97,12,-64,-41,-154,-90,83,-313
-178,-105,-180,-160,-70,-68,-270,-141,-1172
60,-29,-38,48,-16,-26,-27,100,72
-53,4,-27,-12,-75,0,-121,-7,-291
-42,-139,-99,17,-153,-69,-139,86,-538
-36,-143,-93,11,-149,-76,-140,43,-583
-59,-45,-61,0,-68,-24,-81,-31,-369
62,-133,-92,-89,-59,-70,-117,130,-368
20,-69,-36,82,-57,-75,-124,76,-183
20,-42,-62,18,-114,-87,-131,35,-363
-34,-56,-60,-47,-70,-69,-95,4,-427
35,-172,-206,27,-186,-50,-202,229,-525
-1,-32,-61,-19,-30,-39,-73,23,-232
-29,-189,-234,-155,-287,-259,-333,43,-1443
47,-12,8,48,-17,-24,-59,51,42
-5,-29,-26,4,-24,-30,-30,5,-135
18,-37,-44,10,-59,-27,-19,32,-126
-1,-4,-17,1,-6,4,-40,-2,-65
-17,-28,-15,-1,-27,6,-30,9,-103
131,75,22,195,-40,76,-143,258,574
-8,-56,-47,-22,-63,-16,-57,56,-213
-17,-27,-56,-37,-40,-56,-56,12,-277
-11,-9,-15,3,-57,-18,-57,4,-160
128,63,135,167,116,-13,25,147,768
54,-68,-78,68,-144,-79,-132,101,-278
-11,2,3,6,-12,3,-19,10,-18
17,-20,-26,-6,-35,-23,-33,21,-105
-40,-22,-49,-26,-62,-34,-68,8,-293
-34,-85,-71,0,-98,-28,-82,21,-377
32,-36,-74,-2,-63,-56,-116,43,-272
35,-43,-24,33,-38,-16,-38,39,-52
-23,-55,-45,-33,-47,-17,-73,-5,-298
27,-70,-68,24,-72,-48,-86,63,-230
7,-52,-57,5,-71,-46,-102,65,-251
-9,-88,-97,-72,-69,-94,-180,97,-512
-3,-122,-172,-116,-141,-212,-255,75,-946
-27,-119,-101,18,-105,-57,-132,-17,-540
-23,-93,-122,-34,-167,-33,-169,46,-595
36,-60,-67,0,-42,-57,-87,73,-204
162,-36,9,201,-5,-69,-157,256,361
18,-18,-41,-19,-49,-53,-76,22,-216
-27,-29,-127,-54,-122,-102,-147,6,-602
-84,-95,-98,-21,-137,13,-95,50,-467
-81,-89,-73,-54,-117,-19,-88,39,-482
-78,-93,-100,-20,-134,-13,-114,37,-515
-62,-93,-91,-33,-128,-25,-114,46,-500
-44,-83,-82,-5,-111,14,-89,78,-322
-68,-80,-98,0,-121,-28,-107,40,-462
-3,-24,-49,-23,-74,-91,-127,-2,-393
-62,-105,-107,-20,-113,-16,-112,49,-486
-5,-35,-47,-30,-82,-32,-71,-2,-304
10,-42,-75,-6,-71,-36,-84,56,-248
25,-56,-9,-13,16,-80,-122,134,-105
9,-51,-94,-34,-83,-103,-160,30,-486
-288,-57,-209,-222,-316,-289,-573,-175,-2129
-23,-80,-78,-42,-147,-39,-109,42,-476
-35,-88,-95,-62,-123,-68,-124,21,-574
212,0,-213,198,-147,-26,-252,418,190
-16,-40,-38,-20,-30,-20,-35,16,-183
-49,-46,-94,-49,-102,-65,-110,10,-505
4,-2,-23,-1,23,-6,-4,17,8
71,-291,-522,-114,-405,-168,-384,284,-1529
37,-15,-53,-4,-58,-92,-105,13,-277
56,-63,-17,10,-50,-58,-105,83,-144
9,-55,-21,-11,-46,-22,-50,54,-142
1,-52,-34,11,-53,-2,-44,39,-134
10,8,7,55,-26,-14,-49,44,35
4,-192,-172,-74,-221,-63,-245,135,-828
28,-26,-23,15,-43,-28,-29,31,-75
-50,-26,-79,-24,-9,-43,-97,30,-298
-73,-11,-80,-50,-11,-36,-111,50,-322
-40,-39,-70,-40,-33,-58,-94,12,-362
24,-53,-32,30,-45,-8,-59,58,-85
-60,78,5,78,78,-74,78,0,183
19,-85,-99,0,-173,-19,-149,137,-369
293,3,-120,121,-79,-26,-88,381,485
13,-30,-14,46,-64,8,-32,64,-9
-32,-64,-126,-53,-140,-73,-151,64,-575
56,-91,-125,-40,-113,-3,-57,134,-239
4,6,-28,-14,-7,-26,-35,24,-76
132,-107,-140,13,-113,-124,-256,247,-348
-5,-79,-43,-11,-92,-19,-64,28,-285
-7,-45,-43,-34,-75,-85,-158,56,-391
-42,-101,-111,-24,-143,-55,-120,36,-560
12,-40,-21,6,-25,-57,-89,7,-207
100,-168,-339,-23,-240,-110,-263,301,-742
77,-52,-75,40,-94,-62,-119,84,-201
43,-420,-726,-135,-1096,-576,-1130,507,-3533
-12,-76,-139,-42,-171,-76,-184,54,-646
-23,-77,-47,-13,-104,-53,-102,14,-405
-60,-121,-135,-37,-141,22,-105,92,-485
-102,-116,-145,-66,-167,-29,-135,83,-677
-8,-76,-65,-6,-79,11,-47,82,-188
2,-12,-21,7,-33,-59,-95,38,-173
-32,-38,-23,-9,-61,-10,-66,26,-213
206,-378,-580,-280,-585,-472,-836,611,-2314
-1,-2,24,41,-42,2,-37,52,37
-74,-70,-105,-49,-85,-61,-139,-19,-602
11,-47,-6,5,-43,18,-12,47,-27
18,-35,-43,33,-63,-10,-67,43,-124
24,-4,-17,24,-33,-65,-105,39,-137
15,-55,-64,0,-56,-46,-79,5,-280
128,-43,-93,124,-67,-57,-187,286,91
-5,-66,-66,-16,-58,-26,-78,62,-253
37,-85,-80,8,-58,-40,-62,83,-197
-48,-100,-56,1,-66,-15,-85,-1,-370
-16,-138,-230,-114,-191,-108,-359,60,-1096
-47,-65,-83,-65,-105,-18,-127,1,-509
13,-44,-62,-24,-84,-56,-98,18,-337
-14,-36,-58,-14,-63,-36,-94,16,-299
-1,-4,-8,-6,-10,12,-17,29,-5
-37,-128,-118,-65,-143,-58,-162,49,-662
-54,-116,-114,-52,-148,-13,-101,54,-544
10,-26,-17,4,-36,-22,-37,10,-114
-22,-59,-32,-23,-68,-33,-74,46,-265
-41,-120,-111,-54,-167,-94,-181,-10,-778
-12,24,-3,-9,-22,-58,-86,-36,-202
8,-59,-73,0,-100,-71,-124,17,-402
-3,-14,-17,-8,-35,-10,-29,18,-98
-61,-67,-83,-35,-141,19,-111,77,-402
-9,1,-6,-9,-10,-4,-16,-8,-61
-56,-59,-85,-25,-97,-46,-119,4,-483
24,5,-6,21,-5,-17,-1,-1,20
25,11,5,34,-7,7,-20,56,111
-143,-200,-197,-26,-235,-32,-248,60,-1021
67,-15,-11,51,-48,-34,-25,37,22
-262,-356,-384,-66,-532,-33,-536,318,-1851
-222,-382,-405,-104,-603,-167,-647,314,-2216
-26,-100,-105,-67,-121,-68,-151,52,-586
20,-77,-97,3,-124,-78,-124,68,-409
9,-34,-37,-38,-47,-21,-79,59,-188
-8,-36,-32,13,-69,-13,-48,11,-182
-25,-100,-118,5,-91,-60,-132,81,-440
237,-313,-540,91,-225,-419,-671,421,-1419
46,-64,-52,63,-53,-38,-65,73,-90
-44,-61,-73,-23,-84,-34,-66,32,-353
-78,-121,-137,-46,-61,-13,-56,-25,-537
-18,-44,-51,-16,-23,-12,-30,-13,-207
-51,-113,-162,-9,-74,-26,-95,41,-489
-37,-80,-114,21,-44,-31,-90,38,-337
-56,-59,-66,-33,-20,-15,-42,-16,-307
107,-99,-40,-6,20,-116,-95,148,-81
-35,-73,-87,2,-31,-15,-44,12,-271
3,-5,-17,6,-5,-7,-8,7,-26
13,-29,-40,-11,-49,-29,-43,21,-167
-72,-141,-178,-28,-259,-88,-267,75,-958
-17,-74,-73,-9,-81,-38,-101,32,-361
30,-12,-20,9,-5,-9,-20,15,-12
-46,-38,-53,-35,-63,-29,-62,13,-313
48,-11,-51,78,-27,-46,-58,68,1
-38,-17,-44,-5,-39,-53,-144,46,-294
-75,-80,-94,-49,-112,-79,-161,-25,-675
10,-63,-53,29,-96,-28,-82,31,-252
36,-41,-89,7,-96,-48,-91,96,-226
33,-14,-87,-23,-63,-43,-117,63,-251
6,-4,-40,-9,-25,-17,-45,48,-86
-44,-102,-105,-21,-183,-51,-158,30,-634
-67,-109,-123,-20,-170,-59,-166,38,-676
-55,-133,-125,-35,-196,0,-166,98,-612
-39,-87,-85,-16,-140,46,-118,100,-339
-19,-31,-59,-22,-61,-44,-98,5,-329
-46,-139,-159,-17,-202,-29,-166,85,-673
-21,-54,-77,-11,-132,-73,-200,-15,-583
43,-202,-240,109,-398,-55,-340,253,-830
46,-1,-3,-6,5,-27,-24,49,39
4,-21,-18,13,-15,-10,-17,13,-51
9,-9,-22,13,-5,-12,-27,-1,-54
-24,-168,-140,4,-163,-77,-161,85,-644
-19,-78,-92,-54,-151,-45,-138,36,-541
-29,-114,-87,1,-112,41,-88,107,-281
11,-38,-63,-31,-57,-49,-69,54,-242
-84,-153,-168,-45,-259,-102,-294,96,-1009
1,-102,-150,-71,-219,-148,-281,48,-922
-43,-146,-157,-63,-216,-89,-203,102,-815
-2,-27,-11,-7,-31,-19,-39,21,-115
-47,-82,-103,-24,-107,-39,-109,31,-480
-7,-21,-23,-7,-30,-7,-33,19,-109
-26,-124,-103,-4,-90,35,-82,58,-336
2,-25,-37,-14,-40,-33,-34,23,-158
-26,-79,-58,10,-108,-67,-143,23,-448
-2,-5,-17,14,-1,-8,-22,4,-37
-49,-136,-208,-65,-291,-35,-230,138,-876
-29,-63,-60,-29,-78,-41,-68,26,-342
18,-57,-33,-4,-11,-37,-66,16,-174
-100,-105,-105,-81,-117,-49,-155,17,-695
-30,-64,-94,-8,-148,-84,-185,89,-524
-20,-78,-46,-6,-96,-50,-72,0,-368
-6,-24,-18,-14,-39,-26,-11,31,-107
-41,-51,-66,-69,-77,-94,-94,-55,-547
-12,-8,-34,0,-43,2,-38,20,-113
65,-85,-59,32,-170,-68,-135,95,-325
-20,-39,-29,-15,-11,-1,-24,16,-123
-8,-16,-31,9,-35,-10,-47,27,-111
46,-75,-56,18,-139,-3,-69,100,-178
-37,-78,-72,3,-63,22,-98,62,-261
-12,-48,-45,-14,-42,-19,-42,18,-204
-11,-13,-22,-13,-20,-15,-30,0,-124
-20,-8,-18,-35,-55,-37,-60,-17,-250
-13,-62,-52,1,-67,5,-58,57,-189
33,-85,-85,-18,-95,-76,-104,25,-405
-10,-9,-16,-13,-18,-21,-39,-1,-127
-26,-52,-92,-36,-102,-90,-151,20,-529
3,-98,-111,-17,-162,-94,-181,57,-603
41,-59,-60,24,-95,-33,-45,36,-191
-21,-110,-113,-35,-113,-40,-123,93,-462
34,-87,-74,-56,-118,-137,-222,141,-519
-9,-4,-42,5,-61,36,-31,66,-40
-21,-91,-77,-65,-99,-88,-96,27,-510
-50,-132,-140,-53,-96,-88,-149,3,-705
-49,-60,-78,-61,-95,-30,-114,6,-481
24,-31,-33,19,-54,-16,-39,62,-68
4,-21,-35,12,-38,-29,-51,18,-140
-42,-22,-82,0,-47,-34,-56,28,-255
-59,-105,-100,2,-129,-10,-144,33,-512
6,-34,-26,10,-8,12,-21,23,-38
-6,-64,-61,-19,-37,-83,-139,25,-384
-5,-24,-46,-3,-53,-41,-59,33,-198
-5,-11,-15,-9,-6,-4,-9,10,-49
-43,-46,-63,-35,-80,-46,-93,3,-403
-3,-37,-36,-3,-50,-20,-60,33,-176
15,-24,-56,-24,-57,-65,-89,-8,-308
-27,-128,-127,14,-158,-12,-142,100,-480
14,-43,-37,-23,-42,-51,-115,29,-268
-28,-35,-33,-25,-93,-11,-80,15,-290
-6,-82,-36,58,-72,-20,-95,93,-160
29,10,0,18,-18,-23,-34,19,1
-17,-18,-20,8,-16,7,-9,11,-54
-38,-7,-52,-47,-49,-17,-63,99,-174
66,-47,13,18,-75,-98,-137,135,-125
32,-64,-38,-7,-9,-31,-66,66,-117
-35,-60,-52,-30,-63,-32,-69,9,-332
57,-17,-18,24,-29,-17,-72,76,4
92,-49,-71,7,-43,-88,-150,63,-239
-9,-41,-53,-5,-53,-64,-58,3,-280
-25,-76,-92,-53,-138,-104,-160,3,-645
62,-38,-86,22,-72,-2,-67,82,-99
129,-114,-26,125,-45,-41,-83,142,87
21,-36,-54,-1,-59,-31,-70,55,-175
-43,-55,-57,-57,-81,-35,-74,28,-374
6,-65,-60,-5,-99,-39,-78,56,-284
-8,-13,-23,-5,-21,-16,-29,7,-108
104,-77,-84,27,-109,-73,-72,77,-207
32,-77,-74,44,-113,-26,-74,69,-219
-21,-87,-92,6,-170,-58,-156,34,-544
-7,-20,-30,-2,-33,-33,-35,14,-146
-1,-29,-35,1,-23,-17,-21,26,-99
21,-106,-121,1,-127,-39,-113,103,-381
-24,-141,-157,-59,-68,45,-112,106,-410
-30,-41,-41,-10,-71,-31,-50,7,-267
-93,-61,-107,-78,-74,-61,-108,-48,-630
-29,-68,-108,-62,-114,-129,-201,20,-691
-4,-12,-10,0,-35,-18,-28,22,-85
103,-36,-9,97,-38,-103,-146,100,-32
4,-103,-75,-11,-139,-79,-131,61,-473
-6,-82,-102,-26,-97,-56,-102,52,-419
-23,-31,-19,-19,-39,-28,-43,4,-198
-52,-67,-73,-3,-96,-19,-86,62,-334
0,-46,-46,-2,-66,4,-59,46,-169
-52,-195,-157,34,-269,-30,-230,128,-771
-5,-21,-24,-21,-12,-16,-30,-23,-152
-30,-85,-85,-28,-118,-40,-100,-6,-492
-26,-106,-196,-70,-284,-41,-239,111,-851
-46,-81,-62,9,-110,-32,-86,36,-372
-36,-41,-35,-12,-69,-45,-74,33,-279
-22,-170,-209,-52,-249,-149,-297,134,-1014
7,-53,-53,-15,-80,-31,-66,39,-252
-6,-23,-20,0,-27,-29,-59,-15,-179
1,-70,-52,-3,-77,-54,-102,16,-341
-17,-34,-27,-9,-45,-21,-59,-13,-225
23,-92,-56,-5,-96,-39,-70,77,-258
-6,-21,-33,4,-47,-28,-42,21,-152
-10,-44,-60,-33,-64,-42,-44,11,-286
3,-4,-30,-5,-29,-25,-37,9,-118
-7,-31,-34,-5,-20,-5,-23,20,-105
-17,-387,-388,45,-548,-203,-641,373,-1766
5,-33,-62,-35,-63,-98,-150,55,-381
0,-89,-60,-29,-136,-34,-90,60,-378
-19,-81,-86,-8,-135,-56,-114,27,-472
35,-69,-112,-13,-111,-75,-179,115,-409
-37,-81,-55,-41,-98,-39,-93,33,-411
10,-86,-73,76,-129,16,-108,124,-170
8,-66,-41,95,-152,43,-108,149,-72
9,-68,-202,48,-178,31,-145,122,-383
8,-70,-48,18,-111,-48,-125,65,-311
13,-196,-167,-26,-216,-123,-296,137,-874
-35,-286,-224,-1,-252,38,-215,244,-731
9,-21,-69,25,-83,-19,-93,50,-201
21,-27,-73,39,-77,-42,-116,40,-235
-23,-48,-56,-6,-85,-9,-77,18,-286
-8,-127,-84,29,-165,-17,-165,130,-407
14,-67,-75,-14,-80,-31,-65,29,-289
3,-83,-34,22,-63,-19,-47,48,-173
41,-113,-168,-54,-176,-169,-258,95,-802
-51,-80,-86,-34,-92,-43,-126,-1,-513
-20,-63,-76,-28,-109,3,-81,51,-323
62,-147,-69,43,-152,-83,-172,147,-371
-24,-66,-53,-22,-77,-42,-82,16,-350
-5,-8,-10,2,-37,-6,-27,-2,-93
-8,-36,-47,-17,-52,-34,-84,7,-271
-45,-113,-116,-31,-124,-50,-123,29,-573
-35,-78,-80,-12,-122,-41,-101,19,-450
-10,-43,-22,9,-46,-11,-30,-1,-154
-55,-111,-102,-30,-128,-39,-133,27,-571
8,-21,-41,1,-12,-9,-43,23,-94
6,-130,-149,-26,-179,-150,-235,-42,-905
-1,-22,-50,-42,-73,-44,-57,26,-263
-43,-66,-70,-21,-77,-57,-98,14,-418
23,-96,-120,15,-138,-58,-131,105,-400
56,-117,-79,9,-106,-126,-199,96,-466
44,-151,-252,-38,-136,-104,-219,147,-709
-25,-10,-20,-7,-16,9,-17,6,-80
-8,-17,-17,-3,-25,-5,-21,11,-85
-55,-108,-156,-92,-175,-122,-243,29,-922
14,-87,-130,-46,-216,-195,-254,-15,-929
44,1,-114,30,-131,-41,-105,134,-182
2,-48,-18,-25,-10,-5,-31,40,-95
-53,-181,-164,-37,-183,-73,-254,45,-900
19,45,-182,154,-74,92,-191,195,58
-58,-59,-134,-101,-157,-227,-306,-35,-1077
-11,-30,-61,-60,-74,-103,-135,-14,-488
-20,-73,-64,4,-146,-70,-98,26,-441
-16,-84,-116,-59,-175,-135,-177,33,-729
-9,-86,-62,41,-94,8,-82,72,-212
-69,-112,-171,-46,-148,-62,-203,72,-739
246,298,283,170,93,56,-152,342,1336
90,-71,-35,102,-79,-30,-128,151,0
-20,-31,-40,-16,-24,-11,-51,13,-180
38,-52,-85,8,-93,-96,-152,93,-339
-3,-24,-34,-6,-44,-24,-45,18,-162
7,4,-41,10,-24,16,-44,66,-6
-6,-8,-26,-12,-15,-10,-46,19,-104
-24,-17,-16,-23,-21,-23,-53,-20,-197
-16,-78,-68,-48,-103,-56,-82,58,-393
-2,-65,-82,-46,-7,-47,-51,54,-246
-51,-141,-146,1,-192,-5,-156,139,-551
-29,-67,-86,-6,-89,-45,-99,13,-408
-26,-68,-100,-15,-108,-59,-122,24,-474
19,-9,-14,26,-42,-56,-135,73,-138
-31,-95,-156,-75,-175,-145,-253,6,-924
-10,-12,-19,-2,-16,-21,-25,16,-89
-110,-106,-120,-67,-140,-138,-300,13,-968
-39,-57,-104,-60,-178,-129,-168,22,-713
-23,-80,-73,-27,-90,-51,-102,18,-428
-26,-45,-45,-42,-25,-30,-58,45,-226
-11,-3,-15,1,-14,-10,-20,-6,-78
-18,-56,-63,-40,-44,-26,-60,38,-269
-8,-32,-18,-1,-7,-1,-15,16,-66
54,-44,-27,-11,-56,-30,-77,72,-119
-4,-74,-152,-42,-132,-98,-190,40,-652
89,-134,-227,23,-105,-121,-218,135,-558
-10,-55,-30,21,-46,-17,-49,10,-176
-44,-20,-43,-50,-24,-22,-48,35,-216
79,-151,-195,-134,-202,-202,-273,175,-903
-50,-77,-98,-10,-113,-46,-122,45,-471
73,-169,-195,-133,-230,-284,-386,131,-1193
-1,-37,-56,-21,-58,-12,-44,58,-171
8,-33,-49,-6,-58,-35,-42,48,-167
-12,-46,-64,-11,-70,-51,-57,32,-279
-75,-199,-241,-86,-328,-206,-335,-47,-1517
-40,-31,-49,22,-35,-17,-80,14,-216
-18,-72,-96,-61,-95,-113,-155,7,-603
-43,-7,-35,-21,-21,-34,-55,9,-207
-21,-141,-171,-78,-201,-187,-236,42,-993
-24,-39,-49,-37,-55,-55,-71,1,-329
235,-114,-182,117,-110,18,-98,353,219
187,-165,-367,91,-205,-58,-226,353,-390
-41,-139,-167,-25,-268,-80,-249,143,-826
-17,-75,-81,10,-50,-19,-79,45,-266
163,-171,-362,145,-253,-179,-489,480,-666
44,-70,-86,1,-91,-113,-150,59,-406
105,-672,-761,161,-908,-91,-800,921,-2045
-32,-216,-247,20,-211,-126,-198,67,-943
-104,-40,-197,-215,-298,-309,-442,-27,-1632
-11,-47,-50,-25,-38,-32,-69,16,-256
85,-130,-249,-61,-154,-71,-293,244,-629
-95,-149,-143,-56,-78,-30,-114,22,-643
-12,-41,-32,7,-37,-11,-46,2,-170
-108,-29,-94,-53,-129,-88,-179,45,-635
13,-39,-68,-51,-67,-46,-51,48,-261
-24,-27,-36,-18,-40,-32,-32,17,-192
-22,-38,-65,-10,-72,-13,-68,35,-253
-13,-28,-27,-14,-15,-10,-24,16,-115
136,-503,-328,315,-274,354,-186,448,-38
52,-62,-69,-37,-69,-106,-137,77,-351
3,38,39,148,-91,11,-132,47,63
114,-60,-139,24,-74,-117,-114,160,-206
-19,-7,-24,-16,-32,-13,-35,12,-134
3,-50,-122,-4,-98,-43,-120,43,-391
-41,-17,-64,-64,-62,-104,-179,-55,-586
38,-85,-89,46,-113,-6,-118,127,-200
-179,-245,-228,-110,-359,-125,-325,10,-1561
9,1,-38,2,-30,-28,-44,29,-99
15,-85,-87,-31,-140,-56,-151,90,-445
94,-160,-297,49,-317,-103,-377,291,-820
-33,-54,-97,-77,-148,-132,-186,-13,-740
-68,-174,-211,15,-354,-60,-297,130,-1019
104,-87,-93,-6,-113,-183,-264,87,-555
-81,-113,-146,-39,-228,-51,-227,95,-790
-29,-63,-100,-21,-126,-31,-102,68,-404
-13,-116,-64,40,-100,-35,-119,59,-348
64,-77,-104,-61,-84,-148,-174,114,-470
-74,-110,-160,-40,-94,-4,-103,18,-567
-80,-134,-153,-32,-91,-47,-82,7,-612
-3,-39,-27,7,-23,-3,-37,-11,-136
38,-47,-73,-3,-61,-102,-159,56,-351
-23,-21,-50,-9,-27,-29,-60,13,-206
53,-125,-122,-15,-133,-7,-82,139,-292
-85,-236,-306,-174,-303,-226,-373,164,-1539
-4,-158,-170,15,-254,-172,-289,132,-900
-33,-114,-196,-29,-266,-65,-286,97,-892
4,-33,-25,-9,-28,-28,-23,17,-125
-50,-99,-92,-20,-143,-33,-114,92,-459
96,-76,-98,3,-66,-90,-155,85,-301
-23,-111,-129,-69,-132,-132,-91,79,-608
17,-21,-18,-11,-65,-57,-80,-19,-254
-110,-292,-376,-147,-467,-137,-456,162,-1823
-127,-199,-179,-93,-246,-80,-228,49,-1103
90,-47,-102,21,-192,-123,-195,97,-451
11,-18,-9,15,-42,-5,-21,34,-35
95,-82,-125,21,-110,-147,-202,160,-390
1,-45,-44,-3,-57,-41,-56,17,-228
40,-49,-105,-22,-150,-95,-177,86,-472
-28,-99,-115,-31,-148,-108,-179,39,-669
38,-9,-39,3,-31,-32,-43,55,-58
-14,-27,-29,-8,-72,-33,-53,17,-219
-67,-95,-105,-26,-142,-3,-125,74,-489
-104,-63,-89,-56,-90,-103,-163,-64,-732
-30,-66,-119,-106,-164,-238,-292,-63,-1078
-23,-66,-142,-64,-232,-141,-280,34,-914
-11,-74,-128,-51,-128,-112,-193,113,-584
54,-77,-62,12,-89,-72,-133,83,-284
7,-41,-64,-14,-22,-56,-63,0,-253
46,-97,-151,3,-115,-88,-84,127,-359
-21,25,2,12,-33,-51,-71,-14,-151
-12,3,-28,9,-41,-6,-48,10,-113
-8,-71,-88,-13,-150,-18,-97,50,-395
-17,-292,-334,-155,-440,-356,-549,191,-1952
-63,-88,-173,-59,-98,-14,-60,88,-467
-98,-115,-136,-40,-175,-89,-193,-16,-862
-87,-65,-122,-55,-226,-107,-184,15,-831
2,-92,-129,-4,-175,-83,-198,18,-661
-12,-20,-43,19,-30,-69,-91,-6,-252
-37,-76,-174,-51,-109,-72,-158,22,-655
-1,-87,-71,39,-96,-74,-124,3,-411
-18,-112,-105,16,-107,-96,-117,73,-466
165,153,128,108,18,33,-126,247,726
-6,-161,-224,-80,-287,-177,-362,135,-1162
-78,-101,-186,-134,-168,-133,-287,-34,-1121
-33,-42,-82,-45,-120,-40,-102,43,-421
-6,-70,-73,11,-83,20,-92,129,-164
-33,-117,-213,-173,-224,-290,-399,-47,-1496
-41,-33,-67,-56,-85,-76,-112,-22,-492
11,-90,-76,-42,-95,-113,-143,54,-494
168,-57,-102,88,-73,-211,-248,158,-277
1,-204,-235,-26,-267,-31,-188,238,-712
-91,-89,-123,-5,-85,-16,-111,-15,-535
-48,-103,-121,-77,-78,-69,-125,0,-621
10,-60,-96,-20,-100,-2,-69,76,-261
-26,-117,-100,-5,-165,-76,-129,38,-580
-38,-44,-64,-46,-80,-27,-69,45,-323
-14,-263,-304,-76,-337,-117,-294,214,-1191
55,-57,-78,61,-86,-19,-121,146,-99
-144,-167,-242,-125,-273,-110,-297,60,-1298
-24,-78,-79,-58,-111,-157,-199,10,-696
-9,-44,-59,-18,-62,6,-45,64,-167
0,-40,-51,-21,-63,-17,-40,49,-183
-11,-35,-51,-31,-65,-12,-49,50,-204
-35,-41,-58,-33,-79,-44,-88,34,-344
-21,-73,-67,7,-58,-12,-79,24,-279
-12,-19,-13,-5,-20,-10,-13,13,-79
-30,-23,-25,-17,-19,-11,-32,7,-150
-16,-24,-23,-8,-25,-7,-21,1,-123
-17,-18,-23,3,-15,-1,-11,11,-71
-23,-20,-23,-21,-18,-14,-23,-6,-148
-28,-22,-18,-7,-27,-8,-30,-6,-146
-16,-35,-26,-11,-20,6,-26,-3,-131
-18,-25,-27,-1,-10,5,-17,2,-91
-25,-16,-13,-8,-14,-5,-19,-5,-105
-34,-13,-12,-17,-24,-11,-29,2,-138
-149,-172,-174,-20,-258,-43,-287,57,-1046
-89,-106,-193,-17,-91,-30,-127,-20,-673
-98,-123,-116,-60,-132,-56,-122,-23,-730
71,-109,-121,24,-179,-126,-176,106,-510
-31,-41,-36,-29,-39,-27,-33,12,-224
-26,-133,-236,-25,-169,20,-139,161,-547
35,-66,-117,-49,-111,-107,-151,99,-467
122,-146,-59,39,3,-95,-152,100,-188
42,50,-86,4,-54,-42,-98,34,-150
-27,-90,-111,-57,-173,-92,-142,51,-641
-21,-42,-66,-20,-37,-16,-41,34,-209
8,-147,-119,31,-149,-104,-169,20,-629
-39,-96,-93,-50,-118,-34,-93,23,-500
70,-26,-78,47,-172,-80,-176,204,-211
49,52,21,76,-29,49,15,74,307
-17,-30,-40,-22,-23,-30,-59,30,-191
-8,-79,-63,-4,-90,-7,-71,47,-275
-39,-75,-76,-33,-101,-54,-93,2,-469
-11,-145,-110,2,-108,-39,-170,109,-472
-93,-338,-370,-132,-507,-255,-501,173,-2023
-8,-22,-69,4,-51,-26,-53,55,-170
-7,-20,-12,4,-14,-2,-31,-8,-90
-10,-45,-39,-6,-103,-54,-72,66,-263
-17,-21,-20,0,-28,-8,-26,14,-106
-28,-159,-230,32,-281,-150,-311,57,-1070
1,-41,-45,-15,-42,-39,-73,78,-176
-80,-123,-158,-110,-60,-83,-158,-5,-777
42,-64,-30,7,-50,25,-25,138,43
19,-79,-84,-16,-48,-88,-144,69,-371
-118,-63,-196,-83,-190,-173,-309,37,-1095
-90,-20,-134,-63,-136,-123,-212,63,-715
35,-76,-61,52,-42,86,-27,110,77
16,-35,-32,-16,-21,-34,-64,49,-137
2,-44,-56,-29,-45,-42,-64,32,-246
24,-87,-133,-30,-67,-139,-169,43,-558
5,-37,-37,6,-48,-38,-35,16,-168
-62,-165,-145,18,-187,-55,-188,107,-677
-77,-78,-92,-14,-58,-26,-70,-6,-421
5,-31,-34,-13,-40,-37,-43,25,-168
-19,-41,-55,-25,-41,-34,-67,13,-269
-27,-48,-53,-37,-51,-32,-64,-21,-333
-31,-63,-82,-48,-67,-65,-84,0,-440
-58,-56,-94,-35,-131,-17,-105,73,-423
-11,-24,-36,-30,-18,-12,-41,33,-139
-116,-141,-183,-38,-55,-8,-103,-19,-663
18,-65,-102,-11,-109,-80,-96,37,-408
43,-63,-119,-70,-87,-113,-214,116,-507
4,-53,-65,1,-61,-2,-56,56,-176
72,-122,-145,-107,5,-150,-258,76,-629
-56,-130,-141,-14,-91,-34,-110,55,-521
1,-77,-89,-46,-115,-79,-136,7,-534
-14,-43,-46,16,-68,-49,-89,-3,-296
-77,-73,-148,-131,-152,-173,-221,9,-966
-42,-107,-134,-24,-145,-52,-133,79,-558
-4,-28,-24,-6,-22,3,-33,13,-101
-3,-52,-31,-42,-39,-40,-65,47,-225
-25,-42,-61,-44,-75,-54,-88,-6,-395
11,-237,-396,62,-411,-123,-504,324,-1274
-53,-77,-62,-25,-107,-61,-86,11,-460
-5,-27,-25,11,-26,9,-26,39,-50
-18,-12,-4,20,-10,-1,-15,7,-33
-16,12,2,3,-11,-13,-16,-2,-41
-9,20,19,31,5,-2,-11,8,61
-3,43,-1,41,-2,-9,-7,-3,59
-16,34,0,46,-6,-15,-21,-3,19
-1,3,8,18,1,-6,-10,2,15
-16,30,18,28,10,-9,-9,-1,51
2,-4,-16,-1,-18,-14,-15,6,-60
-9,22,13,24,13,-2,-4,-1,56
-11,28,17,32,5,-13,-14,3,47
-14,17,12,29,-2,-9,-14,2,21
-14,44,28,63,10,-2,-13,1,117
-2,-4,-1,14,-4,-9,-18,5,-19
-18,24,14,21,3,-3,-10,4,35
-4,30,26,37,10,-2,-1,9,105
-25,20,16,29,-3,9,-21,7,32
-9,-18,-21,40,-14,16,-44,35,-15
-36,-31,-18,41,-23,-4,-57,51,-77
7,-19,-52,1,-24,-4,-33,55,-69
-15,-65,-75,18,-20,2,-77,79,-153
20,-57,-37,29,-82,-13,-45,59,-126
51,-48,-95,4,-151,-116,-172,31,-496
1,-26,-42,-18,-32,-16,-38,12,-159
6,-96,-93,-25,-165,-174,-198,45,-700
10,-106,-110,-81,-130,-133,-241,140,-651
-49,-85,-150,-116,-176,-176,-216,4,-964
26,-62,-26,45,-30,-49,-96,60,-132
-122,-162,-175,-43,-98,-38,-112,4,-746
-40,-85,-111,-64,-137,-38,-104,36,-543
-2,7,6,18,1,-9,-13,0,8
18,-41,-135,-17,-14,70,-41,71,-89
-20,-123,-122,-65,-202,-162,-208,3,-899
-58,-160,-225,-96,-280,-111,-260,105,-1085
-60,-159,-173,-81,-132,-88,-207,85,-815
-4,-8,-79,-24,-24,-35,-107,32,-249
-65,-36,-74,-42,-46,-43,-79,-6,-391
-16,-27,-34,-14,-32,-7,-35,6,-159
35,-62,-34,-14,-7,-26,-66,61,-113
-18,-81,-84,-18,-132,-48,-107,70,-418
-22,-97,-76,3,-121,-19,-105,43,-394
2,-44,-47,-3,-33,-38,-61,25,-199
17,-16,-28,-11,-20,-32,-57,33,-114
-19,-117,-161,-14,-162,-17,-184,105,-569
-44,-22,-66,-45,-38,-47,-90,4,-348
-68,-100,-146,-28,-45,4,-70,-21,-474
-51,-80,-68,-25,-100,-58,-78,24,-436
-2,-26,-69,-22,-65,-124,-112,55,-365
-13,-22,-20,-9,-7,-7,-25,-4,-107
-52,-58,-67,-25,-92,-36,-91,-13,-434
-27,-34,-25,32,-34,0,-63,47,-104
-60,-89,-104,-6,-51,-37,-74,41,-380
46,-36,-51,7,-18,-87,-72,42,-169
50,-76,-102,11,-189,-48,-142,94,-402
-36,-87,-111,-45,-132,-69,-113,27,-566
-31,-23,-26,44,-118,-33,-161,26,-322
57,-67,-61,-3,-31,-124,-119,55,-293
59,-27,-77,7,-48,-62,-93,71,-170
-7,-76,-59,-51,-66,-87,-138,53,-431
-50,-58,-49,-24,-92,-30,-85,27,-361
-13,18,7,25,-2,-6,-15,4,18
-37,-106,-139,-23,-202,-93,-173,121,-652
82,-178,-359,-150,-257,-192,-395,284,-1165
-50,-207,-183,-16,-255,-31,-242,67,-917
-45,-168,-127,-34,-131,-102,-185,49,-743
-247,-56,-305,-239,-232,-157,-501,-108,-1845
-3,-5,-25,-12,-14,-16,-34,20,-89
-18,-59,-83,-21,-69,-52,-86,47,-341
-18,-56,-47,-6,-37,-40,-102,44,-262
112,-50,-52,21,-25,-76,-109,148,-31
-3,-25,-25,4,-30,-7,-35,20,-101
12,-48,-18,53,-77,-13,-70,54,-107
-207,-400,-411,106,-421,40,-430,258,-1465
-5,-38,-29,-20,-15,-43,-58,35,-173
-7,-13,-14,-1,-36,-19,-57,31,-116
-16,-53,-61,-26,-77,-57,-91,27,-354
-78,-63,-114,-16,-30,-4,-53,-12,-370
-15,-113,-61,24,-148,-32,-134,73,-406
-6,-41,-50,-24,-64,-24,-47,22,-234
-11,-63,-46,36,-5,9,-50,50,-80
10,-33,-21,-10,-56,-3,-31,41,-103
-101,-123,-157,-27,-83,-25,-105,1,-620
80,-80,-107,-42,-49,-146,-127,145,-326
-9,-9,-10,-7,-12,-3,-14,1,-63
-5,-81,-109,-29,-133,-117,-163,43,-594
-52,-90,-112,-50,-125,-69,-136,33,-601
30,-119,-101,11,-129,5,-91,134,-260
-33,-288,-316,-96,-366,-71,-331,155,-1346
-3,0,-12,-6,-3,-25,-25,2,-72
-8,-1,-30,-21,-29,-69,-78,-32,-268
6,-76,-114,-46,-106,-116,-183,102,-533
-76,-52,-99,-68,-88,-86,-165,-17,-651
-32,-83,-66,-24,-122,-39,-106,68,-404
-128,-130,-142,-40,-83,-50,-99,-33,-705
-7,-26,-47,0,-53,-20,-66,37,-182
8,-79,-88,-14,-155,-135,-142,-9,-614
-44,-67,-65,-41,-93,-33,-78,34,-387
-26,-28,-25,-25,-40,-23,-47,-6,-220
-82,-87,-142,-63,-173,-23,-161,36,-695
-18,-25,-52,-9,-111,-108,-137,25,-435
-66,-69,-138,-47,-167,-29,-156,40,-632
-12,-117,-97,-8,-177,-69,-164,60,-584
0,-78,-71,-6,-92,-77,-130,26,-428
-73,-99,-92,-36,-100,-33,-130,51,-512
-57,-54,-35,-19,-54,-34,-86,9,-330
-85,-93,-83,-56,-75,-58,-135,65,-520
33,-29,-30,3,-2,-60,-64,44,-105
5,-22,-58,12,-13,3,-43,42,-74
-5,-29,-50,-22,-48,-4,-35,31,-162
-5,-24,-38,-19,-42,-45,-65,-9,-247
-35,-106,-107,52,-191,-15,-151,126,-427
2,-51,-41,-17,-32,-68,-91,24,-274
-32,-117,-137,-59,-147,-156,-233,-12,-893
-2,-18,-26,24,-20,1,-39,11,-69
-10,-27,-72,-62,-90,-75,-112,33,-415
-29,-79,-140,-66,-86,-101,-123,15,-609
-41,-124,-75,-7,-110,-47,-125,10,-519
19,-46,-91,-3,-98,-49,-83,49,-302
-34,-54,-61,-5,-14,0,-31,-27,-226
-34,-67,-164,-70,-166,-48,-196,62,-683
3,-33,-92,-20,-73,-71,-135,85,-336
-66,-98,-117,-33,-94,-20,-83,-6,-517
-56,-170,-151,-47,-206,-44,-183,65,-792
-15,-36,-44,-20,-44,-37,-49,-28,-273
-5,-160,-270,-66,-335,-103,-290,208,-1021
-56,-70,-86,-78,-85,-35,-117,-3,-530
-13,-28,-119,-54,-75,-141,-171,22,-579
-22,-120,-127,-17,-145,-96,-175,29,-673
-2,-59,-67,-4,-102,-56,-59,44,-305
-35,-13,-13,-18,-32,-15,-29,2,-153
-6,-5,-16,-3,0,-9,-17,-5,-61
-16,-72,-141,-59,-49,-31,-150,6,-512
-31,-62,-96,-62,-127,-55,-103,33,-503
-74,-97,-111,-38,-114,0,-97,54,-477
21,-368,-491,-134,-465,-135,-494,395,-1671
-75,-101,-98,-34,-160,-89,-161,-1,-719
-22,-229,-223,10,-337,-102,-302,178,-1027
-40,-102,-96,-26,-116,-56,-100,17,-519
24,-28,-122,27,-99,-23,-143,129,-235
-11,-114,-144,-39,-157,-81,-178,86,-638
-40,-52,-67,-28,-74,17,-53,25,-272
0,-15,-24,-4,-3,-18,-21,8,-77
7,-25,-19,-7,-31,-18,-32,17,-108
-4,-30,-26,-18,-38,-25,-48,24,-165
-60,-78,-124,-73,-69,-18,-114,28,-508
14,-27,-66,-37,-58,-98,-127,56,-343
-1,5,-18,5,-10,7,-8,23,3
-23,-42,-62,-12,-112,-32,-120,32,-371
-1,-7,-18,-9,-10,8,-5,26,-16
-241,-270,-272,-101,-414,-29,-364,42,-1649
-333,-722,-898,-280,-1064,46,-811,700,-3362
-48,-68,-55,-49,-107,-47,-96,5,-465
-53,-14,-35,-39,-22,-4,-60,-39,-266
90,-32,-176,-21,-232,-213,-242,108,-718
-75,-180,-152,-113,-141,-49,-134,84,-760
12,-35,-51,0,-44,-60,-53,24,-207
-17,-36,-53,-11,-72,-18,-64,30,-241
-93,-73,-167,-113,-201,-215,-295,-91,-1248
-84,-111,-133,5,-191,-10,-187,63,-648
59,-105,-71,15,-36,-14,-76,121,-107
-50,-103,-42,8,-91,-43,-114,22,-413
-24,-45,-142,-26,-128,-33,-181,94,-485
2,-116,-141,-84,-171,-50,-132,49,-643
-52,-35,-33,-5,-38,9,-71,25,-200
-62,-129,-122,-24,-137,-87,-123,15,-669
-25,-63,-68,2,-97,-1,-103,49,-306
128,-182,-151,74,-237,21,-174,330,-191
-14,-35,-60,-31,-55,-40,-71,25,-281
56,-108,-134,-20,-87,-113,-203,94,-515
49,-101,-118,-57,-63,-122,-192,150,-454
-122,-187,-149,-23,-236,-20,-236,55,-918
-20,-31,-54,-5,-64,-12,-58,30,-214
-17,-22,-68,-30,-37,-71,-111,11,-345
-26,-42,-52,6,-83,-33,-70,27,-273
-6,-182,-267,-20,-288,-82,-240,224,-861
-141,-88,-168,-200,-123,-126,-263,-72,-1181
-88,-195,-267,-97,-314,-19,-239,130,-1089
88,-297,-469,286,-372,71,-563,578,-678
-21,-15,-25,-15,-23,1,-57,-28,-183
-8,-7,-14,-7,-21,-10,-27,10,-84
18,-17,-276,-61,-138,6,-177,177,-468
-1,-20,-20,-5,-45,-39,-60,-22,-212
-23,-19,-21,-5,-15,-11,-27,-2,-123
-30,-24,-24,-16,-37,-14,-38,1,-182
-56,-82,-120,-14,-134,-87,-160,36,-617
-64,-107,-148,-72,-131,-99,-186,-49,-856
27,4,1,13,18,-8,-2,12,65
24,-2,-4,10,12,-10,-1,14,43
-76,-6,-95,-112,-141,-208,-263,-105,-1006
-27,-24,-69,-44,-90,-39,-81,4,-370
-116,-196,-203,15,-75,-32,-112,-47,-766
54,-18,-35,17,-38,-42,-79,50,-91
64,13,-29,28,-1,0,-11,53,117
-3,-75,-91,-59,-121,-45,-96,90,-400
-16,-23,-25,-19,-33,-24,-40,-19,-199
-15,-21,-30,-5,-16,-4,-18,8,-101
-36,-62,-101,-87,-125,-151,-206,36,-732
59,-125,-215,-4,-121,-191,-245,87,-755
-118,-232,-253,-91,-289,-29,-272,159,-1125
-117,-217,-254,-112,-350,-34,-283,154,-1213
-17,-26,-39,-25,-42,-36,-57,14,-228
-36,-84,-131,-59,-83,-55,-97,41,-504
-38,-50,-54,-28,-68,-13,-61,51,-261
-13,-11,-29,-29,-39,-27,-36,-2,-186
9,-80,-66,27,-115,-59,-111,77,-318
-48,-51,-61,-11,-59,-6,-74,1,-309
-5,-59,-97,-3,-97,-25,-111,49,-348
-13,-15,-33,-12,-24,-3,-30,20,-110
-20,-16,-24,-17,-35,-14,-46,10,-162
-14,-358,-419,-4,-455,-208,-459,279,-1638
266,-264,-282,-30,-184,-139,-333,457,-509
-14,-120,-109,36,-162,-84,-170,116,-507
-58,-78,-138,-72,-165,-23,-140,68,-606
-10,-231,-247,-48,-309,-148,-271,73,-1191
-68,-57,-99,-69,-91,-78,-141,-6,-609
14,-1,2,13,13,10,-1,5,55
-45,-238,-196,5,-282,-112,-273,119,-1022
37,-67,-54,9,-70,-82,-135,69,-293
15,-24,-16,12,-25,-27,-40,14,-91
-81,-58,-147,-46,-175,-73,-198,47,-731
17,-60,-84,-37,-109,-93,-140,76,-430
-19,-62,-66,3,-38,-21,-79,10,-272
-36,-66,-91,-45,-114,-129,-216,5,-692
0,-11,-14,13,-18,-19,-35,-9,-93
-21,-44,-36,11,-54,-24,-72,18,-222
7,-48,-92,4,-101,-24,-103,66,-291
-23,-13,-21,38,-23,11,-60,53,-38
-29,60,29,58,-39,0,-85,-19,-25
-29,-86,-130,-25,-147,-37,-143,111,-486
-60,-148,-215,-10,-209,-90,-296,37,-991
-10,-17,-30,-8,-17,-15,-17,8,-106
-7,-11,-20,-12,-16,-24,-26,10,-106
-119,-155,-203,-41,-99,-3,-115,38,-697
10,13,-3,-10,-17,-6,-26,32,-7
-14,-61,-84,-62,-76,-59,-84,77,-363
-12,-11,-19,-10,-18,4,-16,10,-72
-4,-16,-23,-4,-24,-3,-15,13,-76
17,-13,-55,-5,-103,-17,-99,35,-240
86,-118,-107,-12,-129,-20,-213,227,-286
-12,-161,-132,40,-171,-13,-226,246,-429
65,-97,-87,-54,-96,-195,-211,30,-645
99,-70,-61,58,-46,-68,-183,149,-122
-45,-63,-83,-45,-120,-16,-98,48,-422
-43,-16,-38,-20,-50,-36,-99,-33,-335
-100,-60,-111,-114,-86,-98,-147,-82,-798
-26,-31,-89,-31,-106,-52,-128,98,-365
-32,-74,-76,-30,-101,-49,-110,29,-443
3,-21,-51,13,-67,-67,-80,-5,-275
26,-28,-44,30,-35,-4,-78,94,-39
-3,-72,-78,-32,-21,3,-72,45,-230
-23,-47,-53,-38,-43,-26,-66,9,-287
23,-34,-22,27,-38,-7,-21,58,-14
-14,-35,-44,-13,-58,-12,-35,22,-189
-5,-112,-84,-1,-102,12,-69,79,-282
-52,-61,-46,-29,-149,-4,-114,34,-421
-4,-88,-79,20,-153,-22,-101,83,-344
3,-44,-34,-4,-43,-17,-43,12,-170
-111,-133,-176,-48,-191,-57,-225,43,-898
16,-18,-30,15,-54,-25,-55,76,-75
-51,-66,-115,-52,-87,-65,-134,-2,-572
-18,-41,-73,-37,-67,-49,-112,28,-369
52,-14,-143,-99,-195,-239,-282,73,-847
-44,-50,-75,-15,-87,-6,-81,42,-316
-32,-54,-126,-50,-135,-129,-174,-32,-732
-51,-85,-116,-32,-126,-32,-99,50,-491
9,-110,-86,31,-169,-60,-164,66,-483
-23,-70,-72,-35,-75,-27,-77,27,-352
-28,-93,-111,-12,-123,-47,-111,50,-475
7,-59,-86,-61,-113,-80,-74,15,-451
-23,-9,-16,-9,-22,2,-31,-12,-120
-22,-68,-84,-9,-118,-18,-108,82,-345
-27,-57,-47,-9,-43,-36,-66,2,-283
-41,-33,-34,-24,-61,9,-59,-13,-256
7,-39,-66,-28,-83,-60,-61,21,-309
-9,-54,-74,-52,-51,-64,-92,-4,-400
34,-90,-72,43,-159,-95,-150,87,-402
44,-50,-55,38,-105,-33,-50,59,-152
-60,-92,-82,-20,-110,-41,-80,43,-442
-42,-28,-39,-34,-56,-9,-75,43,-240
-20,-41,-48,-29,-37,-56,-84,26,-289
53,-26,-77,7,-83,-105,-130,69,-292
1,-3,-12,0,-10,1,-12,3,-32
85,-36,-61,12,-81,-67,-66,87,-127
-45,-63,-101,-46,-115,-31,-108,31,-478
-32,-37,-60,-11,-62,6,-79,33,-242
-108,-191,-153,-122,-263,-113,-257,10,-1197
-5,-30,-44,13,-47,-29,-82,84,-140
10,-26,-39,12,-53,-53,-55,-21,-225
33,-44,-62,-11,-75,-51,-82,47,-245
-17,-34,-59,-52,-64,-64,-104,17,-377
-15,-44,-41,-1,-70,-2,-53,31,-195
-24,-15,-18,-15,-21,-8,-21,-9,-131
9,-74,-64,-15,-72,-50,-83,29,-320
1,-24,-21,-10,-24,-12,-33,17,-106
116,-142,-196,33,-112,-8,-139,213,-235
32,-72,-78,-32,-20,-81,-135,122,-264
13,-41,-62,-26,-63,-85,-77,74,-267
-59,-137,-137,-32,-96,-49,-125,26,-609
-28,-54,-73,-18,-87,-18,-94,37,-335
43,-140,-163,-34,-139,-142,-199,143,-631
-21,-85,-108,-16,-85,-5,-76,62,-334
34,-235,-291,-137,-398,-296,-469,204,-1588
-11,-37,-196,27,-106,45,-140,152,-266
-4,-46,-36,16,-93,-4,-60,41,-186
-87,-100,-110,-105,-123,-86,-186,-64,-861
-18,-46,-46,-15,-56,-43,-62,16,-270
8,-1,-29,1,-28,-19,-38,43,-63
0,-51,-35,-34,-9,-24,-67,41,-179
50,-60,-107,19,-32,-28,-78,98,-138
-28,-25,-137,-135,-113,-169,-194,34,-767
-10,-39,-47,-24,-59,-30,-13,27,-195
-26,-111,-136,-35,-88,-5,-97,108,-390
6,-32,-32,20,-46,-25,-40,54,-95
5,-13,-14,9,-19,-15,-25,7,-65
-72,-136,-229,-63,-205,12,-204,153,-744
-6,-17,-19,2,-24,11,-23,11,-65
-4,-25,-27,-6,-35,-23,-34,19,-135
-2,-10,-65,-8,-51,-77,-114,-35,-362
-38,-221,-250,-127,-262,-135,-243,22,-1254
11,-23,-31,-6,-52,-26,-29,19,-137
2,-17,-5,2,-6,3,-21,41,-1
72,-130,-73,96,-117,-80,-168,139,-261
-7,-124,-133,19,-170,-47,-197,105,-554
77,-366,-339,-22,-417,47,-407,503,-924
41,-133,-197,-56,-293,-309,-386,21,-1312
-5,-104,-190,-46,-107,-66,-117,76,-559
-9,-34,-84,-34,-79,-27,-50,-2,-319
-69,-49,-95,-37,-97,-7,-87,14,-427
-57,-41,-92,-39,-124,-45,-122,19,-501
-62,-29,-68,-38,-59,0,-55,-13,-324
-48,-20,-56,-48,-24,-37,-50,-32,-315
-37,-53,-60,-13,-99,-31,-86,16,-363
-12,-28,-44,-10,-38,-2,-33,36,-131
-31,-78,-78,-26,-84,-19,-68,22,-362
37,-58,-126,22,-184,10,-145,166,-278
-18,-56,-82,5,-97,-43,-133,29,-395
-18,-14,-11,-9,1,-2,-7,2,-58
-54,-80,-143,6,-221,-86,-180,65,-693
27,21,-6,33,-13,-42,-56,25,-11
-34,-73,-83,-24,-97,-19,-85,34,-381
-171,-112,-162,-108,-169,-86,-241,-100,-1149
-48,-63,-59,-35,-58,-22,-64,-1,-350
-118,-73,-132,-117,-154,-162,-264,-104,-1124
-28,-48,-50,-11,-63,-17,-59,13,-263
4,-66,-56,20,-79,-65,-84,21,-305
-108,-188,-145,-63,-183,-36,-162,60,-825
14,-4,-16,-1,-18,-39,-41,9,-96
14,-65,-70,-60,-52,-93,-92,33,-385
-17,-113,-114,24,-198,-78,-183,140,-539
-16,-31,-67,-52,-87,-28,-76,29,-328
-34,-49,-51,-46,-82,-49,-95,-3,-409
-2,-17,-29,-24,-23,-43,-31,-11,-180
-31,-4,-71,-27,7,-10,-60,25,-171
44,26,24,72,-25,60,-60,114,255
-16,-31,-31,-15,-27,-42,-45,-11,-218
12,-39,-9,28,-4,1,-10,28,7
-7,-23,-31,-3,-47,-10,-46,32,-135
-81,-63,-148,-79,-155,-142,-244,36,-876
-87,-105,-146,-85,-136,-103,-175,-57,-894
-66,-94,-146,-21,-79,-8,-91,32,-473
-409,-903,-1427,-358,-1593,33,-1488,690,-5455
-28,-98,-132,-69,-169,-146,-178,7,-813
32,-63,-68,-20,-59,-93,-139,102,-308
601,902,379,952,-146,373,-105,940,3896
5,-227,-294,-38,-249,-55,-265,276,-847
1,-23,-8,-3,-21,-25,-26,1,-104
-12,-22,-17,-5,-11,-10,-11,3,-85
34,-30,-57,8,-77,25,-70,112,-55
-51,-60,-53,-45,-102,-38,-106,17,-438
148,-155,-217,-5,-57,-226,-229,188,-553
-25,-12,-50,-65,-68,-71,-109,-29,-429
8,-34,-10,-10,-28,-17,-20,18,-93
-3,-55,-91,-69,-109,-110,-112,30,-519
-26,-23,-39,-29,-27,-6,-40,-5,-195
-43,-47,-52,-52,-55,-37,-73,-1,-360
-12,-24,-23,-20,-19,-9,-32,14,-125
-32,-27,-38,-25,-40,-19,-54,-13,-248
3,-48,-78,-11,-36,-67,-93,24,-306
-39,-74,-118,-49,-52,-17,-94,43,-400
-43,-64,-109,7,-140,-21,-124,16,-478
136,-109,-173,-57,-119,-243,-303,134,-734
-107,-220,-196,-44,-245,-87,-234,13,-1120
-58,-91,-179,-79,-90,12,-112,82,-515
-67,-94,-93,-31,-63,-46,-78,-13,-485
-18,-19,-23,2,-33,5,-38,15,-109
-45,-103,-38,4,-120,-34,-134,49,-421
-31,-85,-67,46,-48,-7,-100,58,-234
-13,-93,-30,44,-102,-34,-103,69,-262
-21,-33,-20,13,-14,-11,-28,18,-96
-23,-35,-30,-25,-43,-4,-27,20,-167
-16,-4,-36,-1,-31,-22,-38,7,-141
4,-110,-154,-46,-191,-121,-165,125,-658
-105,-102,-108,-40,-142,-36,-135,17,-651
-35,-132,-137,-22,-175,-106,-201,64,-744
-57,-120,-86,12,-167,-94,-181,103,-590
-15,-133,-124,51,-205,-78,-194,97,-601
-113,-119,-115,-42,-166,-16,-186,24,-733
-2,-52,-66,-39,-74,-33,-71,12,-325
-36,-132,-125,16,-239,-53,-201,74,-696
-22,-29,-18,-6,-35,-24,-27,11,-150
-59,-200,-255,-130,-321,-117,-287,113,-1256
42,-310,-317,-26,-532,-65,-296,390,-1114
-58,-40,-67,-45,-72,-26,-82,-18,-408
-11,-13,-26,-3,-34,5,-36,22,-96
49,-28,-46,27,-34,-29,-26,94,7
-7,-57,-70,-16,-82,-41,-73,28,-318
169,-247,-301,-77,-134,-174,-295,427,-632
14,-29,-39,14,-66,3,-46,87,-62
9,1,9,3,-3,-14,-16,15,4
-56,-66,-83,-46,-100,-80,-144,-33,-608
-30,-92,-125,-21,-93,-56,-96,37,-476
8,34,-1,22,25,-18,-7,5,68
-15,-4,-67,-5,-72,-36,-78,49,-228
-37,-86,-125,15,-136,-10,-196,68,-507
618,0,-6,573,-162,-34,-192,482,1279
-37,-56,-128,-18,-184,-26,-159,88,-520
-40,-78,-109,-4,-157,-20,-101,82,-427
142,-99,-149,3,-68,-53,-141,96,-269
-190,-308,-404,-144,-459,-219,-482,62,-2144
-94,-191,-298,-270,-58,-189,-181,109,-1172
78,-127,-85,59,-103,-51,-165,166,-228
-71,-118,-132,-45,-84,-28,-64,7,-535
-73,-175,-181,60,-257,-47,-238,149,-762
32,-286,-456,-173,-308,7,-374,387,-1171
-4,-59,-46,-13,-59,-27,-92,18,-282
8,-35,-34,5,-55,1,-38,48,-100
-61,-123,-85,-20,-105,-6,-99,23,-476
-37,-12,-100,-20,-21,-51,-60,-3,-304
-13,-32,-58,-6,-96,-50,-69,22,-302
23,-77,-106,-45,-56,-31,-102,163,-231
-112,-101,-159,-52,-98,-33,-115,25,-645
-43,-18,-58,-4,-57,-20,-68,15,-253
24,-112,-98,15,-111,-74,-139,110,-385
-3,-24,-10,-7,-24,-27,-32,1,-126
-1,-28,-38,-25,-23,-39,-65,18,-201
88,-139,-205,-61,-166,-62,-251,269,-527
-10,-34,-48,-35,-42,-57,-147,81,-292
-48,-90,-97,-40,-141,-35,-122,9,-564
-1,-16,-33,-8,-13,-26,-22,12,-107
11,-23,-18,37,-27,-14,-36,-1,-71
-103,-191,-152,-62,-185,-33,-166,60,-832
46,-127,-194,20,-215,-256,-364,87,-1003
-18,-24,-26,-18,-6,-7,-10,-1,-110
-18,-9,-8,6,-33,-18,-41,12,-109
-51,-42,-46,-17,-62,28,-56,31,-215
-87,-109,-166,-52,-74,-52,-105,18,-627
-8,-47,-32,-24,-34,-17,-21,25,-158
179,-156,-233,-94,-105,-219,-367,295,-700
-16,-146,-233,-22,-285,29,-188,245,-616
-35,-155,-286,-132,-317,-143,-350,-11,-1429
-7,-68,-82,-58,-127,-102,-130,10,-564
-16,-57,-63,-27,-69,-13,-71,3,-313
4,-14,-64,9,-86,-30,-62,39,-204
60,11,-33,28,-28,-36,-52,17,-33
47,-75,-139,65,-134,-87,-161,41,-443
1,-20,-19,-12,-19,-18,-22,-2,-111
-7,-4,-10,-10,-5,-4,-8,12,-36
-2,-27,-22,16,-53,-4,-42,23,-111
-44,-85,-88,-44,-121,-48,-102,29,-503
-11,-3,-32,-1,-21,-7,-28,9,-94
28,-64,-96,-51,-116,-87,-124,60,-450
62,-116,-189,-53,-148,-132,-289,133,-732
16,-32,-41,-16,-41,-55,-74,49,-194
127,-95,-161,39,-151,-144,-333,126,-592
-107,-138,-209,-179,-65,-121,-200,58,-961
16,18,-1,1,-1,-6,-2,18,43
3,-62,-97,-14,-46,-7,-79,64,-238
-52,-77,-102,-47,-128,-18,-109,67,-466
-25,-84,-50,18,-70,4,-92,81,-218
-31,-177,-173,-42,-186,-125,-168,21,-881
-16,-102,-138,-19,-131,-53,-155,91,-523
21,-54,-55,9,-95,11,-44,75,-132
3,-24,-23,0,-33,-16,-20,21,-92
95,-120,-110,19,-144,-43,-110,141,-272
-35,-140,-125,-22,-129,-57,-194,67,-635
-143,-383,-411,-88,-511,-127,-471,73,-2061
-12,-60,-120,-41,-111,-99,-158,23,-578
-25,-25,-27,-11,-28,-9,-25,8,-142
-5,-24,-19,5,-10,-13,1,7,-58
-70,-144,-134,-21,-160,-48,-149,97,-629
298,-10,-173,155,-58,-186,-415,460,71
-7,-26,-37,13,-45,1,-38,27,-112
-13,-18,-25,-10,-13,-10,-19,19,-89
44,-9,-21,44,9,-19,-61,94,81
9,-6,-17,-6,-19,-29,-38,-7,-113
118,-52,-124,92,-43,-105,-254,218,-150
24,-70,-97,-59,-54,-77,-179,42,-470
2,-4,-42,-13,-78,-65,-102,11,-291
-80,-209,-314,-181,-329,-280,-412,19,-1786
-7,-22,-21,0,-20,-16,-33,-6,-125
0,-51,-65,-2,-92,-42,-34,44,-242
27,-43,-101,-11,-102,-66,-121,109,-308
-22,-71,-94,-52,-132,-57,-151,37,-542
-31,-29,-70,-43,-91,-38,-83,5,-380
-5,-33,-32,-9,-22,-44,-41,12,-174
62,-110,-161,-50,-246,-225,-254,39,-945
-20,-77,-89,-41,-138,-70,-156,6,-585
-70,-56,-87,-83,-85,-121,-133,-31,-666
-23,-73,-78,-27,-99,-65,-99,16,-448
104,-73,-84,24,-191,-207,-401,269,-559
16,-22,-55,-6,-42,-61,-95,44,-221
-141,-214,-215,-41,-335,-127,-344,139,-1278
13,12,-5,4,-1,-9,-14,19,19
4,-58,-41,-2,-52,15,-28,62,-100
-12,-42,-42,0,-57,-23,-47,9,-214
0,-48,-30,9,-38,-20,-35,11,-151
17,-19,-29,-6,-63,-27,-20,42,-105
-60,-209,-333,-144,-316,-259,-419,251,-1489
-38,-110,-84,-25,-119,-85,-120,-2,-583
-148,-179,-165,-21,-108,13,-120,25,-703
-75,-109,-125,-21,-54,-8,-85,-37,-514
-29,-129,-78,12,-145,-28,-97,79,-415
45,11,18,61,-12,-51,-34,44,82
-37,-76,-92,-18,-46,23,-65,42,-269
-41,-75,-72,-16,-101,-45,-94,25,-419
117,-81,-67,103,-98,-150,-201,163,-214
-10,-44,-50,-22,-75,-66,-82,11,-338
-160,-368,-460,-147,-675,-216,-650,222,-2454
-20,-31,-44,-21,-21,-12,-47,18,-178
-28,-38,-41,-14,-36,-17,-48,19,-203
1,-33,-56,-9,-65,-19,-42,58,-165
0,-33,-13,-3,-32,-11,-44,3,-133
3,-46,-77,-25,-39,-55,-110,82,-267
-25,-63,-64,-25,-81,-74,-107,35,-404
-54,-34,-41,-32,-25,-8,-62,1,-255
86,-146,-167,118,-211,57,-235,201,-297
43,-156,-206,-36,-204,-234,-345,52,-1086
8,-143,-185,-38,-222,-165,-290,128,-907
0,-9,-21,-3,-2,-8,-17,5,-55
-35,-39,-27,-3,-43,8,-39,21,-157
21,-109,-147,-56,-154,-157,-222,87,-737
1,-77,-109,-25,-151,-128,-212,33,-668
-165,-285,-309,-52,-312,-69,-352,1,-1543
-11,-236,-208,-38,-245,-108,-351,125,-1072
57,14,-14,55,-53,-27,-136,34,-70
-43,-89,-197,-118,-126,-123,-274,33,-937
-79,-88,-117,-45,-149,-36,-130,48,-596
-26,-57,-108,-24,-134,-43,-119,92,-419
-164,-59,-200,-126,-211,-148,-340,-68,-1316
-31,-28,-78,-4,-49,-37,-86,75,-238
-32,-54,-52,-26,-91,-25,-52,32,-300
-117,-143,-160,-14,-70,-21,-113,-19,-657
-59,-119,-143,-35,-192,-54,-234,29,-807
-1,-8,-13,0,-4,1,-7,7,-25
0,-1,-20,1,3,4,-8,5,-16
16,33,-18,23,0,10,-11,20,73
38,48,-2,52,-13,2,-30,68,163
-21,-47,-58,-34,-63,-50,-77,37,-313
-19,-49,-60,1,-69,-27,-50,40,-233
-78,-93,-91,-40,-146,-39,-129,14,-602
-12,-68,-63,7,-79,-14,-56,42,-243
5,-66,-102,22,-92,-3,-76,70,-242
-2,-76,-79,26,-100,-57,-139,70,-357
-43,-118,-85,11,-130,-42,-106,20,-493
16,-23,-33,12,-21,-37,-19,13,-92
-70,-98,-118,-95,-176,-51,-149,64,-693
-3,-29,-33,-22,-3,-31,-35,38,-118
29,-65,-78,-32,-74,-107,-189,73,-443
-20,-17,-46,-29,-68,-30,-63,15,-258
-93,-96,-109,-92,-163,-8,-148,48,-661
-19,-38,-35,-22,-45,-22,-28,21,-188
155,-58,-182,193,-116,5,-203,261,55
-32,-59,-62,-2,-59,-33,-71,1,-317
-37,-51,-41,4,-43,-18,-71,-6,-263
128,58,-62,86,-25,-30,-68,76,163
-27,-58,-79,-45,-100,-38,-99,20,-426
43,-28,-128,5,-85,29,-128,154,-138
-51,-77,-78,-22,-115,-42,-94,17,-462
-6,-35,-32,-9,-23,-10,-18,24,-109
-17,-67,-100,-8,-116,-51,-116,99,-376
-9,-127,-139,-10,-179,-60,-159,95,-588
-17,-43,-24,-6,-27,-6,-36,30,-129
21,-118,-147,14,-169,-62,-193,98,-556
-2,-93,-78,16,-132,-101,-116,-19,-525
-44,-73,-103,-34,-100,-46,-110,11,-499
-13,-11,-24,-31,-27,-19,-36,-4,-165
105,-13,-198,-31,-112,-125,-298,38,-634
-32,-14,-22,-13,-39,-7,-46,4,-169
-33,-31,-70,-44,-89,-38,-84,6,-383
15,-3,-45,-23,-48,-78,-103,0,-285
-8,-79,-59,6,-68,-49,-77,12,-322
-330,-358,-461,-245,-722,-240,-652,32,-2976
-29,-44,-57,-17,-111,-47,-79,10,-374
-4,-120,-152,-47,-121,-126,-218,71,-717
78,-166,-240,-96,-267,-440,-426,32,-1525
-2,-40,-70,-26,-67,-57,-77,43,-296
-71,-108,-145,-76,-137,-103,-179,-53,-872
-26,-78,-69,-54,-59,-60,-126,35,-437
-5,-79,-60,-34,-53,-55,-91,57,-320
-44,-71,-99,-79,-122,-61,-137,16,-597
25,-31,-70,15,-59,-80,-107,19,-288
-64,-43,-65,-67,-85,-108,-138,-46,-616
-33,-59,-53,-24,-59,-31,-67,-22,-348
3,-27,-34,-3,-34,-15,-36,32,-114
-22,-85,-111,24,-160,-47,-157,100,-458
49,-20,-13,41,-37,-26,-14,75,55
-19,-26,-14,29,-39,-13,-59,17,-124
-185,-298,-384,-204,-523,-377,-531,-1,-2503
11,-40,-54,-2,-57,-19,-57,55,-163
-66,-86,-123,-3,-123,-79,-166,12,-634
-15,-100,-40,40,-48,14,-87,32,-204
23,14,-104,-49,-15,6,-64,56,-133
-27,-20,-39,2,-30,-8,-30,28,-124
228,43,-102,282,-45,203,-78,224,755
-20,-57,-123,-50,-31,-50,-96,90,-337
-25,0,-15,-8,-28,-45,-39,-10,-170
8,-197,-205,-125,-267,-235,-290,37,-1274
0,-15,-9,-3,-11,-24,-32,-8,-102
-21,-32,-38,-14,-58,-29,-38,7,-223
200,-91,-79,32,-84,-139,-148,229,-80
-23,-48,-26,-14,-19,-14,-45,-2,-191
-92,-187,-215,-66,-169,-80,-136,26,-919
-42,-36,-38,9,-68,-14,-72,6,-255
-96,-210,-284,-61,-284,-24,-288,134,-1113
92,-63,-106,7,-86,-163,-195,76,-438
72,-108,-286,-16,-252,-51,-249,254,-636
26,-30,-55,-10,-58,-53,-66,15,-231
48,-48,-111,12,-113,-91,-188,87,-404
-32,-81,-72,-8,-58,-27,-71,33,-316
-121,-93,-95,-87,-123,-77,-177,-31,-804
-93,-90,-99,-88,-152,-72,-165,17,-742
-3,-11,-12,-4,-13,-11,-30,33,-51
-21,-64,-100,-18,-116,-34,-101,51,-403
-11,-45,-100,9,-89,-19,-73,72,-256
-124,-138,-174,-64,-38,-6,-78,-27,-649
78,-156,-220,-131,-204,-281,-428,147,-1195
-11,-28,-40,-18,-46,-27,-49,26,-193
-9,-9,-9,-13,-5,0,-13,-2,-60
-64,-132,-150,-98,-164,-38,-193,92,-747
1,3,-7,8,-20,-14,-5,-1,-35
-91,-230,-217,-8,-277,-9,-188,155,-865
1,6,-30,-7,-34,-57,-49,-8,-178
57,-206,-245,-9,-283,-166,-400,236,-1016
-27,-49,-42,-5,-78,-53,-66,-11,-331
281,-128,-172,156,-110,-111,-320,515,111
-15,-45,-86,-61,-70,-99,-152,33,-495
21,-20,-28,-28,-41,-47,-52,28,-167
-18,-68,-58,-19,-77,-35,-67,21,-321
35,-42,-25,28,-38,-31,-86,48,-111
-3,-24,-46,19,-29,3,-40,19,-101
59,-362,-439,-107,-815,-71,-438,688,-1485
-86,-55,-105,-46,-100,-104,-205,-21,-722
53,-64,-48,44,-65,-89,-62,53,-178
-51,-499,-610,-272,-843,-609,-994,483,-3395
8,-24,-47,-11,-52,-46,-67,9,-230
37,-28,0,40,1,-12,-29,66,75
-16,-45,-69,-27,-54,-45,-74,41,-289
76,-17,-21,26,-42,-55,-58,76,-15
5,-106,-97,-24,-46,-43,-88,64,-335
-4,-29,-29,-1,-48,-10,-65,33,-153
55,-58,-113,-59,-113,-203,-219,40,-670
-6,-19,-29,-2,-36,-18,-42,6,-146
-36,-23,-44,-26,4,-40,-33,-20,-218
1,-38,-48,21,-44,-22,-60,20,-170
-49,-166,-220,-71,-210,-116,-281,33,-1080
-21,-49,-69,16,-69,-65,-109,-7,-373
-45,-55,-70,-36,-80,-5,-76,23,-344
-41,-33,-31,-43,-31,-28,-67,-39,-313
22,-122,-200,36,-112,26,-171,183,-338
229,-193,-169,-56,6,-172,-309,263,-401
-17,-37,-61,-26,-126,-91,-106,65,-399
-36,-86,-108,-35,-172,-79,-141,19,-638
-130,-146,-158,-76,-221,-102,-221,7,-1047
-79,-163,-209,-120,-261,-168,-255,73,-1182
-178,-141,-197,-217,-190,-98,-289,-82,-1392
31,-17,-35,14,-21,-16,-33,44,-33
-24,-41,-24,10,-45,-19,-64,21,-186
-161,-355,-475,206,-519,235,-514,447,-1136
26,-14,-7,32,-6,-28,-21,37,19
11,-30,-14,-6,-35,-13,-25,24,-88
78,-94,-155,-25,-158,-173,-237,140,-624
16,-53,-106,35,-56,1,-109,82,-190
-57,-97,-94,-41,-135,-46,-141,60,-551
162,-293,-476,-133,-147,-249,-590,571,-1155
-15,-24,-27,-13,-23,-1,-23,30,-96
-74,-77,-122,-98,-149,-56,-115,25,-666
-123,33,-252,-152,-233,-168,-417,30,-1282
-30,-23,-44,-7,-46,-15,-53,2,-216
28,-79,-55,-56,-47,-102,-129,44,-396
-1,-34,-54,-26,-67,-51,-76,26,-283
-5,-10,-15,6,-31,-12,-31,10,-88
0,-50,-72,-11,-53,-2,-64,76,-176
9,-7,-34,14,-59,-36,-82,10,-185
-64,-164,-141,-53,-211,-61,-196,31,-859
-4,-23,-19,3,-38,-14,-29,7,-117
-28,-73,-64,-7,-134,-100,-94,5,-495
-31,-81,-87,-23,-104,-55,-112,10,-483
-8,-73,-77,-17,-141,-71,-117,6,-498
-61,-109,-219,-89,-259,-112,-297,-12,-1158
-36,-83,-92,-48,-110,-38,-97,19,-485
46,-16,-84,9,-89,-30,-56,78,-142
26,-8,-10,12,-15,-28,-40,39,-24
-125,-199,-196,-57,-254,-87,-252,54,-1116
-12,2,-55,-19,-19,-63,-67,15,-218
63,-60,-158,8,-69,52,-58,176,-46
-98,-191,-355,-185,-427,-360,-596,1,-2211
-21,-28,-28,-22,-27,2,-33,10,-147
-5,-51,-71,-39,-86,-90,-115,15,-442
37,-55,-79,-18,-83,-90,-132,70,-350
-9,-140,-149,-77,-217,-134,-214,26,-914
159,-97,-72,96,-66,-128,-215,124,-199
16,-81,-87,15,-140,-99,-145,68,-453
-53,-155,-165,-38,-244,-114,-273,29,-1013
-31,-69,-98,-27,-84,-59,-141,35,-474
-29,-55,-60,-25,-47,-69,-76,0,-361
-8,-12,-20,-2,-19,-27,-38,20,-106
16,-19,-3,38,-3,-7,-26,15,11
-164,-760,-1043,-72,-1284,-635,-1356,418,-4896
-16,-23,-40,-13,-59,-22,-53,28,-198
-53,-92,-138,-54,-159,-44,-195,23,-712
26,-33,-65,-32,-33,-68,-94,44,-255
0,-42,-28,9,-16,7,-19,14,-75
-2,10,-10,14,-16,-31,-27,20,-42
-12,11,-4,16,-15,-26,-23,15,-38
-45,-141,-207,-47,-215,-21,-231,177,-730
-49,-101,-101,-15,-50,-5,-73,26,-368
-14,-12,-18,-22,-2,-34,-32,15,-119
-64,-104,-191,-33,-205,-52,-196,40,-805
-25,-79,-87,-27,-93,-65,-92,12,-456
-68,-74,-86,-58,-86,-88,-150,-66,-676
116,-214,-264,9,-189,-150,-309,278,-723
-80,-83,-56,-65,-122,-59,-149,-61,-675
27,-170,-381,-16,-307,-15,-314,335,-841
-46,-124,-114,-44,-169,-89,-189,83,-692
77,-207,-310,-97,-254,-224,-342,146,-1211
-101,-168,-233,-61,-265,1,-255,129,-953
25,-71,-90,16,-36,-92,-105,46,-307
-18,-36,-31,-7,-69,-18,-50,55,-174
-160,-81,-120,-206,-113,-158,-270,-186,-1294
7,-28,-64,-10,-52,-20,-54,7,-214
-16,-35,-33,-17,-47,-37,-58,1,-242
56,-101,-132,-44,-38,-115,-181,155,-400
-1,-71,-70,3,-108,-34,-70,61,-290
278,-37,-124,210,-46,-20,-150,324,435
-8,-5,-33,-8,-36,-23,-48,9,-152
-123,-154,-195,-136,-220,-88,-257,-9,-1182
-20,-41,-26,-23,-16,-17,-39,65,-117
-7,-40,-42,-23,-39,-26,-32,23,-186
-46,-101,-121,4,-117,-59,-142,47,-535
-24,-59,-69,-18,-115,-37,-102,-2,-426
-4,-22,-13,-10,-22,-16,-51,19,-119
-132,-196,-213,-23,-284,11,-230,97,-970
4,-16,-41,-6,-41,-36,-56,11,-181
-30,-60,-47,-24,-33,-22,-53,18,-251
-4,-101,-85,-23,21,-39,-131,202,-160
4,-42,-27,35,-7,6,-47,73,-5
-20,21,-32,28,-37,-20,-41,24,-77
-11,17,-29,25,-30,-13,-33,23,-51
-15,22,-34,24,-36,-21,-35,24,-71
-19,14,-31,23,-36,-24,-39,23,-89
-63,-89,-82,-19,-97,-67,-148,-58,-623
26,-152,-169,-20,-225,-78,-235,181,-672
29,-16,-55,-23,-74,-80,-97,39,-277
-76,-72,-85,-36,-91,-31,-81,2,-470
-104,-8,-151,-81,-133,-8,-198,9,-674
80,-51,-169,-22,-139,-143,-217,96,-565
-45,-27,-51,-35,-50,-45,-48,-30,-331
-18,13,-31,16,-32,-22,-32,20,-86
-22,26,-31,26,-32,-18,-41,23,-69
-21,-33,-42,-14,-49,-8,-63,27,-203
-30,-110,-103,-44,-109,-67,-108,32,-539
-4,-39,-56,-2,-55,-11,-53,22,-198
-23,-29,-55,-59,-44,-66,-115,2,-389
76,-157,-157,42,-144,-82,-195,119,-498
-19,-89,-107,-14,-118,-69,-108,11,-513
-5,-158,-247,-22,-208,-100,-304,109,-935
6,-20,-25,-12,6,-30,-16,15,-76
-19,-25,-42,-28,-15,-41,-36,-3,-209
-71,-212,-316,-64,-289,-106,-266,146,-1178
159,-59,-142,30,-156,-208,-243,225,-394
16,-9,-58,20,-67,-1,-75,68,-106
20,-15,-56,32,-64,-17,-65,78,-87
1,-50,-54,-23,-92,-19,-66,46,-257
-22,-148,-135,-117,-100,-72,-206,156,-644
24,-18,-57,-31,-51,-87,-104,34,-290
68,-40,-51,37,-35,-116,-123,59,-201
-12,-76,-90,-40,-156,-167,-183,-32,-756
35,-38,-78,9,-68,1,-68,112,-95
-36,-61,-85,-37,-106,-92,-123,12,-528
-50,-59,-69,-42,-118,-55,-113,-7,-513
-78,-106,-94,-22,-164,26,-124,66,-496
-223,-85,-221,-216,-204,-225,-450,-188,-1812
-63,-45,-65,-39,-71,-38,-93,12,-402
1,-34,-51,-14,-45,-64,-84,-21,-312
-17,-103,-89,-59,-138,-65,-114,30,-555
-15,-48,-58,-27,-84,-39,-76,7,-340
-2,7,-18,25,-17,-26,-32,20,-43
-5,10,-15,9,-18,-29,-28,20,-56
-12,19,-16,26,-20,-26,-28,14,-43
-20,1,-25,6,-31,-24,-34,14,-113
-18,-5,-24,14,-31,-26,-39,20,-109
-19,-6,-31,13,-31,-26,-45,19,-126
17,-48,-44,-8,-32,-47,-59,5,-216
9,-58,-67,21,-137,-149,-189,-58,-628
25,-14,-15,33,-9,-12,-19,3,-8
-169,-83,-234,-136,-243,-223,-388,85,-1391
-261,-261,-263,-136,-425,13,-357,81,-1609
-11,-88,-130,-137,-74,-107,-176,11,-712
33,-20,-95,29,-133,-44,-75,121,-184
194,180,172,44,91,-100,-106,137,612
-54,-162,-236,-61,-246,-129,-337,143,-1082
-120,-117,-141,-84,-141,-29,-179,58,-753
-134,-59,-233,-131,-182,-144,-315,-72,-1270
-200,-462,-552,-151,-780,-356,-825,255,-3071
-11,-54,-79,-10,-42,-41,-46,7,-276
7,-7,-14,11,-46,-10,-29,21,-67
-2,-16,-17,-1,-16,0,-9,8,-53
-12,-30,-25,6,-40,-20,-51,20,-152
9,-6,-8,5,-7,-3,-23,23,-10
-4,-30,-51,-1,-77,-34,-75,9,-263
-43,-52,-49,-39,-94,-43,-95,15,-400
-25,-61,-90,-16,-103,-6,-85,90,-296
15,-188,-91,-8,-88,-172,-243,157,-618
18,-36,-67,18,-19,-8,-79,39,-134
-75,-96,-77,-51,-130,-92,-141,-6,-668
-16,7,-29,20,-33,-23,-40,22,-92
35,-89,-165,-52,-148,8,-153,239,-325
-243,-209,-337,-241,-299,-132,-481,-80,-2022
-6,-130,-198,-73,-161,-142,-282,115,-877
95,-32,-161,-68,-107,-134,-289,232,-464
100,-84,-213,20,-106,-38,-212,227,-306
17,-49,-61,46,-33,12,-139,132,-75
-47,-66,-76,14,-41,-14,-45,4,-271
-12,-29,-23,-9,-86,-34,-95,29,-259
-3,-61,-101,15,-103,4,-105,61,-293
-43,-208,-191,-2,-300,-61,-270,198,-877
-27,-109,-85,95,-137,-84,-176,-45,-568
-12,-47,-73,1,-78,-73,-104,24,-362
-43,-93,-127,-117,-133,-98,-142,98,-655
-3,-43,-36,12,-84,-16,-77,10,-237
-9,-4,-15,6,-7,-15,-11,11,-44
-2,-23,-23,-17,-16,-21,-21,5,-118
-57,-39,-59,-44,-59,-53,-94,-58,-463
-26,-11,-58,22,-103,-136,-281,10,-583
-51,-95,-129,27,-152,-30,-143,81,-492
-15,2,-16,39,-104,-77,-99,20,-250
-14,-80,-93,6,-86,-35,-97,23,-376
3,-34,-44,-7,-29,-32,-49,33,-159
26,-97,-88,-10,-83,-31,-41,69,-255
2,-53,-82,-49,-142,-118,-153,17,-578
-7,-14,-25,-9,-23,-24,-58,11,-149
-1,-28,-42,-10,-34,-28,-29,19,-153
-20,-54,-48,27,-74,-40,-88,0,-297
3,-20,-10,-12,-23,-32,-47,20,-121
44,-13,-18,19,5,-34,-48,8,-37
-15,-22,-44,-29,-75,-14,-52,8,-243
-66,-120,-123,-38,-182,-77,-153,45,-714
-7,-21,-44,-25,-26,-44,-59,24,-202
-31,-55,-66,-42,-70,-50,-94,-5,-413
-9,-81,-137,-29,-170,-115,-170,31,-680
283,-198,-116,130,-46,-238,-381,380,-186
-2,-1,-1,3,-13,-6,-15,6,-29
-63,-266,-370,-87,-558,-316,-564,192,-2032
49,-75,-26,47,4,18,-39,93,71
-117,-629,-760,-165,-999,-247,-821,561,-3177
49,-172,-384,-57,-309,-85,-374,269,-1063
-194,-291,-269,-73,-311,-135,-342,-24,-1639
-106,-14,-146,-51,-157,-114,-230,99,-719
-145,-247,-335,-159,-422,-313,-496,-1,-2118
-62,-2,-71,-29,-45,-51,-111,-22,-393
59,-183,-234,-23,-224,-113,-263,144,-837
-40,-75,-101,-51,-109,-26,-117,51,-468
-14,-32,-29,-3,-45,-5,-22,20,-130
-131,-231,-252,8,-113,-37,-165,-38,-959
-68,-110,-143,-78,-132,-103,-175,-55,-864
-101,-109,-101,-88,-133,-98,-162,-14,-806
-51,-60,-90,-33,-114,-36,-96,35,-445
-72,-7,-238,-309,-412,-495,-918,-266,-2717
-8,-30,-47,-16,-45,-25,-65,-14,-250
49,-201,-288,-94,-153,-210,-298,190,-1005
-19,-16,-27,-32,-24,-23,-28,-7,-176
-59,-66,-67,-45,-82,-56,-98,5,-468
-22,-66,-80,-28,-55,-21,-93,76,-289
24,-8,-12,18,-46,-69,-104,68,-129
66,-44,-64,46,-62,-29,-172,143,-116
-46,-165,-137,-40,-178,-63,-152,67,-714
-17,-20,-21,-26,-25,-21,-19,-12,-161
71,-92,-66,21,-30,-88,-114,73,-225
-86,-169,-156,-18,-115,-57,-185,75,-711
1,-73,-153,-10,-83,46,-103,84,-291
-20,-48,-50,-12,-48,-19,-66,7,-256
13,-63,-119,-33,-165,-220,-319,93,-813
-29,-95,-100,-58,-128,-67,-149,30,-596
7,-2,-24,3,-57,-38,-59,43,-127
-28,-123,-143,-109,-191,-142,-216,22,-930
-59,-231,-500,-100,-402,5,-485,252,-1520
-78,-118,-129,-88,-163,-94,-191,-32,-893
-97,-130,-144,-39,-88,-28,-100,-12,-638
0,-17,-13,-10,-4,-11,-17,11,-61
21,-105,-26,46,-73,-57,-115,68,-241
-54,-157,-140,-40,-186,-125,-240,12,-930
-12,-6,-30,1,-32,-8,-43,3,-127
2,-5,-7,12,2,5,-13,9,5
-23,-52,-30,21,-76,-12,-63,40,-195
492,-1004,-1550,-422,-1863,-1300,-1856,970,-6533
-20,-11,-68,-33,-33,-49,-70,-10,-294
66,-101,-114,-52,-23,-158,-195,99,-478
-10,-247,-566,-126,-471,-315,-690,235,-2190
-134,-223,-243,-115,-309,-163,-403,60,-1530
-2,-5,-10,-1,-16,-5,-16,3,-52
-20,-20,-12,-23,-27,-13,-29,5,-139
-16,-58,-41,-28,-58,16,-32,52,-165
232,-144,-242,65,-130,-27,-333,379,-200
-20,-61,-69,-54,-91,-47,-78,39,-381
-23,-30,-56,1,-83,-49,-86,-15,-341
8,-112,-184,-27,-148,-99,-246,150,-658
-99,-90,-92,-84,-143,-95,-176,-17,-796
-9,-35,-51,2,-85,-43,-115,31,-305
-106,-80,-88,-71,-127,-82,-172,-22,-748
10,-67,-57,20,-81,-57,-122,79,-275
0,-87,-67,-24,-38,-39,-51,51,-255
25,-45,-69,-25,-80,1,-33,58,-168
-4,-91,-94,-15,-107,-39,-89,69,-370
6,-38,-30,1,-8,-12,-34,26,-89
32,-127,-142,11,-137,9,-99,139,-314
32,-121,-100,-13,-86,-135,-199,135,-487
39,-130,-157,45,-182,58,-129,187,-269
-81,0,-113,-76,-97,-36,-146,26,-523
-8,-75,-140,-13,-129,-39,-125,84,-445
-52,-110,-141,-34,-205,-98,-251,37,-854
-127,-63,-126,-152,-166,-153,-302,-124,-1213
-5,-41,-38,-8,-30,-19,-31,15,-157
-50,-211,-224,-96,-295,-81,-312,176,-1093
3,-16,-17,-4,-12,-7,-12,9,-56
-81,-144,-135,-29,-179,-85,-185,3,-835
28,-186,-287,-106,-163,-210,-308,181,-1051
-167,-90,-405,-267,-440,-475,-726,-76,-2646
-18,-128,-58,31,-82,-22,-76,75,-278
-45,-350,-394,-176,-548,25,-331,387,-1432
-17,-22,-12,-6,-1,-30,-12,-16,-116
14,-46,-67,2,-126,-61,-92,33,-343
-20,-205,-215,27,-311,-64,-221,181,-828
72,-254,-384,-131,-298,-185,-538,295,-1423
42,-100,-153,-12,-159,-141,-195,140,-578
-54,-75,-95,-51,-115,-89,-136,-22,-637
-2,-30,-31,10,-22,-35,-39,10,-139
-23,-156,-169,-51,-115,-62,-158,113,-621
3,-71,-135,-2,-141,-37,-136,78,-441
-14,-28,-73,-12,-118,-45,-152,83,-359
-14,-7,-39,-19,-50,-27,-69,27,-198
-7,-15,-20,-18,-15,-20,-24,1,-118
-72,-112,-145,-78,-140,-104,-177,-51,-879
-31,-90,-79,-45,-141,-48,-110,43,-501
-39,-90,-79,-28,-137,-42,-117,24,-508
-16,-12,-17,-16,-29,-16,-32,19,-119
-11,-73,-61,-56,-72,-89,-137,52,-447
68,-85,-55,19,-71,-117,-129,31,-339
-24,-95,-109,-56,-175,-142,-192,43,-750
7,-80,-89,-10,-116,-52,-106,62,-384
58,-129,-218,-67,-232,-33,-162,222,-561
-30,-33,-69,-8,-29,-12,-47,12,-216
12,-176,-183,203,-152,78,-251,204,-265
160,-203,-299,-71,-160,-202,-429,398,-806
-7,-59,-45,-26,-56,-3,-31,34,-193
-34,-41,-46,-17,-67,6,-63,4,-258
18,-38,-66,-30,-66,-21,-57,32,-228
-52,-93,-151,-56,-123,-47,-155,33,-644
-124,-31,-119,-123,-73,-52,-202,-62,-786
43,-187,-292,-99,-158,-206,-298,190,-1007
15,-32,-42,-7,-75,-23,-21,37,-148
-8,-25,-30,-8,-22,-25,-27,1,-144
-23,-159,-179,-31,-234,-60,-203,161,-728
-38,-78,-63,-2,-36,5,-57,10,-259
-19,-42,-38,1,-84,-41,-59,19,-263
-2,-34,-61,12,-110,-57,-94,44,-302
12,-66,-129,-8,-137,-45,-140,78,-435
-16,-100,-79,-1,-73,-53,-118,-30,-470
-153,-332,-412,-219,-561,-330,-566,0,-2573
-45,-114,-137,-12,-176,-39,-155,76,-602
-62,-74,-56,-27,-92,-5,-90,28,-378
24,-147,-191,-129,15,-55,-156,76,-563
2,-120,-94,-101,-82,-82,-142,64,-555
-28,-73,-57,-11,-103,-65,-100,-4,-441
0,-39,-125,-42,-87,-93,-156,32,-510
-36,-95,-120,26,-114,69,-120,69,-321
-98,-91,-108,-99,-161,-72,-171,23,-777
-98,-78,-101,-62,-142,-87,-173,15,-726
-107,-103,-89,-95,-136,-99,-166,-13,-808
-148,-97,-112,-107,-133,-81,-199,-28,-905
42,-270,-448,-88,-396,-91,-402,327,-1326
-39,-79,-58,-47,-114,-22,-103,21,-441
30,-78,-106,-33,-54,-32,-87,52,-308
-3,-119,-133,-24,-97,-87,-129,107,-485
-39,-160,-224,-64,-211,-172,-346,70,-1146
-42,-96,-153,-57,-50,-13,-151,52,-510
43,-16,1,37,-27,-11,-33,52,46
3,-14,-20,-6,-3,-40,-76,48,-108
-18,-33,-28,8,-52,-10,-47,27,-153
-55,-57,-73,-68,-68,-46,-117,-39,-523
23,-44,-51,19,-67,-23,-82,92,-133
10,-18,-18,15,-10,-7,-18,9,-37
-102,-109,-102,-86,-134,-100,-167,-14,-814
-94,-77,-99,-60,-144,-90,-174,13,-725
-19,-82,-46,37,-76,6,-64,36,-208
-4,-82,-48,21,-58,0,-70,44,-197
20,-57,-44,29,-57,-43,-84,94,-142
0,-32,-31,20,-71,-15,-62,47,-144
-20,-45,-40,-1,-65,1,-57,31,-196
-55,-10,-59,-68,-47,-2,-70,17,-294
-108,-210,-281,-83,-355,-51,-372,38,-1422
55,-6,-22,-3,-12,-47,-74,76,-33
56,-60,-39,84,-27,-110,-269,157,-208
-35,-43,-43,-21,-52,-26,-58,9,-269
14,-238,-272,196,-439,-67,-406,355,-857
-112,-281,-363,-194,-379,-254,-481,-24,-2088
31,-140,-227,-79,-73,-154,-258,182,-718
28,-188,-289,-111,-164,-211,-308,179,-1064
-7,-46,-60,-23,-78,-8,-70,59,-233
-138,-163,-243,-137,-259,-96,-254,90,-1200
92,-64,-91,-1,-49,-121,-92,103,-223
-10,-58,-96,-52,-81,-47,-84,44,-384
-23,-54,-69,-6,-79,-29,-65,26,-299
-23,-35,-34,-18,-53,-21,-44,3,-225
0,-58,-43,13,-77,-16,-65,41,-205
9,-42,-33,-6,-53,-31,-34,15,-175
26,-34,-95,25,-48,-58,-116,38,-262
-12,-62,-79,-16,-101,-58,-84,18,-394
155,-45,-134,-18,-89,-184,-281,267,-329
5,-19,1,28,-7,8,-17,8,7
-99,-41,-114,-140,-163,-178,-292,-117,-1144
-73,-46,-56,-66,-60,-44,-92,-23,-460
-54,-336,-398,-74,-416,-117,-401,284,-1512
16,-10,-75,37,-66,-75,-142,84,-231
-51,-147,-139,-24,-174,-111,-158,6,-798
8,-89,-63,2,-64,-32,-48,35,-251
-16,-60,-70,-20,-78,-60,-104,39,-369
-15,-123,-226,-77,-274,-166,-314,113,-1082
28,-189,-289,32,-218,-59,-271,216,-750
-61,-73,-51,-9,-112,-6,-102,39,-375
11,-54,-180,64,-214,-92,-303,161,-607
1,-43,-44,-7,-29,-13,-21,32,-124
57,-102,-104,-57,-31,-162,-157,115,-441
-17,-30,-36,-17,-33,-29,-44,9,-197
-16,-21,-28,-8,-20,-10,-43,24,-122
15,-50,-56,6,-55,-46,-62,18,-230
-38,-55,-47,-13,-82,-14,-75,15,-309
-46,-97,-133,-25,-171,-70,-233,28,-747
-13,-95,-53,35,-84,12,-67,59,-206
-91,-51,-113,-83,-54,-11,-196,-4,-603
-8,-61,-156,4,-115,-30,-179,81,-464
-54,-98,-105,-56,-134,-12,-103,63,-499
-50,-21,-52,-32,-45,-16,-55,-10,-281
37,-132,-186,12,-155,-37,-181,123,-519
-33,-40,-56,-28,-128,-81,-120,19,-467
-46,-136,-168,-70,-191,-129,-229,17,-952
-52,-95,-103,-8,-92,-5,-101,70,-386
3,-18,-12,10,-33,3,-13,35,-25
-6,-27,-32,-11,-20,-24,-46,10,-156
-12,-10,-12,16,-33,-10,-31,14,-78
-24,-34,-34,1,-25,-7,-37,7,-153
7,-41,-38,-6,-49,-28,-38,22,-171
5,-84,-98,-32,-125,-105,-144,-26,-609
-19,-9,-19,-18,-26,-17,-38,15,-131
49,-83,-100,36,-93,-83,-213,141,-346
-16,-99,-73,2,-109,-61,-116,41,-431
19,-34,-42,-14,-55,-26,-45,46,-151
8,-3,-26,51,-115,-36,-117,17,-221
20,0,-27,9,-37,-44,-47,47,-79
-41,-61,-68,-7,-120,-36,-102,40,-395
9,-24,-27,8,-21,-22,-26,19,-84
56,-36,-26,16,-20,-62,-65,50,-87
-1,5,-18,7,-1,11,-4,27,26
-13,-6,-17,-15,-26,-6,-35,-1,-119
-96,-217,-256,-119,-343,-217,-433,53,-1628
-54,-42,-41,-15,-92,-79,-120,28,-415
32,-67,-77,-32,-144,-86,-87,66,-395
-93,-194,-194,-73,-231,-50,-174,89,-920
-114,-215,-192,-54,-252,-88,-235,52,-1098
-6,-39,-60,-29,-71,0,-43,62,-186
-6,-12,-16,-20,-12,-9,-18,-4,-97
81,-49,-83,7,-122,-44,-50,122,-138
-42,-70,-145,-62,-203,-197,-257,4,-972
-6,-14,-17,-6,-16,-23,-19,-16,-117
-65,-151,-192,-100,-141,-109,-208,88,-878
57,-130,-223,21,-105,-23,-198,133,-468
16,-57,-45,4,-84,-31,-48,58,-187
-173,-215,-281,-99,-357,-99,-339,81,-1482
2,-61,-69,3,-79,-25,-70,30,-269
7,-117,-114,-64,-102,-98,-122,44,-566
-387,-891,-1021,-483,-1442,-850,-1419,48,-6445
-15,3,-38,9,-31,-29,-68,18,-151
-8,-65,-100,69,-194,-16,-151,183,-282
124,-238,-178,-29,-135,-168,-343,287,-680
-102,-111,-131,-78,-202,-28,-169,37,-784
69,-111,-132,-13,-143,-161,-178,107,-562
-16,-64,-63,-22,-67,-79,-98,27,-382
151,-55,-116,89,-161,-137,-167,282,-114
-5,-29,-50,-35,-65,-46,-63,18,-275
-15,-101,-134,-79,-137,-99,-155,56,-664
5,-25,-70,-3,-49,-29,-51,31,-191
15,-90,-96,11,-85,-45,-87,92,-285
11,-12,-13,13,-37,-24,-36,9,-89
4,-99,-78,-28,-18,-10,-16,50,-195
-31,-104,-104,-44,-132,-69,-170,44,-610
-18,-143,-144,-68,-181,-78,-169,30,-771
15,-40,-102,-65,-40,-82,-98,78,-334
-12,-124,-144,-18,-232,-70,-190,111,-679
11,-156,-176,-43,-150,-25,-202,145,-596
-35,-101,-131,-16,-49,-39,-160,136,-395
-208,-118,-193,-249,-279,-193,-406,-141,-1787
-35,-174,-232,-15,-295,-170,-349,73,-1197
29,-101,-87,-24,-49,-87,-110,62,-367
12,-115,-114,-3,-138,-64,-129,105,-446
-61,-63,-103,-82,-98,-90,-167,45,-619
80,-156,-210,-108,-178,-183,-274,164,-865
-46,-122,-92,-33,-146,-73,-147,26,-633
19,-17,-37,-5,-28,-52,-78,49,-149
50,-92,-171,-51,-181,-124,-153,79,-643
-36,-85,-46,24,-120,-13,-84,51,-309
-1,7,-90,-15,-47,-55,-113,75,-239
24,-158,-170,-62,-227,-203,-326,125,-997
14,-66,-98,-30,-166,-166,-196,25,-683
-5,-73,-81,-40,-173,-92,-152,14,-602
-13,-67,-47,-3,-94,-40,-68,54,-278
29,-53,-109,33,-81,11,-121,134,-157
984,-522,-1795,-18,-116,1446,-381,1649,1247
-58,-97,-113,-50,-158,-40,-138,27,-627
25,-113,-112,6,-106,-75,-132,54,-453
30,-128,-82,33,-136,-36,-135,92,-362
-79,-117,-138,-98,-215,-134,-241,-44,-1066
37,-27,-48,-4,-51,-73,-110,56,-220
-12,-71,-92,-8,-126,-45,-102,36,-420
5,-36,-57,12,-49,-6,-47,43,-135
-57,-127,-149,-38,-207,-72,-215,72,-793
235,-140,-224,62,-251,-28,-164,460,-50
-63,-138,-285,-122,-335,-174,-370,98,-1389
-50,-124,-134,-1,-163,-24,-164,86,-574
-7,-83,-74,-6,-99,-9,-98,36,-340
-34,-232,-189,43,-258,-123,-277,71,-999
28,-113,-111,19,-175,-43,-181,145,-431
-102,-113,-133,-76,-260,-137,-255,40,-1036
179,-158,-168,97,-223,-131,-266,299,-371
-67,-66,-85,-45,-106,-86,-153,-27,-635
-83,-163,-189,-63,-258,-83,-223,56,-1006
9,6,-93,-7,-6,2,-160,138,-111
33,-4,-22,21,-26,-8,-15,43,22
-6,-32,-50,-10,-44,-15,-57,23,-191
-102,-153,-201,-92,-153,-61,-222,107,-877
-4,-85,-104,-23,-91,-19,-74,67,-333
-67,-23,-49,-44,-66,-62,-148,-63,-522
16,-46,-51,-17,-105,-40,-58,43,-258
-42,-171,-284,-168,-150,-209,-378,138,-1264
108,-42,-114,4,-124,-161,-194,114,-409
-12,-124,-136,-20,-167,-130,-208,69,-728
305,-117,-330,116,-193,26,-230,547,124
-120,-182,-146,-11,-191,-37,-209,84,-812
-58,-77,-107,-25,-46,-25,-45,13,-370
-198,-429,-564,-276,-711,-559,-831,17,-3551
-23,-70,-94,-75,-32,-123,-167,53,-531
-41,-108,-147,-39,-143,-18,-107,103,-500
-121,-196,-532,-307,-305,-152,-437,377,-1673
123,-217,-499,79,-447,23,-446,351,-1033
-30,-53,-71,-23,-81,-9,-100,36,-331
29,-109,-134,-4,-121,-121,-211,163,-508
-26,-147,-239,-42,-275,-113,-287,174,-955
-105,-127,-173,-49,-48,-6,-87,-42,-637
-19,-110,-94,4,-67,-33,-63,48,-334
-68,-136,-159,-60,-279,-161,-292,-4,-1159
-75,-141,-145,12,-49,-28,-54,-4,-484
151,-134,-91,1,-85,-147,-197,98,-404
-17,-74,-67,-9,-85,-92,-108,16,-436
-23,-47,-67,-9,-69,-73,-91,39,-340
-23,-35,-34,-30,-31,-16,-48,12,-205
1,-32,-16,19,-52,-40,-45,14,-151
-7,-20,-20,-6,-4,-13,-12,0,-82
-26,-126,-115,-42,-136,-41,-120,81,-525
4,-27,-42,-17,-70,-42,-73,11,-256
-71,-112,-155,3,-195,6,-162,118,-568
-12,-34,-56,5,-47,-22,-60,20,-206
20,-65,-207,6,-141,-24,-196,186,-421
6,-57,-48,-31,-68,-41,-78,-12,-329
-10,3,-9,-6,-31,-31,-43,-1,-128
-11,-58,-75,1,-95,-38,-88,73,-291
-41,-177,-221,-56,-393,-230,-434,215,-1337
-17,-63,-182,-9,-208,-109,-274,22,-840
19,-40,-58,-61,-42,-100,-155,73,-364
-5,-7,-10,-7,-1,-16,-17,-11,-74
7,-22,-29,-2,-45,-23,-24,28,-110
-6,-17,-49,-52,-51,-66,-116,39,-318
-73,-46,-81,-14,-104,-61,-162,-29,-570
-88,-75,-84,-36,-98,-36,-161,-13,-591
-17,-76,-61,-28,-82,-46,-89,11,-388
-7,-31,-29,1,-27,6,-19,26,-80
-52,-187,-297,-62,-128,17,-160,202,-667
-36,-165,-252,-38,-287,-188,-336,100,-1202
4,-41,-25,-8,-45,-28,-77,31,-189
-108,-155,-174,-18,-253,-31,-217,117,-839
196,-33,-87,157,-146,-4,-114,309,278
-31,-92,-118,-56,-73,-79,-111,65,-495
-80,-109,-225,-119,-296,-179,-313,91,-1230
-10,-23,-44,-16,-36,-34,-40,5,-198
-68,-58,-93,-28,-34,-12,-33,-6,-332
6,8,-30,17,-116,-60,-122,66,-231
-42,-79,-80,-64,-109,-63,-131,18,-550
-11,-66,-76,-26,-81,-90,-147,25,-472
5,-94,-71,18,-71,-32,-84,53,-276
14,-42,-33,-1,-48,-44,-45,-1,-200
-4,-38,-21,-6,-59,-43,-61,26,-206
-17,-19,-32,-14,-23,-14,-36,18,-137
5,-97,-93,-57,-94,-71,-97,60,-444
-43,-30,-17,-18,-49,-2,-40,13,-186
-13,-35,-56,-27,-49,-31,-47,21,-237
6,-194,-237,-31,-295,-203,-323,148,-1129
53,-85,-47,5,-37,-102,-114,45,-282
-2,-50,-50,-9,-50,-15,-68,40,-204
42,-16,-47,9,-37,-68,-81,49,-149
-45,-75,-99,26,-125,-72,-123,26,-487
-100,-152,-159,-49,-180,-11,-191,103,-739
-20,-67,-60,-33,-84,-43,-68,-6,-381
-17,-83,-70,-19,-72,-98,-128,27,-460
-27,-87,-121,-5,-65,-47,-67,57,-362
-34,-47,-55,-61,-50,-26,-53,-1,-327
41,-68,-25,10,-54,27,-23,133,41
17,-40,-60,-14,-50,-46,-99,39,-253
-10,-62,-72,-13,-104,-53,-113,24,-403
-25,-40,-48,-14,-93,-87,-138,-31,-476
-11,-45,-48,-20,-25,-18,-56,48,-175
-80,-144,-170,-63,-232,-75,-234,86,-912
-43,-132,-180,-36,-209,-120,-275,124,-871
13,-67,-87,-45,-86,-59,-86,81,-336
-23,-94,-158,-30,-195,-98,-254,110,-742
-9,-33,-41,-21,-17,-19,-49,47,-142
-80,-137,-212,-139,-309,-356,-446,4,-1675
-76,-122,-98,-32,-139,-5,-115,59,-528
142,98,37,197,9,47,-73,102,559
-29,-85,-57,-22,-76,-24,-68,52,-309
-22,-28,-38,-29,-43,-30,-40,-2,-232
-128,-172,-172,-46,-120,-73,-136,-46,-893
26,-18,-23,10,-10,-24,-49,36,-52
1,-2,2,4,-8,-1,2,17,15
-11,-38,-43,12,-37,14,-51,36,-118
-51,-171,-210,-55,-218,-32,-186,99,-824
-38,-175,-244,38,-236,-60,-291,162,-844
-10,-68,-132,-85,-105,-102,-194,53,-643
10,-12,-13,-19,-11,-14,-29,4,-84
30,-126,-225,-110,-276,-328,-452,56,-1431
-55,-73,-91,-55,-75,-51,-70,23,-447
2,-2,-31,-5,-29,-27,-35,8,-119
4,-35,-67,-27,-70,-52,-83,34,-296
37,-16,-40,13,-8,6,-10,52,34
-18,-68,-85,-31,-111,-77,-122,25,-487
-16,-27,-42,-10,-46,-31,-53,6,-219
-39,-60,-81,-25,-103,-79,-110,6,-491
5,-29,-33,-16,-36,-41,-38,-7,-195
-39,-44,-62,-20,-37,-33,-64,5,-294
-37,-105,-108,-69,-148,-119,-135,21,-700
26,-34,-44,20,-63,14,-36,42,-75
51,-45,-54,24,-75,-109,-195,74,-329
-7,-82,-97,-39,-159,-15,-84,101,-382
9,-42,-55,1,-55,-29,-63,44,-190
-47,-54,-62,-17,-85,-12,-70,22,-325
-83,-288,-351,-124,-496,-145,-460,181,-1766
-32,-48,-71,-47,-75,-42,-91,27,-379
30,-75,-79,51,-83,-69,-110,62,-273
24,-73,-77,-17,-18,-60,-150,14,-357
13,-39,-51,-2,-69,-35,-102,98,-187
-26,-23,-25,-34,-39,-28,-61,-32,-268
-25,-63,-83,-39,-123,-69,-130,50,-482
-24,-122,-100,-13,-181,-75,-175,57,-633
23,-145,-188,-4,-224,-29,-102,111,-558
19,-31,-17,9,-36,-26,-43,14,-111
3,-68,-58,-22,-94,-40,-70,36,-313
-6,-58,-49,-2,-45,-43,-48,7,-244
-5,-59,-52,-23,-80,-73,-86,-1,-379
43,-63,-66,17,-104,-92,-124,63,-326
-9,-16,-41,-8,-61,-38,-59,10,-222
-77,-93,-114,-39,-155,-75,-145,29,-669
-3,-6,-30,-2,-43,-1,-31,22,-94
16,-22,-52,2,-60,-44,-71,27,-204
-11,-44,-30,-9,-50,-28,-72,16,-228
15,-53,-42,18,-85,-18,-75,72,-168
38,-5,10,48,-2,-19,-57,77,90
-31,-57,-90,-21,-75,-23,-97,48,-346
-7,-46,-53,2,-53,-4,-64,50,-175
-1,-44,-36,10,-62,-13,-60,13,-193
-19,-53,-120,-40,-99,-95,-142,2,-566
45,-195,-266,79,-280,55,-203,315,-450
15,-192,-203,78,-277,28,-195,265,-481
-13,-26,-25,-11,-20,7,-25,20,-93
-38,-110,-155,-56,-151,-93,-142,102,-643
-12,-57,-63,-40,-41,-55,-88,32,-324
65,-126,-197,-99,-255,-158,-238,247,-761
-44,-100,-151,-2,-112,-48,-129,45,-541
-24,-29,-59,-18,-83,-28,-81,24,-298
-80,-108,-92,-33,-131,-18,-129,35,-556
-88,-84,-70,-51,-111,11,-110,27,-476
-52,-105,-95,-31,-147,-27,-112,58,-511
-53,-99,-92,-33,-118,-33,-102,38,-492
-72,-82,-94,-49,-127,-20,-114,31,-527
-77,-94,-103,-33,-131,-11,-117,50,-516
-77,-91,-98,-52,-124,-41,-106,25,-564
-25,-84,-103,-29,-116,-69,-122,7,-541
-75,-74,-106,-45,-136,-9,-98,65,-478
-76,-93,-94,-55,-152,-30,-130,40,-590
-88,-84,-100,-45,-137,-20,-112,31,-555
-60,-108,-117,-61,-141,-23,-102,43,-569
-98,-98,-87,-33,-128,-36,-102,52,-530
-6,-53,-46,28,-61,-19,-58,21,-194
-25,-69,-46,-15,-45,-3,-50,-16,-269
67,-125,-175,55,-41,-27,-188,175,-259
-11,-26,-70,-50,-83,-72,-91,34,-369
-70,-118,-114,-34,-211,-89,-214,19,-831
-13,-22,-57,-24,-66,-46,-64,17,-275
-31,-97,-156,-116,-95,-150,-206,31,-820
-18,-13,-18,-11,-1,-8,-18,-21,-108
-16,-18,-35,-17,-58,-33,-36,7,-206
-17,-46,-38,-40,-54,-53,-57,23,-282
-26,-48,-53,0,-74,-36,-79,23,-293
-38,-44,-62,-25,-75,-24,-97,11,-354
6,-9,-18,-18,-39,-25,-25,33,-95
-11,-77,-73,-16,-73,-98,-125,26,-447
23,33,-5,14,26,-29,3,-7,58
3,-71,-74,5,-87,-52,-92,4,-364
21,-40,-32,12,-22,-48,-63,25,-147
7,-66,-55,8,-69,-16,-78,34,-235
-78,-134,-138,-50,-82,-34,-93,78,-531
-33,-21,-14,-7,-58,-24,-62,11,-208
-8,-151,-130,-65,-137,-150,-232,147,-726
-141,-199,-204,-72,-300,-138,-303,38,-1319
15,-169,-236,-111,-168,-52,-162,249,-634
15,-9,-65,-20,-64,-48,-86,12,-265
12,-97,-195,-39,-201,-86,-218,179,-645
7,1,-16,11,-22,1,-21,16,-23
-34,-90,-99,-51,-130,-40,-144,35,-553
8,-84,-102,44,-101,-10,-81,74,-252
2,-18,-26,13,-30,-10,-36,30,-75
-2,-34,-50,-22,-28,-56,-102,39,-255
-162,-152,-191,-106,-93,-101,-161,-16,-982
-13,-213,-183,-36,-280,-161,-273,83,-1076
9,-60,-15,5,-10,-24,-28,27,-96
-62,-122,-164,-69,-212,-72,-206,107,-800
-61,-82,-68,-74,-100,-74,-132,-9,-600
73,-14,-46,-17,22,-54,-58,77,-17
5,-124,-55,78,-128,15,-105,71,-243
-66,-196,-202,-80,-238,-150,-252,43,-1141
0,-23,-25,-12,-43,-33,-36,40,-132
-6,-33,-39,-6,-49,-38,-54,32,-193
-12,-20,-49,-9,-55,-20,-39,25,-179
-10,-82,-122,-42,-46,16,-94,57,-323
-25,-59,-86,-44,-128,-63,-156,12,-549
-59,-277,-424,-65,-512,-258,-495,277,-1813
-30,-56,-54,-10,-131,-62,-103,11,-435
4,-48,-64,-19,-59,-83,-149,72,-346
-26,19,-41,41,-63,-11,-73,8,-146
-22,76,-20,87,-58,2,-77,0,-12
-24,29,-42,51,-66,-16,-77,0,-145
-26,30,-20,45,-50,-14,-58,-3,-96
-22,119,-30,157,-83,-7,-116,8,26
-34,35,-61,71,-91,-31,-109,19,-201
-13,116,-16,125,-75,-5,-106,6,32
19,-133,-99,-15,-142,-81,-150,92,-509
-20,-33,-32,-8,-47,-6,-20,20,-146
1,-149,-126,-34,-159,-133,-206,107,-699
9,-180,-138,113,-188,-5,-150,149,-390
62,-60,-12,16,-10,-23,-41,70,2
-4,-5,-21,-1,-24,-7,-50,12,-100
71,-77,-147,-8,-85,50,-72,152,-116
-32,-47,-66,-44,-84,-46,-125,46,-398
-38,-24,-50,-23,-63,-46,-72,8,-308
-40,-94,-121,-32,-213,-85,-160,102,-643
-39,-109,-99,1,-177,-61,-124,66,-542
114,-207,-290,39,-82,-112,-263,237,-564
53,-312,-297,204,-493,-4,-385,399,-835
17,-117,-211,33,-104,11,-108,176,-303
-4,-50,-64,-35,-90,-83,-84,16,-394
-171,-174,-186,-74,-189,-132,-289,-120,-1335
-34,-127,-156,-39,-177,-96,-203,38,-794
3,-36,-43,-17,-57,-29,-67,37,-209
11,-18,-33,26,-31,-25,-35,0,-105
18,-23,-39,6,-24,-23,-106,108,-83
-66,-155,-144,-32,-161,-7,-165,116,-614
-58,-106,-129,-30,-133,-21,-119,30,-566
39,-181,-100,3,-177,-131,-161,87,-621
-67,-44,-96,-65,-113,-144,-184,4,-709
-104,-154,-178,-159,-205,-134,-278,-47,-1259
-24,-81,-85,-27,-97,-53,-87,-5,-459
37,-35,-37,51,14,22,-37,82,97
-51,-46,-44,-28,-43,-39,-94,-25,-370
-30,-50,-70,-42,-52,-94,-116,-8,-462
-50,-62,-115,-27,-114,-43,-116,40,-487
-57,-59,-104,-9,-136,-30,-171,60,-506
13,-133,-88,8,-126,-38,-139,65,-438
24,3,-4,8,18,-8,1,13,55
-19,-32,-41,-37,-33,-24,-43,35,-194
-90,-120,-96,-85,-142,-88,-185,5,-801
38,-39,-35,25,-63,-14,-106,86,-108
14,1,-31,-22,-35,-76,-88,27,-210
20,-20,-55,-7,-29,-40,-57,74,-114
-29,-39,-37,2,-34,-15,-57,8,-201
-11,-78,-93,-17,-103,-40,-116,89,-369
28,0,-12,21,-13,-24,-12,35,23
-78,-99,-183,-126,-222,-196,-285,10,-1179
-20,-55,-142,-110,-166,-196,-295,-39,-1023
0,-86,-108,-32,-112,-105,-139,7,-575
-10,-16,-19,-2,-23,-35,-67,62,-110
25,-57,-99,-79,-83,-77,-154,127,-397
-42,-38,-48,18,-104,-42,-88,8,-336
-9,-57,-61,-16,-47,-25,-57,39,-233
-28,-96,-125,-9,-162,-73,-151,9,-635
-10,-104,-110,-14,-114,-68,-143,39,-524
-2,-129,-91,-45,-136,-41,-104,74,-474
-2,-74,-132,0,-75,-64,-143,74,-416
71,-28,-39,-2,-35,-47,-115,54,-141
-92,-144,-197,-110,-215,-102,-257,17,-1100
-89,-147,-157,-78,-223,-127,-243,-23,-1087
-83,-107,-153,-64,-141,-160,-231,-14,-953
-3,-2,-3,0,-7,7,-8,1,-15
19,-121,-127,-1,-123,-17,-114,162,-322
-40,-101,-102,-55,-154,-73,-121,60,-586
-176,-193,-187,-85,-254,-61,-253,61,-1148
-37,-110,-143,-41,-179,-97,-180,49,-738
156,-81,-120,-50,-32,-149,-222,195,-303
39,-100,-125,-4,-163,-132,-212,99,-598
-8,-1,-42,-14,-35,-57,-61,4,-214
18,-13,-12,16,-28,-19,-24,10,-52
12,1,5,14,-8,-7,-8,8,17
-6,-30,-17,-22,-13,-27,-22,-8,-145
-51,-90,-107,-19,-134,-19,-119,80,-459
-7,-30,-35,-13,-27,-14,-24,14,-136
-38,-47,-41,28,-56,-5,-51,52,-158
-35,-32,-57,-17,-104,-41,-88,-9,-383
-2,-22,-33,20,-25,6,-22,2,-76
-76,-95,-125,-82,-116,-45,-142,47,-634
18,-63,-73,19,-98,-40,-82,57,-262
-29,-77,-140,-90,-93,-192,-232,28,-825
-50,-34,-108,-16,-28,-26,-51,-6,-319
-56,-95,-175,-31,-82,-28,-126,34,-559
40,-33,-73,-5,-160,-127,-118,0,-476
-18,-119,-106,8,-129,-83,-168,73,-542
-39,-68,-58,-29,-57,-26,-77,11,-343
-71,-127,-102,-72,-106,-83,-126,37,-650
-9,-52,-72,-37,-62,11,-64,53,-232
-20,-63,-72,-24,-91,-46,-101,8,-409
27,-45,-76,-34,-121,-106,-138,4,-489
-43,-99,-111,-99,-136,-100,-164,-34,-786
-6,1,-14,25,-23,-17,-36,13,-57
2,-9,-22,9,-72,-83,-73,-14,-262
-23,-24,-23,-15,-35,-17,-40,2,-175
-36,-74,-92,-18,-148,-32,-122,58,-464
-64,-72,-102,-44,-169,-40,-151,60,-582
117,-40,-112,28,-138,-203,-270,75,-543
23,-56,-65,-10,-74,4,-58,68,-168
2,-39,-90,-75,-36,-90,-176,34,-470
6,-19,-16,-26,-19,-30,-62,20,-146
-38,-83,-56,-15,-87,-42,-73,6,-388
6,-10,-26,0,-27,-38,-46,21,-120
4,-34,-74,-71,-82,-58,-101,-1,-417
81,-24,-71,14,-65,-32,-94,88,-103
36,-19,-15,3,-18,-41,-28,33,-49
-23,-42,-45,-43,-58,-60,-77,-9,-357
-14,-47,-53,-37,-56,-51,-90,41,-307
-22,-35,-77,-66,-80,-79,-101,29,-431
-27,-76,-74,-3,-130,-39,-118,24,-443
-26,-20,-39,-18,-39,-57,-56,3,-252
-65,-110,-211,-40,-104,25,-145,98,-552
54,-163,-326,-83,-325,-210,-476,303,-1226
-56,-186,-231,-92,-339,-126,-326,172,-1184
-7,-25,-18,2,-15,-14,-25,-5,-107
-86,-202,-180,-12,-250,-86,-210,23,-1003
-74,-133,-118,-4,-139,-38,-156,10,-652
35,-246,-205,-5,-239,-135,-309,143,-961
-4,-91,-92,-63,-113,-49,-89,38,-463
-12,-46,-44,11,-68,-23,-57,33,-206
-11,-18,-28,-3,-41,-36,-58,-9,-204
-41,-68,-87,-50,-104,-39,-101,7,-483
31,-38,-91,21,-36,-15,-124,128,-124
-65,-48,-105,-74,-100,-50,-105,40,-507
-12,-22,-21,-12,-31,11,-20,30,-77
-43,-96,-117,-17,-162,-55,-169,60,-599
1,-163,-198,-96,-273,-149,-261,146,-993
-25,-104,-118,-71,-108,-15,-94,57,-478
74,-99,-111,-59,-133,-249,-220,38,-759
-42,-40,-40,12,-65,-11,-53,-4,-243
-79,-108,-87,-68,-116,-82,-114,-18,-672
-6,-60,-54,16,-82,-18,-58,18,-244
-15,-50,-75,28,-101,-49,-145,60,-347
-25,-77,-84,-50,-97,-106,-127,-9,-575
-42,-26,-66,-45,-85,-22,-99,-21,-406
39,-70,-42,-2,-29,-55,-94,88,-165
-31,-251,-253,-23,-297,-74,-221,129,-1021
-3,-41,-39,-12,-45,-43,-72,18,-237
-79,-130,-131,-1,-78,-18,-79,-3,-519
-22,-121,-117,-8,-124,-61,-139,55,-537
-18,-61,-65,-20,-85,-50,-71,27,-343
-55,-93,-99,-9,-52,-9,-66,-13,-396
-76,-154,-173,-118,-153,-103,-189,31,-935
59,-130,-275,-11,-347,-261,-391,118,-1238
-50,-53,-108,-75,-117,-125,-177,11,-694
-37,-65,-67,-59,-107,-71,-106,23,-489
21,-65,-52,-25,-64,-23,-22,63,-167
-15,-39,-62,5,-72,-24,-65,22,-250
-12,-52,-50,-17,-94,-45,-87,11,-346
-19,-127,-145,-29,-224,-78,-180,40,-762
-235,-535,-338,-94,-477,-186,-506,118,-2253
-181,-257,-301,-75,-352,-123,-389,49,-1629
1,-63,-81,-9,-40,-37,-82,37,-274
-72,-102,-111,-60,-108,-53,-126,9,-623
19,-99,-131,17,-147,-83,-162,64,-522
56,-73,-43,80,-67,-47,-176,163,-107
-117,-162,-197,-48,-102,-21,-120,23,-744
-6,-17,-18,19,-26,-11,-21,-4,-84
-82,-21,-125,-42,-123,-129,-212,27,-707
-18,-117,-131,-28,-107,6,-154,103,-446
-86,-145,-162,-41,-236,-140,-248,-15,-1073
-38,-96,-101,-15,-154,-36,-105,69,-476
26,9,-7,44,-20,1,-26,41,68
-7,-39,-55,-10,-62,-22,-88,48,-235
-24,-100,-78,-9,-87,-57,-88,54,-389
-29,-46,-80,-38,-110,-78,-129,-10,-520
-39,-85,-103,9,-144,-36,-118,73,-443
-36,-68,-77,-18,-88,-17,-75,40,-339
-22,-120,-59,48,-68,-24,-109,38,-316
-50,-27,-30,-22,-48,-16,-67,4,-256
4,4,-25,-3,-59,-76,-59,21,-193
-37,-115,-97,-36,-116,-56,-146,15,-588
18,4,-22,10,-37,-7,-20,38,-16
-6,-99,-224,-70,-177,-17,-186,145,-634
-5,-42,-42,-24,-62,-6,-51,23,-209
14,-67,-59,-23,-115,-70,-84,61,-343
-80,-94,-132,-44,-205,-70,-202,62,-765
99,-219,-265,-91,-245,-115,-245,224,-857
23,-43,-113,-35,-91,-128,-127,49,-465
9,-49,-43,-32,-62,-24,-53,60,-194
12,-7,-26,3,-22,-43,-41,17,-107
-9,-40,-48,-15,-45,-5,-43,7,-198
-1,-28,-43,-31,-63,-39,-52,-3,-260
3,-51,-92,-28,-109,-141,-200,-52,-670
-32,-41,-91,-71,-52,-13,-125,50,-375
-1,-18,-20,-6,-20,3,-15,28,-49
1,-86,-65,32,-71,-31,-86,49,-257
-23,-41,-38,-6,-41,-12,-46,23,-184
0,-96,-169,-22,-205,-201,-249,3,-939
-11,-42,-23,-16,-29,-39,-51,-3,-214
-13,-47,-58,13,-80,-6,-89,69,-211
-72,-119,-164,-152,-139,-181,-280,24,-1083
-5,-29,-33,-11,-68,-48,-38,12,-220
72,8,-37,19,3,-20,-32,-1,12
0,-39,-63,-22,-108,-113,-96,-43,-484
7,-70,-72,-5,-97,-33,-96,57,-309
-29,-43,-72,-42,-65,-22,-71,27,-317
-8,-66,-76,-10,-55,-70,-113,32,-366
-36,-72,-169,-60,-144,-36,-142,128,-531
-11,-74,-149,-64,-166,-117,-199,22,-758
-74,-105,-169,-31,-103,-29,-108,69,-550
-52,-110,-104,-43,-168,-39,-145,74,-587
-105,-139,-141,-46,-104,-42,-101,3,-675
22,-58,-64,26,-93,-57,-76,50,-250
3,-144,-210,-135,-302,-266,-369,34,-1389
-74,-50,-125,-62,-112,-53,-155,-24,-655
-18,-18,-44,-37,-52,-55,-84,-36,-344
-132,-187,-188,-92,-212,-84,-292,-18,-1205
-3,-57,-32,-7,-48,-24,-51,7,-215
-12,-25,-35,-4,-33,13,-35,25,-106
-88,-72,-102,-79,-49,-64,-114,-18,-586
-6,-71,-92,-36,-73,-29,-100,67,-340
-6,-3,-29,-17,-39,-27,-60,16,-165
-2,-17,-18,-13,-4,-9,-11,13,-61
36,-63,-92,-15,-111,-81,-107,81,-352
30,-130,-142,-10,-124,-71,-141,77,-511
9,-54,-41,25,-81,-28,-88,47,-211
-24,-75,-120,-14,-198,-94,-174,59,-640
-12,-34,-71,-15,-38,31,-74,35,-178
24,-92,-141,20,-166,-93,-143,130,-461
-39,-117,-126,-18,-108,-35,-105,19,-529
-61,-55,-125,-127,-64,-159,-238,60,-769
41,-82,-172,71,-194,-180,-270,-14,-800
44,-35,-41,22,-81,-35,-43,31,-138
-3,-25,-25,-16,-30,-24,-39,15,-147
-97,-136,-149,-38,-78,-12,-104,-31,-645
15,-39,-53,43,-93,-17,-105,110,-139
-15,-52,-81,-11,-84,-8,-70,57,-264
-15,-23,-32,-17,-90,-40,-99,63,-253
-16,-39,-53,-9,-32,-4,-58,53,-158
10,-45,-17,3,-25,-16,-51,21,-120
-55,-61,-58,-33,-79,-19,-67,18,-354
-33,-39,-47,-43,-54,-52,-70,11,-327
12,-71,-49,26,-107,-22,-65,52,-224
-50,-79,-82,-84,-121,-128,-208,3,-749
-59,-96,-111,-18,-80,-31,-80,27,-448
-17,-66,-76,-10,-79,-91,-115,-55,-509
-26,-40,-64,-13,-54,-30,-71,-2,-300
56,-90,-115,-28,-179,-118,-178,49,-603
30,7,1,52,23,26,-13,30,156
-7,-113,-221,-42,-269,-132,-293,187,-890
-118,-134,-160,-24,-71,-7,-102,-23,-639
13,-36,-83,-66,-39,-64,-104,95,-284
-24,-301,-314,59,-400,-357,-494,-176,-2007
31,12,-11,32,-53,-33,-59,65,-16
48,-62,-69,56,-62,30,-72,138,7
-26,-29,-41,-21,-32,-3,-43,20,-175
-11,-39,-36,9,-60,-44,-55,-4,-240
-27,-79,-86,-58,-150,-112,-166,-23,-701
-35,-53,-66,-47,-75,-17,-69,-4,-366
-45,-59,-41,-8,-62,-26,-78,-5,-324
-1,-69,-110,-7,-146,-79,-147,51,-508
10,-62,-76,4,-88,-42,-83,54,-283
-76,-117,-107,-88,-170,-56,-140,29,-725
15,-65,-43,58,-41,-39,-116,102,-129
4,-89,-113,-15,-88,-1,-109,44,-367
-31,-35,-38,-13,-59,-31,-98,-1,-306
-13,-20,-32,-23,-22,-20,-39,12,-157
32,-35,-7,36,-14,1,-30,52,35
16,-32,-40,-10,-62,-45,-58,3,-228
-27,-49,3,37,-51,-9,-89,46,-139
-12,-14,-37,-22,-37,-36,-52,-2,-212
-179,-379,-391,-139,-574,-287,-513,23,-2439
-35,-41,-59,-43,-22,-77,-85,3,-359
-2,-27,-54,-34,-74,-56,-89,21,-315
18,-132,-155,-6,-248,-74,-227,150,-674
-20,-33,-41,12,-47,-8,-38,0,-175
-60,-91,-181,-96,-159,-115,-220,99,-823
-83,-88,-121,-44,-180,-55,-154,56,-669
20,-95,-62,6,-130,-34,-98,46,-347
-7,-61,-58,-14,-42,-29,-79,48,-242
40,-42,-52,4,-71,-70,-79,18,-252
2,-94,-87,39,-133,-41,-128,67,-375
-41,-88,-92,-59,-121,-73,-147,-17,-638
-44,-120,-100,-70,-114,-41,-122,29,-582
0,-19,-18,19,-33,-10,-22,24,-59
0,-59,-60,25,-79,-32,-72,81,-196
98,-78,-54,-5,-82,-116,-172,95,-314
-17,-64,-92,-66,-93,-145,-178,20,-635
6,-33,-46,-17,-39,-17,-47,34,-159
-50,-168,-169,-59,-178,-89,-192,123,-782
73,-107,-126,-60,-46,-108,-172,168,-378
19,-135,-207,-98,-231,-260,-266,16,-1162
30,-80,-81,-24,-160,-129,-202,69,-577
23,-185,-157,0,-205,-95,-174,116,-677
24,-141,-173,22,-119,-14,-174,182,-393
-6,-44,-39,1,-28,-47,-84,19,-228
23,-137,-114,-13,-69,-33,-108,114,-337
43,-18,-97,27,-124,-98,-145,52,-360
-22,-28,-54,-63,-29,-71,-48,12,-303
1,-36,-49,4,-98,-26,-66,40,-230
0,-3,-12,18,-12,-2,-9,5,-15
-37,-96,-134,-14,-81,-40,-94,47,-449
-62,-203,-218,-35,-275,-117,-284,107,-1087
40,-106,-120,-9,-31,-74,-179,150,-329
10,-46,-53,-21,-65,-26,-60,35,-226
-37,-52,-67,7,-69,-25,-83,35,-291
-90,-167,-228,-68,-368,-148,-317,128,-1258
30,-19,-35,0,-52,-12,-37,67,-58
-28,-39,-68,-40,-53,-54,-76,20,-338
-57,-92,-98,-49,-152,-51,-158,41,-616
-114,-113,-120,-79,-180,-39,-160,35,-770
83,-175,-389,-83,-352,-411,-540,143,-1724
10,-18,-49,-18,-12,-30,-44,45,-116
-18,13,-19,-16,9,-17,-28,-27,-103
-55,-104,-133,-39,-169,-39,-185,43,-681
-52,-122,-141,-48,-164,-18,-134,87,-592
-15,-66,-72,-40,-93,-49,-80,46,-369
-62,-214,-189,-42,-244,-37,-258,84,-962
5,-40,-34,-8,-12,-20,-35,42,-102
-39,-291,-371,-121,-280,-64,-348,182,-1332
-6,-34,-68,-38,-98,-119,-120,-25,-508
3,-18,-21,-19,-2,-24,-30,10,-101
-17,-56,-65,-40,-75,34,-40,55,-204
-25,-40,-54,-23,-66,-13,-64,16,-269
6,-54,-47,-43,-119,-33,-64,82,-272
-13,-108,-57,-30,-95,-76,-93,10,-462
7,-81,-113,-42,-160,-62,-170,67,-554
-1,-10,-45,-19,-49,-36,-61,6,-215
19,-74,-70,8,-101,-82,-80,35,-345
-26,-203,-219,8,-275,-48,-240,170,-833
26,-7,-40,-16,-44,-43,-72,12,-184
8,-23,-16,14,-23,-24,-50,-24,-138
-165,-222,-287,-114,-286,-105,-335,55,-1459
-148,-204,-339,-83,-482,-149,-455,53,-1807
11,-98,-99,-14,-115,-100,-97,22,-490
-9,-18,-40,-18,-62,-45,-48,33,-207
57,-39,-32,12,-27,-91,-101,64,-157
21,-120,-178,96,-311,-52,-262,344,-462
-7,-17,-26,-16,-30,-15,-29,5,-135
-17,-23,-18,-23,-13,-22,-46,6,-156
-12,-15,-19,1,-9,-4,-24,22,-60
-10,-27,-32,1,-58,-15,-38,14,-165
-12,5,-45,23,-47,-37,-74,13,-174
-3,-9,-57,13,-41,-37,-73,9,-198
20,-65,-81,-1,-81,-74,-138,76,-344
-53,-45,-118,-15,-146,-67,-193,25,-612
4,-33,-67,-2,-70,-49,-81,33,-265
-17,-25,-81,-26,-42,-33,-82,56,-250
-29,-83,-55,-24,-73,-40,-89,-1,-394
-59,-107,-127,10,-95,27,-107,35,-423
17,-71,-74,-10,-63,-24,-95,69,-251
89,-58,-61,-32,-44,-123,-150,99,-280
5,-74,-58,-33,-91,-79,-104,38,-396
-25,-65,-119,-88,-196,-153,-234,-18,-898
-10,-26,-43,-11,-66,-27,-52,42,-193
3,-40,-46,2,-40,-25,-38,12,-172
-100,-103,-119,-53,-183,-62,-181,43,-758
52,-96,-125,-10,-138,-122,-189,95,-533
213,-170,-283,58,-244,-109,-312,351,-496
-25,-83,-88,10,-93,-74,-124,11,-466
-72,-112,-70,-14,-119,-32,-103,44,-478
44,-128,-123,15,-165,-121,-142,95,-525
-108,-123,-163,-130,-160,-40,-155,-6,-885
-195,-190,-244,-156,-280,-225,-477,-224,-1991
-60,-117,-114,-14,-178,-13,-141,66,-571
-22,-117,-111,-25,-150,-55,-129,77,-532
-40,-103,-83,-6,-126,-21,-116,56,-439
-64,-86,-110,-21,-68,-28,-66,-7,-450
-135,-161,-211,-104,-308,-129,-303,74,-1277
27,-11,-24,-15,-13,-47,-45,34,-94
8,-48,-29,-9,-97,-8,-64,63,-184
-27,-88,-89,-50,-252,-120,-235,88,-773
-111,-200,-410,-201,-189,-71,-356,94,-1444
94,-264,-506,-175,-253,-415,-550,50,-2019
-20,-26,-21,3,-19,1,-36,1,-117
-36,-43,-77,-43,-94,-80,-115,0,-488
137,-38,-92,104,-141,3,-113,168,28
75,-42,-40,8,-55,-13,-94,102,-59
-9,-58,-52,12,-61,0,-63,34,-197
-22,-64,-56,-2,-70,-44,-67,0,-325
80,-26,-55,46,-23,-69,-136,126,-57
108,-63,-34,72,-42,-59,-129,154,7
-72,-76,-108,-87,-73,-82,-130,-46,-674
223,-250,-390,-93,-573,-377,-495,395,-1560
-171,-221,-217,-46,-338,-77,-317,107,-1280
-19,-41,-26,14,-46,-2,-37,12,-145
-43,-108,-91,1,-119,-60,-119,25,-514
27,-17,-36,-3,-51,-29,-44,57,-96
-34,-83,-85,-46,-119,-41,-94,31,-471
-16,-9,-30,-24,-21,-21,-31,2,-150
3,-36,-34,12,-35,-11,-51,26,-126
-13,-27,-27,-12,-32,-20,-29,5,-155
0,-59,-77,-7,-46,0,-64,41,-212
-10,-27,-31,-6,-33,-32,-55,4,-190
58,-119,-73,31,-134,-73,-139,116,-333
-12,-114,-98,-9,-113,-42,-90,25,-453
-30,-35,-47,-8,-49,-30,-73,-3,-275
-9,2,-5,-9,-18,-24,-18,-1,-82
-19,-39,-45,2,-37,-10,-48,4,-192
13,-108,-116,-68,-111,-99,-140,73,-556
-12,-47,-54,-30,-39,-9,-80,26,-245
8,-43,-47,-36,-25,-47,-71,22,-239
-138,-55,-98,-105,-172,-150,-257,-61,-1036
-19,-21,-23,1,-28,-19,-25,10,-124
0,-31,-32,-11,-17,-11,-36,25,-113
-19,-41,-37,-17,-50,-2,-40,15,-191
-76,-106,-111,-33,-142,4,-92,42,-514
-26,-41,-38,-26,-59,-33,-66,1,-288
-32,-60,-100,-50,-135,-91,-131,34,-565
-45,-57,-67,-7,-81,3,-73,44,-283
52,-36,-74,11,-31,40,-51,105,16
34,-23,-30,47,-35,-23,-64,79,-15
-100,-107,-186,-115,-224,-81,-250,67,-996
3,-22,-34,-19,-32,-37,-42,22,-161
-28,-22,-27,-30,-21,-13,-30,12,-159
-22,-91,-106,5,-160,22,-124,140,-336
39,-93,-139,-34,-152,-116,-174,131,-538
4,-73,-31,46,-32,-8,-49,9,-134
-6,-98,-78,41,-90,-48,-119,28,-370
-40,-124,-97,-28,-140,-50,-117,40,-556
-24,-52,-67,14,-64,-15,-82,35,-255
5,-41,-36,3,-38,-13,-47,35,-132
-5,-4,-19,0,0,-2,-13,11,-32
-10,-37,-43,8,-84,-34,-59,19,-240
-84,-117,-95,-56,-124,-18,-117,41,-570
178,104,-21,98,-32,-113,-38,-2,174
-10,-20,-14,19,-28,-12,-34,3,-96
-13,-28,-31,-14,-25,-16,-39,20,-146
8,-91,-59,9,-71,-15,-80,67,-232
-12,-6,-9,-6,-17,-14,-25,-3,-92
3,-11,-24,-7,-18,-17,-31,14,-91
1,-4,-20,-2,-14,-24,-21,11,-73
-32,-125,-80,6,-90,-42,-151,68,-446
-39,-77,-61,-50,-40,-33,-93,14,-379
3,-33,-50,6,-41,-6,-33,63,-91
7,-72,-50,-3,-75,-28,-61,44,-238
6,-45,-51,-1,-42,-26,-45,25,-179
11,-29,-27,8,-39,-22,-31,31,-98
64,-77,-67,18,-106,-31,-75,108,-166
-24,-35,-35,-25,-45,-21,-45,21,-209
-47,-98,-88,27,-109,-62,-173,67,-483
-2,-115,-93,12,-96,-37,-86,52,-365
-2,-33,-54,-38,-63,-57,-59,46,-260
-42,-63,-53,4,-90,-14,-93,33,-318
-17,-60,-86,-10,-96,-34,-66,31,-338
-104,-119,-144,-82,-179,-91,-215,32,-902
5,-19,-52,-21,-55,-15,-71,27,-201
15,-66,-28,70,-77,30,-100,88,-68
-17,-57,-72,-28,-97,-90,-136,30,-467
-11,-56,-59,-3,-64,-8,-91,37,-255
18,-39,-64,12,-53,-24,-60,36,-174
15,-13,-20,-10,-19,-20,-36,28,-75
5,-5,-23,-1,-5,-23,-40,22,-70
-15,-40,-58,-14,-60,-18,-55,29,-231
-3,-109,-85,0,-123,-21,-90,70,-361
-27,-15,-37,-36,-39,-46,-56,-21,-277
6,-49,-54,-11,-56,-19,-57,43,-197
-32,-47,-48,-32,-43,-43,-58,10,-293
-29,-67,-73,-8,-94,-24,-88,29,-354
7,-107,-125,24,-164,-136,-197,80,-618
8,-83,-89,23,-126,-3,-48,99,-219
26,-73,-42,-8,-103,-105,-123,35,-393
-33,-43,-67,-13,-85,-83,-132,12,-444
0,-38,-75,7,-36,-9,-66,34,-183
-31,-40,-79,-38,-67,-108,-109,-22,-494
65,3,2,40,13,-41,-98,73,57
39,-36,-61,13,-68,-69,-110,59,-233
-36,-26,-39,-24,-22,-14,-40,5,-196
-23,-19,-27,-21,-18,-27,-28,10,-153
-12,-24,-38,-15,-19,-2,-34,8,-136
5,-41,-54,-10,-70,-58,-93,4,-317
44,-74,-89,0,-61,-52,-105,34,-303
92,-133,-150,53,-184,-215,-300,136,-701
-10,-7,-43,-47,-24,-47,-23,4,-197
16,-82,-103,-45,-75,-72,-227,151,-437
-16,-83,-134,7,-159,-111,-175,58,-613
0,-91,-84,3,-106,-14,-100,84,-308
94,-83,-83,21,-18,10,-81,176,36
0,-88,-85,23,-90,-75,-99,27,-387
64,-155,-160,102,-123,60,-146,200,-158
20,-29,-52,-27,-19,-27,-96,49,-181
4,-99,-94,-48,-140,-115,-144,68,-568
-13,-30,-40,-26,-58,-58,-73,-24,-322
-8,-20,-32,37,-42,-18,-70,27,-126
-6,-29,-20,24,-29,-60,-81,22,-179
-27,-96,-100,-1,-159,-19,-134,85,-451
55,-112,-97,40,-144,-1,-88,136,-211
22,-52,-60,25,-48,-10,-82,89,-116
72,-100,-110,-25,-116,-142,-203,74,-550
-15,-106,-132,7,-155,8,-116,70,-439
-26,-74,-73,-32,-82,-18,-66,56,-315
7,-131,-152,35,-223,-66,-259,127,-662
-14,-38,-53,-15,-16,3,-49,44,-138
-25,-22,-29,-23,-30,-34,-48,-7,-218
-26,-41,-59,8,-48,-27,-83,34,-242
-7,-54,-57,26,-91,-3,-33,59,-160
-7,-12,-30,9,-25,-18,-44,18,-109
23,-37,-44,12,-56,1,-37,39,-99
-5,-36,-42,-5,-31,-30,-50,17,-182
-5,-28,-22,-5,-11,-10,-37,-1,-119
-7,-7,-30,-31,-11,-41,-52,39,-140
-7,-45,-56,-19,-91,-53,-88,2,-357
21,-22,-31,-5,-24,-36,-44,45,-96
0,-30,-32,-5,-21,-20,-46,29,-125
1,-35,-30,0,-37,-20,-41,16,-146
-15,-38,-51,19,-103,-15,-73,31,-245
-20,-24,-40,-17,-23,-19,-33,6,-170
-33,-51,-116,-68,-123,-122,-173,39,-647
11,-18,-34,-4,-22,-31,-33,15,-116
7,-60,-69,16,-56,-43,-95,29,-271
-19,-35,-39,-33,-30,-16,-53,19,-206
-51,-82,-70,2,-83,-34,-67,25,-360
-37,-52,-48,-51,-66,-43,-80,12,-365
1,-44,-41,-5,-27,-27,-41,20,-164
10,-54,-76,-10,-38,-6,-28,52,-150
-6,-211,-260,-116,-266,-83,-311,247,-1006
-59,-35,-43,-14,-28,-11,-58,23,-225
9,-67,-72,19,-76,-71,-160,73,-345
-65,-186,-96,33,-195,-16,-291,160,-656
-20,-26,-64,-17,-62,10,-48,53,-174
-7,-35,-47,-8,-27,7,-31,27,-121
-1,-120,-149,16,-184,-19,-185,157,-485
-68,-55,-90,-41,-127,-82,-164,-14,-641
-19,-82,-137,-43,-134,-11,-148,90,-484
-11,-43,-44,-10,-59,-85,-92,30,-314
-7,-15,-14,-1,-34,-10,-25,8,-98
15,-89,-130,12,7,-110,-252,235,-312
-31,-69,-104,-85,-159,-106,-206,45,-715
-26,-33,-35,-5,-26,-10,-39,-7,-181
19,-19,-32,-8,-46,-43,-65,22,-172
435,-493,-530,360,-1131,215,-695,1262,-577
-45,-74,-124,-76,-164,-137,-216,26,-810
152,-389,-532,50,-793,0,-480,609,-1383
-79,-168,-119,16,-201,-18,-184,74,-679
-5,-21,-23,19,-77,-24,-61,11,-181
-39,-76,-102,17,-44,4,-45,27,-258
-57,-167,-150,-100,-112,-66,-208,81,-779
-9,-76,-57,-51,-66,-86,-139,54,-430
24,-47,-58,-34,-54,-88,-108,75,-290
195,-94,-185,-2,-103,16,-185,288,-70
62,-15,-42,111,-70,-30,-117,120,19
58,-56,-80,-7,-86,-121,-132,11,-413
23,-45,-81,-32,-119,-38,-69,60,-301
-28,-103,-86,-7,-106,-38,-113,40,-441
58,-79,-168,-15,-200,-91,-150,227,-418
-9,0,-26,-5,-30,-8,-29,19,-88
177,-262,-220,26,-200,-190,-322,256,-735
-3,-16,-33,0,-20,-9,-34,13,-102
-107,-158,-143,-96,-167,-26,-184,30,-851
257,-491,-613,65,-197,306,-310,631,-352
-71,-96,-104,-48,-139,32,-107,72,-461
-16,-79,-85,5,-121,-10,-85,72,-319
-36,-112,-153,-45,-158,-137,-263,5,-899
146,-49,-218,24,-138,-126,-242,233,-370
-21,-90,-106,-52,-51,-72,-101,46,-447
-11,-13,-22,-5,-24,-8,-30,6,-107
13,-463,-505,-112,-508,42,-328,502,-1359
-84,-162,-156,-82,-241,-146,-224,-19,-1114
-16,-5,-9,3,-12,-10,-15,16,-48
-12,-41,-31,-3,-30,-3,-40,30,-130
-31,-68,-84,-39,-107,-67,-142,86,-452
-39,-78,-64,-14,-64,-5,-55,40,-279
-39,-138,-113,-13,-131,-29,-112,59,-516
-21,-41,-42,-31,-36,-29,-56,-1,-257
-8,-29,-39,-20,-39,-41,-72,-17,-265
67,-48,-6,63,5,-11,-16,75,129
-2,-31,-28,-8,-26,-20,-33,7,-141
-11,-31,-23,-14,-21,-10,-23,-8,-141
186,103,35,172,21,-138,-35,116,460
-88,-132,-114,-42,-174,-7,-130,72,-615
36,-70,-105,-28,-159,-139,-187,37,-615
-25,-73,-100,-37,-152,-74,-141,55,-547
-103,-95,-151,-102,-255,-160,-285,19,-1132
-14,-21,-26,2,1,-8,-50,26,-90
-7,-22,-34,-23,-42,-49,-68,16,-229
-32,-106,-114,-60,-123,-27,-57,54,-465
-64,-95,-82,-4,-101,13,-104,80,-357
-11,-135,-265,-100,-274,-124,-366,152,-1123
-29,-74,-61,-4,-95,-21,-85,39,-330
-42,-106,-88,-34,-106,-52,-110,26,-512
-11,-71,-78,11,-90,-129,-184,42,-510
-70,44,-124,-46,-17,-124,-199,56,-480
-64,-91,-147,-36,-182,-7,-116,90,-553
-8,-22,-18,2,-12,-4,-20,15,-67
19,-235,-319,4,-362,20,-219,303,-789
-225,-338,-466,-196,-580,-323,-564,3,-2689
-20,-35,-91,-32,-115,-51,-153,57,-440
8,-46,-51,17,-81,-21,-70,36,-208
-29,-110,-80,-12,-109,-11,-100,52,-399
3,-77,-67,-26,-100,-99,-124,24,-466
-35,-86,-92,-4,-104,-51,-126,54,-444
17,-65,-82,-29,-92,-69,-94,26,-388
-27,-73,-104,-26,-157,-69,-186,87,-555
-46,-96,-88,-6,-106,-40,-101,21,-462
-34,9,-104,-75,-103,-121,-221,-14,-663
-54,-121,-161,-49,-173,-139,-245,-51,-993
79,3,-15,66,-86,-40,-95,78,-10
-3,10,-31,-18,-118,-91,-126,13,-364
-14,-51,-60,-43,-55,-36,-69,43,-285
-33,-96,-90,-33,-83,-46,-101,13,-469
13,-81,-78,-11,-73,-87,-114,46,-385
-67,-36,-123,-13,-180,-110,-234,24,-739
-11,-56,-79,-42,-73,-91,-121,29,-444
37,-98,-112,65,-100,8,-130,212,-118
186,-132,-201,61,-154,-244,-340,262,-562
-21,-25,-40,-11,-75,4,-66,42,-192
-21,-91,-46,-4,-106,2,-72,75,-263
-71,-73,-127,-2,-59,-7,-102,-4,-445
-2,-14,-36,-21,-28,-43,-67,-19,-230
10,-53,-76,-13,-54,-21,-76,93,-190
-14,-115,-160,-28,-155,-41,-132,129,-516
-65,-100,-158,-68,-156,-2,-143,66,-626
29,-56,-70,13,-94,-31,-71,73,-207
2,-72,-101,-75,-136,-125,-155,0,-662
-83,-88,-146,-44,-225,-71,-193,30,-820
-88,-17,-57,-91,-46,-54,-148,-28,-529
-111,-141,-158,-51,-42,-2,-100,-39,-644
-95,-79,-112,-70,-164,-53,-225,10,-788
-48,-98,-168,4,-39,-4,-71,35,-389
64,-262,-302,34,-540,-130,-216,226,-1126
76,-52,-118,-34,-111,-233,-311,187,-596
-21,-97,-93,-14,-160,-24,-79,53,-435
-49,-79,-79,-36,-73,-88,-117,18,-503
28,-103,-104,40,-143,-93,-184,114,-445
-119,-103,-129,-142,-254,-259,-352,-143,-1501
30,-62,-46,-38,-24,-93,-156,112,-277
-11,-52,-94,-34,-24,-39,-86,68,-272
95,-30,-40,86,-78,6,-138,168,69
-104,-123,-166,-24,-57,-26,-114,-26,-640
-115,-156,-191,-66,-51,-9,-82,-21,-691
-48,-89,-83,-10,-34,-16,-88,16,-352
-85,-150,-170,-20,-330,-137,-324,47,-1169
-2,-1,-22,7,-4,-8,-36,56,-10
61,21,-14,72,-73,16,-113,143,113
-140,-145,-210,-16,-64,6,-119,36,-652
-26,-160,-151,-61,-198,-92,-180,44,-824
46,-142,-166,1,-170,-37,-185,191,-462
-20,-60,-65,-42,-30,-62,-115,11,-383
-7,-174,-178,-74,-223,-111,-232,92,-907
-47,-101,-98,-60,-128,-84,-127,4,-641
-14,-191,-212,-74,-148,-179,-242,69,-991
-52,-65,-118,-4,-28,15,-49,26,-275
-41,-63,-116,-47,-126,-66,-128,-9,-596
-107,-108,-104,-44,-132,-20,-126,29,-612
-34,-57,-74,-14,-46,-27,-57,4,-305
-97,-62,-115,-58,-121,-85,-181,-24,-743
-6,-5,-21,-16,-15,-17,-16,-18,-114
-175,-171,-233,-24,-67,16,-169,38,-785
119,-104,-163,-5,-117,-77,-181,231,-297
15,-139,-107,-8,-146,-46,-99,116,-414
-8,-11,-22,-2,-13,-27,-14,16,-81
-127,-168,-220,-165,-66,-144,-204,50,-1044
-58,-124,-105,-21,-140,-18,-133,50,-549
48,-74,-71,-2,-38,-11,-81,101,-128
-65,-154,-125,-15,-192,-32,-142,71,-654
-24,-58,-72,-13,-107,-52,-116,32,-410
-40,-7,-65,-53,-68,-103,-129,-4,-469
-21,-94,-47,6,-100,-39,-90,83,-302
-56,-84,-101,-11,-54,-13,-52,1,-370
-124,-171,-208,-48,-91,-37,-118,5,-792
17,-58,-67,-9,-34,-56,-109,46,-270
-34,-65,-81,-8,-90,-56,-103,59,-378
-2,-62,-116,-2,-47,-91,-98,-19,-437
-25,-90,-78,-26,-113,-17,-93,48,-394
12,-440,-546,-254,-664,-579,-837,178,-3130
-14,-20,-42,-30,-44,-30,-52,15,-217
96,-81,-251,38,-223,-140,-336,240,-657
-6,-19,-25,-18,-27,1,-27,7,-114
-80,-39,-48,-54,-57,-12,-87,-8,-385
10,-23,-40,12,-38,-48,-60,12,-175
11,-50,-65,-35,-91,-73,-101,55,-349
-33,-52,-68,-38,-49,-24,-66,-6,-336
41,-78,-159,84,-165,7,-158,115,-313
-41,-55,-88,-22,-99,-37,-114,40,-416
-43,-23,-82,-67,-141,-142,-207,-45,-750
2,-17,-12,2,-22,-24,-23,7,-87
-21,-50,-51,7,-71,-9,-79,44,-230
-66,-183,-272,-150,-303,-271,-394,-60,-1699
-10,-22,-38,-16,-32,-15,-40,30,-143
22,-15,-7,15,2,-16,-44,14,-29
-32,-46,-54,-12,-57,-17,-60,27,-251
-33,-76,-60,-10,-70,-8,-61,40,-278
-163,-167,-186,-78,-245,-61,-252,-4,-1156
36,-50,-26,45,-25,-56,-98,65,-109
-61,-128,-166,25,-166,6,-193,119,-564
-38,-219,-350,-156,-283,-114,-296,289,-1167
-413,-303,-501,-496,-374,-388,-765,-149,-3389
-19,-55,-41,-19,-49,-51,-70,20,-284
-23,-31,-67,-51,-33,-28,-33,15,-251
33,-14,-65,-5,-25,-58,-70,68,-136
10,-10,0,6,-15,-5,-11,12,-13
0,-70,-78,-23,-105,-71,-129,-6,-482
22,-29,-69,-18,-59,-88,-59,-39,-339
19,-26,-46,25,-84,-72,-115,16,-283
-26,-101,-95,-22,-108,-61,-117,-4,-534
-7,-31,-34,-4,-29,2,-20,21,-102
38,-12,-42,11,-15,-55,-79,60,-94
-401,-529,-542,-236,-760,-256,-803,-31,-3558
-76,-84,-95,-53,-122,-45,-136,-4,-615
-178,-177,-252,-105,-84,5,-120,-53,-964
31,11,-10,1,-5,-32,-44,37,-11
-13,-35,-39,12,-26,-39,-41,-4,-185
16,-6,-46,-12,-47,-58,-61,15,-199
-8,-45,-52,-39,-62,-68,-91,-28,-393
-21,-30,-32,-15,-33,9,-31,20,-133
-35,-102,-128,-66,-163,-147,-199,-27,-867
25,-41,-43,-14,-13,-11,-21,57,-61
-105,-235,-205,23,-279,4,-258,200,-855
138,-538,-633,-117,-558,-333,-534,445,-2130
166,-221,-143,-49,-50,-238,-274,170,-639
-45,-73,-101,-81,-165,-103,-161,47,-682
-91,-57,-163,-50,-104,3,-184,-24,-670
15,-36,-69,-16,-52,-54,-74,34,-252
30,-13,-10,-17,-8,-39,-65,56,-66
24,-46,-52,-15,-46,-62,-89,68,-218
-24,-58,-77,-33,-71,-9,-29,11,-290
-18,-119,-159,-27,-193,-139,-190,58,-787
-150,-260,-300,-140,-373,-207,-411,50,-1791
-36,-64,-73,-16,-83,-19,-84,33,-342
-277,-206,-269,-195,-326,-64,-386,-41,-1764
260,-452,-573,-357,-323,-487,-929,697,-2164
57,-107,-168,15,-148,-123,-181,129,-526
7,-53,-50,-31,-52,-60,-103,70,-272
-14,-45,-38,-10,-27,-3,-23,22,-138
120,-110,-150,-17,-169,-221,-324,191,-680
21,12,-16,21,-16,-16,-27,15,-6
-21,-37,-33,-31,-5,-1,-23,17,-134
18,-41,-30,25,-25,-27,-35,-6,-121
26,-22,-14,-14,-12,-31,-52,43,-76
15,-2,-25,14,-44,-27,-18,27,-60
2,-59,-39,8,0,-37,-92,25,-192
-12,-57,-84,-77,-129,-131,-165,10,-645
71,-195,-234,-73,-216,-145,-387,192,-987
-43,-33,-78,4,-45,-9,-71,-2,-277
-333,-398,-495,-152,-701,-210,-695,179,-2805
27,-10,-15,-10,-27,-34,-47,69,-47
-8,-24,-41,-16,-22,-12,-28,29,-122
1,-2,-25,5,-13,-8,-27,31,-38
8,-4,-24,10,-26,-15,-33,27,-57
-32,-77,-120,-94,-105,-155,-201,-1,-785
-226,-544,-660,-245,-844,-516,-901,192,-3744
15,-32,-42,-24,-82,-72,-83,6,-314
-15,-84,-99,9,-122,-42,-84,57,-380
-16,-27,-38,-10,-37,-6,-20,35,-119
25,-7,-22,-5,-24,-54,-74,36,-125
-35,-57,-55,-14,-64,-64,-91,5,-375
-4,-7,-28,-33,-10,-36,-40,30,-128
-3,-16,-23,6,-24,-31,-34,-17,-142
5,-101,-138,12,-118,-88,-141,70,-499
-36,-62,-97,-70,-108,-46,-109,17,-511
6,-53,-66,-40,-67,-94,-47,37,-324
-2,-55,-83,-21,-45,-54,-94,32,-322
-49,-79,-97,-15,-182,-125,-192,33,-706
17,13,1,-6,-3,-43,-23,2,-42
15,-97,-91,6,-88,-24,-117,50,-346
-7,-24,-20,-7,-12,-19,-33,19,-103
-65,-113,-153,-21,-156,-61,-140,76,-633
4,15,-15,-16,9,-40,-42,28,-57
12,-24,-51,-27,-34,-40,-59,29,-194
-27,-46,-54,-28,-51,-36,-68,8,-302
72,-37,-50,41,-34,-27,-45,102,22
-31,-108,-114,-36,-71,-31,-86,31,-446
-69,-131,-161,-46,-169,-9,-175,131,-629
-6,-6,-13,-1,-4,-21,-29,10,-70
-1,-24,-9,12,-12,-29,-24,20,-67
-11,-40,-23,-13,-30,-17,-22,18,-138
14,-15,-25,4,-24,-36,-36,14,-104
92,-48,-63,-8,-68,-133,-172,132,-268
-18,-54,-185,-93,-205,-214,-402,92,-1079
66,-155,-215,30,-99,-75,-179,108,-519
-83,-198,-224,-4,-319,-140,-332,92,-1208
-114,-302,-346,-64,-409,-239,-491,145,-1820
-8,-101,-92,3,-163,-68,-154,70,-513
-23,-48,-50,-50,-77,-80,-121,23,-426
27,-95,-125,-27,-156,-140,-204,5,-715
-32,-43,-48,-10,-23,20,-38,3,-171
16,-49,-44,0,-87,-32,-56,60,-192
-134,-129,-167,-70,-139,-65,-202,97,-809
78,-90,-91,71,-121,-115,-149,91,-326
-22,-42,-64,-4,-18,0,-29,-5,-184
27,-24,-31,-17,-9,-51,-49,29,-125
16,-17,-29,-7,-9,-15,-18,22,-57
7,-53,-41,-21,-28,-30,-69,46,-189
4,-75,-117,-53,-134,-98,-156,17,-612
-17,-75,-79,-39,-116,-56,-112,59,-435
-56,-54,-65,-29,-74,-2,-83,-15,-378
20,-141,-136,-6,-148,54,-83,167,-273
-260,-596,-636,-187,-717,96,-501,453,-2348
-18,-10,-10,-2,-8,-10,-30,26,-62
-12,-65,-49,-22,-79,-63,-63,-6,-359
49,-24,-40,-6,-25,-73,-73,132,-60
23,-25,-51,-38,-78,-83,-103,5,-350
-10,-15,-36,-8,-28,-20,-45,8,-154
-25,-34,-37,-18,-48,-47,-82,9,-282
-46,-45,-58,2,-63,-17,-53,1,-279
77,-28,-154,-66,-37,-177,-279,50,-614
-2,-83,-97,20,-88,-47,-106,37,-366
4,-71,-113,10,-39,-23,-104,49,-287
-136,-360,-390,-182,-324,-159,-400,264,-1687
90,-162,-258,-47,-113,-95,-263,269,-579
54,-62,-72,19,-57,-55,-108,100,-181
-4,-207,-258,-150,-181,-226,-273,111,-1188
-190,-51,-166,-162,-181,-180,-343,-156,-1429
-126,-255,-313,-128,-403,-307,-430,-30,-1992
-27,-157,-212,-92,-187,-95,-238,147,-861
101,-149,-212,-68,-108,-260,-295,216,-775
27,-29,-32,-12,-29,-46,-59,50,-130
-23,-111,-95,-63,-145,-99,-137,16,-657
-24,-42,-56,0,-37,4,-52,21,-186
1,-55,-45,13,-44,-29,-71,-7,-237
-3,-100,-148,-34,-154,-57,-136,118,-514
-51,-57,-98,-48,-120,-47,-120,30,-511
-31,-14,-54,-48,-52,-23,-80,20,-282
72,-154,-128,-26,-160,-137,-230,121,-642
-69,-25,-56,-69,-29,-58,-85,-50,-441
-26,-16,-75,-37,-77,-84,-150,-49,-514
-7,-35,-49,-1,-14,-4,-51,35,-126
-44,-121,-113,-6,-140,-59,-167,93,-557
2,-37,-27,8,-33,-19,-32,14,-124
30,11,-48,-6,-28,-90,-110,58,-183
-134,-177,-219,-62,-301,-125,-302,28,-1292
-12,-18,-43,-17,-23,-42,-48,4,-199
-8,-58,-59,-8,-62,-5,-30,36,-194
-70,-133,-197,-149,-225,-195,-315,72,-1212
-28,-47,-42,21,-66,-25,-82,18,-251
-5,-212,-239,-102,-372,-227,-303,179,-1281
-61,-97,-106,-9,-127,-74,-153,39,-588
0,-8,-26,-13,-33,-28,-42,13,-137
-22,-42,-40,-20,-39,-27,-38,21,-207
-48,-71,-69,-64,-41,-67,-77,-10,-447
-15,-55,-80,13,-113,-95,-138,-1,-484
-5,-147,-272,-2,-212,-102,-319,190,-869
10,-18,-40,-21,-24,-36,-50,31,-148
-3,-17,-28,-3,-15,-16,-26,20,-88
-39,-55,-98,-57,-85,-91,-122,29,-518
93,-54,-70,-27,4,-121,-191,170,-196
28,-66,-137,12,-149,-50,-126,113,-375
-61,-159,-270,-69,-306,-105,-335,77,-1228
-49,-20,-34,-16,-47,-6,-57,24,-205
117,-59,-134,23,-80,-40,-144,139,-178
9,-23,-36,-35,-32,-39,-40,11,-185
65,-96,-160,-64,-198,-247,-278,23,-955
-27,-54,-69,-8,-79,-31,-80,27,-321
-22,-35,-71,-70,-98,-77,-88,21,-440
249,-324,-361,74,-235,-104,-285,398,-588
-24,-30,-35,-16,-37,-19,-43,5,-199
38,-43,-73,-10,-96,-71,-96,76,-275
-16,-23,-33,-16,-20,-22,-25,20,-135
5,-53,-38,28,-117,-71,-126,68,-304
-1,-40,-41,-15,-53,-22,-38,23,-187
-13,-36,-17,-9,-22,-25,-22,-10,-154
2,-91,-67,-17,-96,-129,-170,58,-510
27,-26,-99,44,-73,1,-128,119,-135
10,-20,-31,3,-33,-25,-45,23,-118
-6,-76,-76,-31,-81,-62,-76,67,-341
0,-43,-39,-42,-47,-55,-84,38,-272
-46,-131,-111,-38,-134,-77,-137,54,-620
17,-47,-78,-47,-129,-138,-135,-45,-602
-156,-220,-226,-73,-306,-62,-235,111,-1167
30,-18,-68,-44,-35,-59,-72,46,-220
15,-88,-83,-67,-93,-136,-235,99,-588
17,-55,-111,-83,-65,-143,-208,35,-613
-34,-125,-188,-119,-153,-172,-153,90,-854
-15,-131,-154,-50,-213,-15,-169,106,-641
15,-36,-107,10,-132,-122,-186,38,-520
24,-58,-71,21,-78,-50,-103,74,-241
2,-14,-33,-1,-38,-40,-46,34,-136
-13,-117,-123,12,-159,-95,-175,50,-620
-115,-178,-219,-69,-309,-98,-339,19,-1308
-25,-61,-50,-15,-95,-29,-70,14,-331
-11,-49,-94,-17,-115,-42,-125,8,-445
5,-179,-322,-134,-156,-323,-434,179,-1364
13,-31,-39,-4,-20,-27,-47,30,-125
-25,-68,-65,-13,-130,8,-74,74,-293
-55,-91,-77,-28,-118,-55,-150,-3,-577
-103,-133,-122,8,-162,-6,-150,50,-618
-90,-198,-203,-90,-228,-82,-281,18,-1154
1,-2,-6,4,-16,-11,-13,4,-39
-16,73,-23,96,-70,-20,-88,7,-41
-24,41,-34,63,-58,-7,-72,7,-84
203,-109,-227,-53,-166,-324,-330,209,-797
-208,-605,-677,-218,-995,-208,-740,366,-3285
-12,-117,-110,-6,-178,-67,-147,79,-558
-101,-117,-150,-99,-164,-117,-182,12,-918
-286,-576,-639,-91,-872,-439,-888,101,-3690
-36,-109,-99,-34,-120,-65,-141,68,-536
141,-167,-275,26,-221,-185,-315,330,-666
178,-282,-235,-71,-105,-221,-291,383,-644
7,-118,-191,31,-150,-42,-201,127,-537
-51,-108,-147,-57,-120,-85,-168,79,-657
69,-113,-299,25,-237,-160,-384,305,-794
-29,-118,-176,-25,-171,-48,-145,70,-642
-46,-91,-79,-13,-85,-50,-89,10,-443
55,-131,-185,-38,-184,-182,-302,229,-738
17,-56,-51,16,-97,-53,-64,46,-242
-10,-37,-41,14,-40,-21,-34,11,-158
-27,-64,-31,-9,-56,-15,-47,30,-219
-73,-157,-209,-122,-310,-265,-341,-12,-1489
-18,-89,-91,6,-148,-78,-203,114,-507
-5,-71,-114,-62,-77,-42,-145,94,-422
-43,-38,-66,-50,-89,-35,-105,2,-424
-5,-29,-49,-17,-38,-20,-45,20,-183
-15,-62,-96,-56,-94,-95,-114,14,-518
-130,-191,-308,-84,-396,-188,-354,85,-1566
-40,-90,-89,-14,-115,-43,-113,66,-438
-20,-41,-57,-6,-51,-22,-84,-21,-302
148,-136,-209,13,-39,-124,-253,272,-328
10,-21,-8,20,-28,-5,-29,47,-14
17,-3,-27,-7,-20,-35,-45,36,-84
-28,-33,-33,-29,-69,-15,-55,20,-242
-22,-13,-60,-25,-39,-26,-46,-5,-236
-21,-30,-21,-14,-38,-24,-42,3,-187
-25,-45,-73,-39,-78,-31,-83,38,-336
157,-266,-254,104,-252,-156,-338,406,-599
17,-20,-4,22,6,-27,-35,29,-12
40,-94,-58,58,-103,-63,-149,114,-255
49,-72,-82,29,-57,10,-79,141,-61
-18,-23,-25,-33,-23,-16,-26,6,-158
17,-25,-66,-10,-70,-36,-84,76,-198
13,-23,-27,-21,-29,-38,-47,54,-118
-22,-74,-74,-19,-98,-65,-80,20,-412
-91,-50,-117,-34,-177,-19,-164,60,-592
60,-87,-61,-23,-14,-149,-156,152,-278
11,-64,-46,29,-102,-6,-64,46,-196
-1,-2,-23,-16,-30,-28,-22,4,-118
-12,-22,-25,-26,-16,-3,-19,19,-104
3,-29,-30,-13,-8,-18,-41,26,-110
4,17,-8,10,-12,1,-11,16,17
-1,-10,-30,-6,-9,-24,-44,3,-121
27,-93,-41,-43,-10,-85,-95,101,-239
-60,-83,-115,366,-253,-115,-451,377,-334
-17,-29,-25,-2,-23,-10,-19,17,-108
-123,-212,-205,-106,-272,-167,-274,31,-1328
-137,-291,-293,-110,-309,-50,-286,102,-1374
-113,-230,-175,-9,-236,-28,-274,86,-979
101,-114,-113,2,-92,-118,-267,160,-441
6,-25,-52,-41,-27,-53,-76,41,-227
-23,-19,-34,-21,-22,-24,-34,-8,-185
107,-71,-117,45,-79,-78,-212,96,-309
-107,-147,-153,-23,-178,-76,-220,15,-889
-56,-57,-89,-24,-102,-7,-119,45,-409
12,-89,-202,5,-121,-48,-126,109,-460
-21,-11,-96,-56,-139,-118,-193,25,-609
40,-157,-258,-31,-258,-128,-273,185,-880
31,-97,-131,-41,-78,-32,-142,103,-387
85,-148,-139,-35,-192,-184,-228,185,-656
-100,-145,-188,-12,-93,-20,-97,42,-613
135,-126,-255,-26,-92,-67,-208,280,-359
19,-140,-175,24,-227,-190,-339,205,-823
-57,-135,-155,-91,-112,-80,-158,92,-696
-22,-134,-162,-85,-219,-176,-222,88,-932
79,-31,-106,-8,-98,-117,-192,135,-338
7,-188,-178,91,-292,-76,-379,255,-760
92,-264,-272,-40,-275,-300,-519,137,-1441
-44,-90,-114,-74,-142,-44,-119,68,-559
-29,-143,-189,45,-273,-174,-275,139,-899
13,-138,-171,-40,-235,-102,-226,35,-864
-6,-106,-112,4,-102,-37,-158,144,-373
-61,-82,-112,-55,-124,-71,-146,17,-634
-86,-36,-139,-106,-179,-41,-217,71,-733
-43,-33,-66,-21,-88,-73,-131,-44,-499
-16,-109,-88,58,-190,-38,-188,120,-451
29,-34,-47,4,-25,-72,-92,34,-203
5,-34,-48,-12,-41,-21,-36,31,-156
36,-109,-36,-38,-38,-88,-99,91,-281
-42,-115,-134,-74,-183,-166,-284,23,-975
-27,-64,-114,-52,-129,22,-168,69,-463
-63,-90,-61,-46,-68,-38,-79,-28,-473
5,-63,-70,-41,-25,-38,-57,21,-268
-43,-112,-83,65,-170,-23,-155,86,-435
-27,-73,-81,-21,-80,-47,-114,-15,-458
-52,-98,-96,-32,-90,-24,-62,-5,-459
-54,-88,-92,-66,-109,-28,-65,30,-472
32,-79,-107,-7,-130,-126,-190,29,-578
-104,-189,-165,-78,-208,-52,-185,2,-979
-67,-71,-73,-26,-107,-3,-113,33,-427
52,-4,-22,17,-60,-27,-31,21,-54
-12,-32,-50,17,-76,-14,-67,33,-201
-101,-176,-222,-188,-314,-171,-308,70,-1410
-23,-79,-62,-18,-103,-65,-87,4,-433
48,-64,-64,10,-45,-96,-123,133,-201
27,-37,-64,-35,-70,-112,-150,14,-427
-92,-133,-131,-8,-65,-10,-95,-8,-542
-42,-22,-52,-39,-32,-23,-64,-10,-284
83,-70,-81,55,-79,-44,-87,105,-118
-8,-47,-63,10,-61,-74,-99,0,-342
-18,-47,-62,-23,-35,-51,-64,8,-292
-28,-70,-78,-20,-111,-68,-104,-4,-483
43,-64,-47,-16,-20,-52,-78,63,-171
-11,-54,-122,-15,-155,-116,-196,56,-613
-49,-33,-101,-56,-72,-63,-128,52,-450
-24,-45,-62,-59,-79,-52,-96,4,-413
10,-11,-18,33,-30,-10,-70,33,-63
24,-51,-52,9,-60,-70,-91,56,-235
-63,-71,-45,-9,-109,-8,-82,31,-356
-153,-250,-208,-83,-340,-134,-356,40,-1484
-63,-80,-165,-87,-108,-106,-194,49,-754
4,-25,-72,-17,-72,-98,-134,38,-376
-5,-65,-80,-9,-121,-50,-80,38,-372
30,-47,-58,-36,-55,-65,-136,127,-240
-17,-107,-92,-30,-97,-68,-87,37,-461
-8,-38,-61,14,-71,-58,-96,43,-275
-49,-51,-73,-33,-100,-30,-86,22,-400
-13,-51,-58,-9,-83,-13,-59,24,-262
-40,-120,-117,-68,-139,-42,-103,70,-559
-16,-70,-63,-31,-119,-92,-66,-5,-462
-38,-139,-102,-26,-174,-32,-109,71,-549
-5,-92,-57,-38,-103,-59,-100,10,-444
-84,-115,-138,4,-149,-11,-184,28,-649
-80,-104,-109,-81,-197,-98,-172,13,-828
-3,-1,-31,-11,-24,-27,-37,10,-124
-60,-101,-139,-27,-186,-45,-177,41,-694
-134,-72,-118,-46,-169,-140,-259,-14,-952
0,-54,-82,-1,-60,1,-81,55,-222
-26,-57,-53,-21,-50,-42,-69,22,-296
-9,-78,-95,-40,-81,-80,-103,21,-465
-2,-11,-43,-29,-89,-102,-127,-5,-408
-84,-148,-167,-60,-186,-93,-180,66,-852
-39,-39,-43,-27,-70,-40,-70,1,-327
-25,-35,-46,-13,-84,-39,-79,4,-317
-51,-91,-123,-22,-52,-5,-76,14,-406
-65,-103,-115,-38,-154,-14,-151,58,-582
33,-72,-96,-19,-104,-57,-129,51,-393
-12,-46,-29,15,-38,-2,-33,28,-117
134,-197,-308,71,-291,-163,-317,269,-802
0,-162,-148,22,-211,-47,-172,165,-553
14,-19,-8,19,-28,-19,-35,1,-75
-14,-33,-51,-26,-69,-68,-104,4,-361
-56,-101,-114,-77,-144,-97,-159,61,-687
27,-64,-75,-10,-39,-53,-78,81,-211
40,-5,-36,65,-40,-48,-98,35,-87
-58,-112,-89,6,-104,-55,-156,32,-536
-18,-79,-58,1,-112,-12,-80,25,-333
-52,-74,-49,1,-80,-32,-81,16,-351
-60,-90,-92,-40,-136,-66,-164,18,-630
1,-54,-70,-25,-21,-64,-109,66,-276
-73,-101,-151,-24,-180,-82,-206,59,-758
24,-78,-87,-13,-107,-37,-87,52,-333
-38,-56,-107,-19,-121,-23,-110,57,-417
-40,-213,-349,-147,-260,-234,-527,164,-1606
-162,-196,-228,-105,-261,-159,-329,-68,-1508
-22,-108,-180,-39,-288,-231,-345,-35,-1248
-101,-88,-108,-38,-134,-36,-152,9,-648
-7,-8,-23,-18,-17,-33,-55,17,-144
25,-14,4,37,-50,-59,-111,39,-129
-71,-119,-158,-67,-199,-85,-203,19,-883
-33,-154,-147,-39,-207,-83,-164,86,-741
1,-32,-30,26,-123,-80,-162,4,-396
-100,-103,-150,-48,-195,-58,-228,35,-847
7,-15,-21,7,-16,-15,-27,-3,-83
6,-18,-13,21,-10,-2,-20,2,-34
3,-9,-24,13,-10,-14,-26,5,-62
0,-8,-28,8,-20,-18,-33,-4,-103
-24,-106,-96,-35,-168,-75,-135,87,-552
16,-8,-16,4,-39,-36,-45,11,-113
-1,-33,-32,-18,-38,-56,-73,10,-241
-4,-31,-39,-7,-59,-47,-80,22,-245
22,-22,-25,-5,-31,-69,-97,24,-203
48,-37,-17,26,14,-41,-82,49,-40
6,-17,-27,-5,-39,-46,-79,25,-182
-144,-238,-374,-287,-376,-407,-662,16,-2472
-15,-6,-12,-1,-28,-11,-23,-11,-107
-27,-37,-41,-15,-58,-26,-75,-12,-291
6,-38,-59,-12,-46,-56,-83,22,-266
4,-33,-57,-25,-65,-32,-48,36,-220
-48,-200,-252,-31,-349,-211,-365,40,-1416
-27,-137,-209,-27,-235,-196,-227,72,-986
-43,-176,-192,3,-245,-121,-256,77,-953
-78,-57,-85,-33,-158,-15,-155,25,-556
-48,-79,-104,10,-151,-30,-142,51,-493
-42,-77,-141,-38,-156,-84,-156,51,-643
-76,-96,-122,-11,-144,-27,-168,34,-610
1,-62,-47,-7,-38,-8,-37,34,-164
-8,-66,-62,-6,-91,13,-55,56,-219
-64,-134,-181,-13,-250,-33,-221,202,-694
-63,-129,-161,0,-206,-20,-204,182,-601
-23,-43,-42,-13,-59,-11,-89,52,-228
-54,-70,-100,-19,-143,-10,-136,69,-463
3,-87,-105,-21,-119,-110,-105,22,-522
-16,-42,-126,24,-163,40,-144,168,-259
-17,-49,-81,-43,-85,-43,-55,22,-351
-6,-13,-11,-10,-26,-13,-36,-2,-117
-18,-32,-34,-19,-37,-27,-51,19,-199
-81,-84,-140,-48,-174,-14,-142,76,-607
-10,-202,-186,-6,-282,-76,-228,121,-869
237,-44,-135,35,-20,-103,-139,201,32
-104,-105,-132,-15,-155,-2,-188,57,-644
-5,-19,-24,-19,-20,-20,-30,15,-122
-2,-116,-128,-10,-152,-21,-146,65,-510
21,-2,-54,-2,-40,-20,-38,57,-78
26,-138,-169,26,-161,-25,-158,153,-446
-134,-202,-224,-37,-307,-64,-263,84,-1147
-24,-54,-57,-51,-65,-12,-68,35,-296
-17,-63,-68,-19,-71,-35,-49,0,-322
17,19,2,8,-1,-6,-3,22,58
12,-168,-185,-11,-297,-174,-350,180,-993
-238,-380,-452,-80,-510,-265,-583,16,-2492
21,-242,-391,-194,-312,-260,-448,309,-1517
-58,-80,-140,-49,-216,-78,-230,55,-796
-10,-93,-81,59,-119,-10,-141,107,-288
3,-13,-32,15,-34,-11,-65,65,-72
-158,-344,-472,-180,-511,-134,-489,224,-2064
-100,-137,-174,-29,-114,-21,-130,71,-634
19,-64,-74,52,-106,19,-88,135,-107
-143,-172,-182,-29,-216,-48,-224,24,-990
-78,-263,-227,-64,-299,-107,-234,86,-1186
-48,-81,-100,-49,-70,-62,-90,-14,-514
-10,-19,-17,-9,-10,-13,-21,-13,-112
20,-41,-53,12,-64,23,-38,86,-55
44,-155,-212,-63,-232,-167,-265,138,-912
6,10,-38,15,-60,-22,-50,32,-107
-46,-177,-178,-38,-241,-92,-258,71,-959
8,-30,-35,3,-85,-12,-36,61,-126
6,-88,-94,-41,-129,-82,-124,44,-508
-37,-123,-90,-4,-115,-4,-105,112,-366
-152,-67,-151,-118,-123,-95,-260,-137,-1103
-53,-105,-157,-37,-165,-135,-234,38,-848
-103,-165,-192,-36,-273,-13,-245,122,-905
-34,-77,-91,62,-98,-51,-153,95,-347
-3,-76,-103,-69,-97,-127,-119,23,-571
13,-59,-48,10,-62,-40,-79,36,-229
-41,-73,-159,10,-49,13,-83,28,-354
-61,-174,-213,-61,-288,-126,-249,21,-1151
44,-212,-318,-10,-313,-148,-390,121,-1226
72,-244,-249,-50,-194,-84,-178,291,-636
50,-51,-82,58,-90,-17,-76,66,-142
-97,-114,-128,-4,-158,12,-163,72,-580
-9,-193,-218,10,-312,-152,-246,108,-1012
0,-12,-33,17,-17,3,-22,8,-56
-70,-56,-81,-48,-124,-36,-111,30,-496
48,-70,-249,79,-333,16,-214,236,-487
-123,-285,-352,-137,-456,-200,-440,144,-1849
-233,-212,-228,-177,-361,-125,-334,33,-1637
-143,-119,-153,-45,-58,-33,-133,-73,-757
-25,-22,-33,57,-97,-66,-125,-19,-330
-23,-19,-23,45,-106,-42,-128,-3,-299
-48,-3,-40,28,-113,-39,-154,5,-364
-30,-21,-21,55,-89,-27,-127,-5,-265
-40,-48,-36,-39,-61,-44,-71,7,-332
-86,-154,-156,-87,-212,-75,-168,75,-863
-50,-161,-151,-33,-206,-64,-166,84,-747
-98,-290,-375,-14,-363,-98,-355,301,-1292
-165,-159,-192,-87,-264,-26,-274,66,-1101
-130,-128,-174,-128,-229,-148,-287,62,-1162
-102,-138,-182,-119,-211,-118,-291,49,-1112
-168,-77,-244,-236,-383,-418,-734,-178,-2438
141,-267,-256,423,-481,376,-543,982,375
166,-269,-373,249,-546,129,-580,872,-352
22,-181,-190,-90,-231,-121,-215,145,-861
-8,-65,-80,-29,-90,-89,-121,21,-461
95,21,-97,66,4,8,-39,121,179
-66,-89,-108,-37,-112,-31,-123,48,-518
-38,-55,-77,-37,-78,-60,-59,-15,-419
-5,-1,-15,-21,-25,-5,-20,27,-65
8,-105,-41,14,-99,-30,-94,122,-225
93,-83,-91,30,-48,-45,-126,145,-125
-23,-425,-531,-65,-629,-258,-601,333,-2199
-216,-389,-442,-188,-481,-191,-475,194,-2188
10,-50,-50,-9,-74,-63,-64,-7,-307
-98,-91,-119,-71,-144,-56,-147,43,-683
51,-160,-256,-20,-383,-172,-429,158,-1211
-11,-17,-48,-22,-81,-44,-112,26,-309
-108,-200,-283,-138,-259,-130,-312,19,-1411
-121,-221,-241,-104,-309,-246,-403,-56,-1701
-7,-15,-31,-18,-16,-9,-32,9,-119
29,-68,-71,-49,-99,-138,-214,132,-478
4,-24,-16,4,-15,-12,-13,11,-61
-40,-90,-81,-24,-75,-21,-94,18,-407
-15,-25,-33,-3,-60,-33,-52,8,-213
-7,-4,-40,-33,-21,-42,-41,24,-164
-80,-156,-200,-81,-218,-82,-224,21,-1020
-36,-84,-101,-48,-101,-67,-124,14,-547
4,-37,-36,-9,-21,-48,-66,19,-194
-26,-64,-80,-25,-63,-38,-83,-10,-389
-27,-83,-44,1,-73,-19,-60,22,-283
-30,-115,-142,-80,-153,-145,-190,50,-805
-16,-14,-21,-19,-24,-13,-37,13,-131
-113,-242,-206,15,-328,-257,-418,-160,-1709
-59,-44,-50,-31,-65,-7,-90,-15,-361
10,-11,-43,-23,-41,-23,-49,24,-156
-145,-186,-265,-111,-348,-88,-316,103,-1356
21,-104,-108,-6,-159,-80,-152,24,-564
37,-34,-58,19,-116,-110,-151,68,-345
-20,-87,-120,-46,-195,-88,-198,9,-745
19,-25,-23,15,-36,-25,-39,33,-81
-103,-110,-235,-77,-287,-88,-311,113,-1098
-7,-37,-39,-15,-38,-35,-54,22,-203
-74,-77,-89,-32,-116,-25,-91,44,-460
-78,-131,-147,-96,-134,-90,-200,-6,-882
-33,-20,-30,-38,-11,-1,-39,-3,-175
-29,-110,-147,-41,-77,-82,-140,105,-521
79,-7,-80,-1,-53,-106,-151,111,-208
20,-34,-43,-34,-83,-35,-51,44,-216
-8,-21,-11,18,-29,-15,-31,3,-94
-4,44,38,40,7,-2,-5,10,128
-8,-34,-31,-17,-29,-4,-25,11,-137
-8,-159,-121,15,-171,53,-136,198,-329
-64,-75,-97,-21,-125,-54,-131,-4,-571
0,-159,-245,-13,-150,-26,-218,94,-717
9,-68,-59,-19,-44,-70,-112,17,-346
130,-179,-293,-108,-203,59,-107,375,-326
185,-140,-195,-1,-74,-218,-356,231,-568
0,-21,-42,-7,-49,3,-35,59,-92
-23,-19,-33,-15,-44,-23,-28,7,-178
-10,-27,-43,-19,-32,-24,-36,6,-185
-30,-26,-34,-12,-21,-10,-27,0,-160
-7,-4,-40,10,-35,-48,-77,-3,-204
-31,-27,-39,-27,-1,-9,-37,-18,-189
-22,-8,-27,-6,-23,-12,-36,0,-134
-5,-60,-98,-19,-111,-85,-218,102,-494
-76,-96,-99,-40,-137,-4,-116,60,-508
-53,-83,-100,-48,-115,-24,-83,64,-442
19,-49,-68,-25,-77,-72,-85,53,-304
260,-178,-273,43,-43,-283,-364,293,-545
-174,-269,-269,-46,-409,-114,-365,41,-1605
25,-69,-198,5,-212,-47,-201,116,-581
18,6,-1,18,-19,-5,-41,14,-10
51,-53,-102,13,-162,-27,-73,90,-263
72,2,0,54,-36,-11,-28,56,109
-16,-29,-32,-30,-60,-10,-39,27,-189
-74,-63,-93,-68,-117,-66,-221,15,-687
130,-65,-77,25,-38,-84,-138,90,-157
-116,-209,-221,-2,-258,-95,-319,143,-1077
-19,-75,-75,-25,-109,-44,-69,16,-400
78,-345,-377,-4,-430,-59,-418,505,-1050
-48,-50,-61,-42,-87,20,-66,14,-320
1734,1237,-334,1925,-300,2437,-134,2446,9011
65,-77,-18,59,-75,-50,-106,114,-88
-48,-133,-194,-51,-227,-119,-202,66,-908
68,-106,-73,14,-17,-126,-175,95,-320
-38,-75,-76,21,-121,0,-90,54,-325
0,-10,-66,-15,-62,-14,-41,36,-172
42,-40,-49,13,0,-40,-40,74,-40
-30,-49,-56,-38,-88,-48,-71,-8,-388
-13,-66,-56,-32,-107,-99,-106,54,-425
9,-42,-41,17,-83,-2,-63,52,-153
-17,-109,-119,-61,-165,-91,-142,34,-670
-70,-117,-117,-79,-147,-16,-120,60,-606
-39,-57,-58,-44,-99,-84,-121,-24,-526
-8,-40,-57,-19,-94,-28,-64,12,-298
-60,-82,-101,-53,-133,-70,-159,24,-634
0,-38,-49,-4,-35,-16,-54,31,-165
-36,-140,-150,-99,-196,-129,-200,56,-894
8,-62,-42,10,-91,-33,-54,68,-196
-13,-53,-54,13,-114,-30,-76,60,-267
-30,-53,-64,-1,-58,-15,-69,11,-279
-30,-21,-55,-69,-72,-50,-114,-30,-441
-76,-139,-174,-54,-216,-115,-259,55,-978
-3,-170,-351,-62,-47,-9,-306,244,-704
-9,-42,-65,-13,-81,-73,-99,0,-382
18,-93,-190,-5,-182,-50,-224,125,-601
-1,-19,-43,-2,-32,-25,-47,30,-139
101,23,-143,16,-119,-157,-272,171,-380
18,-15,-26,14,4,-10,-3,29,11
116,-113,-149,18,-115,-63,-142,190,-258
19,-45,-49,-9,-75,-68,-120,54,-293
-39,-89,-114,-29,-164,-125,-185,6,-739
-71,-113,-145,-71,-152,-58,-152,54,-708
-24,-71,-93,-46,-100,-24,-99,63,-394
-4,-60,-89,-28,-107,-111,-148,50,-497
-31,-48,-88,-36,-43,20,-58,27,-257
-41,-91,-98,-64,-113,-58,-102,-1,-568
0,-9,-13,2,-23,-15,-18,2,-74
20,-20,-21,-1,-34,-15,-36,11,-96
57,-18,-34,-1,-15,-38,-66,86,-29
130,-152,-121,93,-216,-56,-164,245,-241
36,-68,-20,35,-43,-29,-63,37,-115
-61,-84,-87,-60,-196,-93,-176,55,-702
-22,-76,-88,-24,-57,2,-66,42,-289
-23,-14,-44,-29,-91,-61,-96,23,-335
112,-25,-110,11,-79,-209,-230,109,-421
11,-51,-91,-18,-95,-65,-113,12,-410
5,-38,-36,12,-25,-22,-33,22,-115
-32,-18,-56,-10,-51,-12,-73,3,-249
34,-37,-49,78,-28,23,-40,49,30
-18,-76,-77,-37,-109,-66,-123,20,-486
-49,-367,-788,-133,-932,-518,-1046,399,-3434
6,-15,-26,-4,-20,-40,-30,-13,-142
-18,-57,-151,-115,-179,-221,-313,7,-1047
114,-26,-3,103,-8,3,-38,150,295
-214,-290,-302,-191,-503,-229,-513,-29,-2271
-39,-77,-81,-18,-111,4,-87,58,-351
-5,60,42,113,-109,22,-94,68,97
-325,-137,-283,-341,-290,-396,-745,-304,-2821
18,-42,-72,-28,-107,-110,-123,12,-452
-49,-121,-108,-52,-123,-73,-164,52,-638
-160,-61,-184,-234,-111,-61,-281,2,-1090
-119,-116,-144,-78,-202,-29,-192,51,-829
-15,-15,-16,-6,-9,-10,-26,10,-87
-26,-20,-31,-20,-22,-4,-34,6,-151
7,-37,-60,24,-73,-44,-93,11,-265
8,-48,-45,-10,-47,-26,-57,45,-180
-6,-34,-49,1,-78,25,-63,58,-146
11,-12,-18,27,-52,-55,-93,47,-145
110,-51,-46,37,-5,-48,-76,127,48
-15,-30,-26,-19,-45,-32,-51,5,-213
49,-207,-223,-116,-46,88,-96,257,-294
-16,-50,-60,-7,-23,-22,-74,45,-207
-18,0,-1,16,-15,-24,-23,-2,-67
-174,-659,-781,-217,-996,-197,-790,543,-3271
-28,-47,-63,-35,-83,-55,-121,8,-424
-36,-26,-36,-21,-50,-37,-38,-1,-245
-32,-50,-49,-70,-58,-54,-77,16,-374
1,-37,-43,-26,-54,-44,-59,33,-229
-18,-58,-56,-12,-77,-14,-71,33,-273
7,2,4,5,-8,-5,-3,19,21
-11,-18,-23,-12,-13,-23,-23,-14,-137
6,-84,-107,-22,-71,-125,-131,57,-477
21,-59,-51,6,-35,-28,-70,49,-167
-118,-165,-171,-72,-243,-124,-229,46,-1076
-100,-134,-154,-76,-234,-89,-234,11,-1010
53,-9,-42,0,-39,-95,-122,77,-177
-46,-38,-109,12,-51,-36,-85,35,-318
81,-244,-312,172,-400,-440,-720,346,-1517
29,-203,-228,-96,-297,-221,-294,131,-1179
3,-84,-60,-11,-90,-93,-140,27,-448
-16,-158,-175,-87,-188,-51,-141,104,-712
-6,-55,-74,-18,-71,-32,-99,33,-322
-11,-24,-37,0,-34,-8,-43,53,-104
-14,-19,-51,-36,-9,-13,-44,26,-160
-35,-34,-43,-24,-35,-15,-35,3,-218
-51,-111,-77,-9,-118,4,-147,59,-450
-9,-55,-56,-46,-68,-86,-85,-16,-421
110,-177,-17,70,38,55,-3,216,292
-57,-23,-27,-39,-20,-44,-60,-13,-283
-8,-5,-20,12,-17,-10,-15,-9,-72
-42,-48,-95,-50,-149,-67,-172,77,-546
3,-25,-19,11,-62,-20,-33,14,-131
17,-36,-60,24,-35,-96,-87,55,-218
-7,-39,-34,-18,-34,-15,-29,8,-168
-8,-15,-35,-17,-43,-43,-41,8,-194
-29,-88,-102,-16,-157,-17,-128,83,-454
13,-84,-66,101,-243,55,-125,206,-143
-22,-93,-68,-14,-97,-49,-84,26,-401
-54,-71,-100,-50,-95,-57,-115,41,-501
-66,-56,-96,-66,-103,-85,-127,-3,-602
-17,-105,-170,4,-181,-24,-185,126,-552
-91,-151,-207,-48,-188,-127,-327,109,-1030
-99,-97,-121,-39,-130,-22,-134,64,-578
-45,-198,-257,40,-302,16,-284,227,-803
-4,-115,-103,-2,-99,-107,-152,49,-533
-121,-42,-96,-102,-114,-125,-187,-98,-885
-61,-47,-74,-24,-107,-76,-122,-27,-538
-7,-105,-79,0,-113,-60,-124,30,-458
-33,-69,-71,-16,-90,-50,-79,47,-361
-45,-78,-116,-71,-89,-105,-182,68,-618
-11,-75,-96,-72,-125,-154,-196,-33,-762
2,11,1,20,-26,-32,-24,1,-47
1,-14,-18,-3,-22,-4,-10,17,-53
-20,-8,-32,6,-34,-15,-37,6,-134
-8,-42,-38,-26,-47,-30,-72,54,-209
20,-41,-98,-16,-87,-76,-135,61,-372
2,-23,-22,-5,-22,-16,-9,24,-71
14,2,-7,2,-11,-24,-41,-11,-76
26,-63,-123,8,-150,37,-95,130,-230
4,-64,-60,46,-82,23,-69,64,-138
-142,-139,-164,-52,-77,-16,-109,-10,-709
-133,-179,-152,-127,-252,-176,-359,-22,-1400
-109,-48,-135,-91,-135,-138,-215,0,-871
-42,-87,-161,-1,-152,-48,-207,91,-607
-37,-66,-102,-53,-65,-73,-118,37,-477
-37,-126,-106,1,-88,-37,-151,59,-485
-23,-63,-35,2,-40,-3,-27,30,-159
-24,-25,-38,-27,-37,-25,-48,24,-200
173,-166,-344,106,-258,-75,-315,294,-585
11,-100,-80,-49,-115,-131,-180,81,-563
58,-165,-214,-16,-163,-56,-207,266,-497
110,6,-68,63,-80,-52,-148,66,-103
-37,-43,-60,-61,-20,-41,-95,-36,-393
-1,-50,-75,-1,-91,-37,-95,47,-303
11,-151,-61,0,-133,-77,-133,95,-449
38,-115,-123,95,-75,-15,-137,162,-170
-125,-179,-220,-108,-261,-140,-350,44,-1339
13,-157,-149,4,-176,-67,-116,104,-544
9,-60,-67,-7,-123,-74,-74,36,-360
-53,-45,-56,-22,-66,-45,-95,-14,-396
-14,-72,-121,-2,-79,-39,-119,22,-424
-10,-92,-94,-24,-96,-84,-125,44,-481
-41,-45,-52,-27,-86,-38,-84,35,-338
-16,-54,-61,10,-137,18,-94,98,-236
-4,-172,-103,-42,-137,-125,-186,89,-680
-13,-22,-28,-25,-48,-47,-44,9,-218
-8,-87,-92,-34,-136,-97,-126,17,-563
-1,-9,-9,8,-8,4,-14,7,-22
-3,-12,-19,-4,-4,-32,-42,-7,-123
-13,3,-12,-20,-16,-3,-19,-2,-82
6,-83,-104,0,-121,-48,-136,15,-471
-47,-141,-150,-54,-228,-186,-327,-67,-1200
-63,-125,-95,-28,-170,-88,-151,19,-701
-18,-51,-64,-29,-89,-69,-112,41,-391
64,-29,-126,5,-97,14,-79,141,-107
-19,-120,-70,93,-127,-54,-148,-18,-463
-13,-27,-32,-10,-24,-2,-35,29,-114
-12,-19,-64,29,-97,-47,-109,77,-242
19,-37,-94,-46,-172,-128,-123,22,-559
-22,-82,-76,-4,-80,-58,-108,26,-404
10,-6,-26,7,-42,-14,-35,31,-75
-14,-35,-47,-10,-32,2,-41,38,-139
-17,-55,-154,-118,-185,-181,-223,8,-925
12,14,-2,9,-7,-20,-56,72,22
9,-83,-91,-31,-133,-84,-108,12,-509
-2,-59,-44,20,-40,-11,-78,62,-152
-60,-248,-215,-34,-253,-178,-379,125,-1242
8,-25,-66,-32,-81,-65,-89,37,-313
-29,-107,-92,19,-115,-34,-149,-26,-533
-29,-19,-37,-21,-60,-25,-78,7,-262
-3,-58,-69,31,-48,1,-90,63,-173
-102,-99,-126,-17,-141,-29,-130,12,-632
-41,-46,-60,-58,-74,-117,-177,5,-568
-13,-36,-85,-38,-73,-126,-130,-2,-503
3,-46,-48,-24,-70,-54,-71,10,-300
-46,-59,-88,-58,-90,-43,-72,17,-439
-57,-68,-121,-15,-31,-16,-71,11,-368
-62,-53,-130,-75,-167,-56,-151,52,-642
-32,-36,-50,-26,-67,-38,-57,11,-295
-264,-182,-227,-97,-152,-57,-171,-107,-1257
70,3,-106,-12,-9,1,-88,89,-52
-39,-94,-108,-13,-124,-75,-155,19,-589
-85,-73,-88,-15,-126,-50,-161,7,-591
-33,-59,-56,-2,-103,-27,-101,20,-361
13,-84,-79,-69,-61,-73,-231,14,-570
-4,-16,-48,-26,-27,-54,-59,2,-232
-125,-131,-183,-51,-214,-1,-215,98,-822
-271,-448,-506,-96,-644,-111,-608,280,-2404
-146,-140,-255,-127,-321,-308,-442,-44,-1783
43,-128,-127,-23,-111,-159,-229,95,-639
-74,-84,-97,-52,-134,-27,-99,32,-535
142,-119,-115,11,-117,-96,-228,230,-292
-28,-82,-61,-4,-65,-78,-127,35,-410
-34,-46,-62,-16,-70,-98,-165,25,-466
-2,-51,-43,5,-44,5,-29,21,-138
107,-99,-102,0,-167,-145,-192,169,-429
-141,-110,-241,-253,-167,-251,-321,-143,-1627
228,-416,-553,114,-349,-370,-540,464,-1422
-20,-123,-127,41,-149,62,-115,123,-308
-49,-169,-211,-42,-217,-34,-189,95,-816
-15,-54,-43,20,-69,-14,-80,36,-219
-11,-53,-54,-20,-60,-20,-67,45,-240
-579,-832,-1087,-285,-1435,-419,-1428,293,-5772
-24,-29,-31,-22,-51,-12,-40,22,-187
15,-40,-37,-9,-17,-30,-53,16,-155
73,-38,-43,13,-92,-138,-110,52,-283
-71,-173,-335,-131,-275,-201,-365,314,-1237
-54,-109,-165,-36,-243,-186,-324,75,-1042
16,-36,-107,-64,-103,-96,-135,72,-453
-67,-121,-180,-82,-262,-193,-333,27,-1211
-2,-54,-54,-32,-44,-54,-90,9,-321
291,36,125,165,153,-170,-241,412,771
-41,-101,-244,-143,-207,-244,-447,74,-1353
130,-104,-68,-29,31,-136,-206,153,-229
-6,0,-15,-14,-13,-17,-23,11,-77
-110,-116,-173,-61,-195,-97,-218,29,-941
-17,-34,-68,-58,-63,-56,-62,-4,-362
-16,-33,-68,-57,-63,-55,-62,-5,-359
-85,-74,-85,-61,-106,-63,-117,16,-575
1,-15,-18,-18,-33,-17,-37,-4,-141
43,-190,-291,-15,-253,-34,-271,215,-796
-65,-191,-189,-66,-302,-184,-334,42,-1289
48,-42,-37,45,-58,-97,-89,44,-186
59,-92,-99,5,-59,-53,-103,135,-207
-49,-87,-133,-80,-240,-29,-171,131,-658
3,-72,-62,3,-116,-73,-120,74,-363
-54,-110,-99,-39,-183,-106,-180,35,-736
42,-81,-66,18,-106,-52,-120,104,-261
2,-41,-35,10,-42,-45,-42,1,-192
-40,-102,-86,13,-127,-65,-127,-11,-545
71,-45,-60,45,-120,-87,-132,90,-238
145,-275,-320,182,-207,-198,-317,224,-766
-39,-145,-165,-30,-222,-45,-174,113,-707
3,-81,-109,1,-149,-38,-135,68,-440
-50,-67,-80,-8,-121,-39,-117,46,-436
-33,-64,-67,-30,-71,-35,-81,19,-362
-16,-21,-18,-12,-62,-17,-37,12,-171
-49,-81,-88,-47,-122,-63,-106,40,-516
31,-96,-91,-14,-88,-76,-135,130,-339
-11,-41,-203,-78,-131,-41,-249,113,-641
32,-47,-67,-2,-46,-45,-86,58,-203
-117,-180,-199,-49,-53,7,-111,-27,-729
46,34,50,98,-5,-41,-22,40,200
-34,-86,-122,-27,-148,-64,-147,48,-580
-17,-44,-56,-42,-110,-74,-91,20,-414
-11,-124,-181,-72,-183,-175,-230,32,-944
-1,-27,-24,-8,-44,-19,-34,7,-150
6,-145,-108,8,-177,-87,-166,81,-588
70,-14,-133,92,-216,-53,-175,166,-263
-124,-150,-180,-88,-179,-51,-221,36,-957
-28,-62,-66,-10,-88,-26,-87,37,-330
-19,-143,-173,-75,-155,-109,-188,57,-805
58,-100,-72,-75,-48,-107,-147,98,-393
146,94,17,149,42,-11,-57,223,603
-75,-90,-125,2,-146,-42,-129,45,-560
16,-168,-244,-70,-255,-140,-232,239,-854
-35,-85,-64,-25,-87,-51,-88,47,-388
72,-354,-232,161,-238,-252,-333,-109,-1285
-4,-18,-25,4,-26,-13,-24,19,-87
-158,-123,-199,-191,-264,-144,-371,-2,-1452
-68,-98,-94,-20,-112,-6,-139,87,-450
-86,-94,-111,-38,-133,-13,-160,48,-587
27,-85,-161,-70,-225,-226,-307,-37,-1084
-29,-305,-304,-105,-442,-364,-505,-52,-2106
-28,-76,-62,-22,-100,-21,-85,37,-357
22,-20,-101,6,-86,-30,-74,75,-208
-42,-127,-165,-44,-222,-83,-194,95,-782
98,8,-128,56,-20,-79,-226,214,-77
-55,-45,-63,-41,-86,-49,-124,-15,-478
-6,-112,-109,-44,-56,-103,-139,-12,-581
51,-98,-154,-28,-186,-101,-206,190,-532
-88,-189,-269,-154,-378,-203,-395,41,-1635
-60,-39,-101,-57,-74,-68,-184,9,-574
59,-33,-107,22,-64,-66,-124,153,-160
44,-18,-110,-52,-18,-13,-83,39,-211
27,-58,-72,-15,-117,-83,-136,65,-389
91,-105,-172,-44,-196,-149,-224,184,-615
15,-56,-82,-50,-111,-130,-157,16,-555
-110,-199,-192,-90,-267,-101,-229,35,-1153
-110,-51,-73,-74,-142,-121,-239,-88,-898
-22,-29,-53,-35,-80,-86,-108,-5,-418
-27,-67,-95,-15,-103,-7,-95,64,-345
-235,-393,-493,-276,-616,-376,-744,-4,-3137
-30,-59,-103,-45,-186,-129,-169,-4,-725
-54,-123,-166,-9,-193,-43,-157,104,-641
-34,-20,-87,-21,-110,-90,-175,23,-514
-14,-30,-40,-3,-42,-22,-48,3,-196
-51,-90,-115,-46,-166,-104,-196,49,-719
39,-1,-41,39,-21,-40,-83,52,-56
-27,-41,-86,-13,-107,-3,-78,89,-266
-50,-119,-122,-62,-141,-68,-112,43,-631
21,-49,-70,24,-81,4,-46,40,-157
33,-49,-86,-8,-85,-92,-130,66,-351
-48,-126,-71,-41,-108,-45,-90,32,-497
5,-29,-44,-1,-24,2,-45,54,-82
-74,-129,-110,-38,-129,-56,-137,11,-662
-30,-46,-92,-18,-60,-48,-101,-6,-401
-145,-204,-214,-93,-248,-169,-317,-67,-1457
-130,-172,-202,-70,-242,-173,-314,-29,-1332
-69,-87,-127,-80,-147,-76,-170,1,-755
-138,-211,-224,-94,-266,-115,-280,30,-1298
-50,-94,-105,-29,-153,-43,-150,70,-554
-36,-63,-67,-6,-79,-18,-80,36,-313
-9,-56,-72,-29,-81,-59,-75,16,-365
-13,-39,-50,-5,-51,-17,-50,23,-202
-38,-76,-84,-44,-114,-50,-133,37,-502
-23,-19,-35,-35,-39,-35,-61,-9,-256
2,-121,-164,4,-146,-73,-179,61,-616
-20,-48,-54,-30,-38,-30,-47,-3,-270
-16,-16,-34,-9,-73,-34,-54,11,-225
-48,-63,-127,-20,-109,-131,-232,5,-725
11,-56,-40,-14,-65,-54,-52,17,-253
-66,-91,-132,-141,-227,-104,-192,33,-920
-42,-122,-155,-60,-186,-110,-187,60,-802
-11,-78,-112,0,-73,-58,-141,68,-405
-52,-71,-123,-10,-136,-44,-146,61,-521
-25,-64,-87,-37,-79,-49,-97,35,-403
-12,-18,-17,-18,-55,-37,-35,11,-181
10,-109,-109,19,-106,-23,-77,65,-330
-9,-33,-33,-20,-82,-22,-71,62,-208
-88,-326,-393,-124,-478,-207,-431,210,-1837
-46,-41,-61,-32,-37,-23,-70,7,-303
-38,-41,-58,15,-52,-19,-73,24,-242
131,-466,-355,334,-888,443,-491,964,-328
-168,-203,-394,-202,-520,-437,-629,-50,-2603
-46,-73,-145,-53,-190,-141,-229,12,-865
-28,-80,-93,-34,-104,-53,-128,41,-479
-35,-84,-134,-44,-144,-117,-182,2,-738
-27,-115,-85,-14,-115,-84,-113,30,-523
36,-54,-97,-51,-139,-179,-196,9,-671
-55,-30,-42,-34,-53,-31,-75,-18,-338
68,-10,-20,76,7,50,-35,104,240
5,-15,-26,-8,-34,-13,-14,26,-79
-2,-17,-39,2,-30,-7,-24,9,-108
-23,-50,-42,-32,-31,-49,-70,-10,-307
76,-47,-66,-17,-47,-70,-121,87,-205
-15,-36,-39,-24,-49,-10,-44,17,-200
-18,-47,-117,34,-75,39,-61,88,-157
-29,-48,-34,4,-83,-5,-91,45,-241
-78,-104,-127,-14,-153,-88,-216,-52,-832
-65,-71,-79,-57,-90,-52,-114,-31,-559
23,-61,-61,-14,-142,-84,-88,33,-394
-15,7,-22,33,-65,-2,-88,45,-107
-5,-6,-18,-21,-24,-33,-30,5,-132
-53,-60,-81,-19,-107,-70,-156,-8,-554
-3,-6,-13,0,-11,-16,-17,-2,-68
-12,-29,-26,-12,-15,-25,-22,16,-125
-99,-203,-208,-130,-236,-178,-269,-22,-1345
-87,-107,-144,-11,-53,-19,-78,41,-458
-23,-44,-68,-65,-117,-122,-148,-50,-637
-55,-221,-309,-108,-343,-106,-375,206,-1311
-45,-41,-40,-21,-62,-10,-73,-3,-295
-33,-53,-69,-18,-52,2,-53,49,-227
6,-111,-129,17,-126,-45,-148,73,-463
63,-95,-76,20,-48,-83,-167,124,-262
-45,-59,-83,-58,-111,-61,-131,-27,-575
-77,-65,-77,-54,-77,-27,-101,-2,-480
107,-39,-58,42,-49,-72,-149,147,-71
-46,-118,-113,-1,-171,-47,-137,119,-514
38,-15,-44,22,-59,-69,-73,63,-137
54,-97,-46,76,-139,-4,-92,132,-116
37,15,-24,19,-17,-60,-60,36,-54
-16,-29,-26,0,-40,0,-28,22,-117
-17,-74,-84,-9,-85,-55,-105,20,-409
-17,-56,-76,-41,-91,-70,-107,-13,-471
-26,-28,-37,-42,-48,-34,-75,3,-287
-60,-10,-89,-45,-19,-15,-80,28,-290
-7,-40,-37,-10,-68,-38,-46,26,-220
-107,-371,-512,-208,-694,-421,-686,14,-2985
67,-17,-12,67,-43,-28,-53,60,41
-7,-51,-134,9,-90,-30,-139,122,-320
-20,-85,-74,-34,-113,-82,-145,-13,-566
-60,-109,-100,-13,-119,-66,-131,30,-568
27,-55,-39,0,-74,-26,-33,55,-145
-2,-19,-23,-15,-31,-12,-40,23,-119
41,-71,-55,-25,-1,-74,-65,21,-229
-13,-25,-72,-29,-50,-61,-87,2,-335
-116,-112,-148,-138,-142,-84,-197,-54,-991
-185,-208,-262,-180,-362,-145,-364,-8,-1714
13,-59,-40,31,-44,-4,-48,44,-107
-9,-77,-104,-71,-163,-167,-173,-1,-765
-50,-72,-80,-31,-121,-88,-130,9,-563
38,-76,-161,-35,-68,-68,-125,147,-348
26,-76,-15,119,-153,56,-108,194,43
-4,-30,-53,0,-41,-18,-64,26,-184
-2,-49,-58,-15,-71,16,-58,104,-133
21,-138,-147,-11,-161,-138,-233,62,-745
-54,-143,-118,14,-202,0,-150,133,-520
-148,-196,-216,-43,-76,-13,-140,-44,-876
200,-188,-179,62,-73,-7,-244,312,-117
110,-65,-50,43,-62,-86,-145,137,-118
-24,-144,-145,-19,-156,-121,-211,53,-767
24,-170,-198,-52,-278,-144,-273,112,-979
94,-8,14,150,-83,-26,-118,166,189
-10,-18,-32,5,-52,15,-44,19,-117
-82,-90,-83,-28,-147,-43,-116,29,-560
-25,-66,-150,-103,-215,-194,-251,-1,-1005
-2,-36,-56,-35,-39,-34,-59,35,-226
-13,-18,-26,1,-35,-16,-40,16,-131
-40,-42,-117,-51,-87,-70,-147,-10,-564
-7,-42,-51,34,-72,-15,-54,56,-151
-43,-74,-81,-32,-118,-27,-108,43,-440
-15,-30,-49,-48,-44,-74,-118,-8,-386
-26,-59,-113,-91,-120,-107,-130,4,-642
-26,-24,-74,-59,-52,-31,-77,18,-325
-86,-124,-127,7,-56,-8,-108,-4,-506
-4,-27,-44,-35,-81,-37,-69,10,-287
83,-560,-638,109,-886,-177,-566,666,-1969
67,-32,-66,57,-49,-29,-81,112,-21
1,-74,-92,-22,-72,-60,-115,116,-318
-28,-92,-80,8,-79,-21,-100,34,-358
-167,-192,-206,-105,-188,-108,-272,15,-1223
154,161,110,56,65,-98,-89,76,435
-100,-128,-126,-32,-83,-28,-103,-11,-611
105,-51,-129,-42,-85,-156,-229,187,-400
3,-3,-7,2,-11,-8,-12,4,-32
6,-2,-6,3,-7,-9,-9,4,-20
-3,-23,-26,-16,-31,-16,-19,17,-117
-5,-24,-27,-18,-37,-17,-23,19,-132
16,-43,-111,-1,-120,-38,-89,57,-329
-77,-93,-149,-48,-154,-49,-170,77,-663
24,-56,-53,7,-46,-27,-80,28,-203
4,-169,-114,23,-163,-143,-185,74,-673
6,-35,-30,17,-36,-24,-32,14,-120
-12,-21,-20,51,-110,-41,-166,15,-304
-19,-161,-223,-133,-304,-241,-342,-25,-1448
-21,-31,-42,-4,-16,7,-36,5,-138
-5,-5,-34,-30,-62,-53,-69,7,-251
-43,-9,-36,-17,-69,-57,-91,-2,-324
2,-110,-118,-67,-108,-137,-229,124,-643
-41,-88,-77,-83,-82,-113,-141,20,-605
-49,-267,-365,-27,-339,25,-350,261,-1111
-6,-5,-43,-17,-90,-58,-94,11,-302
-36,-76,-89,2,-86,-46,-128,6,-453
-3,-130,-247,-86,-170,-74,-210,126,-794
-48,-109,-112,-42,-164,-115,-259,4,-845
-52,-46,-49,-53,-68,-43,-103,64,-350
10,-28,-73,-16,-92,-49,-98,56,-290
21,-17,-46,25,-33,-13,-74,87,-50
42,-45,-84,-17,-25,-74,-99,73,-229
-168,-173,-181,-47,-67,-32,-98,-45,-811
-62,-89,-124,-63,-121,-82,-186,10,-717
-45,-80,-56,17,-119,-33,-103,30,-389
2,-107,-123,-22,-72,-3,-49,90,-284
-13,-51,-90,9,-114,-47,-117,23,-400
11,-44,-42,0,-44,-26,-46,65,-126
-13,-33,-36,1,-61,-37,-100,44,-235
0,-80,-84,-32,-147,-58,-125,40,-486
-15,-61,-96,-35,-119,-61,-138,50,-475
23,10,-27,6,-25,-29,-39,7,-74
19,-6,-40,1,-42,13,-27,47,-35
-14,-40,-63,-13,-56,-24,-95,-10,-315
-38,-67,-68,-27,-79,-25,-92,27,-369
23,-107,-176,-51,-106,-170,-277,147,-717
32,-73,-135,-57,-80,-75,-110,85,-413
-10,-12,-35,-5,-42,-18,-35,13,-144
13,-82,-87,24,-149,-2,-63,99,-247
37,-72,-73,38,-140,-154,-199,-3,-566
-50,-9,-59,-29,-68,-40,-102,-6,-363
-142,-145,-187,-87,-247,-128,-293,-12,-1241
-35,-34,-82,-28,-113,-66,-181,-5,-544
-3,-26,-36,12,-64,-22,-48,23,-164
11,-122,-158,4,-201,-25,-204,147,-548
-72,-140,-148,-64,-167,-79,-163,42,-791
80,-60,-97,-8,-220,-127,-122,58,-496
-47,-59,-82,-49,-96,-13,-92,58,-380
-31,-142,-193,-129,-199,-232,-349,49,-1226
157,-150,-169,87,-95,-158,-358,277,-409
-32,-59,-46,-10,-82,-23,-79,18,-313
-31,-78,-168,-142,-170,-220,-280,3,-1086
-64,-110,-117,-21,-132,-21,-152,48,-569
6,-26,-64,-39,-60,-47,-95,62,-263
-27,-31,-31,-4,-19,-13,-20,-2,-147
-40,-285,-345,-27,-390,-340,-468,191,-1704
897,1345,845,1782,5,487,-698,1405,6068
150,-195,-243,36,-225,-63,-190,274,-456
-41,-210,-183,40,-260,-80,-221,81,-874
-60,-63,-77,-30,-71,-67,-146,-21,-535
46,-7,-1,18,-36,-36,-33,60,11
22,-112,-116,73,-134,-78,-182,125,-402
-20,-1,-20,-9,-3,0,0,-1,-54
-13,-44,-55,-37,-47,-51,-75,-2,-324
14,-66,-93,-22,-38,-55,-125,92,-293
-3,-55,-29,28,-50,-41,-65,35,-180
-107,-152,-195,-114,-202,-155,-266,72,-1119
0,-124,-137,-42,-195,-129,-207,117,-717
74,-66,-60,17,-68,-119,-158,30,-350
5,-63,-79,6,-94,-25,-90,27,-313
-101,-102,-97,-43,-124,-33,-138,10,-628
-39,-73,-65,-2,-83,-75,-109,16,-430
-34,-68,-50,-20,-21,-41,-51,1,-284
-225,-266,-324,-107,-451,-96,-454,132,-1791
-35,-7,-43,-43,-11,-14,-56,7,-202
-28,-15,-17,-7,-16,-9,-17,3,-106
-23,-20,-26,-13,-19,-15,-24,11,-129
5,49,34,51,8,1,2,14,164
-22,-6,-16,50,-15,9,-51,54,3
-16,-23,-49,-7,-30,13,-27,49,-90
4,3,11,20,4,4,-5,16,57
-6,7,13,23,0,15,-20,19,51
-8,-113,-130,-12,-163,-120,-164,32,-678
82,-96,-108,-17,-94,-147,-204,87,-497
-61,-90,-59,-20,-121,-15,-121,57,-430
-185,-23,-153,-125,-160,-200,-348,-140,-1334
-7,-71,-109,-35,-114,-86,-132,23,-531
-10,-30,-34,-10,-26,-25,-31,-9,-175
22,-32,-43,-4,-18,-30,-34,17,-122
6,5,-33,-6,-27,-28,-31,9,-105
-21,-29,-69,-32,-85,-42,-88,1,-365
-29,-70,-85,-33,-103,-72,-97,9,-480
-40,-20,-49,5,-50,3,-55,16,-190
-101,-118,-365,-212,-424,-497,-601,33,-2285
26,-69,-46,3,-45,-37,-59,38,-189
22,-62,-53,43,-106,-27,-72,88,-167
-113,-146,-137,-21,-183,-70,-181,29,-822
-63,-135,-95,45,-168,-54,-123,23,-570
-21,-127,-138,-32,-178,-127,-187,87,-723
39,9,-21,51,-41,7,-32,82,94
-1,-30,-51,-15,-101,5,-65,53,-205
33,-74,-65,20,-121,-34,-92,90,-243
10,-27,-40,-6,-58,-10,-34,61,-104
61,-176,-175,-69,-202,-189,-273,149,-874
52,-119,-135,11,-105,-98,-217,102,-509
26,-33,-50,2,-33,-34,-47,5,-164
-31,-60,-35,-5,-71,-48,-76,-21,-347
-22,-46,-57,-5,-53,-34,-68,24,-261
11,-23,-46,-21,-55,-28,-72,10,-224
-43,-185,-188,-36,-219,-160,-275,13,-1093
20,-55,-102,-15,-55,-28,-106,84,-257
-86,-119,-131,-64,-231,-114,-195,-29,-969
-74,-77,-86,-33,-111,-39,-122,0,-542
-6,-60,-70,-29,-112,-130,-194,6,-595
7,-33,-58,-28,-45,1,-33,81,-108
-26,-52,-51,-9,-67,-3,-49,30,-227
-24,-110,-69,6,-67,-21,-91,22,-354
-27,-113,-145,-75,-17,-67,-190,102,-532
-40,-54,-84,12,-46,-25,-89,56,-270
-33,-72,-82,-50,-63,-40,-101,46,-395
-102,-87,-92,-56,-162,-33,-195,13,-714
38,-79,-47,15,-115,-52,-77,48,-269
7,-79,-61,-12,-107,-30,-100,79,-303
-6,11,-28,22,-55,-8,-87,46,-105
-11,-58,-60,-36,-84,-129,-139,39,-478
0,-102,-83,15,-102,-73,-107,34,-418
4,-118,-98,-41,-101,-88,-127,39,-530
-23,23,-22,-8,-3,-9,-29,31,-40
-46,-64,-73,3,-141,-17,-100,37,-401
4,-31,-36,-19,-38,-41,-59,31,-189
62,-101,-106,-55,-50,-108,-130,44,-444
-175,-216,-289,-166,-337,-137,-375,-14,-1709
-49,-127,-113,-13,-161,13,-120,49,-521
-47,-152,-141,-66,-195,-100,-187,87,-801
-34,-47,-79,-31,-74,-59,-77,-23,-424
-27,-65,-61,-12,-73,-72,-104,-17,-431
-31,-76,-101,-32,-120,-96,-156,7,-605
-28,-63,-68,-16,-47,-31,-72,8,-317
10,-25,-41,-14,-26,-22,-53,27,-144
53,-110,-156,-65,-131,-149,-218,112,-664
20,-13,-16,1,1,-26,-26,25,-34
-29,-108,-127,-6,-168,-59,-151,63,-585
-5,-88,-97,-14,-60,-36,-84,80,-304
20,-62,-79,-23,-85,-98,-71,87,-311
-57,-107,-94,-40,-150,-78,-178,26,-678
22,11,-3,9,-8,-16,4,19,38
-80,-134,-120,25,-163,-20,-196,49,-639
19,-44,-42,4,-73,-51,-94,37,-244
-31,-79,-104,-30,-74,-35,-70,40,-383
8,-38,-55,-16,-44,-47,-44,36,-200
-26,-2,-42,-45,-22,-77,-113,1,-326
-47,-147,-290,-15,-260,-108,-338,157,-1048
60,-109,-141,-70,-31,-169,-223,111,-572
1059,-434,-721,-136,-519,-866,-118,1190,-545
-533,-737,-735,-404,-1193,-438,-1187,-7,-5234
-27,-195,-319,-22,-330,-216,-371,147,-1333
-164,-107,-139,-155,-185,-150,-298,-137,-1335
-84,-188,-191,-142,-251,-182,-322,55,-1305
-213,-300,-339,-75,-325,-84,-388,-1,-1725
-6,-6,-5,-6,-8,-4,-7,3,-39
49,-45,-87,7,-69,-150,-152,118,-329
-56,-58,-82,-65,-109,-70,-115,4,-551
-15,-126,-121,-51,-146,-63,-138,106,-554
-57,-70,-102,-11,-65,-49,-145,-20,-519
-7,-59,-102,-16,-160,-71,-148,89,-474
-18,-10,-22,-13,-34,-19,-50,-3,-169
-8,-7,-12,-4,-13,-3,-17,10,-54
220,-86,-416,215,-298,-36,-474,480,-395
266,-83,-416,125,-309,-111,-487,570,-445
-45,-126,-79,12,-166,-89,-230,0,-723
-19,-81,-121,-63,-134,-190,-242,-28,-878
-9,-55,-59,41,-69,-7,-72,28,-202
-21,-42,-41,-25,-26,-61,-64,-30,-310
-8,2,-31,-24,-38,-15,-14,16,-112
-83,-107,-106,-25,-183,-81,-184,24,-745
2,-8,-21,-2,-2,-2,5,8,-20
-8,-61,-41,7,-22,-32,-53,31,-179
-1,-18,-14,18,-35,-9,-44,16,-87
-80,-91,-104,-18,-65,-40,-95,12,-481
-89,-66,-82,-42,-84,-26,-72,5,-456
11,-69,-73,-30,-104,-86,-94,48,-397
26,-61,-82,-20,-145,-158,-157,13,-584
66,-76,-72,-1,-113,-103,-126,122,-303
37,-111,-142,-20,-193,-118,-205,103,-649
15,-101,-154,-69,-161,-61,-182,169,-544
-67,-153,-169,-46,-236,-81,-222,62,-912
-20,-33,-17,7,-50,7,-51,7,-150
-59,-170,-197,57,-483,62,-265,214,-841
21,-55,-65,5,-41,-39,-69,50,-193
-17,-48,-66,-36,-84,-34,-70,29,-326
7,-34,-35,0,-31,-7,-38,32,-106
-70,-70,-97,-58,-84,-24,-109,14,-498
23,-36,-65,32,-66,-90,-142,44,-300
-6,-80,-92,33,-171,-66,-167,115,-434
7,-4,-19,-4,-24,-17,-21,12,-70
-11,-84,-85,-44,-83,-49,-84,75,-365
-29,-54,-77,-45,-87,-60,-72,18,-406
22,5,-40,31,-35,10,-59,89,23
-3,-73,-124,-28,-170,-77,-177,65,-587
-105,-128,-147,-33,-62,-9,-94,-36,-614
-12,-20,-32,-23,-30,-37,-79,-19,-252
-17,-66,-63,-52,-100,-52,-101,1,-450
32,-39,-73,-6,-108,-65,-87,48,-298
25,1,-5,29,-28,-19,-7,40,36
-92,-116,-139,-67,-135,-2,-183,80,-654
20,-90,-70,71,-121,-106,-163,76,-383
-46,-63,-82,-19,-86,-34,-80,-29,-439
-35,-69,-77,21,-115,-19,-149,62,-381
-21,-115,-146,-79,-169,-146,-253,76,-853
-74,-140,-195,-7,-214,-6,-164,83,-717
-49,-144,-141,-54,-200,-65,-186,28,-811
-103,-168,-170,-30,-226,-61,-228,22,-964
-98,-93,-116,-74,-105,-37,-116,50,-589
-75,-80,-113,-58,-120,-118,-177,-10,-751
29,-188,-287,-104,-162,-211,-309,184,-1048
-15,-147,-245,-32,-253,-146,-312,147,-1003
-13,-55,-73,7,-118,-30,-52,44,-290
4,-133,-272,-102,-176,-77,-240,172,-824
0,-106,-179,-41,-86,-38,-144,29,-565
6,-23,-37,-19,-26,-33,-50,38,-144
-43,-124,-138,-61,-190,-116,-191,70,-793
29,-38,-94,-11,-66,-82,-143,28,-377
-21,-16,-52,12,-50,-24,-81,4,-228
32,-118,-183,-27,-183,-133,-236,120,-728
-8,-102,-95,13,-165,-82,-154,96,-497
-72,-124,-138,-105,-129,-88,-145,21,-780
-1,-19,-13,5,-10,-8,-13,2,-57
-66,-30,-66,-60,-72,-41,-101,-58,-494
-81,-156,-138,-42,-152,2,-116,47,-636
157,-241,-567,-60,-359,-102,-414,599,-987
-318,-88,-250,-319,-204,-216,-513,-245,-2153
-11,-208,-180,18,-290,-85,-312,195,-873
42,-1,3,26,-17,-14,-48,37,28
33,-1,6,21,-21,-19,-52,36,3
-20,-40,-29,-15,-29,-29,-68,-15,-245
-4,-4,-23,-1,-26,-12,-36,16,-90
-5,-6,-21,-14,-23,-20,-20,19,-90
421,174,-144,271,-65,-236,-444,368,345
-12,-16,-55,-26,-45,-40,-63,20,-237
-25,-91,-104,-63,-157,-81,-166,67,-620
-4,-161,-155,24,-145,-46,-178,79,-586
-102,-82,-100,-103,-104,-44,-137,-14,-686
-48,-25,-77,4,-29,-8,-41,37,-187
8,-22,-21,19,-28,-15,-11,8,-62
-29,-20,-63,-32,-56,-9,-46,8,-247
-158,-277,-492,-186,-566,-414,-727,80,-2740
-152,-190,-152,-111,-237,-49,-246,-31,-1168
162,-122,-194,91,-249,-110,-313,223,-512
-37,-90,-105,-36,-140,-57,-133,28,-570
-53,-156,-99,16,-120,-68,-150,56,-574
-79,-134,-125,-13,-119,-26,-157,59,-594
-31,-81,-101,-9,-91,-41,-101,17,-438
25,-32,-48,22,-87,-37,-60,59,-158
46,-142,-144,-8,-230,79,-141,218,-322
-252,-298,-332,-126,-467,-199,-490,31,-2133
-211,-308,-315,-84,-390,-216,-443,53,-1914
39,-80,-146,17,-86,6,-138,108,-280
21,-94,-64,24,-121,-63,-79,67,-309
-42,-117,-112,-57,-128,-38,-103,58,-539
-58,-117,-171,-70,-239,-203,-249,-83,-1190
94,-52,-40,7,-7,-169,-183,174,-176
-16,-54,-67,93,-78,-34,-116,132,-140
-9,-79,-172,-61,-135,-109,-170,98,-637
-21,-127,-223,-148,-250,-251,-434,101,-1353
390,-157,-313,148,-304,-181,-344,403,-358
-48,-40,-39,-23,-47,-23,-61,-19,-300
-92,-159,-141,-13,-158,-36,-161,52,-708
-32,-80,-97,-13,-188,-16,-118,82,-462
26,-59,-105,-17,-42,-107,-111,41,-374
42,-90,-124,20,-191,-142,-226,104,-607
-41,-130,-217,-88,-236,-169,-306,63,-1124
21,-67,-79,-4,-126,-11,-71,92,-245
12,-40,-39,9,-57,2,-34,30,-117
11,-136,-142,-5,-128,-118,-157,82,-593
162,-157,-123,3,-27,-209,-298,187,-462
-56,-73,-222,-138,-129,-148,-209,46,-929
24,-51,-65,-13,-37,-67,-139,76,-272
-70,-144,-135,-83,-217,-98,-156,22,-881
-1,-22,-27,-9,-30,-29,-35,3,-150
-85,-116,-225,-90,-199,-119,-243,102,-975
-36,-79,-47,-29,-50,-27,-51,5,-314
-53,-78,-67,40,-97,-39,-152,104,-342
11,-59,-73,0,-70,3,-59,47,-200
-6,-101,-93,-67,-70,-65,-250,18,-634
-10,3,-14,5,-19,-2,-38,-14,-89
-8,-28,-47,5,-66,-29,-76,14,-235
-47,-135,-106,38,-155,-37,-152,28,-566
-15,-18,-39,-15,-53,-12,-64,28,-188
-64,-79,-83,-59,-127,-20,-114,38,-508
79,-88,-91,98,-161,-32,-194,171,-218
12,-58,-82,-18,-74,-86,-105,22,-389
13,-44,-37,-15,-42,-43,-85,53,-200
-7,-106,-114,-44,-175,-114,-141,1,-700
18,-95,-138,-22,-175,-54,-152,118,-500
-12,-106,-139,-67,-174,-129,-155,56,-726
-40,-118,-121,-19,-159,-67,-129,38,-615
-21,-59,-52,6,-58,-63,-100,7,-340
176,-95,-193,18,-152,-121,-252,268,-351
147,-89,-114,53,-83,-112,-138,179,-157
-55,-74,-99,-65,-116,-58,-147,33,-581
-12,-119,-97,-33,-126,-103,-173,34,-629
14,-30,-36,18,-28,-7,-35,26,-78
-58,-47,-44,-63,-67,-34,-71,-11,-395
29,-32,-36,-6,-28,-40,-41,29,-125
7,-11,-19,2,-14,-10,-13,18,-40
-36,-54,-74,-49,-99,-80,-117,-19,-528
-2,-77,-24,-2,-21,-20,-40,50,-136
-2,-23,-42,3,-101,-23,-76,63,-201
65,-47,-28,25,-27,-35,-64,70,-41
26,-6,10,13,7,-30,-48,24,-4
43,-7,-8,32,-9,-34,-50,35,2
8,-110,-78,31,-121,-44,-104,61,-357
-51,-129,-167,-44,-170,-56,-161,48,-730
-7,-26,-54,0,-48,-18,-26,36,-143
-15,-39,-28,-15,-59,-36,-80,11,-261
-66,-70,-124,-102,-133,-167,-241,-6,-909
-85,-145,-160,-97,-169,-36,-224,75,-841
-10,-59,-81,-24,-8,15,-84,57,-194
-107,-90,-75,-86,-97,-83,-160,-77,-775
-1,-7,-53,-24,-47,2,-49,9,-170
3,-70,-87,5,-125,-43,-116,101,-332
29,-130,-193,28,-187,-34,-201,163,-525
10,-60,-71,-57,-32,-82,-115,61,-346
-65,-112,-74,-26,-186,-82,-237,75,-707
-70,-82,-99,-30,-151,-30,-138,48,-552
29,-46,-55,-10,-82,-66,-100,64,-266
-35,-66,-118,-120,-92,-118,-181,84,-646
-43,-88,-135,-66,-108,-46,-160,33,-613
-19,-79,-68,-47,-107,-56,-82,52,-406
-13,-32,-37,3,-73,-13,-44,39,-170
61,-163,-205,-57,-134,-151,-256,270,-635
93,-29,-26,136,-74,-43,-119,135,73
-19,-202,-204,-113,-352,-194,-324,196,-1212
-195,-157,-187,-171,-239,-77,-281,-36,-1343
-154,-327,-375,-149,-442,-219,-427,54,-2039
-74,-129,-156,-76,-178,-140,-201,16,-938
-30,-49,-69,-20,-90,-69,-116,35,-408
-24,-18,-17,-19,-16,-27,-38,-25,-184
74,-163,-121,-18,-113,-151,-231,147,-576
-20,-108,-139,-29,-170,-101,-201,87,-681
-40,-205,-227,-176,-244,-174,-302,120,-1248
73,-12,-5,42,-12,-29,-18,60,99
-28,-36,-62,-49,-83,-28,-74,9,-351
-43,-152,-108,14,-174,-33,-159,86,-569
-44,-90,-81,-9,-105,-32,-85,20,-426
-44,-111,-123,-35,-157,-40,-136,62,-584
-7,-86,-102,-10,-95,-22,-120,35,-407
-1,-16,-56,-10,-22,-7,-11,44,-79
54,-103,-123,-8,-100,-154,-212,22,-624
35,-47,-78,-27,-84,-154,-174,15,-514
-42,-80,-126,-107,-174,-175,-168,60,-812
-141,-165,-142,-98,-148,-108,-239,-45,-1086
-65,-49,-71,-55,-86,-9,-87,29,-393
-92,-135,-164,-35,-215,-36,-203,33,-847
169,-109,-266,-74,-185,-292,-422,309,-870
-75,-43,-66,-51,-88,-30,-93,-7,-453
-94,-56,-158,-101,-124,-126,-271,-64,-994
-34,-96,-162,-84,-29,12,-97,94,-396
23,-32,-50,13,-39,-23,-61,53,-116
26,-25,-74,-8,-80,-65,-114,75,-265
12,-20,-26,2,-11,-28,-43,10,-104
-14,-101,-73,-24,-125,-75,-95,1,-506
-70,-146,-281,-232,12,-96,-281,301,-793
36,-53,-93,43,-113,-87,-160,21,-406
53,-30,-37,37,-1,-19,-57,52,-2
-1,-137,-161,-48,-227,-117,-209,38,-862
-56,-132,-144,-35,-205,-83,-178,59,-774
-123,-150,-208,-43,-47,13,-111,-42,-711
6,-31,-91,-32,-97,-30,-98,80,-293
12,-79,-45,7,-69,-45,-70,55,-234
-47,-187,-353,17,-440,-21,-358,305,-1084
11,-30,-47,33,-45,-9,-43,43,-87
-251,-104,-150,-224,-133,-144,-300,-144,-1450
-49,-33,-111,-97,-105,-131,-221,-16,-763
45,-102,-105,2,-54,-136,-150,37,-463
-93,-161,-166,-3,-241,-131,-281,-73,-1149
12,-41,-93,-68,-63,-137,-168,41,-517
14,-75,-155,-24,-119,-43,-133,162,-373
30,-22,-28,30,-39,-19,-50,34,-64
-29,-89,-118,-43,-185,-137,-211,2,-810
-58,-116,-140,-34,-63,-13,-77,18,-483
32,-31,-21,-20,-19,-31,-83,69,-104
33,-92,-85,13,-139,-4,-73,96,-251
-56,-84,-113,-69,-115,-55,-160,9,-643
45,-44,-82,-43,-96,-108,-152,76,-404
-21,-67,-95,-92,-106,-136,-140,-31,-688
-50,-153,-95,-36,-142,-57,-132,47,-618
7,-24,-43,-22,-77,-72,-87,38,-280
-38,-109,-121,-45,-170,-117,-173,42,-731
55,-12,-42,20,-40,-39,-33,80,-11
-69,-108,-93,-28,-116,-6,-101,22,-499
-108,-137,-159,-133,-161,-134,-235,-3,-1070
-39,-54,-47,-48,-98,-36,-61,24,-359
-94,-102,-125,-23,-134,-51,-152,20,-661
-28,-104,-76,-32,-117,-33,-101,74,-417
-87,-115,-162,-37,-36,-18,-91,-39,-585
-2,3,-4,-7,4,-8,-14,7,-21
43,-29,-24,31,7,-21,-29,26,4
-29,-47,-46,-5,-66,-4,-49,31,-215
-64,-82,-108,-40,-119,-82,-110,18,-587
-27,-122,-113,22,-209,-53,-157,69,-590
-84,-127,-117,-73,-183,-86,-161,-29,-860
-27,-110,-161,-53,-202,-160,-241,-15,-969
-1,-6,-28,39,-63,-4,-66,62,-67
-49,-82,-126,-31,-171,-10,-175,46,-598
31,-75,-45,22,-77,-44,-127,16,-299
-19,-99,-120,-82,-150,-142,-175,28,-759
51,-8,-60,34,-55,-122,-114,27,-247
9,-62,-51,-27,-41,-50,-81,79,-224
27,-9,-9,25,-31,-42,-22,20,-41
39,-30,-102,52,-112,-49,-86,110,-178
-86,-172,-150,-45,-185,-96,-218,25,-927
-81,-70,-128,-144,-142,-135,-244,-105,-1049
-41,-85,-94,-14,-141,-48,-137,11,-549
47,-99,-134,54,-177,-62,-239,178,-432
-39,-102,-113,-5,-199,-77,-185,108,-612
11,-41,-32,35,-58,-61,-98,44,-200
-33,-74,-93,-13,-107,-62,-92,7,-467
-21,-53,-63,-19,-61,-36,-95,-5,-353
-131,-415,-571,-266,-660,-560,-854,-77,-3534
-9,-91,-134,-11,-138,-34,-139,63,-493
-40,-59,-115,-60,-53,-21,-99,43,-404
-61,-84,-117,-26,-31,1,-62,9,-371
-44,-87,-66,-13,-111,-66,-84,1,-470
3,-58,-114,-49,-86,-109,-166,99,-480
-18,-50,-67,-50,-76,-76,-105,26,-416
-2,-103,-61,-8,9,-21,-60,39,-207
-78,-54,-81,-62,-58,-68,-88,-34,-523
-20,-54,-113,-93,-92,-154,-198,6,-718
-12,-48,-74,18,-108,-19,-105,27,-321
-17,-73,-94,-11,-141,-40,-89,12,-453
-1,-99,-116,-5,-165,-117,-197,66,-634
-48,-128,-92,-18,-191,-75,-155,14,-693
-26,-59,-63,-56,-57,-46,-65,23,-349
20,-86,-91,-7,-51,-116,-125,43,-413
-6,-100,-150,-116,-52,-34,-142,67,-533
-85,-87,-132,-34,-69,-29,-96,22,-510
18,-73,-85,-44,-69,-88,-123,86,-378
21,-58,-90,23,-176,-107,-182,30,-539
-14,-138,-130,-81,-195,-205,-216,38,-941
3,-37,-45,9,-57,-26,-41,49,-145
69,-61,-46,8,-4,-87,-122,72,-171
-7,-104,-112,-67,-139,-115,-136,44,-636
6,-74,-79,-44,-96,-75,-109,58,-413
-58,-80,-52,0,-78,-29,-74,-4,-375
77,-93,-141,-17,-199,-212,-232,33,-784
-26,-42,-53,-29,-62,-34,-82,-2,-330
36,-117,-217,-44,-191,-9,-130,184,-488
57,-43,-70,-5,-29,-82,-63,70,-165
-49,-107,-109,-35,-121,-57,-114,3,-589
501,207,224,141,212,-165,-212,476,1384
-76,-74,-125,-45,-65,-43,-74,12,-490
60,-38,-41,17,-39,-62,-149,93,-159
188,-225,-250,13,-101,-56,-274,401,-304
-1,-64,-104,-6,-66,-55,-106,75,-327
-64,-99,-128,10,-191,-38,-203,79,-634
-148,-344,-368,-119,-513,-205,-506,148,-2055
9,-105,-158,-101,-160,-55,-187,76,-681
-262,-373,-366,-191,-558,-132,-460,232,-2110
-83,-239,-272,5,-328,126,-287,291,-787
-83,-122,-173,-46,-230,-16,-179,64,-785
-72,-124,-139,-41,-158,-64,-180,43,-735
-19,-174,-254,-87,-266,-232,-348,67,-1313
78,-591,-788,-42,-597,423,-424,699,-1242
-57,-125,-147,-57,-226,-22,-164,127,-671
8,-239,-254,19,-311,-78,-302,230,-927
-36,-31,-55,-49,-61,-69,-73,-24,-398
-27,-42,-51,-39,-62,-68,-72,-18,-379
8,-153,-159,-21,-178,-111,-233,77,-770
91,-309,-339,17,-442,-196,-328,357,-1149
-20,-81,-75,-48,-85,-92,-143,45,-499
0,-41,-29,7,-62,-11,-42,40,-138
-109,-115,-110,-9,-166,-44,-164,36,-681
165,61,0,220,117,-145,-80,260,598
13,-58,-186,-167,-116,-212,-385,161,-950
-4,-64,-36,-20,-90,-77,-109,-3,-403
-8,-20,-26,3,-41,2,-28,38,-80
3,-49,-100,12,-98,-23,-76,69,-262
-80,-107,-133,-31,-177,-21,-162,55,-656
-8,-77,-88,14,-93,-12,-116,104,-276
-12,-9,-15,-7,-16,-5,-28,-5,-97
98,-64,-5,48,-19,-3,-92,133,96
-11,-77,-73,-16,-73,-98,-125,26,-447
13,-27,-17,3,-36,-28,-51,1,-142
-13,-32,-39,3,-39,-45,-54,16,-203
-47,-62,-65,-9,-57,-32,-100,35,-337
-40,-186,-233,-46,-246,18,-268,200,-801
-193,-581,-674,-212,-915,-347,-842,364,-3400
113,-76,-121,32,-114,-102,-171,191,-248
-17,-54,-57,-1,-79,-16,-77,39,-262
-20,-25,-15,10,-30,-13,-60,2,-151
-2,-46,-46,-17,-48,-25,-53,12,-225
-10,-58,-55,-8,-60,4,-28,39,-176
13,-167,-154,29,-273,-87,-193,85,-747
-666,-955,-832,-553,-1142,-494,-1116,102,-5656
-67,-75,-71,-49,-79,-10,-89,-4,-444
-13,2,-12,-10,-11,-10,-19,-13,-86
-22,-9,-23,-37,-17,-31,-28,-10,-177
-19,25,-41,-25,13,-38,-79,-7,-171
-31,-246,-227,1,-359,-101,-288,117,-1134
-46,-13,-26,-18,-28,-50,-37,-2,-220
-23,-283,-185,45,-280,-66,-242,122,-912
8,-65,-160,-30,-183,-7,-153,180,-410
-13,-61,-55,4,-64,3,-62,59,-189
-6,-55,-77,-24,-101,-34,-80,13,-364
57,-95,-129,1,-107,-72,-175,177,-343
-31,-187,-231,-43,-237,-184,-294,151,-1056
9,-294,-417,-257,-570,-484,-687,185,-2515
-5,-15,-28,-6,-21,-6,-36,11,-106
-36,-112,-88,-2,-88,-39,-106,38,-433
-4,-27,-43,-12,-48,-32,-56,11,-211
-38,-15,-57,-63,-40,-88,-99,-67,-467
-29,-99,-86,-8,-103,-34,-84,39,-404
5,-13,-17,-3,-9,6,-14,13,-32
19,-51,-57,-18,-29,-20,-71,33,-194
19,-13,-79,-17,-94,-23,-80,80,-207
-7,-23,-27,-6,-38,-3,-26,9,-121
-35,-58,-86,-33,-60,-51,-117,-7,-447
-34,-37,-48,-19,-69,-24,-74,14,-291
-10,-36,-52,-31,-27,-32,-63,26,-225
1,-43,-58,-10,-61,-66,-80,15,-302
-21,-103,-94,11,-164,4,-80,108,-339
1,-86,-62,9,-90,-33,-99,25,-335
13,-138,-187,-84,-303,-263,-317,25,-1254
-8,-140,-78,37,-117,-9,-105,89,-331
-31,-86,-74,-50,-53,-18,-61,14,-359
-22,-29,-54,-2,-51,-29,-71,27,-231
-14,-58,-106,-22,-143,-77,-137,-22,-579
0,-36,-57,-23,-80,-42,-76,22,-292
46,-57,-116,21,-87,-70,-113,42,-334
14,-42,-62,-25,-45,-88,-77,7,-318
-89,-81,-81,-64,-144,-33,-125,33,-584
-43,-88,-99,-14,-133,0,-105,73,-409
-3,-44,-34,0,-34,-29,-64,-6,-214
18,-32,-37,-25,-56,-45,-55,55,-177
-39,-70,-137,-76,-124,-43,-142,70,-561
19,-48,-86,-27,-110,-80,-91,38,-385
8,-69,-84,-13,-103,-68,-90,52,-367
-19,-26,-93,-25,-112,-7,-93,125,-250
-6,-17,-26,-7,-38,-41,-50,-11,-196
33,-72,-123,-47,-147,-85,-172,116,-497
-19,-12,-17,-5,-9,-3,-24,-1,-90
60,18,-47,59,-44,0,-54,71,63
10,-61,-76,-1,-65,-6,-79,111,-167
50,-22,-23,18,13,-26,-26,30,14
-20,-24,-39,-29,-35,-39,-70,9,-247
5,-70,-45,-11,-28,-30,-57,52,-184
-52,-130,-107,-34,-128,-48,-144,3,-640
39,-119,-61,35,-101,-67,-127,71,-330
1,-253,-218,-13,-381,-134,-301,125,-1174
-35,-63,-67,-6,-55,9,-48,31,-234
14,-50,-75,6,-74,-22,-86,70,-217
-81,-105,-102,-13,-141,-13,-116,52,-519
2,-5,-41,-1,-21,-7,-15,31,-57
-18,1,-45,-37,-27,-49,-47,-12,-234
-15,-107,-177,-90,-202,-112,-212,80,-835
32,-12,-67,28,-29,37,-35,61,15
-20,-96,-112,-61,-159,-110,-153,35,-676
-3,-47,-72,1,-118,-13,-55,17,-290
-6,-50,-124,-74,-140,-232,-307,2,-931
-26,-37,-36,-14,-52,5,-33,19,-174
-256,-276,-348,-140,-414,-70,-479,113,-1870
-21,-51,-47,13,-85,-30,-94,38,-277
-122,-117,-134,-57,-82,-63,-123,-38,-736
-10,-16,-50,2,-84,-13,-73,50,-194
6,-90,-113,-3,-71,-75,-149,90,-405
-8,-66,-79,-55,-76,-90,-130,28,-476
2,-137,-86,-6,-149,-100,-114,82,-508
-72,-74,-78,-9,-124,-2,-98,40,-417
-43,-78,-96,-46,-132,-39,-93,51,-476
11,-74,-80,17,-73,-45,-114,117,-241
-67,-201,-212,-67,-225,-11,-127,131,-779
-10,-33,-74,-24,-131,-134,-186,43,-549
20,-99,-102,-33,-141,-115,-150,89,-531
-74,-90,-92,-18,-133,8,-95,48,-446
9,-131,-151,-93,-152,-179,-265,69,-893
-22,-70,-48,-22,-76,-30,-62,17,-313
-8,-20,-33,-22,-4,-11,-22,5,-115
-79,-134,-165,-55,-61,-4,-88,-12,-598
32,-71,-126,-36,-76,7,-79,115,-234
119,-93,-135,-28,-66,-149,-203,101,-454
-43,-24,-45,-30,-61,-10,-76,-16,-305
-3,-50,-24,-3,-14,-14,-28,26,-110
-18,-57,-44,-7,-85,-37,-66,12,-302
-59,-88,-127,-60,-243,-114,-250,18,-923
-60,-112,-92,-10,-132,16,-103,74,-419
3,0,-39,-15,-25,-43,-61,22,-158
-19,-65,-34,-17,-11,-25,-39,8,-202
-9,-14,-12,15,-33,-19,-43,24,-91
-68,-28,-88,-43,-139,-64,-152,-29,-611
-44,-114,-145,-18,-220,-141,-221,21,-882
-32,-153,-217,-158,-248,-242,-416,57,-1409
153,-108,-142,11,-124,-155,-246,263,-348
101,-130,-157,-26,-138,-180,-273,183,-620
-47,-122,-135,2,-186,-51,-142,96,-585
-30,-59,-112,-106,-111,-120,-182,5,-715
-47,-87,-91,-19,-95,20,-96,40,-375
-203,-297,-377,-132,-439,-146,-460,115,-1939
26,-24,-40,-54,-57,-62,-50,50,-211
-55,-106,-123,-79,-138,-13,-134,47,-601
-11,-25,-52,-18,-38,-30,-51,35,-190
-49,-79,-74,-16,-84,-23,-74,8,-391
-3,-40,-62,-19,-41,-85,-89,14,-325
-25,-137,-117,-10,-162,-60,-177,121,-567
19,-71,-78,22,-129,-57,-131,44,-381
17,-27,-53,4,-36,8,-19,37,-69
-40,-8,-36,31,-111,-54,-154,23,-349
-22,-144,-146,-74,-122,-154,-131,-2,-795
197,-176,-288,-90,-192,-94,-255,385,-513
17,-47,-39,2,-54,-10,-35,44,-122
-13,-28,-43,2,-67,-23,-62,35,-199
3,-37,-57,34,-99,-44,-115,52,-263
-138,-166,-195,-97,-283,-98,-288,29,-1236
-23,-63,-73,-17,-188,35,-66,74,-321
7,-15,-26,11,-22,-15,-29,24,-65
-87,-146,-318,-109,-403,-185,-432,134,-1546
-13,-126,-127,-29,-95,-108,-88,74,-512
18,30,12,25,-11,-41,-31,52,54
-8,-42,-58,-22,-47,-31,-64,35,-237
-160,-326,-441,-253,-640,-520,-734,35,-3039
4,-16,-50,-4,-47,-98,-140,1,-350
23,-78,-67,15,-50,-56,-93,59,-247
4,-74,-133,-50,-194,-150,-208,21,-784
-6,-31,-36,-5,-24,-11,-19,23,-109
26,-44,-87,55,-58,23,-94,96,-83
-11,-22,-26,-6,-28,-22,-32,-3,-150
12,-111,-207,-80,-260,-196,-274,45,-1071
-16,-58,-196,-86,-182,-252,-323,-87,-1200
-10,-15,-34,-7,-28,-1,-19,25,-89
-1,-20,-56,-8,-46,-31,-56,23,-195
-12,-35,-52,-24,-74,-41,-75,24,-289
-1,-33,-37,-18,-26,-37,-38,43,-147
-66,-33,-53,-42,-54,-22,-90,7,-353
-99,-404,-567,-165,-729,-311,-859,272,-2862
6,-16,-25,-4,-35,-36,-32,4,-138
-51,-204,-216,53,-258,12,-279,211,-732
-14,-51,-65,-24,-56,-67,-81,4,-354
-19,-27,-69,-34,-87,-32,-79,10,-337
-18,-25,-33,12,-26,-10,-48,28,-120
-2,-43,-55,5,-10,-39,-57,17,-184
11,-56,-108,-68,-120,-151,-200,1,-691
3,-93,-67,-2,-137,-101,-124,37,-484
-36,-33,-41,-11,-62,-27,-64,13,-261
13,-39,-62,5,-96,-61,-102,60,-282
-70,-110,-135,-32,-74,-42,-120,17,-566
-18,-53,-58,-29,-102,-72,-96,22,-406
-7,-85,-46,2,-105,-29,-84,31,-323
-23,-53,-50,-25,-44,-19,-66,21,-259
-27,-71,-82,-13,-100,-48,-106,35,-412
-28,-35,-127,-20,-80,-108,-232,110,-520
-112,-132,-208,-152,-245,-133,-292,-86,-1360
31,-155,-90,29,-159,-54,-83,130,-351
-34,-89,-71,-41,-50,-49,-49,-13,-396
2,-43,-69,-38,-93,-104,-128,18,-455
72,-160,-112,87,-133,-246,-352,356,-488
-3,-20,-26,15,-25,-35,-45,-7,-146
-16,-61,-73,-22,-94,-58,-76,25,-375
-29,-65,-68,-67,-60,-35,-120,75,-369
11,-5,-11,11,-1,-9,-8,27,15
170,-107,-165,87,-163,-209,-399,312,-474
1,-17,-18,6,-17,-9,-31,-12,-97
-7,-15,-10,-12,-4,-16,-14,-4,-82
7,-51,-94,21,-65,-25,-83,77,-213
151,-122,-151,-14,-113,49,-152,194,-158
-34,-86,-141,-153,-141,-55,-180,44,-746
-10,-11,-59,-50,-51,-64,-74,29,-290
-86,-105,-90,-39,-155,-7,-85,20,-547
-17,-28,-35,-21,-36,-20,-48,9,-196
-12,-113,-104,-5,-113,-30,-106,102,-381
-23,-23,-54,-29,-92,-30,-74,18,-307
-78,-103,-63,-32,-86,-47,-98,-15,-522
-19,-10,-27,-6,-15,-18,-15,-10,-120
54,-54,-84,-13,-97,-81,-128,74,-329
-79,-88,-79,-13,-110,-5,-101,33,-442
132,-75,-54,30,-81,-145,-153,83,-263
-33,-53,-82,-19,-110,-53,-145,22,-473
36,-31,-40,5,-26,-31,-80,62,-105
-88,-82,-140,-34,-152,-47,-184,55,-672
-15,-79,-77,-40,-108,-68,-109,-9,-505
33,-40,-28,22,1,-31,-47,37,-53
29,-52,-46,0,-71,-57,-97,48,-246
47,-28,-71,30,-37,34,-56,85,4
-37,-59,-96,-57,-105,-81,-150,8,-577
-113,-88,-142,-98,-90,-121,-147,14,-785
-87,-202,-198,18,-210,-123,-298,11,-1089
137,-156,-225,-50,-240,-259,-392,194,-991
-29,-143,-161,-34,-184,-2,-142,149,-546
-175,-375,-363,-176,-612,-197,-512,29,-2381
27,-79,-110,43,-115,4,-114,141,-203
165,39,-131,10,-179,-193,-336,158,-467
-43,-112,-131,-60,-175,-123,-238,28,-854
20,-14,-12,15,-27,-19,-22,19,-40
82,-96,-132,-34,-32,-116,-217,150,-395
-30,-88,-106,-5,-133,-63,-167,47,-545
3,-111,-110,-48,-124,-18,-94,54,-448
-14,-34,-39,-19,-24,-7,-20,11,-146
-8,-29,-40,-5,-92,-7,-61,58,-184
-32,-85,-116,-48,-104,-39,-83,33,-474
65,-54,-103,-33,-68,-58,-118,156,-213
13,-30,-66,-3,-89,-32,-78,44,-241
0,-74,-90,-13,-97,18,-70,76,-250
-61,-69,-66,-3,-33,-20,-34,0,-286
241,-378,-856,-192,-598,-46,-670,543,-1956
-6,-14,-101,-29,-49,-121,-192,-50,-562
-116,-204,-253,-50,-421,-165,-340,68,-1481
-85,-101,-100,-44,-130,-55,-149,-9,-673
-31,-47,-91,-55,-114,-68,-110,-2,-518
-84,-169,-211,-97,-218,-60,-191,105,-925
-42,-98,-100,-63,-162,-126,-158,7,-742
66,-123,-176,-62,-236,-85,-197,227,-586
27,-1,-16,18,-10,-24,-29,9,-26
-71,-160,-154,-9,-280,-152,-289,47,-1068
151,-137,-165,-8,-44,-104,-198,232,-273
106,-70,-177,5,-56,-21,-168,219,-162
-13,-25,-103,25,-103,-49,-120,31,-357
23,-105,-82,12,-170,-80,-111,66,-447
-11,-195,-131,-76,-183,-189,-213,31,-967
-31,-56,-70,-9,-80,-41,-84,13,-358
-21,-35,-53,-29,-89,-35,-58,65,-255
-32,-54,-52,-34,-100,-25,-54,43,-308
-59,-39,-91,13,-69,-27,-105,82,-295
28,-26,-21,22,-77,-19,-15,54,-54
32,-74,-57,38,-38,15,-62,108,-38
-18,-59,-55,0,-83,-29,-75,50,-269
10,-100,-76,45,-106,-55,-138,86,-334
-10,-82,-107,-8,-92,-45,-144,108,-380
-41,-90,-92,-38,-114,-34,-141,14,-536
-23,-101,-85,-2,-144,-46,-109,46,-464
-48,-95,-101,-35,-118,-66,-129,-1,-593
-92,-115,-118,-54,-195,-21,-157,58,-694
12,-94,-81,3,-130,-35,-134,46,-413
22,-84,-80,-47,-91,-62,-80,84,-338
-3,-129,-130,-50,-179,-63,-150,41,-663
5,-39,-44,42,-52,-90,-86,-12,-276
44,-60,-88,-52,-36,-73,-93,70,-288
-18,-64,-116,-30,-145,-42,-135,56,-494
-46,-37,-41,-30,-43,5,-74,-15,-281
-17,-88,-115,-65,-137,-98,-174,26,-668
-34,-68,-88,-55,-133,-87,-110,39,-536
-53,-103,-135,-40,-173,-64,-169,85,-652
-26,-55,-73,-28,-37,-58,-47,6,-318
-42,-98,-110,5,-164,7,-111,103,-410
-21,-47,-52,-5,-78,-39,-75,11,-306
19,-7,-64,-6,-26,19,-8,40,-33
-20,-41,-68,-12,-71,-70,-99,33,-348
-67,-123,-83,-25,-126,-32,-142,14,-584
31,-45,-53,-29,-47,-62,-109,46,-268
-90,-107,-90,-53,-146,-34,-163,17,-666
38,-34,-34,-34,-12,-81,-93,37,-213
-16,-20,-48,-22,-31,-26,-46,16,-193
-318,-67,-297,-307,-339,-358,-587,-219,-2492
-60,-40,-48,-35,-66,-12,-86,-10,-357
-6,-110,-132,-41,-180,-115,-213,173,-624
-25,-46,-57,-38,-58,-14,-59,35,-262
-26,-28,-35,-13,-52,-26,-43,-2,-225
-8,-53,-45,7,-63,-49,-71,5,-277
5,-87,-111,-56,-148,-49,-114,90,-470
-51,-59,-82,-34,-110,-21,-87,43,-401
-75,-85,-84,-36,-114,-30,-99,36,-487
-25,-24,-38,-17,-36,-17,-32,-4,-193
-13,-74,-77,-18,-87,-20,-105,74,-320
-15,-15,-12,-8,-15,-2,-25,0,-92
-35,-86,-59,-3,-93,-8,-129,12,-401
2,2,-21,0,-33,-20,-37,14,-93
9,-95,-79,-21,-109,-108,-149,68,-484
-47,-42,-62,-30,-68,-12,-75,34,-302
8,-60,-60,-16,-35,-25,-70,48,-210
-54,-34,-63,-74,-56,-77,-126,-15,-499
-75,-144,-174,0,-197,-64,-219,94,-779
-1,-32,-30,4,-35,-21,-40,4,-151
25,-103,-67,55,-154,-64,-156,40,-424
-60,-95,-96,-79,-146,-60,-149,24,-661
-67,-104,-125,-22,-165,-86,-222,-54,-845
-6,-23,-26,-14,-36,-45,-38,-10,-198
-27,-63,-110,-71,-84,-68,-147,28,-542
24,-66,-65,6,-84,-45,-69,72,-227
1,0,-11,30,-2,-7,-21,8,-2
-48,-17,-80,5,-96,-26,-97,69,-290
-20,-40,-67,-19,-80,-79,-109,4,-410
-10,-99,-60,-2,-81,-62,-136,46,-404
-43,-123,-84,25,-80,-34,-108,30,-417
-51,-30,-59,-40,-65,-77,-120,-5,-447
13,-19,-40,-11,-66,-31,-47,13,-188
-35,-66,-78,-38,-123,-43,-173,13,-543
0,-29,-30,7,-35,-12,-32,6,-125
-55,-100,-138,-43,-179,-91,-166,55,-717
-24,-82,-84,-7,-108,-68,-119,22,-470
-170,-238,-254,-67,-131,-46,-181,9,-1078
21,-88,-132,-68,-104,-90,-186,42,-605
-26,-20,-57,-38,-93,-101,-168,-34,-537
2,-31,-44,-2,-56,-50,-45,28,-198
-22,-19,-58,-51,-56,-29,-79,1,-313
-34,-87,-135,-88,-124,-131,-181,24,-756
4,1,-26,-7,-15,-1,-17,13,-48
18,-46,-32,36,-74,-94,-100,22,-270
-39,-89,-96,-26,-100,-28,-138,41,-475
8,-69,-98,-25,-70,-105,-126,79,-406
-17,-70,-127,-57,-80,-50,-153,69,-485
-23,-41,-38,-27,-53,-34,-65,-6,-287
-14,-38,-44,-8,-23,-35,-35,8,-189
29,-71,-123,2,-143,-18,-171,129,-366
13,-69,-134,24,-120,14,-95,96,-271
-35,-92,-105,8,-142,-91,-170,-18,-645
-37,-95,-126,-8,-72,1,-51,43,-345
8,-55,-60,31,-60,-75,-118,50,-279
64,-19,-55,42,-89,-77,-111,33,-212
-68,-97,-95,0,-122,-54,-131,17,-550
-62,-77,-97,-20,-76,-37,-96,40,-425
-76,-148,-189,-92,-228,-51,-191,98,-877
-50,-59,-59,-17,-48,0,-59,2,-290
82,-103,-67,73,-15,-29,-113,206,34
6,-86,-80,28,-167,-79,-110,25,-463
-25,-105,-65,-14,-85,-33,-95,30,-392
-37,-29,-87,-10,-25,-40,-105,80,-253
-7,-11,-10,-10,-20,-4,-19,5,-76
-101,-88,-155,-53,-143,-78,-191,-19,-828
24,-16,-31,11,-38,-59,-71,2,-178
44,-132,-175,-39,-126,-99,-221,113,-635
29,-101,-100,-28,-100,-37,-108,99,-346
-15,-48,-43,-26,-57,2,-62,30,-219
-20,-75,-78,-15,-89,-40,-67,12,-372
16,1,-33,9,-46,-17,-23,30,-63
16,-26,-69,-19,-77,-74,-78,30,-297
-9,-32,-37,20,-25,-15,-46,6,-138
-19,-34,-32,-28,-24,-16,-38,-6,-197
-1,-18,-30,-21,-38,-41,-48,24,-173
-36,-70,-48,-24,-75,-41,-98,-14,-406
-7,-27,-17,3,-23,-32,-51,-18,-172
-24,-53,-49,-18,-55,-22,-52,12,-261
-11,-36,-28,-18,-8,-27,-37,20,-145
-15,-31,-34,-29,-47,-7,-48,31,-180
-23,-21,-54,7,-3,-27,-34,5,-150
95,-197,-191,-79,-100,-125,-207,153,-651
-23,-90,-132,-49,-129,-97,-225,39,-706
-24,-59,-57,-24,-58,-55,-93,37,-333
-5,-29,-58,7,-17,0,-23,45,-80
15,-70,-83,-49,-98,-75,-90,52,-398
-53,-109,-106,-31,-150,-82,-172,10,-693
23,-61,-46,-29,-31,-65,-88,40,-257
7,-37,-49,4,-71,-16,-65,65,-162
40,-100,-157,18,-111,-79,-197,148,-438
-92,-106,-101,-79,-142,-72,-195,34,-753
-10,-21,-27,-7,-21,-21,-35,-1,-143
29,-41,-37,5,-32,-37,-60,48,-125
23,-42,-49,-13,-56,-28,-53,34,-184
-46,-92,-110,-56,-83,-37,-118,44,-498
-25,-84,-87,-13,-99,-50,-90,14,-434
-27,-91,-71,-3,-90,-29,-91,43,-359
-2,-14,-50,-28,-32,-51,-69,20,-226
-75,-150,-174,-29,-213,-14,-172,76,-751
-60,-91,-110,-18,-103,-27,-101,50,-460
-35,-132,-178,-130,-189,-214,-367,57,-1188
-45,-61,-71,-52,-82,-5,-74,29,-361
-2,-21,-30,-19,-18,-34,-31,-3,-158
-50,-78,-89,-28,-110,-16,-97,42,-426
-33,-68,-94,-11,-131,11,-103,62,-367
17,-162,-94,22,-191,-96,-183,105,-582
-99,-33,-105,-37,-112,-92,-172,56,-594
-28,-53,-68,-14,-79,-73,-89,-3,-407
-6,-24,-31,0,-27,-16,-40,11,-133
6,-73,-82,0,-105,-40,-77,65,-306
-27,-67,-69,-9,-95,-9,-77,64,-289
72,-75,-50,8,-81,-79,-149,118,-236
-17,-33,-39,-23,-23,17,-24,10,-132
-24,-23,-21,-17,-5,-9,-27,3,-123
-18,-7,-18,-7,-14,-3,-30,7,-90
28,-62,-8,-26,13,-64,-99,95,-123
-41,-151,-152,19,-195,-13,-162,128,-567
-29,-97,-109,2,-180,-64,-202,23,-656
-37,-54,-68,-11,-61,-8,-89,61,-267
-45,-218,-245,-9,-228,-33,-244,219,-803
-14,-24,-29,-23,-28,-22,-36,8,-168
0,-64,-80,21,-69,-28,-114,107,-227
-32,-52,-77,-47,-87,-19,-65,62,-317
18,-17,-51,-6,-69,-64,-71,-11,-271
11,-38,-56,11,-44,-43,-74,40,-193
-14,-32,-35,-5,-20,3,-28,7,-124
10,-33,-47,-24,-43,-63,-76,18,-258
-13,-15,-31,-19,-14,-6,-25,14,-109
-20,-70,-65,-10,-27,-30,-50,1,-271
-74,-50,-93,-4,-115,-43,-101,19,-461
-61,-265,-312,-47,-284,-170,-381,205,-1315
71,-39,-69,73,-74,-66,-103,61,-146
22,-11,-52,12,-53,-58,-92,-4,-236
-36,-44,-36,-6,-55,-22,-53,19,-233
7,-25,-31,-6,-30,-8,-38,27,-104
55,-29,-28,-9,1,-55,-62,43,-84
-48,-106,-94,-37,-130,-81,-104,-26,-626
-38,-42,-88,-92,-94,-100,-183,-32,-669
-26,-26,-46,-13,-41,-15,-43,14,-196
-8,-12,-31,-4,-30,-25,-55,11,-154
-37,-27,-50,-43,-41,-45,-75,-29,-347
-37,-69,-73,-20,-79,-35,-106,9,-410
-1,-58,-33,3,-93,-19,-64,38,-227
-48,-140,-141,-17,-201,-97,-179,47,-776
-32,-41,-45,-32,-57,-35,-74,-12,-328
-4,-28,-30,-18,-24,-19,-16,-2,-141
5,-23,-36,-5,-50,-59,-91,11,-248
3,-21,-19,12,5,-6,-44,8,-62
1,-28,-24,-10,-38,-27,-38,-8,-172
6,-7,-3,11,-8,-10,-16,-9,-36
3,-103,-96,-8,-58,-47,-132,99,-342
-80,-46,-50,-72,-61,-31,-94,-27,-461
-14,-31,-79,-8,-41,-28,-84,66,-219
-40,-95,-125,-25,-129,-57,-163,-2,-636
-34,-99,-108,-56,-203,-105,-143,69,-679
-11,-13,-13,-8,-14,0,-14,11,-62
12,-62,-90,-45,-111,-43,-136,15,-460
-3,-41,-33,-3,-45,-18,-64,42,-165
-44,-89,-131,-50,-153,-77,-138,70,-612
96,-23,-46,81,-26,-4,-56,93,115
-4,-37,-55,-57,-71,-63,-81,31,-337
29,-9,-14,18,-27,-42,-64,60,-49
-31,-98,-124,-36,-164,-23,-163,105,-534
1,-8,-8,-6,-22,-7,-22,8,-64
-40,-39,-67,-48,-40,-46,-83,-13,-376
30,-55,-51,17,-68,-77,-69,62,-211
21,-41,-92,-14,-132,-203,-259,-27,-747
-4,-100,-137,-21,-230,-16,-172,167,-513
-89,-93,-86,-58,-62,-43,-102,-18,-551
-57,-52,-97,-137,-65,-158,-186,-14,-766
-55,-98,-101,-13,-77,-25,-77,4,-442
-4,0,-23,-29,-29,-49,-49,13,-170
-12,-28,-40,-37,-42,-52,-64,1,-274
-1,-69,-56,-18,-72,-14,-86,114,-202
-20,-52,-38,9,-60,-32,-35,-3,-231
-43,-56,-65,-21,-77,-22,-90,2,-372
-38,-164,-210,-39,-294,-95,-226,133,-933
12,-9,-19,2,-19,-14,-13,17,-43
-43,-49,-67,-23,-29,-11,-51,-30,-303
-42,-55,-18,27,-68,-2,-79,33,-204
-33,-60,-57,-13,-73,5,-54,33,-252
-14,-42,-67,-26,-51,-41,-57,15,-283
-24,-93,-79,17,-79,-38,-81,1,-376
-43,-64,-69,-9,-85,-14,-72,21,-335
-61,-28,-59,-24,-102,-51,-122,-15,-462
-62,-56,-52,-3,-96,31,-73,61,-250
-36,-51,-72,-15,-88,-13,-60,26,-309
23,-79,-69,-41,-47,-49,-65,70,-257
-7,-12,-23,-30,-20,-39,-47,-8,-186
-53,-53,-55,-37,-61,-77,-112,17,-431
26,-26,-16,-9,-6,-33,-37,26,-75
63,7,-26,63,-59,-32,-65,83,34
10,-30,-45,3,-37,-29,-60,50,-138
118,-2,-67,30,-59,-89,-119,129,-59
-81,-106,-189,-7,-50,-43,-89,-5,-570
-35,-47,-26,-16,-28,-18,-41,20,-191
-15,-38,-45,-13,-58,-5,-44,31,-187
-94,-143,-201,24,-60,-21,-107,-15,-617
-3,-54,-69,-39,-95,-50,-79,7,-382
-39,-112,-88,12,-114,-33,-115,23,-466
-21,-25,-57,-11,-60,-46,-76,-1,-297
28,35,-39,-37,23,-2,-28,103,83
-8,-39,-30,6,-45,-35,-51,28,-174
-93,-141,-200,-24,-47,26,-121,-32,-632
25,-22,-25,46,19,22,-16,47,96
33,-39,-66,-6,-16,-40,-78,65,-147
-3,-75,-76,3,-117,-41,-87,31,-365
-2,-41,-46,0,-41,-34,-65,-4,-233
16,-37,-54,-43,-73,-56,-88,79,-256
-19,-95,-99,-26,-96,-51,-130,25,-491
74,5,13,95,-18,6,-122,149,202
-13,-17,-29,-15,-20,-13,-43,-3,-153
10,-29,-85,-29,-77,-35,-91,85,-251
-88,-281,-374,-140,-320,-108,-332,91,-1552
212,64,268,482,67,-3,-216,245,1119
12,-63,-52,-12,3,-66,-99,52,-225
38,-23,-55,23,-60,-45,-78,68,-132
-10,-21,-42,-15,-28,-9,-65,13,-177
21,-38,-43,-18,-37,-52,-63,53,-177
-202,50,-66,-95,117,-35,-114,-125,-470
-8,-177,-271,-5,-268,-98,-303,119,-1011
6,-51,-38,2,-27,-5,-44,61,-96
16,-24,-65,20,-59,-53,-72,14,-223
-54,-74,-134,-68,-137,-5,-88,73,-487
-41,-62,-107,-49,-125,-83,-132,35,-564
-7,-20,-26,-2,-30,-16,-34,10,-125
8,-56,-23,22,-30,-45,-87,43,-168
11,-22,-24,5,-20,-18,-26,28,-66
-34,-57,-75,-35,-106,-47,-100,14,-440
-31,-63,-91,-22,-82,-37,-94,40,-380
6,-25,-88,-55,-112,-117,-167,-5,-563
-126,-150,-180,-25,-90,-35,-126,-12,-744
-4,-48,-45,-24,-96,-37,-89,38,-305
-56,-127,-182,-49,-121,-42,-172,70,-679
-33,-70,-67,3,-50,-5,-75,-10,-307
-45,-121,-83,-23,-22,-9,-90,19,-374
-52,-87,-127,-53,-141,-126,-162,16,-732
-75,-79,-142,-68,-68,-4,-31,30,-437
-19,-106,-96,-47,-83,-65,-121,19,-518
-10,-10,-36,-3,-7,-12,-25,-6,-109
-35,-122,-128,-58,-55,-96,-105,58,-541
36,-94,-145,-7,-256,-176,-199,-50,-891
34,-85,-115,-58,-156,-134,-166,92,-588
-2,-11,-21,0,-40,-28,-31,22,-111
-34,-69,-74,-22,-56,-15,-66,13,-323
-84,-95,-84,-62,-117,-2,-102,22,-524
-3,-67,-57,-105,-91,-155,-203,12,-669
-44,-44,-45,-16,-84,-8,-56,31,-266
4,-37,-41,2,-29,-24,-44,3,-166
29,14,-8,20,-9,-39,-44,23,-14
-17,-17,-54,9,-31,-78,-124,45,-267
-183,-62,-122,-144,-148,-151,-280,-140,-1230
-8,-17,-32,34,-47,-13,-86,46,-123
-6,3,-16,-1,-38,-5,-29,18,-74
70,-66,-50,61,-14,-52,-92,64,-79
-26,-22,-41,-30,-50,-18,-45,7,-225
-22,-19,-26,-6,-31,11,-26,-2,-121
-29,-13,-30,-35,-36,-38,-42,-21,-244
33,-21,-28,0,-4,-42,-50,31,-81
-4,-73,-46,3,-61,-19,-63,33,-230
-116,-123,-165,-54,-64,-15,-70,-1,-608
-1,12,-13,-6,-20,-17,-33,20,-58
24,-93,-131,5,-128,-36,-103,126,-336
-79,-121,-129,-33,-50,-6,-72,-16,-506
-10,-27,-41,-39,-52,-49,-80,16,-282
4,-32,-42,-48,-76,-74,-86,26,-328
-18,-22,-52,-44,-53,-18,-38,30,-215
-9,-22,-18,15,-52,19,-39,53,-53
-18,-31,-35,-28,-38,-6,-31,6,-181
-14,-31,-34,-14,-32,-25,-30,17,-163
-41,-60,-84,-45,-104,-64,-104,6,-496
0,-39,-65,-61,-79,-58,-52,26,-328
-24,-88,-94,-39,-120,-50,-105,37,-483
-55,-63,-96,-24,-123,-5,-120,61,-425
8,-34,-74,-14,-86,-67,-77,18,-326
-17,-59,-52,8,-58,-15,-84,53,-224
-41,-36,-46,-8,-50,-19,-49,-2,-251
9,-2,-35,7,-73,-63,-181,63,-275
3,-70,-93,-16,-108,-49,-126,40,-419
32,-47,-63,46,-42,-76,-120,7,-263
-16,-107,-142,-43,-102,-37,-95,82,-460
-51,-68,-122,-52,-129,-64,-156,14,-628
16,-8,-45,21,-84,-50,-96,41,-205
-11,-9,-33,-17,-27,-24,-46,16,-151
29,-105,-98,-13,-86,-37,-97,141,-266
-47,-104,-92,-62,-103,-60,-81,0,-549
-46,-67,-64,3,-79,-30,-97,-13,-393
-17,-44,-48,-22,-2,-8,-7,11,-137
10,-42,-39,-18,-16,-29,-59,50,-143
65,-30,-83,49,-93,-18,-104,117,-97
-107,-154,-150,-4,-71,-23,-101,-3,-613
-12,-24,-40,-19,-46,-42,-63,29,-217
5,-20,-30,-23,-14,-36,-43,29,-132
-29,-32,-50,-63,-41,-40,-53,-2,-310
147,-57,-112,65,-61,-138,-210,143,-223
-29,-40,-40,-27,-44,-11,-35,22,-204
-45,-2,-41,-27,-25,-22,-76,-24,-262
-73,-133,-150,-38,-195,-75,-181,62,-783
-95,-128,-154,-130,-175,-119,-244,-13,-1058
-9,-168,-155,25,-290,-186,-327,50,-1060
-46,-53,-86,-2,-92,-52,-99,48,-382
-32,-48,-50,-29,-75,-56,-131,19,-402
-112,-148,-203,-21,-42,12,-75,19,-570
-10,-6,-49,-31,-46,-19,-32,11,-182
9,-53,-48,-37,-62,-21,-53,45,-220
-50,-30,-51,-1,-57,-18,-88,6,-289
-58,-75,-106,-13,-59,-3,-76,30,-360
-58,-6,-54,-81,-47,-71,-149,-76,-542
-22,-55,-57,-6,-57,-8,-57,16,-246
-27,-39,-31,-12,-44,-5,-35,5,-188
10,-43,-64,26,-96,-81,-66,-4,-318
-39,-153,-191,-129,-212,-206,-315,30,-1215
-35,-86,-85,-31,-121,-63,-90,14,-497
-4,-114,-166,-94,-161,-57,-95,125,-566
-36,-2,-81,-43,9,-15,-47,28,-187
14,-70,-54,-5,-90,-85,-102,20,-372
-47,-57,-65,-36,-85,-25,-64,-10,-389
-74,-118,-123,-26,-75,-21,-85,-17,-539
-13,-35,-43,-44,-23,-62,-73,65,-228
15,-18,-18,-1,-30,-30,-24,-2,-108
0,-135,-169,-113,-250,-245,-241,-22,-1175
69,-74,-132,-61,-75,-99,-149,134,-387
13,-43,-63,-17,-32,-7,-44,-2,-195
-45,-88,-95,-53,-123,-55,-116,17,-558
-22,-45,-42,-49,-41,-47,-91,12,-325
-116,-81,-122,-48,-100,-44,-101,-26,-638
12,-71,-79,-9,-44,-43,-76,44,-266
-4,0,-21,-6,-15,-4,-16,12,-54
-25,-40,-29,-18,-101,-62,-122,47,-350
50,-59,-92,-17,-92,-36,-95,79,-262
33,-74,-106,-27,-117,-141,-162,26,-568
-38,-34,-60,4,-82,-28,-86,40,-284
46,-41,-63,3,-110,-60,-72,93,-204
-38,-20,-31,-37,-42,-10,-70,-5,-253
8,-7,-21,-11,-19,-2,-25,33,-44
13,-43,-25,-13,1,-53,-73,56,-137
-27,-20,-60,-53,-56,-49,-72,40,-297
-26,-21,-48,-44,3,-12,-22,11,-159
-3,-31,-24,-24,-9,-36,-47,34,-140
-22,-32,-31,-23,-27,-9,-35,4,-175
-73,-118,-100,2,-138,-57,-149,29,-604
-32,-69,-67,-26,-102,-63,-113,35,-437
-4,-15,-25,-13,-33,-26,-39,28,-127
-24,-35,-73,-33,-42,-103,-144,16,-438
-20,-94,-108,-24,-105,0,-114,121,-344
19,24,18,50,-20,5,-17,36,115
-45,-56,-99,-41,-95,-53,-129,14,-504
-5,-72,-92,-5,-135,-32,-87,46,-382
26,-105,-92,-17,-67,-96,-97,21,-427
-97,-210,-333,-108,-287,-65,-378,94,-1384
22,202,32,80,62,-147,-140,-50,61
16,-79,-101,-25,-117,-100,-140,23,-523
30,-54,-14,21,-5,-3,-40,78,13
-17,-38,-34,0,-31,-7,-47,33,-141
1,-84,-89,-37,-98,17,-55,55,-290
-3,-24,-39,-31,-23,-35,-39,44,-150
-12,-16,-31,-8,-38,-8,-42,23,-132
-7,-51,-51,-36,-28,-73,-102,48,-300
-93,-100,-110,-34,-69,-8,-97,5,-506
3,-48,-45,-31,-49,-45,-80,48,-247
21,-62,-80,4,-69,-20,-63,74,-195
-67,-21,-90,-40,-78,-18,-115,-5,-434
31,-106,-65,-10,-95,-59,-91,66,-329
-7,-47,-70,-29,-101,-48,-47,59,-290
-58,-107,-139,-10,-167,-50,-166,82,-615
-64,-108,-169,-26,-144,-25,-168,29,-675
-80,-83,-96,6,-50,-27,-68,-14,-412
-68,-92,-84,-70,-91,-82,-147,-66,-700
-89,-150,-150,-64,-201,-39,-166,14,-845
-41,-96,-95,17,-119,-88,-160,-47,-629
4,-56,-66,-11,-2,7,-54,57,-121
-46,-108,-118,-25,-131,-52,-105,53,-532
-34,-47,-73,-62,-62,-87,-122,1,-486
-62,-85,-101,-67,-94,-12,-94,22,-493
20,-119,-55,-36,-26,-100,-112,18,-410
-75,-135,-150,-131,-81,-102,-143,39,-778
20,-109,-132,-2,-148,-73,-135,77,-502
-11,-75,-71,6,-99,-39,-82,74,-297
14,-3,-15,12,-13,-26,-40,13,-58
31,-60,-116,76,-75,-45,-136,175,-150
-4,-37,-48,-31,-38,-48,-81,29,-258
-3,-43,-56,-20,-22,-19,-72,48,-187
-15,-3,-32,-12,-15,-3,-27,6,-101
14,-90,-110,-60,-183,-133,-184,16,-730
-25,-19,-51,-49,-84,-81,-77,8,-378
5,-18,-36,-12,-27,-16,-32,30,-106
-47,-120,-118,13,-158,5,-119,73,-471
17,-103,-156,-61,-192,-218,-242,56,-899
9,-17,-31,-8,-26,-34,-29,15,-121
15,-67,-87,-57,-29,-162,-177,19,-545
30,-69,-99,-56,-129,-163,-176,25,-637
15,-41,-51,-39,-42,-54,-67,37,-242
-20,-21,-69,17,-45,7,-62,62,-131
-6,-95,-118,12,-197,-101,-187,63,-629
-9,-33,-39,-5,-54,-2,-43,41,-144
-2,-208,-225,22,-149,-24,-182,203,-565
43,-43,-94,48,-117,-50,-117,88,-242
-3,-17,-38,-31,-27,-40,-46,14,-188
19,-21,-25,-2,-18,-23,-39,13,-96
-31,-150,-110,-71,-137,-65,-125,35,-654
-12,-138,-183,-55,-186,-58,-181,122,-691
-3,-40,-52,-15,-57,-30,-42,35,-204
-72,-31,-62,-76,-74,-22,-97,41,-393
-1,-20,-53,-38,-53,-83,-93,45,-296
22,-54,-71,-11,-59,-62,-113,69,-279
-41,-84,-84,1,-124,-45,-84,24,-437
-28,-181,-220,-47,-272,-95,-262,86,-1019
10,-43,-45,-3,-52,-50,-44,29,-198
-63,-54,-90,-88,-115,-43,-142,-11,-606
-199,-105,-138,-142,-161,-174,-361,-188,-1468
25,-51,-62,12,-74,-41,-54,47,-198
-90,-142,-118,17,-92,-44,-116,-23,-608
52,-117,-200,6,-295,-247,-271,-34,-1106
-137,-222,-238,-60,-329,-24,-300,88,-1222
-83,-172,-233,-17,-97,-6,-130,48,-690
10,-74,-104,15,-81,2,-107,103,-236
-21,-287,-355,88,-427,-125,-458,198,-1387
9,-138,-124,22,-151,-72,-110,45,-519
-9,-66,-113,-40,-197,-94,-187,71,-635
-114,-144,-202,-74,-214,-14,-210,95,-877
-29,-44,-58,-43,-51,-26,-75,29,-297
13,-29,-37,-21,-12,-26,-34,25,-121
4,-58,-83,-56,-56,-79,-108,37,-399
22,-21,-32,-7,-22,-35,-43,33,-105
-33,-53,-42,-10,-60,-17,-53,15,-253
-71,-104,-56,28,-131,7,-134,20,-441
18,-86,-90,-6,-95,-134,-168,75,-486
17,-55,-117,20,-158,-18,-94,84,-321
8,-13,-31,-12,-15,-20,-34,31,-86
26,-74,-95,-10,-130,-49,-124,75,-381
-13,-77,-57,43,-95,-25,-91,46,-269
-38,-66,-76,-19,-78,-39,-93,32,-377
-6,-24,-57,-34,-32,-72,-103,22,-306
-75,-106,-119,-10,-152,-56,-173,40,-651
-17,-85,-74,-18,-99,-83,-122,-4,-502
-1,25,-19,3,-38,-30,-52,10,-102
-1,-142,-92,-36,-151,-103,-162,37,-650
38,-36,-22,30,-35,-24,-35,28,-56
-78,-199,-162,-4,-259,-23,-199,169,-755
70,-47,-24,30,-34,-25,-75,57,-48
-37,-98,-66,5,-85,-40,-93,29,-385
-60,-52,-71,-32,-94,-52,-129,-8,-498
-46,-56,-60,-3,-109,-49,-95,35,-383
40,-108,-97,28,-147,-66,-118,75,-393
-86,-113,-137,-34,-143,-43,-179,49,-686
-4,-58,-55,-6,-89,-29,-101,2,-340
-41,-144,-150,-16,-192,-109,-224,-3,-879
-45,-77,-140,-47,-160,-85,-168,66,-656
9,-84,-135,-49,-171,-126,-147,91,-612
-19,-74,-76,-29,-78,-10,-77,23,-340
-54,-84,-87,-44,-99,-62,-108,6,-532
-7,-76,-94,-47,-58,-95,-140,76,-441
65,-24,-90,31,-80,-73,-140,30,-281
-27,-57,-57,-46,-26,-47,-87,23,-324
-87,-185,-200,-60,-260,-129,-259,53,-1127
24,-67,-74,-1,-76,-79,-73,-4,-350
30,-83,-76,2,-120,-30,-28,86,-219
-15,-13,-20,-11,-43,-43,-54,-14,-213
-40,-113,-106,-9,-153,-48,-160,71,-558
-17,-70,-50,-12,-103,-58,-77,3,-384
-23,-31,-51,-21,-74,-49,-81,42,-288
-17,-64,-96,-63,-87,-89,-81,42,-455
-69,-118,-120,-7,-184,-3,-140,88,-553
-5,-44,-62,5,-103,-11,-82,65,-237
15,-33,-15,-20,-11,-30,-67,66,-95
-18,-60,-56,-11,-67,2,-82,46,-246
51,-26,-40,1,4,-40,-58,45,-63
-31,-49,-65,-1,-56,-28,-74,-5,-309
-12,-47,-29,-5,-21,-33,-69,57,-159
5,7,-31,-8,-34,-46,-51,81,-77
-25,-82,-88,12,-44,-9,-43,12,-267
-1,-12,-18,-14,-18,-19,-17,10,-89
11,-34,-67,-16,-95,-29,-86,62,-254
17,-43,-73,-26,-102,-125,-199,56,-495
53,25,5,35,-9,-10,-19,27,107
25,-31,-44,16,-41,9,-39,73,-32
-32,-77,-91,-37,-137,-113,-186,6,-667
-59,-82,-115,-92,-131,-106,-152,55,-682
-15,-80,-66,19,-104,5,-97,91,-247
-2,-54,-27,-7,-47,-1,-40,13,-165
51,-24,-76,-62,-18,-139,-199,46,-421
43,-25,-14,0,-37,-25,-22,65,-15
46,52,55,103,0,3,-66,27,220
17,-23,-39,-6,-51,-55,-61,49,-169
93,-66,-68,52,-73,-45,-61,45,-123
-17,-68,-51,-7,-75,-46,-71,35,-300
-31,-85,-122,19,-176,-10,-162,112,-455
-7,-66,-123,-24,-95,-62,-180,119,-438
-32,-72,-73,-31,-110,-30,-100,45,-403
7,-70,-106,34,-167,-76,-170,100,-448
-1,-84,-76,27,-89,-67,-102,30,-362
-17,-29,-75,-61,-53,-76,-90,80,-321
-47,-108,-64,-41,-116,-68,-111,30,-525
-34,-135,-114,-11,-222,-111,-199,77,-749
-31,-86,-64,-54,-100,-96,-128,17,-542
-52,-115,-87,1,-98,-30,-142,38,-485
-2,-13,-17,16,-94,-8,-69,86,-101
-29,-85,-112,1,-46,-32,-79,17,-365
9,-35,-123,-28,-130,-118,-210,51,-584
-56,-144,-93,-42,-110,-51,-138,44,-590
-46,-69,-79,-25,-82,-32,-73,22,-384
-9,-103,-109,-69,-77,-101,-154,38,-584
-54,-168,-186,-63,-258,-47,-201,125,-852
-409,-634,-674,-328,-1064,-501,-1176,-97,-4883
25,-51,-72,21,-101,-29,-65,113,-159
-39,-58,-142,-81,-109,-101,-186,49,-667
-35,-135,-102,50,-191,-58,-150,72,-549
14,-49,-105,28,-100,-4,-79,118,-177
-3,-23,-31,-18,-20,-20,-40,37,-118
-29,-19,-20,-18,-31,-5,-43,-5,-170
-51,-105,-106,-9,-120,-39,-144,40,-534
-17,-42,-88,-43,-44,-31,-68,44,-289
-20,-94,-86,-22,-138,-36,-108,46,-458
-10,-61,-31,24,-50,-2,-55,13,-172
-30,-83,-30,3,-22,-33,-79,8,-266
-45,-37,-58,-10,-63,23,-75,43,-222
-33,-36,-39,-23,-38,-33,-55,12,-245
-129,-166,-169,-44,-223,-48,-226,25,-980
21,-56,-84,-32,-82,-21,-97,86,-265
-57,-114,-138,-51,-87,-17,-107,45,-526
-12,-13,-28,-19,-22,-39,-49,-18,-200
-143,-129,-169,-141,-114,-164,-288,-83,-1231
2,-20,-62,-75,-85,-93,-138,37,-434
1,-13,-9,-4,-17,-14,-26,-1,-83
27,-103,-115,-37,-102,-165,-196,42,-649
27,-41,-32,38,-60,-90,-144,102,-200
5,-35,-41,-4,-54,-11,-53,53,-140
-45,-103,-95,-12,-136,-57,-127,84,-491
-177,-116,-141,-166,-200,-198,-335,-189,-1522
-53,-15,-13,-53,-52,-27,-95,-16,-324
8,-153,-136,4,-141,-152,-193,129,-634
-101,-40,-70,-65,-78,-72,-120,-60,-606
46,-144,-202,-80,-272,-223,-393,139,-1129
-11,-75,-107,-70,-77,-111,-159,40,-570
25,-12,2,42,-31,-40,-44,37,-21
-42,-89,-139,-70,-114,-132,-213,2,-797
40,20,0,81,-11,13,-48,90,185
-62,-161,-166,-65,-149,-68,-207,105,-773
-73,-39,-110,-21,-142,-19,-121,53,-472
-36,-80,-65,-9,-107,-43,-98,20,-418
-57,-130,-209,-22,-95,-16,-83,121,-491
65,-68,-70,49,-51,-61,-140,148,-128
-21,-42,-38,-26,-77,-63,-96,5,-358
8,-45,-47,-21,-54,-75,-84,24,-294
419,-563,-828,-254,-1074,-591,-876,996,-2771
-135,-329,-414,-256,-550,-432,-622,-64,-2802
-71,-94,-135,-48,-117,-40,-159,48,-616
-28,-15,-26,-23,-12,-40,-70,6,-208
61,-48,-12,39,-1,-43,-50,100,46
8,9,1,26,-8,17,-15,20,58
-26,-43,-63,-26,-40,-36,-62,24,-272
72,-47,-74,78,-76,-28,-103,113,-65
-48,-291,-272,-93,-377,-121,-301,142,-1361
-189,-266,-455,-218,-298,-80,-360,198,-1668
39,-60,-105,-4,-151,-95,-113,37,-452
6,-52,-69,25,-94,-58,-108,56,-294
6,-127,-179,-3,-147,-81,-228,78,-681
2,-131,-94,35,-120,-72,-216,184,-412
-225,-226,-297,-199,-376,-130,-397,42,-1808
37,-75,-56,16,-114,-30,-84,67,-239
-64,-100,-126,-18,-43,-19,-83,-18,-471
-132,-137,-190,-86,-94,-41,-97,-25,-802
62,-52,-72,-1,-130,-151,-250,68,-526
-33,-69,-50,16,-46,5,-45,44,-178
-60,-101,-109,-63,-150,-86,-134,13,-690
-210,-165,-199,-191,-269,-168,-368,-103,-1673
535,148,14,517,147,211,-249,494,1817
-46,-105,-121,-13,-50,15,-67,5,-382
-144,-221,-262,-101,-357,-244,-447,-159,-1935
68,-105,-138,-22,-87,-161,-286,108,-623
-34,-85,-76,34,-145,-2,-115,104,-319
93,-112,-216,-34,-153,-93,-159,266,-408
-10,-32,-46,-7,-52,-23,-24,23,-171
-18,-37,-44,-1,-49,-11,-58,34,-184
-29,-35,-54,13,-74,-56,-105,-28,-368
-25,-10,-35,-22,-29,-21,-54,9,-187
37,-26,-25,19,-47,-58,-84,0,-184
3,-40,-47,-35,-19,-56,-61,33,-222
100,-77,-61,106,-79,-15,-114,179,39
13,-96,-134,-80,-145,-139,-200,128,-653
-19,-79,-70,-29,-123,-82,-136,18,-520
-88,-118,-149,-57,-149,-66,-149,5,-771
-53,-123,-108,-11,-175,-40,-134,79,-565
24,-96,-150,-74,-191,-153,-251,43,-848
-139,-261,-263,-80,-220,-76,-276,51,-1264
-49,-119,-152,-59,-172,-44,-189,76,-708
-1,-48,-55,-14,-66,-7,-65,43,-213
-64,-93,-125,-85,-198,-126,-210,14,-887
19,-56,-95,-49,-49,-86,-99,50,-365
139,-91,-40,96,-39,-59,-99,165,72
21,-76,-81,15,-115,-91,-119,41,-405
-16,-106,-99,-47,-126,-96,-156,24,-622
-17,-22,-20,-11,-34,-11,-29,16,-128
-106,-18,-110,-92,-45,-119,-140,32,-598
-89,-73,-80,-20,-97,-31,-89,11,-468
-48,-57,-45,-32,-97,-75,-92,21,-425
-36,-38,-25,-21,-43,-21,-71,-2,-257
-30,-22,-41,-19,-29,-2,-65,23,-185
67,-107,-112,13,-109,-110,-190,179,-369
-62,-62,-93,1,-130,-30,-108,43,-441
7,-74,-52,2,-61,-47,-61,19,-267
-6,-73,-120,-23,-77,-45,-104,37,-411
-55,-165,-144,-27,-160,-107,-189,41,-806
9,-130,-143,4,-205,-163,-208,82,-754
-52,-134,-140,-78,-143,-55,-136,47,-691
-11,-11,-17,-16,3,-10,-23,7,-78
-129,-142,-131,-65,-216,-40,-181,8,-896
-7,-110,-155,5,-153,-138,-210,44,-724
-119,-64,-79,-104,-19,-50,-87,-83,-605
4,-37,-91,-45,-58,-27,-81,47,-288
-36,-56,-37,-13,-58,-17,-58,26,-249
42,-59,-32,24,-6,-39,-46,37,-79
28,-69,-76,14,-105,-65,-102,49,-326
-103,-85,-134,-77,-98,-32,-138,16,-651
-37,-127,-139,-72,-141,-144,-160,29,-791
-139,-17,-63,-73,-17,-95,-158,-115,-677
-10,-39,-42,8,-57,-11,-27,30,-148
-21,-36,-61,-44,-62,-44,-68,28,-308
-94,-118,-134,-16,-72,-6,-113,22,-531
-29,-66,-64,-35,-91,-20,-69,18,-356
-44,-64,-59,-42,-58,-29,-73,4,-365
-20,-101,-112,28,-171,-39,-173,105,-483
-11,-112,-194,-32,-146,-49,-150,108,-586
-111,-111,-148,-43,-52,4,-90,-24,-575
-5,-54,-93,11,-173,-28,-128,68,-402
15,-69,-127,5,-110,-88,-146,137,-383
-52,-188,-173,7,-152,-18,-121,116,-581
-56,-99,-166,-64,-217,-99,-243,30,-914
-46,-144,-218,-127,-215,-110,-271,84,-1047
2,-32,-90,-45,-101,-103,-134,-1,-504
31,-88,-126,-32,-69,-31,-102,136,-281
-1,-38,-55,5,-73,-66,-85,31,-282
-107,-157,-165,-30,-95,-32,-105,22,-669
-8,-38,-43,-16,-28,-19,-46,8,-190
26,-29,-42,-14,-15,-20,-27,25,-96
-61,-144,-156,-7,-198,-71,-226,56,-807
-38,-76,-103,-33,-130,-40,-116,30,-506
-16,-84,-72,-36,-110,-66,-116,23,-477
-14,-19,-23,-11,-13,-19,-23,0,-122
-17,-10,-21,-13,-19,-5,-22,6,-101
153,-79,-203,174,-114,-80,-183,352,20
-10,-41,-54,-21,-28,-16,-64,63,-171
-34,-95,-69,-34,-121,-101,-154,4,-604
-102,-143,-152,-79,-197,-72,-205,-7,-957
-15,-74,-101,15,-139,-70,-137,20,-501
-19,-105,-38,-2,-83,-35,-72,27,-327
-206,-236,-323,-112,-325,-61,-310,75,-1498
127,-167,-328,154,-160,67,-275,427,-155
-57,-22,-64,-72,-43,-67,-99,0,-424
-11,-51,-79,12,-145,-51,-112,56,-381
-10,-34,-39,-33,-10,-29,-36,10,-181
-29,-23,-17,-3,-11,1,-15,5,-92
-29,-19,-25,-5,-14,4,-17,-9,-114
-20,-38,-49,-8,-90,-13,-73,29,-262
120,-159,-316,52,-264,-159,-469,300,-895
-22,-57,-59,-26,-76,-18,-62,9,-311
-14,-89,-99,-38,-107,-70,-99,31,-485
4,-65,-80,16,-10,-34,-101,59,-211
5,-68,-55,-28,-57,-36,-108,45,-302
-36,-213,-191,93,-341,-105,-270,27,-1036
436,-510,-512,67,-354,-372,-680,993,-932
-16,-42,-66,-22,-131,-21,-91,53,-336
-6,-109,-94,-34,-137,-77,-137,30,-564
-111,-437,-403,-105,-557,-238,-557,149,-2259
136,-92,-34,91,-25,-68,-165,201,44
-41,-17,-33,-29,-24,-37,-67,-26,-274
-3,-29,-44,-34,-49,-50,-62,55,-216
-946,-965,-1511,-1001,-2141,-1847,-2747,-800,-11958
-87,-97,-107,-42,-83,-48,-130,19,-575
-29,-195,-228,27,-284,-70,-308,157,-930
-7,-43,-65,-50,-81,-73,-100,32,-387
-69,-90,-82,-70,-140,-38,-128,25,-592
261,-46,-477,-41,-317,49,-334,390,-515
10,-117,-135,-38,-198,-163,-179,12,-808
5,-25,-32,-30,-30,-30,-43,23,-162
467,26,14,495,53,-233,-337,542,1027
-42,-103,-116,-43,-171,-1,-147,142,-481
-25,-87,-105,-36,-123,-104,-174,3,-651
-21,-94,-111,-33,-139,-71,-135,86,-518
34,-59,-57,2,-106,-4,-52,79,-163
2,-63,-38,8,-90,-13,-54,34,-214
31,-29,-27,19,-36,-3,-45,100,10
62,-102,-93,41,-36,-90,-162,97,-283
-37,-117,-132,-75,-195,-90,-191,120,-717
21,-34,-10,17,-27,-62,-68,10,-153
-39,-89,-95,-26,-107,-47,-98,40,-461
-40,-126,-90,-24,-139,0,-96,71,-444
55,-1,-33,95,-62,-38,-148,53,-79
-35,-79,-118,-58,-148,-105,-158,41,-660
-37,-32,-73,-35,-67,-48,-79,22,-349
-18,-79,-55,-31,-70,-79,-101,30,-403
-130,-203,-265,-83,-304,-193,-395,45,-1528
1,-120,-143,13,-142,-80,-170,136,-505
-4,-96,-186,-15,-188,-75,-212,151,-625
-19,-36,-28,-14,-41,-28,-22,0,-188
33,-160,-129,-16,-151,-45,-123,196,-395
-2,-19,-24,-23,-36,-22,-34,21,-139
-57,-424,-494,-13,-786,-117,-611,354,-2148
-22,-68,-75,-15,-88,-36,-75,52,-327
-24,-79,-109,4,-135,10,-109,77,-365
80,-18,-81,13,-71,-65,-97,45,-194
-27,-36,-28,-2,-43,0,-36,7,-165
-126,-127,-88,-89,-99,-97,-186,-99,-911
-66,-127,-170,-112,-202,-157,-238,29,-1043
-97,-128,-120,-46,-193,-13,-164,52,-709
10,-100,-127,-35,-106,-104,-173,76,-559
16,-73,-103,63,-85,-34,-152,110,-258
5,-98,-88,-25,-121,-72,-134,74,-459
-11,-95,-89,-19,-154,-85,-152,61,-544
2,-15,-20,7,-17,-15,-35,3,-90
12,-27,-8,-14,-9,-2,-22,26,-44
-5,-75,-95,-3,-68,-27,-68,39,-302
101,-234,-424,-45,-231,-46,-295,323,-851
-1,-27,-37,-15,-92,-58,-83,27,-286
-84,-94,-74,-49,-76,-56,-124,26,-531
402,278,272,151,132,-146,-227,372,1234
25,-47,-50,42,-61,-105,-107,34,-269
-9,-52,-66,-15,-106,-41,-92,40,-341
32,-97,-164,-27,-159,-110,-208,86,-647
-7,-44,-30,18,-42,-26,-37,19,-149
36,-199,-170,41,-186,-25,-160,217,-446
-10,-123,-110,23,-161,-33,-115,55,-474
-85,-177,-190,-56,-244,-79,-293,132,-992
-5,-135,-88,40,-124,-4,-110,81,-345
67,-121,-75,12,-127,-106,-184,122,-412
-25,-15,-54,-40,-94,-121,-141,-32,-522
-79,-129,-128,-38,-141,-33,-109,76,-581
20,-37,-89,-33,-111,-45,-81,50,-326
-19,-99,-147,-60,-180,-99,-187,81,-710
-34,-44,-66,-58,-99,-98,-148,-11,-558
-33,-138,-176,-21,-255,-15,-200,135,-703
-46,-57,-66,5,-98,-21,-84,28,-339
94,-44,-59,71,-72,-65,-98,131,-42
-45,-222,-331,28,-353,34,-349,186,-1052
-15,-7,-18,-4,-15,-12,-24,4,-91
11,-21,-19,0,-18,-33,-47,14,-113
-71,-157,-171,-52,-233,-119,-187,44,-946
-15,-44,-52,-33,-66,-46,-84,33,-307
58,-69,-60,-2,-32,-122,-119,57,-289
-101,-61,-87,-52,-127,-67,-184,-31,-710
-27,-76,-73,-9,-77,-25,-88,30,-345
-67,-99,-91,-29,-143,4,-101,58,-468
-50,-99,-80,-12,-123,-49,-93,19,-487
-51,-100,-78,-16,-121,-66,-103,8,-527
-85,-103,-108,-18,-146,-1,-137,54,-544
-73,-103,-71,-12,-117,3,-105,40,-438
-76,-80,-79,-13,-119,-9,-93,58,-411
-73,-87,-88,-12,-129,-13,-101,50,-453
-78,-105,-112,-43,-142,-35,-120,47,-588
-69,-93,-71,-21,-123,1,-95,43,-428
-65,-86,-93,-42,-125,-31,-110,34,-518
-64,-94,-101,-29,-113,-9,-107,51,-466
-80,-69,-79,-35,-126,-22,-111,46,-476
-34,-74,-82,-20,-123,-46,-95,63,-411
-43,-66,-83,-12,-114,-26,-103,58,-389
-82,-69,-87,-45,-134,-24,-118,37,-522
-59,-81,-86,-27,-130,-16,-104,54,-449
-74,-92,-107,-42,-138,-22,-109,49,-535
-53,-81,-88,-15,-112,-25,-90,56,-408
-42,-64,-97,-36,-103,-55,-97,29,-465
-78,-100,-108,-44,-137,-19,-113,24,-575
-67,-85,-98,-50,-126,-31,-114,25,-546
-57,-84,-82,-44,-146,-21,-107,40,-501
-86,-105,-109,-41,-140,-23,-106,32,-578
-67,-82,-76,-40,-111,-20,-109,24,-481
-78,-93,-78,-40,-136,-18,-117,32,-528
-62,-103,-88,-23,-131,-12,-115,46,-488
-94,-99,-94,-46,-152,3,-121,63,-540
-85,-125,-108,-44,-131,-31,-119,55,-588
-86,-114,-106,-47,-145,-28,-110,61,-575
-67,-100,-95,-44,-133,-7,-102,40,-508
-64,-96,-86,-36,-137,-36,-110,18,-547
-74,-99,-80,-33,-135,-20,-100,20,-521
-79,-100,-112,-68,-152,-11,-111,71,-562
-74,-85,-89,-51,-127,2,-107,65,-466
-82,-95,-97,-42,-127,6,-106,52,-491
-78,-98,-96,-44,-135,3,-95,63,-480
-84,-105,-93,-33,-126,-12,-120,44,-529
-76,-88,-75,-48,-139,-19,-119,36,-528
-79,-84,-69,-59,-133,-21,-109,49,-505
-55,-101,-97,-38,-136,8,-95,73,-441
-59,-119,-113,-55,-163,-4,-136,74,-575
-61,-96,-101,-28,-143,4,-116,69,-472
-67,-106,-83,-40,-148,-12,-122,55,-523
-53,-89,-95,-16,-130,1,-98,49,-431
-74,-78,-94,-38,-117,-17,-113,39,-492
-65,-89,-80,-28,-105,-12,-111,35,-455
-74,-86,-109,-68,-138,-29,-112,35,-581
-59,-86,-79,-41,-114,-10,-78,62,-405
-93,-105,-96,-42,-131,-21,-120,42,-566
-73,-94,-92,-56,-136,5,-105,47,-504
-63,-90,-106,-43,-137,-30,-122,43,-548
-72,-81,-97,-26,-157,-32,-130,25,-570
-62,-77,-100,-34,-155,-45,-104,57,-520
-77,-98,-116,-44,-142,-56,-122,14,-641
-69,-91,-77,-10,-125,-22,-112,38,-468
-40,-97,-108,-35,-132,-43,-125,35,-545
-70,-82,-100,-17,-129,-6,-110,39,-475
-66,-89,-99,-53,-149,0,-111,48,-519
-81,-99,-95,-45,-126,-13,-121,32,-548
-71,-101,-100,-22,-130,4,-95,57,-458
-57,-96,-99,-37,-139,-23,-108,58,-501
-62,-106,-102,-13,-147,-20,-99,65,-484
-59,-102,-102,-32,-138,-11,-107,57,-494
-77,-90,-84,-19,-133,2,-107,45,-463
-96,-94,-113,-61,-132,-2,-115,37,-576
-54,-65,-100,-40,-126,21,-108,70,-402
-61,-91,-114,-38,-122,-5,-110,32,-509
-58,-90,-99,-16,-119,14,-106,67,-407
-72,-87,-92,-53,-116,-12,-91,52,-471
-80,-103,-94,-57,-131,-32,-121,26,-592
-58,-79,-110,-73,-136,-62,-145,35,-628
-74,-77,-113,-71,-141,-56,-144,41,-635
-86,-100,-88,-61,-134,-37,-115,29,-592
-89,-92,-85,-56,-141,-8,-85,48,-508
-66,-91,-74,-15,-131,-16,-85,33,-445
-71,-77,-78,-41,-129,-21,-130,11,-536
-68,-94,-83,-19,-127,-18,-76,29,-456
-70,-91,-92,-39,-132,-32,-139,13,-582
-76,-88,-89,-54,-122,-20,-102,33,-518
-71,-98,-93,-76,-140,-28,-108,28,-586
-67,-82,-89,-32,-128,-4,-130,48,-484
-85,-66,-76,4,-135,2,-124,47,-433
-36,-94,-90,0,-129,-4,-101,59,-395
-54,-93,-96,-12,-131,-29,-108,53,-470
-55,-95,-78,-48,-123,-24,-103,41,-485
-67,-94,-92,-23,-135,-12,-79,62,-440
-87,-100,-112,-46,-156,-15,-111,58,-569
-87,-88,-100,-46,-140,-19,-104,30,-554
-74,-94,-101,-61,-151,-55,-132,22,-646
-70,-106,-98,-45,-150,-19,-112,48,-552
-61,-105,-102,-45,-151,-21,-117,49,-553
-59,-87,-99,-62,-120,-60,-142,15,-614
-83,-108,-121,-71,-147,-38,-125,42,-651
-72,-82,-102,-53,-152,-44,-106,45,-566
-105,-106,-114,-81,-150,-40,-138,16,-718
-93,-71,-84,-44,-148,-4,-87,35,-496
-61,-105,-97,-28,-152,-56,-129,8,-620
-58,-108,-102,-38,-152,-49,-126,29,-604
-70,-87,-100,-55,-145,-46,-122,41,-584
-50,-88,-81,-4,-131,-52,-105,45,-466
-64,-123,-124,-68,-154,-4,-98,70,-565
-73,-104,-100,-56,-143,-23,-118,37,-580
-53,-106,-115,-54,-138,-6,-89,69,-492
-59,-101,-99,-52,-134,-25,-105,43,-532
-66,-97,-98,-38,-121,-18,-99,47,-490
-68,-84,-108,-45,-140,15,-112,54,-488
-75,-95,-105,-42,-119,-25,-126,16,-571
-95,-97,-80,-26,-119,17,-119,28,-491
-73,-96,-104,-51,-135,-23,-101,32,-551
-75,-87,-97,-40,-126,-5,-110,49,-491
-70,-99,-98,-63,-144,0,-123,33,-564
-80,-79,-101,-45,-143,-1,-126,66,-509
-63,-94,-87,-57,-128,-25,-107,46,-515
-79,-102,-106,-80,-153,-51,-142,21,-692
-79,-108,-111,-35,-130,-51,-121,29,-606
-52,-101,-109,-39,-142,-36,-107,66,-520
-54,-102,-116,-47,-141,-39,-104,59,-544
-56,-104,-115,-54,-136,-44,-118,47,-580
-59,-84,-98,-36,-125,-30,-104,59,-477
-70,-84,-70,-25,-112,-4,-107,28,-444
-75,-78,-100,-46,-124,-5,-96,65,-459
-61,-103,-93,-30,-121,1,-108,38,-477
-70,-100,-106,-29,-126,-14,-94,58,-481
-58,-97,-89,-29,-115,13,-86,62,-399
-90,-98,-82,-36,-124,4,-99,42,-483
-70,-101,-82,-15,-120,-6,-112,24,-482
-75,-103,-88,-22,-125,-23,-117,36,-517
-66,-98,-81,1,-132,-2,-99,46,-431
-59,-99,-79,-10,-134,-27,-111,34,-485
-50,-106,-96,-30,-122,-32,-88,30,-494
-77,-85,-98,-36,-124,6,-110,51,-473
-78,-97,-106,-59,-145,-45,-122,21,-631
-50,-87,-95,-26,-132,-36,-122,19,-529
-60,-89,-99,-33,-132,-23,-102,49,-489
-56,-100,-95,-9,-128,-27,-122,46,-491
-74,-109,-106,-42,-152,-22,-102,51,-556
-29,-78,-106,-25,-149,-75,-122,24,-560
-55,-86,-87,-20,-128,-60,-118,19,-535
-82,-96,-105,-35,-141,-6,-89,52,-502
-51,-89,-89,-37,-127,-52,-108,26,-527
-74,-105,-115,-52,-134,-20,-93,41,-552
-70,-90,-98,-23,-116,-42,-117,21,-535
-63,-88,-96,-18,-134,-24,-89,44,-468
-64,-75,-86,-40,-139,-23,-117,31,-513
-64,-84,-97,-39,-140,-28,-103,50,-505
-50,-70,-84,-17,-134,-44,-113,22,-490
-79,-98,-82,-42,-129,-26,-114,40,-530
-70,-87,-87,-18,-116,9,-103,59,-413
-69,-93,-96,-23,-138,-7,-116,56,-486
-46,-83,-96,-29,-135,-16,-93,60,-438
-68,-85,-93,-60,-125,-7,-109,45,-502
-67,-83,-89,-48,-121,-3,-114,50,-475
-71,-86,-92,-49,-114,-5,-104,47,-474
-86,-84,-96,-55,-130,-20,-127,18,-580
-70,-91,-119,-73,-129,-51,-125,16,-642
-76,-88,-100,-54,-124,-9,-110,39,-522
-88,-98,-100,-59,-133,-36,-125,31,-608
-69,-80,-100,-55,-127,-37,-109,35,-542
-59,-93,-91,-37,-118,-17,-98,36,-477
-63,-102,-101,-44,-134,-15,-97,59,-497
-27,-70,-92,-55,-117,-82,-123,16,-550
-14,-78,-115,-82,-123,-153,-196,39,-722
-70,-74,-93,-49,-131,-37,-98,30,-522
-103,-92,-107,-49,-145,-6,-134,33,-603
-86,-82,-95,-34,-127,-12,-121,35,-522
-79,-93,-79,-20,-127,-7,-99,42,-462
-71,-113,-121,-58,-149,-28,-116,45,-611
-73,-100,-105,-38,-129,-17,-117,38,-541
-94,-103,-115,-49,-136,-20,-119,42,-594
-68,-84,-67,-14,-115,-42,-91,19,-462
-64,-85,-93,-45,-127,-19,-113,32,-514
-72,-103,-103,-68,-129,-20,-106,29,-572
-72,-93,-99,-46,-145,-13,-102,51,-519
-76,-101,-113,-47,-135,-13,-121,41,-565
-64,-111,-89,-30,-138,-36,-112,17,-563
-69,-103,-89,-45,-131,-39,-127,14,-589
-79,-75,-97,-63,-140,-40,-107,25,-576
-78,-88,-103,-17,-136,-44,-126,34,-558
-79,-113,-113,-49,-141,-10,-105,41,-569
-84,-87,-69,-34,-125,10,-98,31,-456
-74,-93,-97,-51,-124,-36,-125,15,-585
-72,-104,-100,-37,-132,-32,-135,19,-593
-66,-90,-98,-40,-124,6,-87,61,-438
-76,-100,-75,-26,-132,-8,-95,42,-470
-60,-87,-94,-17,-127,-14,-92,46,-445
-68,-94,-105,-38,-133,-48,-119,48,-557
-66,-94,-88,-40,-120,7,-98,35,-464
-53,-86,-93,-59,-125,-28,-112,37,-519
-58,-89,-102,-64,-129,-36,-112,34,-556
-55,-94,-107,-51,-150,-42,-120,30,-589
-63,-91,-90,-27,-126,-8,-97,43,-459
-59,-81,-86,-14,-118,-24,-101,45,-438
-55,-90,-95,-30,-125,-17,-98,37,-473
-50,-98,-92,-32,-120,-33,-102,37,-490
-59,-86,-67,-7,-111,-41,-91,22,-440
-53,-89,-89,-19,-132,-34,-96,24,-488
-79,-93,-95,-48,-137,-43,-126,29,-592
-51,-86,-98,-35,-131,-44,-102,55,-492
-66,-99,-101,-33,-120,-14,-109,48,-494
-57,-75,-111,-71,-133,-91,-143,-2,-683
-61,-67,-108,-41,-134,-45,-140,25,-571
-73,-93,-73,-11,-114,-18,-94,39,-437
-73,-102,-72,-13,-118,2,-103,40,-439
-67,-96,-107,-39,-148,-21,-116,52,-542
-91,-73,-74,-59,-120,8,-104,18,-495
-68,-83,-81,-47,-144,-18,-107,43,-505
-65,-94,-89,-30,-117,-20,-110,20,-505
-30,-98,-125,-54,-135,-44,-124,55,-555
-49,-123,-115,-64,-158,-19,-126,87,-567
-63,-94,-87,-40,-137,-23,-116,52,-508
-86,-90,-100,-52,-140,5,-117,40,-540
-51,-95,-85,-4,-130,3,-92,60,-394
-53,-95,-94,-41,-135,-20,-90,57,-471
-67,-93,-86,-32,-127,-10,-108,42,-481
-87,-95,-98,-49,-142,-7,-118,33,-563
-70,-91,-84,-30,-133,-8,-92,39,-469
-79,-94,-90,-69,-133,-62,-109,8,-628
-69,-92,-101,-47,-151,5,-86,45,-496
-75,-103,-103,-57,-146,-16,-121,33,-588
-49,-92,-115,-48,-145,-57,-108,48,-566
-86,-92,-97,-61,-145,-35,-121,28,-609
-68,-92,-96,-45,-157,-24,-108,54,-536
-91,-98,-104,-48,-148,-11,-111,45,-566
-56,-91,-101,-64,-131,-39,-101,40,-543
-89,-88,-89,-58,-137,-37,-122,7,-613
-67,-94,-86,-18,-153,-54,-119,52,-539
-65,-88,-87,-13,-112,-19,-105,26,-463
-94,-91,-97,-64,-141,-15,-119,36,-585
-71,-87,-84,-38,-121,-27,-98,45,-481
-61,-87,-87,-39,-115,17,-96,44,-424
-55,-72,-86,-18,-113,-19,-112,47,-428
-68,-80,-90,-43,-139,-43,-120,7,-576
-84,-88,-105,-69,-127,-7,-111,19,-572
-93,-97,-96,-63,-125,-19,-119,19,-593
-79,-87,-100,-54,-134,-49,-127,21,-609
-63,-72,-92,-43,-137,3,-92,76,-420
-67,-97,-90,-11,-131,-13,-99,42,-466
-48,-84,-96,-4,-123,7,-108,67,-389
-61,-79,-71,10,-108,17,-68,61,-299
-60,-81,-89,6,-117,17,-81,67,-338
-89,-86,-92,-44,-130,10,-105,49,-487
-75,-98,-97,-45,-142,-4,-96,39,-518
-93,-95,-96,-42,-150,-1,-99,42,-534
-28,-50,-48,-9,-58,-15,-46,28,-226
-83,-93,-84,-46,-140,-27,-109,54,-528
-51,-68,-81,-22,-107,-47,-111,24,-463
-50,-79,-83,-16,-120,-53,-100,32,-469
-55,-71,-74,-8,-126,-64,-107,45,-460
-74,-99,-81,-26,-130,-5,-110,40,-485
-69,-94,-89,-28,-135,-1,-104,40,-480
-62,-81,-101,-57,-145,13,-87,66,-454
-69,-92,-86,-44,-137,-7,-108,51,-492
-79,-97,-84,-32,-138,-4,-93,78,-449
-46,-100,-91,-43,-134,-5,-99,79,-439
-57,-95,-78,-13,-115,-23,-95,26,-450
-19,-26,-26,-6,-32,-3,-34,6,-140
-19,-9,-21,-14,-7,-13,-23,-11,-117
46,3,-17,63,-40,-39,-56,47,7
28,-121,-128,-31,-142,-75,-207,86,-590
-65,-77,-94,9,-136,-59,-137,17,-542
7,-76,-66,-16,-59,-60,-102,76,-296
8,-64,-79,0,-68,-11,-79,113,-180
31,-78,-86,36,-82,-78,-143,108,-292
8,-23,-16,19,-53,4,-43,57,-47
-113,-199,-256,-182,-203,-111,-258,104,-1218
-2,-66,-59,13,-78,-72,-95,-7,-366
-39,-106,-87,-24,-112,-28,-100,34,-462
-37,-83,-96,-65,-105,-62,-134,6,-576
40,-116,-79,29,-110,-65,-127,64,-364
-108,-54,-86,-75,-111,-66,-151,-56,-707
-79,-18,-50,-69,-75,-14,-102,-34,-441
-84,-78,-100,-91,-111,-56,-127,11,-636
-17,-56,-39,4,-48,-10,-50,11,-205
2,-24,-26,-4,-31,-13,-27,6,-117
26,-25,8,61,-18,13,-48,34,51
-17,-17,-46,-5,-43,-20,-50,26,-172
-27,-49,-74,-17,-94,-13,-95,46,-323
-59,-82,-106,-28,-163,-23,-149,59,-551
-76,-106,-112,-40,-181,-89,-196,-38,-838
10,-43,-45,15,-18,-1,-50,65,-67
-4,-24,-10,-7,-23,-23,-32,-1,-124
-94,-284,-238,-36,-339,-78,-288,115,-1242
-68,-101,-88,-26,-104,-3,-110,43,-457
-2,-208,-205,-68,-230,-91,-171,97,-878
-35,-42,-63,-42,-77,-16,-100,0,-375
52,-46,-112,50,-131,32,-78,141,-92
-37,-44,-40,-17,-49,-9,-70,18,-248
20,-12,2,6,-21,-30,-24,35,-24
53,23,-6,43,-28,-66,-78,43,-16
0,-34,-27,-3,-26,-18,-28,27,-109
9,-40,-58,7,-74,-8,-44,37,-171
9,-19,-12,11,2,-19,-13,8,-33
4,-31,-45,-9,-25,-36,-63,44,-161
-109,-179,-183,-64,-272,-131,-286,103,-1121
-32,-84,-103,-56,-134,-50,-105,88,-476
24,-123,-125,73,-179,-66,-138,144,-390
3,-109,-128,-75,-81,-111,-207,152,-556
-18,-49,-63,-40,-107,-58,-86,40,-381
-70,-189,-196,-29,-110,-65,-132,38,-753
-21,-31,-37,-32,-48,-42,-61,10,-262
-6,3,2,-1,-4,4,-17,8,-11
2,-79,-140,18,-133,5,-165,96,-396
-10,-106,-148,-28,-98,28,-132,79,-415
8,-10,-14,19,-26,-18,-29,3,-67
-176,-209,-379,-160,-246,-146,-363,-63,-1742
9,-40,-61,-38,-63,-64,-73,62,-268
-12,-40,-51,-47,-80,-37,-65,28,-304
-11,-53,-57,-1,-38,-5,-46,24,-187
73,-9,-208,-2,-337,-44,-281,295,-513
-31,-138,-155,-11,-253,-73,-211,111,-761
23,-16,-24,16,-67,-35,-53,46,-110
5,-47,-61,-21,-84,-88,-98,2,-392
-59,-110,-145,-56,-100,-62,-99,18,-613
46,-85,-85,37,-149,-94,-163,4,-489
-74,-112,-168,-61,-151,-64,-147,22,-755
61,-44,-44,31,-69,-102,-121,18,-270
-35,-13,-49,-28,-16,-35,-35,-2,-213
-65,-95,-114,-14,-60,-22,-73,26,-417
-24,-32,-46,-9,-24,0,-38,22,-151
-4,-42,-39,-12,-78,-2,-58,32,-203
-14,-33,-35,-53,-57,-43,-70,5,-300
-57,-107,-112,-43,-160,-73,-166,26,-692
61,-147,-197,-14,-258,19,-180,249,-467
8,-1,-29,0,-25,-46,-55,15,-133
-25,-8,-13,-11,-17,-10,-34,-7,-125
1,-22,-27,8,-40,9,-23,20,-74
3,-28,-34,-22,-52,-52,-59,-1,-245
-4,-59,-22,44,-50,-2,-45,61,-77
4,-31,-41,-25,-30,-37,-70,18,-212
-92,-107,-168,-43,-274,-93,-222,98,-901
11,0,-9,12,0,-3,2,11,24
-19,-20,-40,-31,-56,-40,-68,73,-201
1,4,-19,9,-31,-37,-47,21,-99
-73,-82,-96,-40,-179,-43,-157,56,-614
-5,-32,-33,-28,-13,-68,-70,-10,-259
0,-85,-111,-10,-153,-42,-88,55,-434
-24,4,-32,-21,-27,-11,-22,26,-107
-121,-131,-134,-28,-70,-32,-123,-40,-679
-25,-47,-43,16,-70,-16,-77,28,-234
28,-31,-44,20,-49,-25,-31,51,-81
-10,-41,-40,-9,-30,-24,-42,40,-156
-85,-134,-138,-55,-219,-94,-188,-13,-926
-23,-26,-40,-39,-26,-33,-48,20,-215
-11,-35,-49,-14,-59,4,-39,32,-171
32,-53,-65,-31,-87,-18,-59,46,-235
20,-22,-43,0,-47,-66,-98,29,-227
-23,-38,-94,-47,-56,-64,-55,42,-335
-31,-19,-34,-8,-44,-22,-73,4,-227
-67,-103,-163,-53,-184,-67,-161,73,-725
-8,-97,-56,44,-110,-64,-116,20,-387
-12,-18,-29,-1,-20,-7,-47,-1,-135
-16,-27,-24,6,-24,-28,-36,-11,-160
-69,-123,-125,-69,-177,-91,-144,41,-757
-13,-32,-34,-54,-22,-64,-104,32,-291
30,-1,1,42,0,0,-4,72,140
101,-148,-173,-18,-56,-154,-196,118,-526
-164,-141,-159,-40,-54,-59,-128,-75,-820
-39,-47,-57,-8,-67,-19,-90,13,-314
0,-72,-70,2,-113,-71,-114,46,-392
7,-32,-39,-10,-22,-59,-84,-1,-240
-43,-88,-131,-16,-106,-9,-91,86,-398
-11,-85,-91,-15,-126,-31,-98,56,-401
-2,-26,-13,-15,-22,-13,-27,27,-91
42,-37,-34,50,-45,-70,-85,45,-134
-61,-84,-142,0,-63,-34,-86,58,-412
-37,-47,-73,-5,-20,-39,-52,-12,-285
-15,-67,-91,-98,-119,-127,-156,14,-659
-13,-49,-55,-25,-104,-15,-80,29,-312
7,-19,-38,0,-37,-11,-26,32,-92
-39,-110,-132,-19,-105,-64,-122,43,-548
-11,-80,-57,-32,-28,-39,-35,10,-272
57,-128,-95,-25,12,6,-77,109,-141
-36,-45,-81,-54,-88,-49,-91,21,-423
27,-24,-36,2,-26,-42,-82,53,-128
-34,-39,-73,-31,-51,-47,-76,21,-330
-15,-29,-47,-45,-71,-41,-90,-7,-345
40,-42,-23,40,6,-34,-39,36,-16
28,-100,-94,18,-154,-126,-194,57,-565
9,-173,-187,-87,-164,-158,-282,138,-904
-12,-4,-20,0,-12,-2,-17,18,-49
-43,-56,-63,-55,-88,-44,-109,-4,-462
9,-10,-38,-9,-78,-31,-60,53,-164
-5,-60,-40,0,-83,-28,-55,55,-216
-9,-55,-71,-32,-98,-18,-77,33,-327
35,-103,-102,4,-186,-88,-144,82,-502
-37,-100,-124,-26,-127,-72,-134,59,-561
5,-74,-72,-73,-35,-85,-97,20,-411
-95,-126,-135,1,-44,11,-73,-26,-487
160,-32,-92,166,-161,-139,-208,151,-155
-36,-105,-116,-14,-103,-25,-90,83,-406
9,-43,-57,15,-89,-21,-46,56,-176
15,-85,-67,56,-118,-23,-99,106,-215
-19,-35,-97,-6,-136,-64,-193,4,-546
-23,-42,-46,-23,-49,-20,-48,12,-239
-35,-71,-116,-59,-157,-45,-160,91,-552
34,-42,-34,45,-33,-29,-70,94,-35
-67,-127,-151,0,-202,-18,-205,125,-645
25,-71,-130,-20,-136,-75,-148,115,-440
-37,-68,-52,-20,-99,-21,-96,41,-352
48,-40,-66,17,-46,-118,-127,6,-326
33,-95,-105,-49,-4,-145,-248,106,-507
-47,-75,-43,-16,-65,-31,-76,-2,-355
-10,-39,-40,0,-49,-37,-69,-3,-247
-55,-87,-78,-25,-113,-5,-98,74,-387
-17,-47,-44,-22,-63,-27,-58,2,-276
-6,-19,-48,-11,-59,-41,-53,10,-227
-19,-18,-58,-9,-24,1,-51,31,-147
0,-52,-54,-19,-96,-29,-66,25,-291
-58,-22,-42,-45,-79,-51,-101,-54,-452
-2,-83,-68,2,-116,-39,-75,11,-370
2,-42,-65,53,-71,-2,-60,66,-119
7,-85,-93,-52,-99,-62,-91,89,-386
-36,-77,-90,-21,-99,11,-88,43,-357
-6,-75,-69,30,-47,-28,-94,28,-261
-21,-61,-67,-38,-97,-69,-144,17,-480
21,18,-73,23,-41,10,-52,60,-34
-27,-30,-32,-6,-38,-9,-45,17,-170
18,-25,-24,43,-26,-12,-57,14,-69
-27,-61,-90,-53,-77,-70,-99,5,-472
-38,-75,-133,-57,-160,-113,-172,79,-669
16,1,-9,-9,-24,-39,-58,35,-87
-33,-87,-80,-32,-96,-10,-76,19,-395
-25,-21,-24,-13,-34,-5,-38,7,-153
-8,-31,-32,-1,-46,-20,-37,15,-160
-2,-20,-27,-16,-15,-14,-16,6,-104
-58,-64,-59,-36,-106,-36,-86,21,-424
-19,-83,-65,3,-100,-38,-93,62,-333
2,-96,-89,18,-80,-13,-100,61,-297
-203,-55,-146,-161,-103,-234,-316,-216,-1434
-68,-130,-199,-25,-236,-22,-204,95,-789
-105,-51,-143,-80,-122,-33,-191,-46,-771
-71,-131,-157,-134,-182,-125,-195,-7,-1002
27,-94,-111,0,-110,2,-53,115,-224
-106,-87,-137,-34,-33,5,-80,-18,-490
-23,-31,-59,-22,-62,-27,-63,-14,-301
-81,-116,-123,-28,-80,8,-85,1,-504
-37,-65,-45,-40,-77,-40,-56,15,-345
18,-101,-129,-22,-76,-43,-104,72,-385
-74,-103,-128,-17,-156,-75,-146,42,-657
-50,-54,-64,-25,-83,-36,-92,4,-400
-5,-14,-20,2,-32,-2,-26,10,-87
-76,-88,-120,-47,-108,-52,-178,-48,-717
-91,-134,-133,-57,-92,-39,-99,-14,-659
-7,-62,-79,-23,-114,-43,-119,63,-384
-30,-75,-120,53,-151,-6,-147,117,-359
-31,-36,-51,-28,-20,-13,-51,-15,-245
-8,-50,-45,-11,-91,-42,-58,36,-269
-31,-74,-81,-48,-53,-69,-143,63,-436
-5,-88,-85,-1,-131,-19,-46,39,-336
28,-70,-120,42,-95,-22,-103,88,-252
-33,-96,-103,-36,-132,-80,-141,55,-566
-51,-168,-179,-102,-214,-89,-172,71,-904
-25,-71,-100,-19,-126,-72,-140,73,-480
20,-65,-66,4,-75,-24,-101,69,-238
-1,-57,-78,-37,-86,-37,-36,41,-291
10,-9,-22,-4,19,-17,-110,62,-71
-52,-60,-79,-25,-119,-85,-160,-9,-589
9,-73,-70,-33,-100,-60,-94,53,-368
5,-54,-55,3,-41,5,-59,37,-159
-12,-30,-31,-7,-43,-13,-57,7,-186
-52,-48,-72,-19,-138,-20,-123,24,-448
-59,-86,-106,-47,-149,-48,-102,31,-566
-26,-56,-54,-11,-64,-56,-50,13,-304
-21,-39,-41,-33,-26,-17,-27,-3,-207
-70,-99,-118,-41,-144,-40,-174,49,-637
-7,-18,-13,-8,-12,0,-12,6,-64
-10,-26,-31,-36,-71,-40,-49,12,-251
-14,-43,-44,5,-69,9,-30,59,-127
-22,-87,-90,-31,-99,-47,-88,-3,-467
-12,-45,-28,-12,-44,4,-29,29,-137
-33,-43,-59,-17,-62,-30,-69,-22,-335
-159,-129,-177,-163,-235,-133,-298,-69,-1363
-31,-68,-61,2,-101,-16,-88,56,-307
-32,-150,-153,-19,-238,-181,-245,54,-964
-15,-13,-37,-30,-38,-29,-30,8,-184
9,-59,-21,12,-3,-12,-24,25,-73
-64,-58,-80,-11,-108,-42,-106,-31,-500
-58,-214,-153,59,-236,-55,-192,84,-765
-15,-74,-168,35,-170,-37,-168,105,-492
-101,-93,-128,-56,-164,-45,-180,-2,-769
-30,-52,-81,-40,-74,-10,-57,40,-304
0,-105,-140,-42,-234,-35,-131,103,-584
-33,-88,-103,-44,-156,-66,-116,75,-531
0,-45,-40,2,-81,-43,-63,30,-240
-18,-77,-86,3,-133,-35,-123,87,-382
4,-115,-134,-45,-168,-116,-168,114,-628
-58,-120,-125,-41,-162,-19,-141,71,-595
-45,-61,-89,11,-108,-14,-113,16,-403
-95,-121,-148,-61,-197,-30,-171,64,-759
355,-444,-773,-42,-650,-81,-556,702,-1489
-97,-159,-215,-74,-271,-70,-257,119,-1024
-99,-177,-266,-82,-390,-252,-397,45,-1618
-9,-36,-48,-17,-32,-68,-64,12,-262
-1,-50,-67,19,-92,8,-80,90,-173
-42,-124,-106,-44,-150,-11,-97,57,-517
-30,-47,-63,-15,-71,-36,-75,5,-332
-19,-91,-131,-51,-154,-166,-212,4,-820
-21,-16,-25,-16,-21,-7,-19,-2,-127
-6,-23,-49,-11,-24,-33,-55,11,-190
-79,-125,-138,-69,-249,-154,-268,32,-1050
64,-7,-5,48,-11,-12,-27,61,111
-5,-20,-18,-3,-16,-3,-20,12,-73
-19,-17,-25,-7,-27,-23,-42,2,-158
-40,-36,-59,-35,-59,-32,-74,-5,-340
-1,-65,-86,-53,-144,-121,-127,33,-564
-55,-37,-74,-52,-45,-47,-105,-63,-478
-81,-79,-103,-81,-134,-156,-282,-71,-987
-6,-81,-108,-22,-59,-72,-150,44,-454
0,-79,-101,3,-155,-36,-187,87,-468
-80,-76,-166,-35,-188,-13,-193,102,-649
7,-67,-68,-21,-94,-46,-95,46,-338
-108,-135,-163,-44,-23,-2,-94,-52,-621
-27,-231,-362,-64,-377,-214,-515,165,-1625
-4,-87,-56,-1,-96,-42,-117,46,-357
-52,-29,-118,-165,-195,-219,-299,-53,-1130
-6,-3,-13,-1,-15,-18,-23,-3,-82
-9,-19,-26,-27,-21,-46,-65,-4,-217
-83,-174,-186,-85,-338,-214,-361,96,-1345
-28,-82,-73,-36,-66,17,-58,23,-303
-21,-46,-46,-37,-75,18,-43,34,-216
36,-45,-70,-48,-27,-79,-108,65,-276
-336,-743,-582,-166,-999,-360,-1055,48,-4193
56,-300,-306,6,-419,-11,-324,428,-870
0,-17,-15,30,-20,-20,-23,-15,-80
-46,-83,-71,-7,-138,-56,-136,3,-534
-16,-93,-119,-50,-156,-96,-198,29,-699
59,-63,-44,27,-32,-79,-66,78,-120
53,-26,-30,23,-24,5,-40,45,6
-26,-103,-143,-27,-135,-33,-140,65,-542
-74,-61,-101,-13,-149,8,-146,62,-474
20,-30,-15,30,-9,-25,-50,35,-44
-15,-85,-98,-61,-131,-97,-216,95,-608
-48,-78,-142,-102,-188,-171,-209,90,-848
67,-39,-3,64,0,-39,-70,88,68
-104,-120,-106,-5,-175,-25,-164,49,-650
-9,-30,-37,-18,-18,-17,-33,13,-149
-28,-97,-79,8,-100,18,-82,88,-272
-59,-96,-123,-63,-135,-129,-192,46,-751
-14,-60,-75,-31,-111,-41,-89,27,-394
-99,-141,-236,-74,-253,-78,-280,25,-1136
-25,-12,-26,-21,-31,-41,-44,-28,-228
-80,-180,-282,-35,-252,-226,-380,132,-1303
-74,-122,-164,-4,-164,-56,-244,104,-724
-106,-116,-116,13,-137,-26,-209,43,-654
8,-542,-531,16,-746,-279,-639,378,-2335
-26,-67,-117,-51,-147,-54,-143,11,-594
-1,-12,-25,-26,-49,-42,-63,9,-209
-15,-2,-16,-6,-13,-1,-27,24,-56
-13,-201,-283,-120,-390,-292,-478,137,-1640
-85,-97,-128,-87,-176,-87,-194,41,-813
-71,-81,-88,-15,-133,-59,-154,68,-533
25,-37,-67,7,-86,-87,-188,105,-328
-51,-72,-56,-32,-62,-17,-62,15,-337
-57,-78,-68,-16,-92,-6,-81,50,-348
6,-13,-30,-16,-41,-12,-37,18,-125
-14,-36,-44,-4,-59,1,-74,27,-203
-29,-40,-69,-17,-60,-15,-65,18,-277
-4,-47,-25,24,-69,-18,-59,22,-176
-41,-11,-130,-75,-98,-34,-147,-26,-562
32,-46,-82,-16,-96,-95,-143,40,-406
-3,-15,-32,-19,-22,-35,-62,-4,-192
-66,-95,-95,-45,-134,-28,-116,36,-543
-24,-93,-129,-38,-138,-59,-176,72,-585
-71,-80,-123,-46,-124,-52,-108,40,-564
9,-104,-118,-16,-93,-144,-160,19,-607
-58,-62,-62,-35,-88,-3,-74,30,-352
-27,-56,-93,-21,-100,-104,-151,5,-547
-18,-108,-122,-60,-138,-84,-133,62,-601
-11,-91,-103,-15,-118,-58,-113,59,-450
-70,-84,-106,-50,-137,-54,-158,6,-653
-56,-81,-106,-26,-123,-51,-127,49,-521
-96,-183,-172,-87,-209,-63,-209,35,-984
-30,-98,-121,-18,-144,-81,-184,-18,-694
20,-35,-126,-6,-101,9,-133,125,-247
276,-524,-608,225,-1190,105,-574,1077,-1213
-14,-46,-24,-3,-51,-35,-58,-10,-241
-66,-55,-97,-9,-99,-43,-110,-2,-481
-11,-72,-30,11,-56,-37,-56,18,-233
-4,-505,-578,-36,-672,-265,-725,476,-2309
-210,-198,-267,-273,-305,-161,-458,-38,-1910
1,-59,-80,-32,-103,-60,-94,14,-413
16,-80,-164,-28,-158,-155,-248,47,-770
141,-172,-212,-36,-230,-213,-279,232,-769
14,-141,-184,-49,-167,-186,-278,25,-966
-5,-30,-47,-33,-64,-66,-81,27,-299
15,-10,-23,42,-53,-67,-108,66,-138
7,-43,-66,3,-53,-73,-77,23,-279
-88,-203,-191,-34,-245,-34,-225,138,-882
82,-100,-150,32,-150,-167,-228,65,-616
-34,-121,-152,-20,-204,-27,-177,100,-635
-10,-134,-169,-32,-194,-135,-231,129,-776
8,-198,-197,33,-158,-100,-247,160,-699
25,-128,-149,26,-137,-119,-202,144,-540
-40,-150,-172,-22,-174,-122,-252,134,-798
-8,-180,-186,62,-100,-51,-224,187,-500
-42,-79,-96,-73,-73,-88,-190,28,-613
24,-105,-115,-63,-142,-140,-191,66,-666
-12,-8,-26,-29,-47,-32,-44,0,-198
-426,-712,-660,-228,-1163,-370,-1162,11,-4710
-33,-117,-150,-36,-126,-29,-161,78,-574
11,-49,-90,-26,-149,-111,-161,90,-485
-2,-220,-289,-77,-373,-301,-472,17,-1717
4,-98,-99,0,-76,-43,-115,77,-350
-4,-114,-130,-74,-201,-159,-250,35,-897
-62,-112,-103,-48,-97,-65,-113,24,-576
-11,-56,-77,-46,-93,-67,-99,38,-411
-98,-160,-160,-56,-251,-98,-240,34,-1029
-13,-21,-42,-24,-33,-15,-31,8,-171
9,-50,-48,32,-153,-58,-104,79,-293
11,-47,-67,-1,-114,-10,-51,95,-184
-31,-49,-34,29,-64,-31,-83,27,-236
-22,-78,-110,-36,-114,-14,-128,167,-335
-23,-103,-95,-35,-142,-25,-87,40,-470
-21,-51,-58,-39,-50,-15,-56,18,-272
-46,-86,-99,5,-150,-5,-152,83,-450
-11,-95,-138,-63,-135,-115,-212,49,-720
27,-31,-36,1,-2,-41,-51,45,-88
-27,-37,-40,-25,-29,-29,-51,-4,-242
12,-211,-145,-64,-135,-144,-216,115,-788
73,-102,-131,18,-130,-110,-182,143,-421
99,-163,-246,13,-207,-245,-407,182,-974
-86,-110,-157,-72,-236,-113,-231,-9,-1014
68,-356,-372,-119,-568,-121,-367,444,-1391
41,-234,-442,20,-498,-71,-441,416,-1209
5,-69,-130,-2,-175,-93,-195,107,-552
-80,-251,-318,-86,-354,-164,-354,74,-1533
-47,-201,-277,-98,-310,-237,-387,75,-1482
83,-134,-128,83,-206,-54,-210,223,-343
-21,-88,-258,-173,-297,-340,-483,57,-1603
29,-87,-136,-55,-131,-234,-321,10,-925
-22,-186,-132,9,-188,-19,-131,118,-551
-25,-140,-282,-29,-378,-86,-324,224,-1040
29,-109,-92,5,-79,-49,-95,57,-333
5,-7,-35,-18,-34,-22,-49,23,-137
-3,-160,-182,-3,-220,-115,-203,98,-788
35,-33,-135,53,-182,-132,-222,231,-385
-18,-60,-70,-20,-64,-30,-64,26,-300
38,-69,-114,-34,-107,-119,-207,110,-502
-97,-139,-238,-155,-297,-272,-407,-55,-1660
-10,-31,-70,-41,-77,-72,-93,28,-366
-49,-122,-145,-8,-180,-55,-175,90,-644
-44,-120,-101,2,-113,-82,-138,28,-568
12,34,-96,3,-48,-60,-172,146,-181
-12,-137,-164,-27,-287,-143,-230,71,-929
3,-19,-19,2,-23,-4,-14,4,-70
-15,-13,-11,-6,-23,-4,-18,5,-85
-74,-210,-300,-62,-344,-253,-497,-31,-1771
-168,-192,-279,-26,-48,8,-110,-65,-880
89,-41,-132,-35,-214,-270,-375,-82,-1060
-23,-57,-112,0,-122,-21,-137,47,-425
-36,-105,-149,-117,-169,-190,-260,20,-1006
-103,-121,-169,-30,-37,-1,-102,-16,-579
-87,-99,-163,-41,-103,-59,-153,10,-695
-4,-107,-200,13,-242,-65,-239,171,-673
-3,-97,-113,-4,-132,-37,-130,86,-430
52,-21,-55,31,-62,-73,-115,67,-176
-107,-89,-170,-33,-64,-34,-104,34,-567
-72,-155,-202,-75,-325,-110,-220,48,-1111
-24,-112,-142,-8,-60,-33,-64,28,-415
6,-98,-111,-53,-83,-133,-168,79,-561
-8,-74,-154,-43,-206,-198,-302,45,-940
-122,-212,-204,-32,-349,-34,-278,124,-1107
6,-35,-71,-29,-28,-29,-72,51,-207
14,-49,-65,-13,-80,-37,-82,27,-285
-27,-16,-58,-25,-81,-23,-77,13,-294
-35,-76,-68,-5,-106,-20,-161,57,-414
45,-91,-121,40,-53,-66,-62,94,-214
-58,-78,-125,-15,-154,-42,-148,110,-510
172,-167,-273,-10,-174,-213,-503,316,-852
102,-80,-35,-21,19,-91,-133,121,-118
-20,-92,-144,-57,-151,-73,-212,129,-620
-2,-53,-48,-34,-52,-77,-67,26,-307
6,9,4,7,5,-10,-16,10,15
-21,-13,-11,-11,-15,-7,-23,3,-98
-18,-24,-35,-18,-12,-27,-31,-9,-174
-5,-91,-97,-14,-100,-66,-112,2,-483
-9,-19,-46,14,-54,-15,-50,29,-150
-32,-140,-142,-43,-180,-99,-177,44,-769
-87,-194,-208,-25,-105,-70,-132,27,-794
-14,-73,-96,-31,-74,-109,-132,44,-485
-6,-40,-40,-2,-68,-19,-55,30,-200
57,-4,-3,76,-40,5,-21,67,137
-2,-44,-41,2,-23,16,-43,43,-92
-154,-146,-186,-180,-153,-109,-247,-34,-1209
-28,-14,-34,-22,-91,-35,-102,30,-296
58,4,-52,15,-98,-124,-106,63,-240
-3,-93,-103,-8,-112,-36,-100,82,-373
7,-27,-39,-25,-18,-30,-43,25,-150
-63,-138,-226,-95,-273,-182,-290,7,-1260
-50,-85,-81,-43,-113,-32,-76,0,-480
-5,-68,-69,-20,-111,-21,-90,67,-317
-67,-126,-113,-88,-93,-128,-135,18,-732
-24,-73,-89,-18,-60,-15,-63,-7,-349
-33,-58,-50,-29,-51,-19,-55,11,-284
-14,-35,-53,7,-46,-6,-45,8,-184
-29,-53,-48,-3,-59,-19,-33,32,-212
-2,-61,-65,5,-90,-25,-68,23,-283
-120,-169,-164,-25,-281,-69,-220,98,-950
30,-35,-51,16,-45,-6,-63,71,-83
-7,-17,-29,-2,-32,-42,-52,-2,-183
-6,-3,-20,7,-27,-1,-24,13,-61
6,-32,-30,-14,-37,-6,-35,44,-104
85,-97,-63,18,-29,-114,-69,74,-195
12,-155,-134,2,-199,-55,-134,150,-513
-26,-77,-75,13,-81,-12,-71,62,-267
-9,-21,-40,-1,-43,-12,-34,22,-138
0,-116,-162,-92,-188,-119,-186,19,-844
30,-26,-20,63,8,-29,-38,51,39
-32,-19,-69,-30,-42,-28,-57,17,-260
-50,-33,-56,-24,-85,-9,-73,58,-272
8,-153,-143,-30,-117,-131,-222,107,-681
-17,-92,-97,-23,-116,-91,-141,30,-547
-4,-51,-82,-47,-82,-67,-117,27,-423
-20,-26,-42,25,-26,-32,-53,30,-144
3,-39,-67,6,-28,-54,-77,42,-214
-27,-9,-22,18,-60,-3,-38,15,-126
-19,-17,-27,-44,-15,-44,-49,-34,-249
-57,-89,-87,1,-145,-37,-124,59,-479
23,-18,-37,-1,-76,54,-28,92,9
146,-111,-56,26,-35,-148,-237,163,-252
-33,-79,-78,-20,-109,-29,-97,17,-428
-51,-60,-110,-31,-165,-114,-183,12,-702
-25,-25,-26,-5,-36,-9,-31,1,-156
-64,-177,-169,-62,-257,-154,-255,14,-1124
13,10,-12,25,-18,10,0,34,62
24,-124,-150,-91,-138,-173,-263,112,-803
-24,-29,-26,3,-51,-1,-38,16,-150
9,-26,-32,9,-40,-32,-72,33,-151
8,-196,-125,76,-249,0,-133,203,-416
-25,-41,-45,-32,-69,-33,-59,-4,-308
-49,-120,-182,-16,-320,-109,-308,117,-987
74,-142,-117,10,-128,-161,-199,33,-630
-37,-103,-150,0,-207,-35,-147,103,-576
8,-11,-32,-5,-19,-33,-44,10,-126
18,-77,-70,-45,-33,-85,-104,23,-373
-57,-21,-82,-49,-107,-101,-183,39,-561
5,-20,-30,-30,-8,-19,-38,6,-134
-23,-79,-80,-35,-119,-15,-84,41,-394
29,-119,-135,-16,-116,-146,-226,84,-645
-20,-70,-74,-21,-89,-51,-91,23,-393
60,-57,-71,40,-26,-80,-96,73,-157
-11,-28,-25,23,-32,8,-48,59,-54
22,-45,-28,16,-39,9,-34,76,-23
-10,-14,-5,-2,-23,4,-27,-12,-89
-83,-88,-112,-33,-160,-32,-151,63,-596
-5,-32,-30,5,-28,-7,-41,24,-114
-12,-51,-83,-56,-99,-103,-127,19,-512
-28,-41,-47,-49,-79,-56,-92,-2,-394
383,-69,-309,346,-353,0,-491,523,30
5,-4,-49,-34,-55,-60,-87,17,-267
-70,-126,-112,-92,-108,-77,-141,18,-708
6,-10,-9,-20,-20,-16,-38,39,-68
-11,-1,-24,14,-24,-20,-30,4,-92
-21,-63,-66,3,-77,-36,-100,72,-288
-36,-89,-74,4,-120,-49,-119,52,-431
-29,-47,-45,-11,-53,-39,-79,3,-300
-40,-36,-47,-26,-56,-34,-59,-9,-307
-9,1,-86,-63,-33,-92,-79,58,-303
69,-70,-71,24,-1,-31,-70,105,-45
3,-25,-54,-22,-70,-66,-82,1,-315
-70,-116,-119,-12,-63,7,-94,25,-442
32,-87,-43,59,-104,-77,-103,62,-261
-16,-29,-77,-38,-114,-95,-145,83,-431
20,-5,-33,-4,-43,-60,-89,1,-213
-49,-75,-93,-56,-116,-36,-129,6,-548
-1,-35,-49,-37,-47,-48,-71,19,-269
-84,-127,-136,-47,-166,-28,-140,99,-629
-54,-38,-44,-17,-64,-29,-54,-15,-315
-32,-82,-85,-21,-128,-65,-109,3,-519
16,-44,-44,-4,-42,-46,-62,29,-197
2,-84,-87,-39,-120,-112,-106,17,-529
4,-134,-169,-94,-243,-239,-261,85,-1051
114,105,-24,142,-71,-55,-72,111,250
-44,-45,-51,-32,-80,-56,-70,-6,-384
-7,-41,-42,0,-29,2,-27,39,-105
16,-30,-40,-2,-67,-22,-38,30,-153
-10,-44,-34,26,-55,-30,-60,5,-202
12,-27,-57,6,-62,-6,-93,87,-140
-18,-16,-31,-2,-43,-10,-43,22,-141
-43,-46,-46,-32,-63,-31,-104,4,-361
-8,-12,-25,-15,-25,-15,-35,13,-122
-38,-32,-54,-20,-70,-24,-74,0,-312
-2,7,-14,4,-13,-36,-34,-14,-102
-21,-10,-4,-8,-25,4,-18,18,-64
6,2,-14,8,2,0,3,12,19
16,-7,-21,0,-17,-10,-21,15,-45
-12,-22,-33,4,-30,-18,-45,21,-135
-49,-4,-35,-42,-40,-4,-37,21,-190
-10,-28,-12,-2,-15,-11,-21,-6,-105
-1,-24,-34,6,-48,-28,-41,-9,-179
-37,-65,-56,-55,-90,-22,-81,39,-367
-89,-148,-186,-80,-304,-162,-317,57,-1229
-16,-96,-90,-11,-147,-59,-137,27,-529
24,-40,-54,-1,-50,-31,-47,51,-148
-30,-30,-60,-19,-56,-25,-94,26,-288
-9,-33,-36,-26,-58,-61,-66,-8,-297
-97,-93,-112,-63,-169,-51,-198,34,-749
36,-58,-55,3,-80,-16,-64,58,-176
-31,-77,-93,-51,-114,-89,-174,109,-520
-42,-99,-203,-85,-258,-133,-225,53,-992
122,-68,-47,48,-107,-111,-152,88,-227
-61,-54,-99,-32,-95,-28,-105,12,-462
-48,-92,-113,-55,-149,-32,-113,60,-542
21,-83,-80,35,-102,-17,-92,103,-215
2,-3,-8,-1,-18,-12,-20,13,-47
-47,-116,-76,-5,-146,-14,-117,47,-474
-35,-52,-44,-27,-47,-36,-66,4,-303
-26,-90,-87,-41,-76,-43,-85,63,-385
-37,-61,-89,-29,-99,17,-49,63,-284
15,-152,-89,41,-181,-87,-163,104,-512
-4,-8,-17,4,-38,-17,-34,7,-107
31,-1,-20,27,-7,7,-14,28,51
-20,-49,-51,-22,-13,-40,-57,11,-241
-4,-6,-36,-22,-24,-42,-46,2,-178
-28,-7,-35,-28,-59,-32,-57,6,-240
-45,-78,-67,-32,-107,-99,-131,-65,-624
-11,-67,-43,15,-58,-2,-73,49,-190
-27,-55,-43,-14,-25,-39,-52,-2,-257
27,-29,-27,4,-23,-12,-25,14,-71
-34,-39,-51,-31,-46,-41,-71,2,-311
-2,-18,-26,1,-32,-6,-18,18,-83
-19,6,-12,23,-24,-23,-33,2,-80
58,-140,-154,81,-117,-15,-180,118,-349
-68,-65,-70,-5,-106,-22,-103,36,-403
7,-110,-117,-36,-149,-89,-109,44,-559
24,-28,-46,-11,-62,-34,-43,32,-168
-9,-46,-28,44,-39,-1,-30,38,-71
29,-44,-2,78,-11,37,-41,56,102
20,9,-38,38,-40,-22,-56,48,-41
-27,8,-7,2,-21,-31,-39,-26,-141
-53,-54,-46,-44,-64,-17,-67,1,-344
31,-66,-70,2,-77,-60,-109,64,-285
-6,-70,-66,-17,-84,-47,-86,25,-351
5,-30,-29,6,-40,-2,-27,32,-85
10,-41,-46,11,-35,-7,-46,56,-98
8,-116,-108,-76,-116,-83,-116,74,-533
15,-26,-17,6,-27,-28,-34,-10,-121
-23,-29,-17,5,-49,-31,-33,3,-174
-4,-22,-38,-4,-34,-9,-31,19,-123
-3,-7,-37,22,-40,-13,-51,47,-82
-51,-49,-80,-66,-95,-54,-110,-41,-546
5,-47,-77,-10,-72,-36,-77,11,-303
-38,-184,-261,-25,-250,-108,-347,211,-1002
-112,-155,-180,-32,-228,-74,-206,52,-935
-24,-92,-142,-62,-82,-11,-85,41,-457
-6,-66,-123,-93,-163,-137,-186,51,-723
-131,-288,-311,-194,-169,-42,-273,77,-1331
8,7,-6,0,0,-16,-9,12,-4
219,-91,-57,73,10,-111,-163,270,150
17,-45,-51,-13,-47,-20,-55,13,-201
-3,-165,-239,-111,-284,-251,-429,218,-1264
17,-59,-108,-5,-70,-36,-100,66,-295
-14,-31,-62,-48,-93,-59,-88,2,-393
-58,-221,-274,-66,-348,-68,-274,242,-1067
-34,-107,-97,-31,-135,-84,-142,54,-576
-53,-140,-215,198,-326,3,-428,212,-749
19,-56,-54,-10,-78,-70,-116,83,-282
6,-14,-25,11,-31,-8,-17,29,-49
-83,-142,-124,-56,-175,-62,-187,45,-784
-34,-70,-121,-42,-102,-86,-142,-18,-615
20,-51,-6,78,-34,16,-55,57,25
25,-79,-71,-14,-111,-38,-43,68,-263
32,-87,-94,9,-56,-43,-111,79,-271
-61,-58,-78,-84,-63,-55,-98,7,-490
-12,-95,-110,-5,-109,-62,-157,110,-440
-16,-60,-63,-16,-95,-52,-106,7,-401
-76,-159,-174,-43,-214,-72,-231,96,-873
2,-29,-74,0,-95,-39,-139,47,-327
-9,-21,-40,-13,-32,-20,-47,11,-171
7,-9,-27,-12,-19,-25,-22,6,-101
-30,-80,-60,11,-105,-15,-100,65,-314
-12,-19,-28,4,-28,-5,-39,21,-106
-4,-20,-26,-12,-30,-28,-31,1,-150
-234,-246,-343,-121,-432,-75,-427,116,-1762
-221,-320,-390,-97,-522,-60,-439,195,-1854
-33,-63,-81,-4,-118,18,-84,77,-288
-14,-31,-33,10,-38,10,-36,21,-111
3,-39,-61,-42,-59,-53,-54,40,-265
-71,-100,-122,-107,-143,-136,-174,-20,-873
136,-195,-188,36,-166,-102,-247,273,-453
-147,-172,-177,-75,-232,-172,-286,-80,-1341
-18,-17,-23,-16,-35,-9,-28,12,-134
-117,-41,-95,-73,-117,-101,-193,-88,-825
-45,-82,-95,-11,-106,-36,-132,56,-451
-60,-3,-114,-82,-50,-21,-118,31,-417
-7,-40,-47,-12,-63,-34,-56,4,-255
-43,-160,-179,26,-93,-27,-121,-1,-598
-8,-10,-12,-7,-12,-17,-27,-2,-95
11,2,7,20,-12,-12,4,12,32
-184,-168,-145,-63,-195,-16,-205,81,-895
-21,-29,-78,-12,-44,-33,-104,-62,-383
-11,-26,-24,-8,-30,-9,-32,5,-135
216,-163,-151,-17,-83,-261,-317,233,-543
120,-115,-137,-49,-72,-219,-329,155,-646
-10,-96,-143,-84,-172,-181,-205,81,-810
74,-126,-149,2,-177,-34,-137,189,-358
-22,-31,-73,-10,-37,-8,-45,93,-133
-11,-20,-6,18,-25,-51,-117,27,-185
4,-11,-24,3,-31,-17,-44,30,-90
24,-19,-6,26,-20,18,-14,30,39
-55,-90,-92,-7,-123,-34,-143,17,-527
-16,-8,-55,-32,-81,-72,-115,32,-347
-51,-57,-68,-34,-87,-41,-105,21,-422
55,-173,-265,-12,-340,-141,-314,282,-908
-8,-13,-14,-3,-14,-14,-17,7,-76
-6,-536,-892,59,-1889,254,-1138,1392,-2756
-867,-702,-1108,-879,-1424,-1001,-2018,-569,-8568
63,-10,-66,59,-59,-41,-141,127,-68
-8,-66,-81,-38,-105,-77,-104,-2,-481
-33,-76,-86,-1,-89,-30,-78,57,-336
-40,-53,-64,-33,-91,-39,-82,19,-383
-35,-137,-179,-32,-149,-74,-235,77,-764
-8,-62,-100,-57,-153,-133,-150,-3,-666
2,-113,-106,-33,-176,-78,-132,70,-566
1717,-1828,-4085,65,-1926,2569,-1881,4232,-1137
-29,-47,-46,-15,-31,-7,-51,5,-221
-9,-53,-71,-27,-60,-93,-123,45,-391
-66,-58,-74,-48,-91,-19,-85,27,-414
-15,-71,-87,-25,-147,-83,-122,-27,-577
1,-46,-54,0,-72,-49,-72,13,-279
-10,-27,-41,-18,-93,-77,-104,8,-362
19,-34,-31,4,-42,-10,-44,39,-99
-22,-60,-59,29,-114,9,-100,39,-278
-55,-178,-223,-12,-335,-125,-285,114,-1099
24,-18,-23,18,-15,-13,-41,21,-47
-32,-35,-64,-29,-78,-28,-78,27,-317
2,-8,-5,70,-79,-60,-121,76,-125
72,-133,-150,4,-169,-109,-228,196,-517
-14,-73,-62,-59,-73,-89,-136,55,-451
-52,-71,-76,-39,-63,-51,-121,-40,-513
-129,-97,-105,-136,-154,-90,-239,-107,-1057
-349,-766,-621,-216,-983,-384,-974,25,-4268
5,-14,-31,0,-48,-59,-53,-11,-211
125,-186,-170,-66,-83,-190,-259,197,-632
-71,-121,-164,-42,-217,-87,-231,83,-850
7,-177,-220,15,-265,-94,-188,205,-717
-32,-46,-71,-32,-68,-33,-92,50,-324
-23,-46,-209,-62,-40,-42,-121,86,-457
37,-50,-53,30,-35,-74,-106,29,-222
-8,-54,-54,-52,-28,-24,-61,8,-273
55,-88,-108,21,-120,-83,-165,109,-379
-24,-76,-89,-15,-119,-40,-113,18,-458
41,-82,-109,3,-69,-52,-105,88,-285
-13,-15,-45,-23,-44,-33,-61,-2,-236
-149,-74,-125,-125,-106,-129,-190,-94,-992
-7,-79,-130,8,-117,-39,-122,88,-398
-102,-23,-74,-75,-124,-62,-134,-21,-615
34,-84,-295,10,-130,-42,-324,351,-480
-26,-25,-24,-4,-36,-36,-49,6,-194
-42,-32,-45,-26,-83,-29,-87,21,-323
17,-118,-125,-25,-179,-56,-116,70,-532
6,-153,-158,93,-289,25,-261,222,-515
-44,-17,-29,-33,-10,-22,-54,-13,-222
7,-149,-205,3,-173,-122,-271,121,-789
-35,-63,-49,-6,-64,-45,-91,3,-350
-5,-62,-115,-11,-125,-12,-113,120,-323
-47,-128,-160,-33,-142,-115,-202,85,-742
-23,-290,-443,-185,-459,-129,-396,377,-1548
23,-24,-26,20,-13,-44,-42,37,-69
-23,1,-33,-27,-39,-20,-44,10,-175
-6,-72,-85,-45,-118,-68,-140,112,-422
107,-105,-142,81,-77,-51,-181,268,-100
-66,-92,-192,-105,-217,-156,-285,94,-1019
23,23,9,45,10,15,-39,43,129
-39,-56,-78,-56,-113,-84,-113,1,-538
-24,-34,-59,-26,-68,-46,-87,-4,-348
-8,-33,-33,-7,-30,-12,-38,13,-148
-10,-38,-25,-10,-20,-19,-39,6,-155
599,-5684,-6471,-3030,-6202,550,-5030,5517,-19751
23,-10,-8,39,-33,-34,-63,49,-37
-10,3,-27,-5,-24,-19,-29,6,-105
-44,-132,-107,-45,-187,-41,-133,39,-650
-71,-255,-314,-39,-376,-56,-373,131,-1353
-24,-49,-31,-23,-67,-28,-56,7,-271
22,-44,-91,4,-57,-85,-85,42,-294
-7,-45,-57,-12,-60,-71,-83,36,-299
53,-187,-280,-16,-242,-161,-371,152,-1052
102,-81,-173,-63,-155,-213,-313,197,-699
-31,-69,-63,24,-51,-32,-93,36,-279
12,-13,-31,-23,-38,-48,-68,34,-175
-51,-95,-101,-26,-116,-24,-123,45,-491
-48,-86,-111,-32,-146,6,-113,63,-467
-61,-78,-106,-39,-137,9,-95,52,-455
-24,-7,-18,-8,-31,-41,-55,-20,-204
-25,-126,-116,-40,-169,-82,-155,85,-628
-88,-175,-180,-85,-254,-83,-218,76,-1007
-67,-83,-89,-38,-116,-30,-115,35,-503
2,-12,-6,-4,-8,-7,-14,8,-41
93,-37,-99,9,-111,-185,-222,19,-533
-14,3,-30,-26,-28,-11,-25,25,-106
-27,-126,-115,-51,-136,-37,-121,87,-526
-20,-121,-121,-44,-136,-43,-129,91,-523
-12,-84,-56,9,-68,-31,-75,43,-274
-38,-75,-62,-12,-103,-35,-92,20,-397
-34,-93,-79,-47,-105,-28,-93,20,-459
-5,-86,-62,-8,-90,-29,-66,47,-299
-18,-31,-31,9,-26,4,-38,10,-121
44,-39,-59,-7,-77,-70,-85,48,-245
-32,-39,-45,8,-88,-27,-78,48,-253
5,-95,-58,29,-79,-5,-62,59,-206
48,-83,-26,40,-78,-49,-90,59,-179
22,-63,-63,117,-37,84,-94,128,94
-2,-54,-87,17,-152,-44,-96,60,-358
44,-149,-167,-3,-191,-170,-289,135,-790
-18,-121,-147,-51,-185,-33,-139,92,-602
35,18,-65,5,-133,-105,-124,37,-332
42,-17,-28,1,-82,-44,-43,63,-108
-372,-498,-564,-357,-749,-510,-836,114,-3772
-16,-65,-72,-16,-98,-28,-101,43,-353
9,-23,-35,10,-31,-8,-38,24,-92
-120,-167,-130,-72,-171,-56,-180,36,-860
29,-17,-40,-5,4,-36,-25,19,-71
-64,-157,-131,15,-206,-105,-190,57,-781
1,-63,-88,-60,-148,-85,-128,1,-570
-25,-39,-49,-24,-51,-37,-50,-15,-290
66,-90,-82,7,-95,-100,-150,84,-360
30,-26,-31,-11,-29,-34,-72,24,-149
-44,-94,-87,-12,-104,-36,-102,42,-437
-63,-114,-135,-29,-178,-5,-149,93,-580
14,-17,-53,-11,-67,-42,-58,59,-175
-48,-319,-364,-123,-421,-276,-498,108,-1941
43,-108,-163,17,-154,-40,-174,137,-442
90,-160,-173,27,-99,-107,-197,154,-465
15,1,-120,-11,-72,-71,-147,73,-332
5,-112,-125,11,-172,-60,-165,113,-505
-42,-140,-202,-129,-207,-141,-308,69,-1100
-122,-149,-127,-19,-189,-2,-173,100,-681
90,-265,-359,52,-313,5,-364,468,-686
-5,-71,-109,-62,-91,-27,-92,97,-360
8,-235,-333,-91,-291,-92,-296,166,-1164
-7,-35,-66,-2,-97,-44,-80,37,-294
-16,-78,-68,-11,-95,-63,-117,-21,-469
-78,-105,-109,-35,-191,-73,-192,-35,-818
24,-132,-88,-94,-69,-100,-155,87,-527
24,-81,-108,-8,-137,-68,-159,89,-448
-23,-55,-40,14,-75,-36,-78,21,-272
-34,-154,-133,-15,-214,-44,-144,137,-601
19,-30,-56,56,-54,-60,-81,6,-200
-8,-50,-47,25,-66,-28,-58,9,-223
-52,-119,-116,-57,-151,-65,-171,22,-709
49,-79,-6,43,34,-6,-27,62,70
-2,-62,-62,0,-91,-40,-82,4,-335
28,-108,-120,-19,-63,-102,-177,84,-477
-22,-19,-29,6,-57,3,-48,10,-156
-29,-155,-174,-88,-204,-195,-331,42,-1134
33,-56,-97,-18,-88,-11,-115,47,-305
48,-152,-340,-89,-239,-44,-233,229,-820
-73,-119,-129,-23,-209,-49,-197,111,-688
-7,-14,-21,0,-20,-8,-23,6,-87
192,-36,-43,118,-9,-163,-171,228,116
7,-27,-38,37,-76,-28,-40,66,-99
19,-102,-143,-11,-139,-60,-127,22,-541
-21,-62,-80,-48,-112,-63,-99,19,-466
-47,-72,-77,-62,-98,-67,-88,-35,-546
-47,-73,-66,-18,-105,-34,-77,17,-403
-212,-294,-285,-57,-443,-176,-367,44,-1790
-17,-71,-99,57,-148,-52,-182,104,-408
117,-162,-265,-14,-144,-149,-256,242,-631
-8,-102,-59,39,-102,-57,-142,68,-363
-29,-108,-164,-25,-141,-77,-166,84,-626
-153,-142,-317,-168,-413,-366,-591,-24,-2174
76,-115,-98,2,-80,-70,-162,119,-328
-125,-420,-596,-352,-800,-618,-850,-83,-3844
47,-241,-164,-222,-82,-205,-305,105,-1067
112,-123,-141,48,-150,-164,-227,141,-504
55,-114,-201,-46,-240,-218,-315,75,-1004
-69,-143,-186,-57,-258,-123,-266,92,-1010
-264,-317,-358,-214,-588,-363,-641,-12,-2757
21,-126,-174,28,-202,-110,-264,123,-704
-2,-28,-33,-6,-17,-48,-74,-10,-218
-14,-110,-132,4,-185,-110,-198,0,-745
74,-118,-154,36,-198,-150,-241,90,-661
-62,-224,-208,-30,-312,-93,-244,121,-1052
50,-71,-210,117,-177,-2,-252,213,-332
-18,-35,-60,-19,-51,2,-54,27,-208
-35,-71,-72,-5,-95,-63,-114,42,-413
-56,-86,-83,-11,-135,-15,-119,72,-433
-41,-146,-136,19,-216,-34,-179,110,-623
-38,-49,-59,-27,-50,-15,-70,49,-259
-19,-77,-60,0,-110,-23,-68,63,-294
-48,-111,-102,-57,-63,-65,-82,0,-528
-50,-69,-85,-45,-81,-21,-72,13,-410
68,-79,-170,-46,-167,-95,-182,158,-513
-75,-90,-84,-49,-58,-34,-101,-21,-512
44,-284,-343,141,-491,-62,-404,369,-1030
-74,-161,-177,-31,-186,-69,-186,69,-815
53,-21,-117,20,-79,-27,-129,69,-231
-108,-117,-133,-57,-149,-77,-174,20,-795
12,17,8,16,-14,-17,-10,14,26
-4,60,-18,22,-17,-6,-53,17,1
59,-59,-81,-17,-72,-22,-95,111,-176
-63,-111,-105,-110,-146,-144,-204,-45,-928
-52,-137,-135,-88,-203,-115,-212,44,-898
-29,-271,-190,19,-314,-131,-302,175,-1043
-26,-62,-60,-34,-53,-34,-63,17,-315
-19,-70,-89,-15,-126,-76,-149,50,-494
79,-37,-23,27,32,-67,-95,65,-19
88,1,0,80,10,-38,-37,103,207
-381,-753,-885,-160,-1171,-557,-1249,131,-5025
-1,-26,-37,-17,-70,-59,-61,22,-249
33,-132,-118,-12,-87,-105,-188,103,-506
0,-36,-67,-39,-127,-16,-87,70,-302
11,-76,-56,33,-110,-23,-38,56,-203
7,-12,-15,7,-29,-25,-21,11,-77
5,-134,-235,-126,-163,2,-113,161,-603
45,-146,-167,50,-274,59,-182,260,-355
-50,-63,-75,-10,-101,-44,-114,-4,-461
47,-67,-70,-8,-75,-93,-122,27,-361
-50,-80,-87,-59,-139,-94,-145,22,-632
-49,-61,-64,24,-111,-74,-165,20,-480
-15,-44,-75,-32,-63,-38,-72,9,-330
108,-209,-290,-7,-189,-236,-342,184,-981
-3,-50,-14,43,-65,-26,-59,40,-134
-91,-105,-174,-57,-219,-152,-268,41,-1025
-41,-48,-73,-54,-102,-36,-62,23,-393
89,-96,-70,44,-76,-48,-138,154,-141
-21,-58,-59,-34,-94,-60,-86,9,-403
-42,-39,-48,-8,-45,-51,-102,-5,-340
59,-64,-52,34,-57,-84,-81,69,-176
-35,-24,-47,-10,-43,-49,-90,11,-287
-21,-20,-48,31,-44,-60,-81,34,-209
3,-84,-93,36,-109,-94,-128,90,-379
28,-80,-45,58,-83,-94,-137,-9,-362
275,-173,-199,103,-7,-295,-271,459,-108
11,-63,-262,-10,-131,-122,-312,374,-515
47,-57,-41,25,-150,-60,-145,97,-284
-62,-171,-220,-151,-309,-213,-352,31,-1447
-7,-141,-131,14,-113,-51,-130,112,-447
16,-51,-60,26,-24,2,-69,53,-107
203,242,232,339,99,110,52,142,1419
-110,-35,-114,-103,-81,-181,-221,-65,-910
-3,-54,-80,-22,-114,-54,-103,45,-385
-120,-218,-286,-295,-451,-493,-623,-184,-2670
-79,-131,-100,3,-186,-24,-163,78,-602
-15,-66,-71,10,-63,0,-63,28,-240
75,-175,-168,26,-208,13,-169,262,-344
-67,-223,-252,171,-223,-117,-317,131,-897
34,-70,-18,37,-14,-36,-68,59,-76
-38,-106,-90,-29,-112,-37,-103,68,-447
-80,-168,-152,-76,-130,-91,-213,53,-857
-74,-140,-171,-46,-125,-94,-200,44,-806
-58,-92,-127,32,-131,-20,-170,50,-516
-34,-121,-230,-63,-169,-79,-216,132,-780
38,28,-102,18,-91,94,-99,115,1
-47,-152,-220,-120,-125,-80,-275,117,-902
26,1,-39,-44,-38,-83,-89,30,-236
22,-8,-21,18,-53,-30,-67,61,-78
-23,-152,-148,-14,-210,-155,-224,28,-898
15,-58,-21,76,-94,-77,-119,73,-205
19,-37,-41,14,-49,-51,-61,20,-186
5,-36,-58,-15,-53,-35,-62,16,-238
-107,-87,-69,-65,-191,-80,-199,-33,-831
-47,-103,-123,-50,-150,-31,-135,75,-564
-38,-91,-105,-43,-112,-56,-122,23,-544
28,-168,-167,-24,-178,-65,-145,160,-559
47,-36,-45,17,-50,-79,-89,49,-186
119,-205,-251,-7,-238,27,-203,397,-361
82,-104,-107,20,-96,-48,-123,106,-270
-14,-30,-20,-26,-60,-10,-57,21,-196
38,-73,-44,10,-105,-55,-74,59,-244
-2,-32,-25,-12,-44,-31,-52,9,-189
-292,-73,-189,-227,-256,-137,-346,-169,-1689
28,-41,-51,85,-87,-76,-93,34,-201
7,-29,-20,25,-35,-20,-36,6,-102
14,-42,-30,-3,-66,-64,-98,23,-266
-174,-287,-343,-119,-468,-86,-448,180,-1745
-54,-71,-138,-114,-177,-180,-264,49,-949
-141,-151,-186,-131,-254,-124,-275,-5,-1267
2,-36,-38,23,-41,-6,-26,35,-87
-163,-139,-152,-99,-269,-216,-254,-30,-1322
51,-117,-110,32,-197,-101,-207,142,-507
-28,-92,-98,-77,-80,-29,-67,35,-436
-68,-119,-142,-61,-172,-101,-197,27,-833
-98,-123,-95,-19,-149,-24,-133,65,-576
41,-75,-33,16,-10,38,-4,97,70
10,-42,-42,32,-55,-39,-69,-2,-207
130,-17,-51,122,12,-98,-155,136,79
-41,-96,-155,-30,-182,-82,-213,98,-701
-6,-24,-59,6,-38,-8,-47,47,-129
-12,-36,-43,-14,-43,-30,-52,39,-191
-12,-20,-43,1,-34,-18,-45,40,-131
28,-22,-53,-23,-59,-64,-70,36,-227
-52,-116,-143,-76,-178,-110,-217,107,-785
73,-108,-139,-19,-75,-157,-174,70,-529
0,-55,-33,-8,-82,-100,-110,17,-371
-8,-17,-24,32,-47,-22,-26,0,-112
-49,-29,-32,19,-53,7,-52,5,-184
67,-131,-158,-2,-184,-178,-275,99,-762
26,5,-11,31,-17,-20,-39,46,21
13,-146,-113,-37,-142,-119,-179,85,-638
108,35,124,133,-11,-57,-93,107,346
-28,-33,-50,23,-91,-44,-112,24,-311
48,-62,-35,11,-52,-79,-108,60,-217
-27,-107,-98,-72,-141,-101,-168,72,-642
-54,-114,-181,-47,-173,-57,-222,96,-752
416,-338,-414,-184,226,145,-65,335,121
-6,-48,-63,-32,-51,-17,-48,50,-215
-76,-137,-142,-12,-197,-50,-218,91,-741
-24,-35,-32,-19,-70,-30,-49,15,-244
-35,-61,-50,-6,-99,-37,-118,-2,-408
27,-66,-41,37,-72,-32,-103,104,-146
-75,-113,-128,-35,-249,-117,-232,-23,-972
-90,-81,-163,-163,-215,-143,-285,-2,-1142
-11,-32,-46,-34,-57,-29,-36,34,-211
0,-25,-26,19,-36,-17,-41,18,-108
31,-91,-70,-30,-70,-107,-149,48,-438
14,-54,-26,-5,-17,-44,-57,35,-154
-20,-61,-70,-29,-105,-15,-67,85,-282
-109,-62,-107,-78,-106,-13,-178,-26,-679
-59,-75,-102,-49,-103,-40,-99,47,-480
-6,-50,-97,-39,-166,-124,-174,32,-624
19,-65,-59,50,-169,-50,-138,117,-295
72,-59,-54,58,-109,-51,-143,185,-101
-101,-390,-310,-29,-551,-335,-656,93,-2279
-44,-163,-117,11,-190,-98,-142,86,-657
-4,-51,-64,-57,-45,-58,-98,34,-343
-37,-153,-207,-32,-223,-44,-192,156,-732
-99,-140,-144,-65,-186,-125,-226,-50,-1035
12,-68,-84,-33,-64,-79,-113,-5,-434
-22,-18,-26,-23,0,-7,-49,-25,-170
-106,-140,-131,-18,-190,3,-187,84,-685
99,-103,-20,26,16,-42,-95,148,29
9,-44,-37,-7,1,-14,-38,12,-118
-13,-150,-122,-15,-195,-77,-153,99,-626
-41,-93,-77,1,-73,-24,-86,19,-374
71,-93,-167,21,-95,-39,-148,175,-275
-77,-205,-340,-33,-311,-369,-426,209,-1552
0,-127,-127,6,-113,-90,-193,149,-495
-2,0,-32,-10,-28,-27,-36,6,-129
-6,-34,-33,-7,-22,-9,-19,19,-111
-16,-15,-23,-2,-13,-22,-19,-7,-117
-17,-188,-194,-81,-286,-94,-248,99,-1009
-11,-48,-70,6,-97,-28,-85,58,-275
-7,-43,-50,4,-72,-56,-107,-15,-346
-11,-49,-37,-15,-30,-25,-37,5,-199
-16,-27,-40,-30,-38,-10,-36,4,-193
-27,-65,-70,-18,-111,-67,-72,14,-416
-16,-44,-49,16,-77,-49,-103,22,-300
25,-79,-45,43,-56,-3,-71,76,-110
-100,-135,-185,-50,-240,-91,-220,46,-975
-19,-48,-68,-21,-91,-52,-62,24,-337
-13,-40,-66,-39,-69,-7,-49,54,-229
-26,-45,-42,0,-40,-8,-40,9,-192
-23,-9,-18,-23,-27,-15,-24,11,-128
-14,-57,-20,28,-45,-6,-58,57,-115
-16,-23,-28,5,-16,-19,-49,0,-146
7,31,-3,13,19,-27,0,6,46
37,-4,-7,19,-41,-41,-27,26,-38
0,-16,-19,10,-27,-23,-45,6,-114
-4,8,-15,10,-27,9,-25,22,-22
62,-36,-55,-29,-38,-106,-75,86,-191
-3,-107,-130,-35,-136,-121,-149,40,-641
-114,-181,-236,-121,-275,-113,-295,47,-1288
7,-28,-27,32,-65,-50,-53,40,-144
8,-32,-40,13,-13,-40,-86,23,-167
18,-13,-36,-23,-25,-72,-84,20,-215
-4,-13,-3,7,-24,12,-21,17,-29
-8,-44,-89,-29,-82,-69,-92,58,-355
-34,-23,-104,-37,-159,-11,-45,135,-278
1,-70,-138,-64,-126,-147,-209,57,-696
-37,-33,-33,-18,-57,-14,-60,8,-244
16,-29,-28,21,-30,-6,-40,37,-59
-5,-21,-21,-2,-12,-5,-24,12,-78
-17,-48,-48,-7,-56,-1,-68,38,-207
-57,-92,-120,-5,-161,-2,-138,95,-480
-37,-35,-108,-53,-54,-74,-103,6,-458
5,-15,-22,-14,-42,-36,-49,2,-171
-14,-56,-38,16,-39,6,-46,50,-121
4,-25,-60,12,-81,-38,-81,67,-202
-11,-96,-88,-37,-167,-124,-144,35,-632
-20,-57,-80,-34,-87,-36,-90,31,-373
-12,-58,-45,1,-53,-27,-64,33,-225
8,-17,-8,-6,-43,-1,1,19,-47
7,-49,-60,-19,-78,-57,-54,33,-277
-49,-74,-103,-33,-120,-46,-143,73,-495
9,-24,-10,43,-29,-8,-60,48,-31
-7,-40,-35,-16,-32,-15,-37,-3,-185
-36,-152,-146,-61,-130,-60,-133,51,-667
-57,-106,-108,-32,-146,-3,-109,82,-479
44,-75,-102,-32,-147,-137,-132,97,-484
-53,-64,-71,-33,-86,-46,-100,-21,-474
-63,-109,-109,-69,-132,-103,-164,-18,-767
-17,-13,-26,-25,-9,-16,-18,19,-105
-52,-16,-51,-17,-48,-16,-69,-9,-278
-5,-10,-42,-10,-45,-42,-52,-2,-208
0,-43,-41,14,-69,-23,-39,28,-173
-61,-76,-81,-9,-89,-43,-123,-7,-489
-13,-116,-153,21,-171,-89,-220,105,-636
25,-116,-116,-19,-115,-57,-123,137,-384
-1,-44,-92,-27,-117,-59,-86,52,-374
-70,-90,-96,-22,-138,-3,-92,53,-458
31,-36,-22,1,-50,-50,-49,45,-130
23,-58,-59,24,-82,-70,-98,31,-289
-33,-37,-42,-44,-61,-32,-77,8,-318
68,-73,-113,-40,-163,-187,-200,25,-683
-30,-106,-135,-55,-224,-82,-176,-4,-812
10,-32,-45,-6,-78,-90,-115,-5,-361
-6,-37,-18,8,-34,-6,-65,29,-129
-27,-30,-33,3,-65,-17,-58,22,-205
43,-50,7,57,-5,-14,-38,71,71
12,-133,-96,8,-181,-84,-127,68,-533
-25,-44,-56,-19,-70,-23,-72,37,-272
-69,-114,-87,-29,-117,-9,-108,46,-487
-5,-121,-112,-13,-190,-127,-152,36,-684
-22,-53,-62,-58,-135,-86,-136,-58,-610
-42,-62,-95,-59,-106,-60,-84,34,-474
73,-99,-169,-74,-72,-161,-232,164,-570
-18,-23,-11,0,-17,-6,-24,12,-87
-53,-115,-90,-60,-115,-44,-115,39,-553
33,15,-19,35,-2,-9,-47,43,49
-78,-79,-83,-16,-54,-11,-61,-14,-396
1,-38,-31,-8,-36,-15,-78,66,-139
-33,2,-22,-30,-20,-31,-56,1,-189
-29,-90,-53,-19,-108,-8,-83,82,-308
-33,-66,-76,-26,-72,-9,-76,86,-272
-22,-55,-40,6,-73,11,-44,26,-191
9,-162,-130,-6,-186,-46,-101,113,-509
-35,-127,-115,-32,-140,-10,-113,133,-439
18,-30,-99,-50,-157,-122,-164,19,-585
-33,-125,-144,-85,-175,-161,-241,-28,-992
-34,-48,-59,-45,-87,-42,-79,29,-365
-13,-48,-62,-51,-35,-58,-132,61,-338
-24,-1,-12,-32,-25,-39,-45,-3,-181
4,-24,-29,0,-20,-29,-30,-1,-129
-22,-31,-26,-26,-49,-26,-66,-14,-260
-9,-37,-41,-10,-29,-3,-27,20,-136
9,-82,-108,-52,-130,-97,-115,31,-544
-27,-114,-66,-40,-113,-102,-141,22,-581
-33,-7,-62,-69,-105,-138,-220,-72,-706
-4,-5,-26,-4,-11,-11,-13,16,-58
23,-98,-77,24,-132,-7,-74,80,-261
-20,-59,-79,-21,-77,-8,-63,39,-288
-17,-32,-40,-12,-26,-13,-47,3,-184
2,-49,-49,-8,-45,-3,-73,66,-159
-48,-89,-101,-28,-116,-38,-126,42,-504
-7,-17,-6,7,-30,-12,-19,6,-78
0,-30,-47,33,-66,-27,-70,46,-161
-13,-43,-25,-28,-37,-1,-28,27,-148
5,-62,-32,-3,-22,-35,-48,46,-151
13,-33,-42,-7,-67,-68,-76,23,-257
28,-51,-34,33,-78,-64,-77,24,-219
-8,-54,-72,-31,-81,-76,-74,53,-343
12,-31,-30,-1,-37,-48,-67,18,-184
-41,-86,-90,-38,-102,-44,-111,62,-450
-19,-36,-52,-4,-41,7,-41,48,-138
-7,-18,-29,4,-39,-12,-31,21,-111
-27,-25,-34,-27,-53,-11,-35,15,-197
-27,-15,-14,5,-21,-75,-124,30,-241
-24,-6,-26,8,-37,-20,-59,32,-132
-114,-128,-172,-87,-258,-142,-271,-22,-1194
2,-78,-83,5,-126,-53,-116,60,-389
-23,-25,-33,-6,-41,-9,-23,9,-151
39,-45,-28,10,-14,-37,-58,32,-101
66,7,4,10,-26,-80,-106,66,-59
43,13,10,14,-37,-55,-102,80,-34
-8,-23,-29,-29,-30,-37,-41,3,-194
-13,-61,-99,-35,-115,-95,-138,62,-494
-91,-116,-172,-78,-198,-105,-247,29,-978
-146,-45,-83,-132,-161,-169,-260,-152,-1148
-7,-23,-46,-36,-57,-48,-61,11,-267
-6,-39,-49,-23,-87,-55,-56,23,-292
-58,-138,-104,-6,-146,-54,-126,-3,-635
-18,-27,-149,-112,-138,-229,-251,63,-861
-36,-93,-93,-43,-129,-78,-166,20,-618
84,13,74,121,-10,-38,-60,84,268
-42,-161,-175,-1,-267,-165,-251,20,-1042
-22,-57,-57,-18,-99,4,-96,47,-298
-24,-28,-59,-55,-32,-74,-85,-44,-401
7,20,-15,15,-16,21,-23,42,51
-22,-40,-29,-11,-61,-20,-43,6,-220
-27,-6,-15,-19,-85,-64,-97,5,-308
-45,-4,-24,-36,-68,-19,-79,4,-271
-45,-125,-77,-1,-68,-13,-92,23,-398
-67,-82,-100,-44,-125,-57,-128,48,-555
-39,-88,-115,-58,-125,-133,-151,14,-695
3,-59,-121,-40,-65,-98,-145,82,-443
-75,-72,-81,-4,-107,-43,-133,14,-501
33,-50,-88,-40,-59,-46,-100,106,-244
-4,-24,-47,-19,-38,-60,-76,45,-223
-14,-14,-49,-13,-67,-48,-83,28,-260
32,47,-84,-40,-59,-139,-152,20,-375
-30,-65,-60,-12,-55,-51,-71,16,-328
-36,-35,-69,-48,-102,-62,-125,-13,-490
53,-34,-33,23,-39,-50,-77,48,-109
15,-3,-25,-5,-16,-12,-15,25,-36
11,-25,-8,16,-48,-12,-23,34,-55
47,-134,-158,-37,-140,-92,-180,190,-504
-8,-38,-22,7,1,-22,-56,34,-104
-47,-62,-85,-31,-136,-59,-155,11,-564
3,-43,-38,1,-60,-24,-48,12,-197
54,-117,-125,-46,-229,-172,-198,70,-763
-10,-76,-108,-46,-124,-101,-124,57,-532
-1,-31,-19,-15,-104,-39,-88,107,-190
187,-286,-428,206,-484,-392,-707,156,-1748
11,-27,-32,0,-65,-37,-45,19,-176
-15,-24,-36,-30,-62,-37,-48,10,-242
43,-41,-74,-19,-53,-35,-53,90,-142
-6,-26,-25,-2,-8,4,-4,27,-40
108,-18,-46,69,-52,-123,-217,155,-124
-49,-69,-70,-18,-110,-41,-83,20,-420
97,-4,-68,42,-68,-26,-46,110,37
-4,-37,-45,-21,-61,-26,-51,25,-220
21,-42,-71,-24,-63,-63,-79,56,-265
53,-39,-38,0,-7,-52,-82,37,-128
-22,-45,-42,-7,-50,-13,-52,22,-209
-4,-6,-17,-2,-26,-15,-20,2,-88
-1,-12,-12,14,-21,-9,-19,11,-49
-10,29,-19,-6,14,-23,-39,23,-31
-5,-76,-84,-2,-93,-5,-87,73,-279
47,-58,-101,-47,-96,-136,-135,42,-484
-49,-44,-55,-14,-58,-28,-58,14,-292
24,-94,-81,14,-88,-59,-106,30,-360
-24,-27,-51,-13,-51,-17,-54,33,-204
6,-15,-92,-40,-65,-8,-110,109,-215
34,-62,-87,-26,-62,-101,-129,39,-394
-39,-133,-161,14,-197,-104,-240,90,-770
-14,-107,-123,-82,-33,-39,-99,60,-437
-2,-41,-42,-19,-57,-42,-37,19,-221
-35,-32,-44,-51,-50,-7,-62,9,-272
23,-25,-31,5,-31,-45,-51,85,-70
52,-89,-84,17,-117,-85,-140,111,-335
-24,-35,-79,-43,-20,-75,-100,27,-349
-12,-60,-48,34,-14,15,-41,32,-94
-34,-65,-129,-43,-145,-93,-147,46,-610
-35,-70,-74,-17,-133,-33,-114,41,-435
-40,-58,-45,-32,-46,-28,-61,3,-307
-62,-103,-128,-88,-193,-143,-243,-19,-979
21,-20,-40,-5,9,-33,-32,6,-94
20,0,-29,15,-36,-14,-25,29,-40
-1,-51,-62,-27,-91,-103,-118,-8,-461
-30,-16,-23,-9,-42,-1,-50,15,-156
22,-69,-54,-9,-62,-58,-72,25,-277
20,-82,-99,-7,-98,-33,-98,118,-279
-21,-51,-60,-19,-68,-63,-83,-14,-379
-17,-12,-18,-4,-23,-16,-33,-13,-136
5,-124,-85,-24,-143,37,-70,92,-312
-6,-44,-40,10,-44,-10,-39,19,-154
-75,-92,-95,-53,-109,-61,-101,2,-584
-42,-53,-43,-29,-60,-48,-101,-31,-407
-5,-103,-83,-18,-128,-45,-104,30,-456
22,-30,-12,51,-21,-42,-32,-10,-74
-47,-80,-135,-31,-83,-28,-96,25,-475
8,-50,-67,19,-81,-13,-78,88,-174
-12,-21,-10,13,-43,-4,-35,8,-104
-23,-30,-54,-25,-42,-37,-52,49,-214
52,-48,-106,-41,-85,-115,-142,85,-400
-6,-88,-117,-29,-126,-72,-102,83,-457
32,-3,-66,15,-61,-30,-43,65,-91
-57,-50,-96,-35,-33,-119,-136,13,-513
-4,-17,-36,-2,-56,-8,-63,33,-153
-36,-35,-55,-42,-87,-35,-85,-11,-386
-35,-86,-93,-6,-115,-42,-106,52,-431
-3,-64,-27,5,-32,-19,-34,26,-148
-25,-36,-53,-40,-85,-73,-111,-28,-451
-55,-400,-360,8,-500,-111,-455,142,-1731
-36,-335,-358,-3,-493,-146,-415,293,-1493
29,-29,10,85,-6,-13,-63,54,67
48,-102,-83,-13,-100,-92,-95,85,-352
-28,-9,-29,-35,-25,-74,-85,-25,-310
-17,-82,-63,-26,-114,-88,-113,0,-503
-11,-22,-52,1,-60,-28,-121,52,-241
-2,-15,-25,3,-28,-29,-26,-19,-141
3,-57,-98,-62,-124,-136,-189,11,-652
-13,-94,-107,-57,-182,-144,-165,-7,-769
45,-70,-68,8,-133,-76,-100,52,-342
10,-109,-213,-108,-218,-260,-391,11,-1278
-5,-20,-28,14,-36,-40,-78,-5,-198
32,-42,-54,0,-51,-11,-30,59,-97
-25,-53,-103,-53,-93,-35,-122,53,-431
-41,-75,-77,-57,-66,-60,-82,9,-449
-4,-72,-101,-64,-129,-109,-173,23,-629
0,-44,-74,-17,-95,-50,-87,13,-354
-158,-162,-293,-188,-361,-135,-348,53,-1592
-14,-28,-50,-33,-19,-42,-58,38,-206
39,-51,-59,-5,-35,-34,-53,52,-146
-33,-59,-40,-17,-46,-40,-59,-30,-324
-21,-42,-43,-28,-93,-57,-95,-12,-391
-2,2,1,2,-28,-24,-41,11,-79
44,-36,-22,40,-81,-45,-101,58,-143
17,-45,-52,-21,-56,-67,-67,27,-264
-27,-28,-45,-19,-20,-17,-41,15,-182
63,-32,-98,30,-32,-11,-61,83,-58
6,-77,-66,-16,-101,-53,-96,44,-359
-61,-162,-175,-79,-256,-102,-205,89,-951
-3,-89,-113,-67,-153,-116,-188,-20,-749
13,-48,-35,-16,-56,-42,-28,13,-199
-50,-38,-69,-10,-71,1,-74,29,-282
-22,-7,-17,3,-34,-44,-63,14,-170
-13,-27,-35,6,-27,8,-23,39,-72
-11,-9,-16,-2,-24,5,-61,35,-83
-13,-75,-104,-28,-123,-69,-113,32,-493
27,-4,-45,26,-43,17,-47,53,-16
23,-51,-108,-17,-98,-64,-116,66,-365
-2,-55,-63,-43,-90,-78,-80,20,-391
3,-17,-6,-3,-61,-44,-62,21,-169
-20,-88,-78,-18,-125,-33,-95,42,-415
-83,-74,-141,-73,-184,-167,-274,-34,-1030
-62,-32,-91,-66,-146,-167,-280,-97,-941
-5,-53,-62,-35,-97,-49,-67,41,-327
-84,-41,-113,-85,-142,-187,-286,-94,-1032
8,-18,-29,-4,-12,-35,-16,33,-73
-21,-103,-142,-71,-166,-82,-214,88,-711
-53,-77,-61,-29,-110,-48,-93,28,-443
-36,-72,-62,-15,-92,-27,-88,29,-363
-21,-42,-47,-35,-65,-31,-84,-29,-354
-52,-75,-66,-30,-97,-42,-127,12,-477
-76,-92,-114,-77,-57,-103,-129,43,-605
29,-27,-7,30,-25,-33,-19,19,-33
93,-146,-122,33,-137,-45,-191,175,-340
-8,-28,-41,-26,-32,-46,-61,-19,-261
11,-52,-62,-11,-112,-38,-94,73,-285
-67,-34,-113,-91,-78,-106,-160,-65,-714
-8,-57,-78,-27,-111,-5,-58,76,-268
-88,-147,-160,-46,-253,-133,-265,6,-1086
39,-1,-39,15,-63,-20,-68,70,-67
-31,-68,-60,24,-55,-43,-117,28,-322
5,-11,-43,21,-62,-14,-83,55,-132
-58,-60,-78,-14,-23,-16,-49,-12,-310
-43,-43,-67,-41,-73,-43,-156,3,-463
-15,-30,-61,-30,-53,-12,-48,42,-207
12,-14,-11,-10,-17,-24,-23,19,-68
32,-96,-98,31,-138,-11,-146,121,-305
49,-26,-6,26,-73,-79,-62,6,-165
-18,-47,-44,-6,-63,-17,-32,25,-202
17,-73,-67,-15,-83,-66,-97,67,-317
0,-88,-117,-54,-29,79,-19,104,-124
-14,-101,-88,-38,-132,-68,-76,54,-463
6,-53,-61,11,-141,-123,-148,-3,-512
-21,-45,-50,-34,-42,-35,-57,10,-274
-15,-27,-40,-20,-63,-43,-84,19,-273
153,-112,-71,45,-80,-41,-130,204,-32
-53,-41,-55,-57,-74,-33,-95,19,-389
14,-18,-17,10,-36,-34,-40,36,-85
2,-17,-28,1,-14,-17,-29,39,-63
-26,-46,-45,-23,-74,-7,-37,17,-241
12,-13,-14,13,-17,-12,-27,12,-46
-22,-48,-29,-24,-88,-28,-89,24,-304
-22,-64,-50,-2,-45,-41,-105,-22,-351
2,-27,-37,-25,-29,-6,-32,17,-137
-49,-56,-110,-91,-133,-123,-200,-6,-768
7,-39,-58,-13,-91,-54,-81,39,-290
-29,-65,-47,1,-86,-19,-74,5,-314
-61,-47,-39,-70,-69,-20,-95,-32,-433
-8,-49,-37,-9,-29,-38,-66,31,-205
3,6,-29,-10,-58,-53,-71,2,-210
11,0,-19,15,-26,-4,-24,22,-25
-13,-9,-27,-29,-46,-33,-49,-2,-208
30,-66,-74,6,-49,-68,-109,24,-306
-22,-46,-26,0,-52,-5,-40,1,-190
51,-21,-1,62,-26,-26,-9,77,107
11,-46,-41,18,-84,-23,-27,57,-135
-91,-116,-107,-34,-144,-14,-94,0,-600
-26,-92,-109,-10,-137,-54,-86,72,-442
-50,-143,-133,-52,-176,-43,-137,66,-668
-9,-35,-46,0,-67,-14,-58,28,-201
-9,-110,-158,-43,-88,-81,-253,165,-577
-114,-197,-195,-77,-275,-127,-258,-8,-1251
106,-101,-117,-87,1,-206,-369,291,-482
-27,-77,-71,-61,-70,-36,-74,51,-365
-14,-35,-29,10,-45,-10,-40,11,-152
-11,-38,-51,-35,-76,-28,-73,3,-309
-20,-124,-162,-80,-145,-59,-180,143,-627
26,-27,-24,-1,-6,-21,-17,9,-61
-1,-37,-36,-9,-37,-19,-48,7,-180
-4,-75,-68,-44,-102,-50,-87,57,-373
-469,-928,-811,-381,-1233,-605,-1296,-109,-5832
-10,-71,-94,-2,-93,-5,-77,43,-309
68,21,-37,120,-66,-48,-132,143,69
-29,-53,-87,2,-89,21,-67,67,-235
70,-37,-81,25,-60,-61,-102,59,-187
-12,-45,-47,15,-88,-35,-72,30,-254
-39,-87,-57,-30,-77,-80,-90,2,-458
-32,-44,-57,-11,-92,-34,-72,39,-303
-20,-90,-87,-3,-136,-66,-142,55,-489
16,-20,-36,-18,-71,-67,-72,0,-268
29,30,-45,7,-46,-52,-74,12,-139
-22,-43,-54,9,-39,-34,-53,9,-227
-79,-28,-74,-84,-74,-68,-138,-62,-607
-91,-149,-201,-116,-201,-61,-214,47,-986
-45,-89,-93,-49,-73,0,-84,25,-408
25,-82,-61,-3,-56,-60,-60,78,-219
-31,-39,-60,-16,-63,-43,-88,18,-322
3,-59,-44,0,-78,-48,-93,29,-290
9,-33,-21,21,-30,2,-53,82,-23
-2,-47,-58,-34,-66,-25,-59,26,-265
10,-9,-21,-8,-33,-30,-24,18,-97
-11,-13,-4,10,-22,-2,-17,28,-31
-8,-29,-23,39,-56,-10,-26,33,-80
-20,-52,-68,-23,-101,-69,-82,7,-408
-33,-82,-69,-21,-96,-37,-109,34,-413
2,-29,-33,-6,-39,-25,-16,11,-135
95,33,40,123,0,-40,-76,103,278
-9,-43,-46,-28,-51,-42,-55,0,-274
-65,-124,-115,-59,-135,-30,-142,22,-648
-17,-34,-34,-16,-40,-15,-36,14,-178
1,-29,-50,23,-29,-26,-58,27,-141
-106,-42,-87,-90,-91,-88,-179,-67,-750
-40,-44,-86,-19,-96,-30,-114,26,-403
32,-39,-45,27,-121,-70,-137,93,-260
-27,-43,-62,-37,-93,-20,-81,39,-324
-112,-47,-90,-117,-148,-159,-274,-104,-1051
38,-56,-65,34,-106,4,-33,71,-113
-10,-15,-22,-11,-34,1,-32,6,-117
-58,-97,-112,-7,-154,-41,-146,39,-576
-4,-65,-57,-32,-94,-42,-68,38,-324
-24,-42,-60,-1,-66,-39,-86,-11,-329
68,-54,-52,45,-92,-54,-82,80,-141
-37,-52,-85,-32,-4,-83,-121,34,-380
-11,-32,-37,-19,-71,-30,-40,30,-210
-15,-11,-10,-11,-6,-5,-9,8,-59
-5,-53,-67,-32,-60,-48,-72,4,-333
-1,18,-16,20,25,-7,-23,-19,-3
2,-111,-132,-96,-59,-73,-116,35,-550
-11,-18,-75,-17,-22,-73,-55,25,-246
-28,-124,-99,-45,-150,-110,-216,-47,-819
-18,-30,-49,-27,-30,-13,-37,12,-192
-51,-120,-154,-45,-150,-68,-189,91,-686
17,-52,-68,4,-82,-77,-101,28,-331
12,-5,-44,-34,-45,-61,-85,44,-218
-11,-54,-50,-23,-57,-35,-49,6,-273
-1,-12,-19,-10,-40,-24,-19,21,-104
21,-55,-54,-4,-112,-51,-63,34,-284
10,-152,-132,29,-208,-42,-154,132,-517
9,-16,-27,-31,-60,-52,-66,-13,-256
-51,-158,-174,-69,-197,-248,-315,-5,-1217
1,-50,-102,-1,-84,-64,-109,84,-325
79,-15,20,44,31,-35,-16,104,212
-34,-58,-88,-6,-106,-69,-142,42,-461
15,-34,-45,56,-59,-17,-65,9,-140
-31,-60,-64,-29,-67,-38,-62,8,-343
-41,-75,-77,-31,-135,-76,-99,17,-517
-27,-47,-77,-63,-113,-98,-151,3,-573
-26,-45,-125,-67,-113,-138,-198,-26,-738
-20,-55,-39,-20,-53,-60,-83,10,-320
-23,-61,-58,-18,-87,-29,-79,63,-292
-19,-22,-34,-53,-21,-62,-60,-15,-286
-15,-46,-62,13,-78,-23,-58,30,-239
141,-59,-64,-96,4,-130,-162,299,-67
-19,-27,-54,-8,-61,-58,-93,12,-308
33,-90,-71,6,-86,-26,-68,70,-232
-9,-23,-27,-21,-18,-9,-21,4,-124
-55,-62,-92,-23,-113,-59,-139,38,-505
44,-85,-101,21,-111,-97,-67,101,-295
-15,-49,-42,25,-75,2,-69,93,-130
-36,-18,-29,-20,-34,-22,-45,-11,-215
14,-39,-56,5,-60,-30,-71,73,-164
-54,-128,-149,3,-189,-96,-198,-3,-814
-10,-6,-54,0,-55,-27,-66,15,-203
31,-78,-69,-28,-86,-114,-93,10,-427
-27,-23,-73,-53,-87,-67,-95,30,-395
-17,-59,-76,-31,-122,-82,-114,54,-447
125,-85,-93,29,-31,19,-50,148,62
-179,-282,-195,-84,-327,-141,-360,12,-1556
-6,-20,-12,-9,-46,-18,-55,0,-166
-37,-27,-57,-28,-83,-29,-70,13,-318
-6,-29,-43,-12,-45,-68,-80,-26,-309
-24,-63,-65,-35,-81,-12,-64,45,-299
-41,-56,-71,-54,-103,-79,-130,-11,-545
135,-34,-4,180,-64,-83,-133,122,119
-25,-136,-164,-64,-169,-156,-208,106,-816
2,-12,-31,-16,-60,-67,-93,35,-242
-34,-351,-344,6,-347,-135,-376,185,-1396
-21,-27,-53,-15,-50,-17,-102,50,-235
-1,-20,-27,-12,-29,20,-4,34,-39
20,-43,-77,-13,-109,-35,-65,79,-243
16,-56,-54,19,-71,0,-47,67,-126
-16,-36,-52,-20,-51,-42,-69,13,-273
-40,-62,-98,-105,-135,-116,-167,-11,-734
6,-53,-65,7,-71,0,-51,43,-184
-89,-105,-160,-107,-194,-149,-261,67,-998
-60,-116,-121,-61,-157,-56,-157,57,-671
7,-15,-33,4,-35,-18,-50,20,-120
-9,-5,-21,-42,-38,-45,-79,12,-227
-12,-34,-62,-35,-27,-23,-64,46,-211
-24,-64,-74,-33,-108,-77,-98,1,-477
12,-23,-28,3,-29,-17,-30,4,-108
-9,-53,-60,-54,-64,-65,-113,43,-375
-27,-61,-86,-53,-92,-62,-88,-3,-472
4,-12,-11,8,-20,-2,-8,3,-38
16,-51,-34,33,-95,18,-37,78,-72
-69,-83,-128,-58,-193,-80,-209,59,-761
-68,-117,-94,-47,-147,-31,-113,38,-579
-14,-89,-81,-18,-113,-64,-109,39,-449
2,-92,-66,16,-114,-34,-100,72,-316
-47,-78,-116,-88,-119,-155,-215,57,-761
-3,-6,-37,-9,-34,-13,-27,8,-121
-5,-11,-13,5,-25,-12,-27,6,-82
11,-10,0,17,-8,-8,-18,12,-4
49,-134,-187,-59,-189,-192,-266,146,-832
-6,-46,-79,-2,-126,-100,-204,46,-517
7,-8,-8,10,-33,-30,-37,21,-78
-22,-8,-32,-17,-47,-44,-94,-2,-266
18,-38,-76,-1,-95,-86,-100,26,-352
-41,-41,-43,16,-70,-16,-72,27,-240
-73,-85,-124,-11,-103,-19,-147,5,-557
-5,-37,-28,9,-64,-25,-41,28,-163
12,-14,-8,-1,-7,1,-7,17,-7
18,-22,-49,-23,-98,-24,-44,37,-205
-41,-42,-41,10,-71,-18,-89,4,-288
-7,-65,-67,-24,-47,-41,-61,30,-282
-34,-47,-62,-3,-74,-33,-74,12,-315
-31,-6,-9,-24,-35,-33,-53,-24,-215
-85,-99,-160,-135,-153,-130,-272,-36,-1070
12,-83,-106,29,-112,-57,-136,18,-435
-3,-59,-80,-43,-107,-64,-105,-8,-469
-21,-56,-54,-43,-81,-33,-64,15,-337
-75,-104,-101,-19,-118,-44,-128,11,-578
18,-10,-21,5,-11,-29,-31,23,-56
4,-34,-48,-2,-43,-38,-81,33,-209
-35,-12,-44,-44,-46,-34,-48,-10,-273
2,-36,-33,17,-45,3,-40,41,-91
12,-77,-73,-13,-66,-100,-156,87,-386
-43,-67,-74,-27,-114,-102,-146,-28,-601
-5,-19,-23,-21,-36,-21,-33,19,-139
81,-35,-33,67,-64,-74,-87,89,-56
-35,-56,-77,-40,-120,-91,-129,-29,-577
-32,-41,-83,-39,-86,-91,-140,15,-497
3,-105,-108,-6,-118,-97,-148,31,-548
-31,-70,-90,-7,-90,-29,-103,84,-336
-7,-33,-40,5,-61,-40,-90,42,-224
15,-43,-73,-25,-87,-65,-98,10,-366
-30,-34,-53,-19,-46,-14,-55,10,-241
-12,-103,-109,-48,-102,-70,-95,49,-490
-67,-89,-79,-33,-114,-49,-142,11,-562
25,-23,-61,-13,-89,-69,-99,20,-309
-1,-91,-134,-29,-95,-57,-136,95,-448
-44,-60,-59,-36,-76,-37,-76,13,-375
-106,-107,-163,-93,-149,-113,-223,8,-946
-88,-157,-175,-9,-50,-41,-102,-19,-641
-29,-24,-24,-1,-26,-29,-38,-4,-175
6,-30,-26,-1,-22,-17,-31,27,-94
8,-1,-1,38,-12,-15,-32,34,19
-15,-37,-34,18,-52,-23,-49,6,-186
10,1,-12,21,-41,-51,-66,1,-137
-33,-96,-114,-58,-129,-40,-126,45,-551
17,-61,-48,-31,-65,-19,-18,63,-162
-2,-27,-16,-1,-14,-13,-52,33,-92
5,-101,-101,-43,-106,-45,-101,84,-408
-19,-78,-40,-5,-96,-78,-112,28,-400
28,-77,-62,27,-95,-59,-122,53,-307
-26,-40,-69,-9,-83,-21,-79,71,-256
6,-82,-131,-27,-32,-147,-207,106,-514
10,-68,-100,-11,-104,-103,-145,26,-495
-66,-74,-142,-99,-128,-125,-159,8,-785
-23,-104,-72,5,-156,-73,-165,-6,-594
-58,-57,-90,-63,-70,-56,-109,15,-488
34,2,-22,-5,-47,-54,-111,56,-147
-10,-54,-36,12,-86,-26,-77,63,-214
-10,7,-8,-1,9,-5,-6,-3,-17
25,8,-5,-2,3,-3,1,13,40
-17,-27,-37,-4,-17,-19,-56,10,-167
55,-69,-122,-6,-127,-92,-221,133,-449
-18,-138,-118,-51,-147,-89,-167,53,-675
4,-88,-108,26,-148,-9,-118,94,-347
0,-5,-8,4,-17,-4,-23,9,-44
25,-84,-137,50,-124,-24,-135,113,-316
10,6,-11,0,-14,-8,-4,12,-9
-23,-18,-31,6,-47,-14,-42,21,-148
25,-36,-57,-6,-2,-14,-50,48,-92
-7,-42,-28,-14,-23,-30,-68,26,-186
-48,-93,-129,-71,-158,-63,-165,62,-665
-48,-54,-65,-48,-39,-29,-72,-15,-370
16,-57,-92,-24,-49,25,-59,67,-173
-17,-12,-27,-9,-43,-41,-72,-21,-242
-44,-70,-50,-4,-72,-10,-89,18,-321
-9,-41,-38,-7,-21,-28,-46,2,-188
-80,-135,-148,-49,-41,6,-74,-30,-551
-87,-187,-182,-69,-274,-152,-302,41,-1212
-10,-21,-93,-7,-101,-93,-148,2,-471
-37,-65,-54,-6,-100,3,-70,42,-287
-5,-36,-68,-8,-59,-53,-69,-2,-300
8,-75,-52,-15,-44,-89,-89,31,-325
-12,-51,-67,13,-96,-62,-111,0,-386
247,-182,-199,111,-73,-27,-314,400,-37
17,-58,-32,-2,-50,-59,-114,88,-210
6,-124,-215,-72,-325,-397,-544,-45,-1716
12,-37,-29,13,-43,-15,-44,49,-94
-9,-40,-69,-24,-82,-70,-92,-4,-390
34,-94,-104,-57,-61,-149,-228,101,-558
76,-98,-109,36,-63,3,-65,123,-97
-5,-17,-32,22,-45,-47,-101,15,-210
21,-70,-59,13,-70,-31,-56,40,-212
-54,-67,-74,-19,-85,-47,-149,-8,-503
5,-42,-49,3,-56,-60,-83,1,-281
-25,-102,-85,-84,-49,-43,-94,54,-428
-31,-33,-56,-14,-58,-50,-65,-1,-308
-17,-18,-23,2,-29,-20,-40,14,-131
-15,-35,-64,-16,-57,-27,-55,43,-226
-39,-67,-96,-7,-93,3,-100,53,-346
7,-72,-102,-4,-84,-25,-83,49,-314
-30,-113,-117,-23,-125,-33,-132,93,-480
2,-14,-50,-26,6,-28,-91,-3,-204
2,-37,-42,29,-58,9,-63,46,-114
-10,-23,-32,-19,-33,-35,-44,-10,-206
0,-22,-45,14,-56,-16,-89,47,-167
-5,-93,-46,-50,-68,-80,-102,56,-388
52,-72,-100,0,-121,-61,-100,26,-376
-76,-405,-424,-206,-586,-346,-642,90,-2595
-29,-73,-63,-40,-93,-4,-80,10,-372
-25,-45,-57,-1,-71,-58,-89,-6,-352
-71,-115,-143,-28,-83,-33,-108,31,-550
4,-14,-15,10,-15,-29,-28,-3,-90
-17,-21,-9,7,-22,-19,-30,-4,-115
83,-45,-66,16,-21,-30,-101,136,-28
-6,-36,-46,-15,-71,-47,-61,11,-271
-5,-47,-48,-27,-72,-45,-90,4,-330
-5,-7,-11,-10,-28,-12,-41,2,-112
-65,-127,-144,-88,-231,-137,-218,-20,-1030
-21,-21,-43,-32,-47,-11,-45,12,-208
-59,-52,-81,-46,-93,-50,-96,10,-467
-37,-185,-185,-105,-290,-211,-259,-7,-1279
-4,1,-42,-36,-43,-37,-115,8,-268
-26,-118,-136,-46,-176,-100,-172,62,-712
21,-10,-27,-18,-39,-66,-90,10,-219
-1,-10,-16,-19,-11,-18,-16,9,-82
-4,-58,-72,-10,-100,-87,-120,55,-396
42,-45,-48,-6,-96,-52,-70,56,-219
-10,-10,-20,-8,-24,-12,-30,3,-111
68,-4,6,49,-78,-8,-56,92,69
7,-4,-49,-17,-61,-62,-66,38,-214
-30,-56,-86,-2,-25,-17,-40,-24,-280
45,-73,-78,-46,-103,-151,-145,13,-538
-4,-12,-11,9,-13,-9,-8,5,-43
11,-16,-26,7,-26,-11,-14,24,-51
41,-23,-43,10,-107,-31,-71,118,-106
-21,-74,-83,-47,-130,-39,-121,55,-460
-35,-19,-77,-31,-94,-69,-96,52,-369
-3,-31,-37,-19,-56,-49,-69,15,-249
28,-53,-35,40,-95,-34,-75,26,-198
-85,-94,-172,-111,-181,-139,-211,22,-971
-5,-88,-91,-32,-92,-19,-90,81,-336
26,-1,-20,53,-43,-73,-136,67,-127
-82,-51,-85,-71,-148,-66,-141,-7,-651
5,-90,-88,-34,-170,-92,-226,47,-648
-11,-61,-66,-11,-88,-28,-90,47,-308
-45,-56,-57,-6,-99,-55,-92,37,-373
24,-6,2,27,-23,-43,-27,14,-32
-54,-66,-86,0,-128,-29,-121,65,-419
-29,-38,-47,-14,-12,-31,-60,-6,-237
-26,-25,-30,-21,-19,-33,-31,-12,-197
-21,-46,-21,12,-105,-6,-75,41,-221
17,-34,-82,-2,-56,-7,-62,89,-137
37,-66,-63,-5,-9,-64,-95,75,-190
-182,-238,-287,-61,-124,-20,-186,-23,-1121
6,3,-5,3,0,4,4,7,22
21,-25,-46,2,-79,-79,-89,32,-263
13,-35,-28,-10,-25,-45,-60,20,-170
-26,-66,-84,-55,-87,-91,-148,48,-509
1,-14,-18,-16,-16,-8,-10,1,-80
13,-11,-19,-24,-24,-77,-99,-2,-243
8,-23,-29,3,-47,-30,-55,34,-139
-27,-80,-137,-36,-162,-46,-167,44,-611
-65,-88,-95,-49,-96,-28,-100,14,-507
28,-53,-22,8,-8,-80,-81,29,-179
-43,-68,-62,29,-66,-15,-70,30,-265
-7,-14,-16,8,-8,2,-15,11,-39
-26,-18,-25,-26,-17,-10,-39,-39,-200
-17,-50,-51,-30,-58,-43,-50,-10,-309
-21,-111,-90,14,-114,-4,-95,48,-373
19,5,-31,12,6,-42,-70,51,-50
-49,-75,-80,-29,-87,-29,-76,2,-423
-50,-54,-65,-19,-53,-35,-77,2,-351
-6,-64,-47,15,-80,-23,-62,12,-255
-50,-2,-93,-64,-55,-30,-101,51,-344
32,-48,-50,31,-81,-12,-31,64,-95
-20,-128,-97,38,-115,12,-153,88,-375
0,-38,-58,-5,-83,-34,-82,45,-255
-160,-243,-319,-137,-434,-131,-367,143,-1648
-169,-250,-287,-117,-432,-119,-433,152,-1655
-16,-23,-37,-29,-20,-20,-44,-2,-191
56,-105,-100,34,-148,-22,-114,135,-264
-8,-31,-14,10,-30,-15,-44,31,-101
76,-31,-35,54,-55,-109,-98,51,-147
-24,-19,-73,-50,-30,-77,-78,-15,-366
73,-142,-180,-78,-204,-176,-355,295,-767
-84,-123,-128,-24,-196,-59,-153,66,-701
36,-152,-199,-26,-246,-107,-230,125,-799
-22,-56,-102,12,-94,-33,-111,11,-395
26,-40,-126,3,-91,-64,-73,66,-299
-461,-779,-732,-286,-1177,-349,-1162,54,-4892
-94,-149,-159,-82,-207,-129,-234,-34,-1088
35,-24,-35,49,-38,-70,-116,68,-131
-30,-55,-71,-40,-126,-107,-136,-15,-580
45,-80,-98,20,-137,-51,-98,99,-300
-42,-117,-79,-46,-136,-73,-113,51,-555
-109,-154,-194,-126,-229,-142,-235,-26,-1215
-105,-111,-144,-39,-55,10,-68,-17,-529
45,9,-29,29,-5,5,-57,85,82
-22,-61,-58,-23,-83,-20,-67,13,-321
94,-123,-83,91,-82,-112,-212,138,-289
200,-89,-113,-25,-6,-80,-80,164,-29
-25,-90,-80,-3,-129,-74,-132,77,-456
-177,-108,-188,-75,-98,-42,-168,-53,-909
-88,-176,-170,-60,-260,-123,-236,20,-1093
82,-134,-118,33,-140,-94,-165,73,-463
721,-303,-387,16,100,-687,-894,724,-710
13,-104,-185,-51,-215,-134,-196,107,-765
-33,-156,-218,-116,-255,-252,-379,77,-1332
-288,-423,-488,-157,-669,-317,-711,-20,-3073
-95,-111,-93,-34,-185,-90,-195,-18,-821
109,42,-27,64,-22,-102,-161,121,24
-22,-60,-70,-2,-119,-8,-86,50,-317
56,-56,-110,88,-137,-41,-163,208,-155
56,-75,-66,34,-131,-56,-149,126,-261
150,35,-9,152,32,-133,-81,202,348
-48,-132,-144,-36,-104,-61,-142,38,-629
-62,-474,-446,14,-342,-157,-434,383,-1518
78,-174,-166,-20,-24,-70,-221,147,-450
-229,-157,-305,-217,-236,-46,-417,-28,-1635
34,-118,-109,11,-81,-40,-94,122,-275
59,-17,-46,37,-19,-20,-62,104,36
-195,34,-159,-147,-100,-199,-337,-86,-1189
105,-62,-123,63,-274,-81,-250,246,-376
-37,-109,-113,-32,-146,-91,-143,-42,-713
54,-161,-220,-132,-222,-331,-373,183,-1202
-31,-15,-138,-62,-64,-69,-104,46,-437
78,-160,-109,9,-193,13,-132,197,-297
507,-343,-454,48,-756,-477,-698,677,-1496
53,-97,-197,12,-234,-66,-214,170,-573
-25,-16,-24,8,-47,1,-61,52,-112
-25,-118,-134,-30,-148,-57,-141,54,-599
-37,-110,-126,-68,-179,-125,-198,53,-790
-43,-68,-113,6,-194,-42,-164,79,-539
-67,-131,-124,-73,-195,-72,-195,27,-830
-13,-74,-69,19,-92,-37,-102,61,-307
19,-39,-59,11,-70,-52,-106,81,-215
3,-50,-63,-17,-40,-41,-69,45,-232
-83,-130,-94,-26,-161,-22,-141,26,-631
20,-9,-6,13,-27,-16,-19,24,-20
-40,-40,-39,-13,-90,-34,-84,24,-316
29,-26,-58,28,-37,-95,-105,-4,-268
30,-40,-49,-9,-11,-28,-46,60,-93
-22,-58,-82,-2,-86,-48,-98,-5,-401
-7,-108,-96,-34,-120,-56,-110,61,-470
-76,-108,-132,-28,-194,-18,-149,75,-630
-3,-120,-151,-49,-80,-125,-114,21,-621
85,-109,-84,-24,-64,-118,-130,93,-351
-52,-78,-104,-12,-60,-38,-96,19,-421
0,-153,-197,52,-301,-109,-258,110,-856
-53,-129,-196,10,-211,31,-186,150,-584
17,-41,-47,25,-51,-70,-90,73,-184
-77,-169,-265,1,-194,-68,-189,96,-865
-45,-172,-134,-28,-160,-43,-107,95,-594
-6,-40,-45,7,-58,-15,-32,22,-167
-27,-26,-44,-1,-51,-8,-48,2,-203
-48,-96,-99,-84,-80,-104,-139,-37,-687
42,-46,-60,12,-86,46,-24,51,-65
-42,-63,-93,-41,-73,-35,-78,38,-387
34,-89,-76,20,-101,-53,-123,72,-316
-2,-6,-16,-1,-9,-13,-7,2,-52
-10,-21,-30,-5,-15,-10,-26,9,-108
-24,-20,-41,200,-34,10,-199,155,47
61,-140,-132,11,-124,-119,-182,68,-557
-7,-47,-51,-17,-49,-18,-54,26,-217
-23,-101,-139,-22,-189,-169,-230,31,-842
-21,-37,-14,-3,-18,-35,-39,3,-164
-16,-96,-118,-35,-177,-82,-183,75,-632
-75,-93,-93,-38,-124,-42,-114,18,-561
-3,-1,-31,-8,-27,-25,-36,5,-126
-17,-136,-186,-96,-21,-35,-123,145,-469
44,-46,-32,9,-60,-54,-69,55,-153
-7,-50,-67,-23,-132,-37,-91,77,-330
36,-46,-49,37,-45,-53,-72,69,-123
17,-29,-40,-10,-51,-56,-73,19,-223
-56,-164,-183,-66,-214,-132,-298,37,-1076
14,-32,-57,-23,-50,-34,-59,58,-183
-27,-50,-84,-44,-62,-81,-125,61,-412
-57,-135,-167,-65,-223,-106,-253,9,-997
-14,-52,-65,17,-113,-30,-74,40,-291
-63,-20,-63,-63,-43,-73,-92,-55,-472
87,-84,-116,-11,-42,-82,-211,146,-313
17,-63,-155,-45,-217,-116,-283,142,-720
111,-200,-184,47,-119,-132,-166,109,-534
-14,-101,-125,-31,-117,-54,-164,54,-552
-13,-29,-64,-34,-62,-21,-46,32,-237
-8,-66,-104,-63,-76,-74,-142,35,-498
29,-44,-39,14,-78,-67,-94,43,-236
-21,-20,-30,-30,-45,-39,-75,-16,-276
-7,-26,-31,-6,-16,-18,-29,17,-116
-7,-14,-31,-14,-21,-18,-26,13,-118
-36,-46,-109,-51,-110,-76,-138,21,-545
-16,-88,-111,-43,-157,-15,-109,108,-431
116,-301,-379,-93,-538,-292,-330,334,-1483
129,-164,-201,39,-78,-2,-208,271,-214
6,2,-18,12,-23,-1,-27,25,-24
-3,-25,-19,12,-18,-14,-39,1,-105
-21,-20,-19,-23,-15,-9,-33,-8,-148
-61,-62,-66,-45,-93,-52,-93,-12,-484
-65,-95,-87,-35,-74,-55,-104,17,-498
9,-26,-60,-10,-47,-26,-32,66,-126
-1,-21,-24,-1,-23,-12,-21,27,-76
-10,-31,-46,19,-42,-25,-61,0,-196
7,-39,-30,1,-59,-18,-64,44,-158
-2,-31,-52,-13,-68,-43,-68,22,-255
-10,-39,-35,-31,-51,-39,-30,16,-219
2,-59,-48,-33,-52,-36,-60,20,-266
-13,-82,-126,-50,-117,-79,-180,103,-544
-117,-141,-263,-45,-264,-50,-265,124,-1021
2,1,-14,38,-54,-33,-40,15,-85
-68,-68,-99,-75,-117,-39,-106,19,-553
-2,-65,-60,-23,-100,-107,-138,-1,-496
107,-227,-411,-1,-224,-212,-418,330,-1056
239,-469,-464,-192,-371,-553,-564,491,-1883
-5,-77,-76,21,-126,-28,-88,66,-313
-204,-99,-194,-195,-253,-152,-372,-58,-1527
-9,-41,-45,-30,-31,-33,-53,22,-220
217,-12,-237,25,-92,-217,-340,309,-347
26,-70,-85,30,-104,2,-78,122,-157
2,-60,-53,6,-106,-26,-108,82,-263
6,-35,-40,-14,-105,-61,-89,21,-317
-101,-75,-104,-87,-121,-25,-121,41,-593
-82,-74,-106,-76,-125,-31,-125,34,-585
-95,-64,-110,-70,-135,-52,-126,36,-616
-91,-82,-105,-72,-144,-40,-138,29,-643
-99,-10,-54,-48,-63,-48,-116,-33,-471
-26,-9,-8,2,-5,-13,-23,-14,-96
2,-35,-47,30,-83,-14,-51,61,-137
-8,-48,-23,26,-75,-4,-75,50,-157
36,-101,-147,-20,-82,-52,-138,150,-354
-5,-15,-17,2,-21,-29,-43,10,-118
-17,-11,-57,-11,-64,-13,-73,34,-212
16,-90,-84,-34,-137,-168,-228,52,-673
9,-48,-36,17,-56,-31,-58,16,-187
-33,-91,-85,9,-104,-47,-116,17,-450
-6,-83,-71,8,-75,-1,-71,76,-223
-35,-80,-66,-17,-80,-12,-43,20,-313
5,-45,-62,-15,-97,-52,-82,43,-305
23,-38,-59,-37,-38,-28,-54,45,-186
-15,-6,-26,-10,-36,-24,-27,-3,-147
11,-38,-53,-1,-42,-38,-91,26,-226
9,-24,-31,-5,-39,-32,-29,28,-123
-34,-56,-62,-20,-59,-40,-82,-12,-365
-10,-47,-23,19,-59,-48,-83,15,-236
-9,-18,-28,-14,-22,-20,-29,9,-131
-13,-47,-39,8,-20,-14,-37,24,-138
16,-61,-17,0,-6,-39,-24,-4,-135
-9,-30,-26,1,-37,-28,-42,17,-154
-57,-28,-63,-27,-51,-43,-110,-33,-412
-5,-75,-75,-31,-47,-32,-84,57,-292
-58,-74,-88,-55,-92,-61,-100,-35,-563
3,-6,-41,-10,-53,-45,-67,16,-203
-13,-38,-37,-21,-35,-17,-24,17,-168
-6,-37,-7,4,-27,-4,-46,34,-89
15,-15,-17,4,-7,-38,-23,3,-78
-38,-23,-68,-45,-101,-63,-107,2,-443
1,-8,-26,-1,-16,-25,-25,21,-79
-81,-98,-89,-31,-129,-19,-115,30,-532
-20,-34,-70,-48,-96,-55,-103,9,-417
-55,-72,-98,-56,-153,-33,-124,40,-551
-44,-69,-101,-51,-61,-62,-119,37,-470
-11,-14,-20,16,-51,20,-35,44,-51
21,-142,-126,29,-165,-40,-168,170,-421
-114,-126,-164,-39,-98,-11,-145,19,-678
-15,-86,-90,-52,-100,-80,-82,21,-484
0,-92,-90,32,-117,-24,-116,54,-353
-4,-55,-46,-28,-68,-49,-59,14,-295
-62,-71,-82,-47,-55,-59,-94,-31,-501
1,-84,-93,-57,-131,-163,-209,20,-716
-31,-86,-87,-3,-51,-24,-82,12,-352
2,-26,-49,-27,-38,-61,-75,37,-237
-2,-46,-58,-2,-50,-35,-70,38,-225
-8,-14,-8,5,-41,-4,-26,18,-78
-78,-77,-84,-16,-64,-34,-117,-26,-496
-11,-92,-120,-73,-113,-82,-158,105,-544
-7,-47,-30,-9,-55,-38,-48,32,-202
-2,-35,-38,-21,-41,-24,-36,15,-182
-23,-42,-43,-3,-29,-16,-66,56,-166
-109,-106,-95,-64,-145,-53,-146,29,-689
49,-82,-54,-6,-52,-7,-94,99,-147
-65,-74,-67,-25,-111,-64,-136,-60,-602
-58,-76,-129,-56,-145,-69,-192,29,-696
61,-28,-44,64,-66,-51,-40,60,-44
2,-8,-24,10,-40,-22,-38,10,-110
5,-42,-126,-45,-84,-97,-153,32,-510
-41,-48,-78,-78,-29,-38,-93,24,-381
-75,-109,-113,-40,-116,-25,-166,1,-643
3,-72,-73,-1,-62,-44,-83,12,-320
-63,-37,-69,-40,-161,-121,-191,8,-674
20,-25,-22,1,-1,-32,-40,35,-64
-67,-117,-115,-30,-174,-73,-217,42,-751
5,-30,-35,-25,-48,-25,-49,12,-195
-123,-112,-256,-151,-183,-98,-189,2,-1110
-1,-44,-36,-3,-17,-16,-34,11,-140
-395,-750,-1036,-680,-1206,-1093,-1557,-85,-6802
-101,-123,-151,-83,-153,-89,-199,33,-866
-110,-37,-72,-105,-89,-90,-176,-89,-768
-2,-103,-112,-1,-106,-38,-134,55,-441
-27,-108,-105,12,-166,-24,-118,61,-475
-62,-44,-46,-42,-72,-52,-101,-50,-469
-39,-88,-113,-36,-131,-80,-161,-3,-651
0,-52,-45,-16,-58,-14,-69,8,-246
81,-58,-15,-13,-13,-84,-94,83,-113
-55,-85,-69,-63,-133,-66,-101,-9,-581
-14,-54,-59,3,-100,-42,-76,25,-317
-130,-105,-121,-120,-143,-139,-244,-99,-1101
-60,-24,-76,-43,-84,-120,-176,-27,-610
-35,-23,-27,-43,-31,-34,-65,-32,-290
-52,-92,-118,-39,-166,-45,-161,68,-605
-19,-54,-65,-24,-46,-32,-52,39,-253
-11,-118,-114,-10,-118,-83,-106,18,-542
-10,-41,-58,-29,-42,-32,-34,10,-236
-40,-117,-198,-82,-248,-152,-260,83,-1014
-55,-66,-137,-44,-68,-78,-116,58,-506
0,-18,-20,1,-25,-16,-28,13,-93
-12,-21,-42,-24,-24,-15,-39,28,-149
-12,-21,-31,-9,-8,-14,-43,9,-129
7,-72,-61,-14,-60,-33,-56,46,-243
5,-31,-41,1,-42,-16,-38,16,-146
23,-32,-56,-40,-16,-66,-97,18,-266
-25,-23,-29,-31,-43,-48,-50,3,-246
-21,-28,-50,15,-65,-20,-89,31,-227
6,0,-23,12,-21,-49,-65,14,-126
-54,-73,-45,-18,-109,-43,-83,2,-423
-54,-107,-123,-57,-143,2,-133,88,-527
-17,-29,-38,-12,-80,-58,-78,8,-304
-74,-197,-206,-25,-279,-132,-278,103,-1088
-53,-114,-161,-69,-233,-153,-309,44,-1048
-44,-116,-90,-39,-145,-74,-135,45,-598
-18,-34,-59,-21,-41,-37,-63,35,-238
-21,-116,-125,-43,-205,-140,-177,62,-765
-60,-78,-115,-34,-94,-75,-146,57,-545
-158,-169,-230,-125,-283,-169,-299,-58,-1491
-23,-42,-60,-54,-52,-27,-52,-5,-315
7,-39,-80,-35,-42,-71,-92,15,-337
-28,-122,-138,-37,-161,-107,-154,55,-692
-15,-62,-53,-26,-76,-53,-88,3,-370
-178,-158,-193,-119,-268,-90,-272,5,-1273
-1,-19,-33,-11,-22,-31,-40,33,-124
-108,-183,-202,-15,-121,-51,-140,-32,-852
149,-134,-227,-26,-154,-144,-372,326,-582
19,-66,-56,-14,-102,-49,-71,31,-308
22,-2,-32,0,-40,-35,-44,20,-111
-112,-176,-163,-79,-215,-78,-221,46,-998
-6,-76,-111,42,-116,-92,-176,88,-447
3,-19,-15,6,-20,0,-37,9,-73
-215,-154,-281,-153,-348,-127,-389,30,-1637
-114,-72,-117,-121,-105,-93,-213,-77,-912
-36,-34,-62,-31,-46,-26,-83,19,-299
-70,-150,-209,-14,-112,-49,-97,-7,-708
1,4,-84,-29,-96,-34,-135,110,-263
16,-96,-39,42,-52,-9,-95,108,-125
-41,-87,-82,-17,-93,1,-95,52,-362
-55,-92,-95,-32,-87,-24,-87,51,-421
-2,13,-27,-12,-30,-31,-55,-5,-149
-38,-92,-115,-50,-191,-107,-202,15,-780
-29,-116,-110,-12,-132,-52,-164,29,-586
-7,-40,-43,18,-63,-43,-71,5,-244
23,-59,-63,-63,-21,-105,-124,89,-323
10,-30,-34,-5,-61,-4,-20,25,-119
81,-18,-16,90,-28,-13,-96,89,89
-25,-98,-130,-76,-75,-121,-186,-23,-734
-28,-70,-70,-45,-88,-55,-124,-14,-494
-11,-27,-40,-21,-32,-15,-44,43,-147
25,-48,-39,1,-27,-37,-39,24,-140
6,-25,-38,-13,-28,-20,-19,17,-120
-44,-96,-84,-72,-150,-84,-142,40,-632
-96,-15,-69,-111,-135,-143,-199,-105,-873
-30,-120,-131,-55,-131,-112,-176,57,-698
-32,-77,-72,-38,-30,-18,-37,6,-298
47,-51,-96,-4,-111,-115,-189,102,-417
-110,-151,-196,-40,-59,26,-118,-33,-681
-425,-600,-661,-238,-846,-306,-924,89,-3911
-15,-34,-47,-32,-52,-14,-41,13,-222
-24,-53,-62,-28,-61,-11,-46,34,-251
-107,-109,-166,-45,-51,-3,-84,-29,-594
-45,-78,-146,1,-132,-52,-220,51,-621
3,-19,-37,-6,-30,-26,-47,31,-131
-86,-120,-147,-16,-60,-14,-116,-7,-566
99,-83,-144,-29,-25,-35,-135,192,-160
-65,-135,-114,-13,-142,-104,-208,-3,-784
-124,-384,-379,-88,-525,-157,-506,166,-1997
-4,-31,-42,-21,-39,-37,-47,27,-194
24,-95,-47,21,-160,-78,-152,76,-411
-6,-33,-81,-23,-65,-64,-55,33,-294
-46,-137,-152,-10,-190,-69,-180,56,-728
-42,-37,-76,-22,-53,-45,-77,0,-352
-44,-61,-87,-6,-124,-95,-130,11,-536
-4,-11,-60,-33,-54,-104,-142,-14,-422
1,-48,-65,-25,-94,-91,-140,46,-416
-12,-29,-30,-8,-30,-28,-53,1,-189
-13,-65,-46,-4,-72,-18,-42,41,-219
-15,-22,-52,-30,-70,-38,-90,16,-301
-26,-17,-34,-23,-17,-20,-27,-14,-178
-14,-57,-79,-30,-59,-29,-60,35,-293
-69,-137,-144,-2,-70,-33,-88,3,-540
-75,-83,-118,-12,-168,-62,-153,20,-651
-36,-47,-59,-37,-61,-43,-79,22,-340
-29,-46,-110,3,-108,-81,-187,-66,-624
-51,-79,-119,-31,-62,-20,-81,10,-433
-84,-114,-124,-31,-70,-30,-80,-3,-536
-180,-244,-281,-118,-322,-109,-337,32,-1559
3,-104,-106,-9,-151,12,-115,103,-367
-101,-142,-123,-24,-68,-49,-97,-18,-622
19,-7,-8,10,-19,-39,-44,30,-58
-35,-84,-101,-4,-64,-54,-94,32,-404
-20,-131,-105,-9,-180,-85,-164,33,-661
-85,-51,-112,-25,-69,7,-76,-9,-420
-10,-44,-35,-1,-16,-20,-89,29,-186
-29,-48,-85,-6,-115,-44,-151,36,-442
14,-24,-59,18,-56,-14,-85,43,-163
-80,-124,-143,-32,-80,-28,-105,-31,-623
-94,-54,-82,-109,-118,-98,-189,-73,-817
-4,-15,-22,-8,-44,-17,-46,16,-140
73,-46,-76,28,-33,-64,-122,111,-129
28,-75,-110,-63,-132,-59,-111,92,-430
7,-4,-20,-11,-19,-27,-35,20,-89
-115,-244,-231,-48,-304,-28,-242,153,-1059
8,-22,-39,-43,0,-46,-76,47,-171
-50,-70,-89,-39,-95,-43,-88,19,-455
-17,-39,-37,-7,-31,-17,-28,0,-176
-3,-62,-92,-24,-109,-131,-151,-27,-599
-12,-31,-30,9,-14,-15,-35,4,-124
4,-8,-23,-4,-23,-30,-62,4,-142
30,3,-9,29,8,-29,-42,-3,-13
-21,-50,-41,0,-62,-38,-55,25,-242
-49,-103,-127,-29,-155,-97,-175,28,-707
50,-129,-160,89,-263,-57,-289,228,-531
31,-48,-53,-29,-85,-135,-205,67,-457
-23,-19,-47,-14,-118,-66,-124,-12,-423
-16,-163,-216,-51,-255,-182,-245,53,-1075
27,-128,-169,8,-118,-75,-258,173,-540
-23,-71,-94,-17,-86,-42,-106,28,-411
-2,-47,-60,5,-82,-87,-135,40,-368
173,38,-13,91,-72,-85,-92,59,99
18,-43,-110,-55,-91,-75,-117,86,-387
-29,-74,-97,-69,-116,-122,-178,13,-672
63,-58,-50,24,-57,-96,-116,82,-208
40,-94,-63,0,-81,-84,-137,50,-369
-5,-19,-23,-28,-17,-42,-29,18,-145
-40,-40,-41,-20,-45,-22,-42,-13,-263
6,-70,-98,-31,-117,-112,-130,30,-522
-16,-58,-87,10,-95,-8,-81,41,-294
-19,-40,-61,-48,-86,-52,-95,1,-400
-185,-161,-222,-105,-252,-167,-310,3,-1399
-10,-83,-116,20,-112,-71,-179,78,-473
-5,-79,-122,-21,-148,-30,-138,143,-400
116,109,120,24,-32,-28,-84,228,453
23,-138,-134,18,-200,-112,-243,124,-662
-36,-243,-269,-169,-316,-250,-416,102,-1597
11,-131,-161,-11,-236,-175,-231,54,-880
1,-43,-61,-11,-100,-22,-51,66,-221
-108,-92,-124,-89,-199,-59,-215,44,-842
-19,-61,-93,17,-118,-7,-71,32,-320
7,-71,-128,-4,-133,-35,-131,85,-410
-72,-105,-112,-57,-143,-17,-108,43,-571
-35,-99,-133,-51,-130,-25,-133,95,-511
-90,-84,-98,-25,-126,18,-93,48,-450
-74,-114,-90,-38,-147,3,-111,51,-520
-28,-88,-101,-37,-126,-96,-150,43,-583
-27,-158,-217,-62,-327,-174,-266,51,-1180
8,-63,-51,6,-100,-86,-137,28,-395
-58,-64,-81,-28,-92,-55,-108,13,-473
-137,-203,-204,-52,-282,-11,-248,87,-1050
-29,-84,-55,41,-89,1,-103,42,-276
-11,-49,-50,7,-81,-25,-67,8,-268
0,-72,-70,-28,-66,-50,-72,21,-337
-33,-27,-31,-23,-51,4,-56,2,-215
66,-81,-125,15,-139,-55,-323,97,-545
19,-103,-126,-3,-106,-25,-116,128,-332
-6,-31,-37,-12,-24,4,-29,34,-101
17,-94,-86,-21,-110,-122,-147,53,-510
-49,-73,-55,-24,-91,-14,-65,41,-330
-33,-43,-69,1,-93,-20,-70,69,-258
23,-169,-228,-55,-290,-197,-382,146,-1152
129,-173,-260,-2,-315,-288,-565,358,-1116
-73,-159,-173,-68,-248,-127,-226,47,-1027
-19,-25,-37,-22,-35,-1,-38,3,-174
-58,-86,-97,-5,-45,-18,-50,-4,-363
22,-30,-40,-9,-45,-25,-36,17,-146
-9,-75,-105,-27,-151,-24,-132,89,-434
-31,-56,-50,-19,-101,-51,-80,7,-381
-25,-18,-27,-10,-35,-14,-27,17,-139
-29,-82,-74,-50,-60,-50,-74,19,-400
42,5,-32,-15,-7,-54,-59,53,-67
-92,-128,-145,-40,-204,-110,-225,18,-926
-7,-19,-32,-19,-19,-11,-16,10,-113
7,-5,-15,0,18,-17,8,15,11
5,-59,-94,-13,-76,-20,-70,99,-228
192,-94,-26,241,-62,-109,-136,158,164
-8,-24,-22,-19,-22,-15,-41,-1,-152
6,-87,-69,17,-83,1,-73,59,-229
-25,-86,-110,-71,-127,-61,-127,55,-552
-58,-44,-47,-17,-60,-45,-56,-29,-356
-1,-65,-66,-35,-19,-59,-102,43,-304
-318,-327,-301,-102,-427,-89,-440,-14,-2018
116,-93,-65,35,-27,-205,-187,213,-213
-21,-32,-40,-8,-66,-40,-63,6,-264
-14,-64,-55,-14,-32,-13,-33,22,-203
-30,-73,-87,-2,-123,-94,-118,-13,-540
-43,-59,-123,-42,-140,-71,-164,-16,-658
83,-154,-219,-35,-253,-107,-188,250,-623
52,-76,-99,14,-81,-10,-102,130,-172
8,-3,-23,30,-19,-25,-28,8,-52
-35,-105,-149,-25,-89,-76,-90,13,-556
-1,-117,-143,24,-161,-95,-145,57,-581
-41,-98,-104,-21,-151,-50,-194,98,-561
-8,-50,-58,-20,-31,-12,-37,34,-182
-11,-33,-26,-3,-30,-6,-26,12,-123
5,-45,-57,-2,-65,-30,-77,39,-232
-25,-12,-30,-19,-37,-38,-36,22,-175
-22,-17,-32,-20,-35,-40,-38,23,-181
0,-96,-101,13,-115,-36,-125,118,-342
-22,-144,-111,4,-93,-28,-191,105,-480
-18,-56,-57,-33,-44,-30,-66,-7,-311
26,-62,-26,14,-9,-9,-27,56,-37
-44,-121,-143,-21,-225,-92,-395,161,-880
-22,-40,-55,-40,-92,-61,-111,30,-391
110,-79,-46,142,-22,-102,-155,118,-34
127,-20,-132,-36,-16,-92,-247,197,-219
64,-33,-122,19,-114,-47,-134,159,-208
17,-18,-89,8,-78,-90,-142,15,-377
-17,-101,-99,0,-121,-8,-157,69,-434
39,-134,-206,-63,-275,-245,-340,119,-1105
27,-13,-36,-5,9,-36,-66,81,-39
-103,-186,-180,-115,-233,-143,-282,86,-1156
-75,-74,-187,-73,-190,-110,-252,42,-919
-31,-75,-92,-9,-119,-30,-106,62,-400
-52,-90,-110,-22,-115,14,-85,74,-386
178,-313,-301,368,-515,156,-564,815,-176
238,-149,-147,-55,-84,-247,-422,273,-593
-45,-184,-221,-91,-287,-91,-238,144,-1013
330,-31,-142,178,-211,108,62,290,584
-11,-90,-110,-1,-191,-41,-137,59,-522
-56,-60,-71,-29,-101,-61,-98,-21,-497
-184,-592,-735,-191,-1015,-537,-1033,91,-4196
-17,-102,-112,-24,-154,-116,-189,9,-705
-76,-35,-73,-61,-46,-52,-115,-29,-487
-21,-83,-78,-13,-87,-78,-106,22,-444
-16,-201,-279,-60,-348,-118,-369,181,-1210
-8,-54,-84,-28,-86,-40,-92,67,-325
-8,-35,-15,11,-49,-34,-32,1,-161
-45,-57,-47,-18,-73,-47,-79,36,-330
-11,-45,-52,-27,-39,-29,-56,25,-234
-294,-154,-291,-212,-270,-75,-442,-42,-1780
-89,-135,-218,-131,-238,-173,-323,61,-1246
-3,-39,-81,-61,-80,-63,-92,24,-395
-9,-28,-24,6,-24,-8,-24,-2,-113
61,-113,-251,-16,-287,-133,-291,217,-813
78,33,0,53,-40,-69,-160,130,25
-16,-104,-78,-19,-110,-43,-113,12,-471
-72,-109,-132,-29,-176,-24,-159,66,-635
-30,-6,-46,-21,-25,1,-29,63,-93
-23,-80,-115,54,-159,-42,-180,109,-436
-84,-225,-389,-96,-259,-43,-271,196,-1171
-30,-145,-160,-82,-100,-97,-198,44,-768
-60,-80,-81,-32,-108,-27,-98,17,-469
8,-65,-92,-15,-81,-50,-109,35,-369
154,51,-61,66,-63,-101,-82,234,198
-57,-116,-88,-29,-143,-28,-142,19,-584
38,-103,-109,-84,24,-131,-159,123,-401
2,-24,-27,4,-47,-27,-41,-6,-166
5,-49,-60,-42,-79,-75,-85,36,-349
-95,-138,-129,-58,-230,-118,-247,-8,-1023
-13,-10,-20,-19,-28,-20,-24,8,-126
19,-119,-225,30,-213,-107,-227,123,-719
10,-22,-35,-2,-24,-32,-40,8,-137
18,18,22,69,-42,-35,-68,26,8
-24,-63,-93,-22,-105,-95,-120,40,-482
68,-64,-128,0,-58,-141,-189,34,-478
-13,-61,-61,-7,-96,-48,-97,42,-341
-159,-345,-337,-93,-440,-100,-409,136,-1747
26,-122,-152,-46,-105,-102,-202,157,-546
64,-318,-277,-83,-426,4,-319,400,-955
-1,-21,-68,-7,-43,-27,-51,29,-189
-36,-90,-103,-22,-144,-85,-135,22,-593
-122,-253,-247,-129,-367,-167,-327,29,-1583
-84,-58,-102,-13,-110,-40,-149,57,-499
-4,4,-32,-5,-28,-22,-37,7,-117
-64,-104,-100,-55,-154,-63,-151,1,-690
32,-61,-178,-54,-184,-52,-226,206,-517
-15,-14,-22,1,-22,0,-27,3,-96
-100,-110,-224,-139,-220,-195,-340,-35,-1363
-55,-86,-80,6,-113,5,-83,60,-346
-39,-90,-80,9,-124,-25,-93,55,-387
-69,-98,-102,-29,-135,-26,-119,33,-545
-91,-102,-93,-21,-142,-1,-125,56,-519
-53,-86,-84,-26,-128,-52,-106,44,-491
-92,-100,-100,-56,-125,-34,-109,9,-607
-69,-98,-93,-47,-123,-36,-128,28,-566
-79,-93,-93,-47,-124,-38,-125,25,-574
-76,-79,-81,-26,-121,8,-97,65,-407
-69,-103,-103,-62,-130,-8,-110,38,-547
-61,-85,-82,-42,-147,-19,-109,42,-503
-63,-102,-99,-34,-143,1,-118,66,-492
-47,-99,-94,-29,-128,-42,-103,40,-502
-68,-70,-86,-12,-130,-12,-91,58,-411
-59,-101,-92,-20,-106,-24,-97,37,-462
-57,-87,-81,-5,-118,10,-102,72,-368
-56,-91,-101,-22,-114,16,-105,67,-406
-80,-87,-89,-44,-139,-3,-96,44,-494
-62,-106,-114,-70,-165,-34,-95,39,-607
-88,-82,-84,-46,-141,-9,-113,32,-531
-31,-132,-105,-45,-137,-109,-182,15,-726
-36,-80,-92,-14,-127,-16,-117,33,-449
17,-159,-219,14,-224,-38,-214,218,-605
55,-58,-54,66,-75,-35,-90,101,-90
-49,-115,-126,-21,-75,-39,-91,29,-487
92,-97,-63,72,-94,-106,-121,106,-211
12,-158,-226,-83,-282,-170,-308,171,-1044
1,-57,-107,-32,-124,-111,-177,9,-598
-47,-64,-59,-16,-55,-30,-98,1,-368
-45,-95,-90,5,-131,16,-104,104,-340
-22,-122,-97,-1,-124,-1,-96,79,-384
-91,-103,-92,-16,-133,8,-104,46,-485
8,-21,-44,-34,-23,-47,-63,31,-193
-33,-20,-23,-17,-43,-17,-49,14,-188
363,-196,-187,66,-58,-166,-327,464,-41
57,-23,-14,4,-8,-59,-66,33,-76
-6,-104,-98,22,-92,-75,-153,-21,-527
25,-22,-123,-31,-72,-33,-108,86,-278
40,-78,-141,-32,-104,-94,-170,154,-425
-175,-564,-553,-173,-801,-64,-592,323,-2599
-8,-22,-24,-20,4,-31,-22,15,-108
-85,-157,-200,-31,-301,0,-261,194,-841
42,-59,-74,-47,-20,-225,-67,110,-340
-2,-24,-37,-16,-18,-21,-38,18,-138
2,-86,-82,-21,-113,-106,-134,76,-464
-19,-89,-102,-66,-141,-63,-154,80,-554
-1,-64,-100,6,-157,-32,-112,69,-391
-18,-80,-63,-6,-110,-11,-60,39,-309
15,-105,-95,12,-183,-52,-125,71,-462
19,-103,-112,-54,-139,-118,-132,17,-622
-36,-90,-127,-47,-161,-60,-148,82,-587
-21,-53,-95,-42,-107,-57,-116,86,-405
72,-38,-85,97,-103,-13,-143,97,-116
-57,-91,-89,-16,-151,-34,-146,28,-556
6,-85,-180,64,-180,2,-243,162,-454
-6,-101,-81,-70,-69,-94,-234,0,-655
71,-291,-260,-34,-373,-269,-478,233,-1401
-64,-210,-193,-60,-280,-148,-245,35,-1165
-35,-143,-177,-13,-219,-86,-256,21,-908
-29,-70,-72,0,-97,-72,-134,-3,-477
-12,-78,-87,-51,-94,-95,-126,14,-529
6,-67,-62,-32,-110,-59,-103,42,-385
34,-298,-494,46,-580,-159,-582,402,-1631
168,-634,-699,13,-1105,166,-731,1074,-1748
119,-101,-171,16,-142,-156,-315,226,-524
5,-246,-268,-4,-423,-254,-373,22,-1541
-56,-139,-115,-45,-151,-106,-182,44,-750
70,-20,-35,-6,-20,-64,-79,80,-74
9,-130,-139,-10,-227,-127,-140,81,-683
17,-56,-33,0,-56,-36,-67,41,-190
-7,-19,-32,-7,-47,-46,-59,-4,-221
-21,-35,-36,1,-73,-22,-55,37,-204
-35,-82,-138,-41,-173,-122,-182,12,-761
15,-126,-194,-4,-256,-104,-257,115,-811
-19,-75,-66,-29,-65,-61,-101,16,-400
-7,-39,-58,-21,-76,-33,-75,21,-288
15,-132,-133,-10,-169,-99,-190,50,-668
-19,-80,-60,-29,-105,-56,-110,78,-381
72,-75,-95,30,-157,-112,-170,92,-415
52,-69,-38,92,-62,-86,-141,132,-120
49,-21,-63,61,-100,-72,-160,134,-172
-15,-88,-94,0,-119,-73,-128,10,-507
-24,-53,-55,-42,-80,-25,-48,33,-294
57,-24,-39,42,-68,-53,-101,70,-116
3,-46,-37,-6,-69,-73,-80,39,-269
-4,-13,-35,-10,-27,-34,-60,3,-180
-37,-52,-112,-45,-111,-83,-151,98,-493
3,3,-6,8,-13,-12,-9,14,-12
-9,-36,-28,6,-20,-30,-36,31,-122
-41,-98,-120,-40,-124,-39,-120,41,-541
-13,-49,-62,-20,-80,-58,-76,27,-331
-73,-116,-136,-6,-158,-56,-162,71,-636
60,-49,-76,-35,-99,-137,-170,96,-410
-32,-43,-91,-27,-86,-38,-131,27,-421
-146,-131,-137,-73,-224,-112,-270,-54,-1147
112,-15,-58,70,-60,-154,-179,45,-239
-34,-117,-144,-39,-143,-23,-118,86,-532
-25,-91,-86,-28,-125,-88,-124,-2,-569
-108,-182,-217,-25,-66,4,-134,22,-706
19,-64,-135,-46,-133,-139,-167,-2,-667
99,-76,-48,88,-55,-15,-79,147,61
-25,-36,-49,-24,-80,-32,-57,36,-267
9,-72,-95,-24,-95,-62,-148,34,-453
-64,-43,-62,-6,-84,-12,-107,10,-368
7,-135,-76,30,-67,-28,-145,96,-318
-105,-163,-195,-46,-109,-58,-114,-36,-826
-77,-123,-135,-44,-167,-76,-183,55,-750
18,-44,-34,9,-47,-17,-24,34,-105
-4,-48,-87,0,-79,-135,-155,5,-503
35,-112,-95,-2,-102,-55,-115,92,-354
-21,-68,-66,-45,-89,-37,-97,35,-388
-232,-111,-307,-255,-329,-292,-562,-72,-2160
-58,-81,-149,-8,-69,-36,-85,59,-427
47,-66,-54,-47,-46,-61,-98,45,-280
-44,-64,-105,-59,-92,-82,-136,2,-580
-80,-129,-125,-52,-64,-5,-79,-12,-546
64,66,-63,37,-86,-46,-136,147,-17
17,-209,-163,-23,-208,-132,-257,107,-868
-62,-51,-127,-127,-75,-178,-217,-61,-898
6,-113,-125,12,-165,-34,-128,105,-442
-25,-77,-61,-6,-82,-41,-74,26,-340
-17,-64,-64,-6,-86,-57,-100,34,-360
-29,-76,-169,-85,-110,-164,-199,70,-762
-4,-41,-22,-14,-44,-46,-68,21,-218
-51,-89,-125,-69,-146,-99,-151,74,-656
-26,-4,-96,-62,19,-92,-146,-11,-418
58,-120,-154,-29,-77,-43,-135,101,-399
-132,-32,-240,-143,-134,-63,-273,115,-902
123,-111,-110,9,-63,-150,-181,99,-384
58,-57,-69,30,-176,-135,-229,138,-440
5,-73,-77,-24,-117,-96,-142,16,-508
-92,-16,-99,-65,-145,-168,-216,-81,-882
6,-33,-37,-32,-48,-6,-34,38,-146
-53,-137,-135,-39,-170,-82,-166,57,-725
-29,-41,-64,-6,-76,-41,-116,21,-352
-23,-38,-69,-33,-96,-44,-100,26,-377
333,-507,-625,-155,-420,-290,-604,583,-1685
-14,-23,-37,-36,-50,-40,-63,11,-252
12,-79,-86,-66,-87,-61,-98,40,-425
-13,-39,-49,-19,-63,-30,-39,-13,-265
-32,-96,-144,35,-97,13,-75,89,-307
-11,-16,-21,-9,-14,-6,-25,14,-88
-47,-188,-245,-168,-313,-267,-340,26,-1542
-65,-141,-150,13,-224,-38,-231,130,-706
11,-76,-82,29,-118,-72,-141,91,-358
-5,-22,-31,-14,-44,-25,-26,25,-142
45,-84,-113,-9,-77,-100,-163,86,-415
2,-113,-156,-33,-214,-40,-180,139,-595
12,-137,-133,-15,-141,-125,-188,9,-718
-28,-70,-118,3,-187,-57,-150,53,-554
-3,-11,-74,-16,-111,-76,-159,14,-436
-57,-138,-184,-73,-138,-98,-234,49,-873
-24,-28,-54,-54,-36,-47,-53,4,-292
110,-8,-21,88,-61,7,-134,182,163
260,-239,-401,174,-218,226,-359,550,-7
27,-42,-3,-33,6,-38,-25,61,-47
29,-44,-10,-23,2,-48,-25,66,-53
-223,-331,-397,-71,-515,-3,-507,305,-1742
-30,-97,-96,34,-99,-20,-104,21,-391
-8,-17,-21,-10,-9,-16,-39,-17,-137
-44,-48,-63,1,-59,-28,-96,-16,-353
-35,-130,-126,-25,-199,-119,-198,13,-819
14,-40,-35,10,-49,-13,-52,40,-125
-74,-57,-113,27,-130,-20,-139,18,-488
8,-28,-26,7,-56,-12,-32,41,-98
-16,-33,-24,24,-77,9,-63,60,-120
23,-5,-4,56,-9,-23,-26,40,52
1,-19,-26,5,-14,-5,-4,12,-50
-40,-34,-66,-31,-36,-6,-61,-15,-289
-21,-28,-28,-2,-35,2,-50,25,-137
8,-45,-53,-8,-81,-36,-54,51,-218
65,-7,-34,106,-24,-48,-88,31,1
-13,16,0,80,-94,-49,-127,16,-171
44,-28,-89,-4,-45,29,-92,67,-118
-89,-93,-103,-80,-100,-113,-196,-29,-803
-19,-141,-148,-3,-210,-76,-225,18,-804
-74,-75,-95,-45,-108,4,-103,41,-455
59,-73,-162,123,-155,-393,-474,134,-941
-92,-93,-128,-12,-160,-30,-187,22,-680
15,-34,-51,17,-37,-31,-52,52,-121
19,-4,-38,10,-33,4,-19,51,-10
-6,-20,-22,3,-25,-30,-30,-10,-140
-22,-45,-71,5,-79,-28,-71,13,-298
-2,-62,-58,-23,-91,-26,-74,53,-283
98,-126,-205,-17,-187,-197,-381,224,-791
10,-42,-50,16,-58,-19,-63,2,-204
14,-9,-27,-2,-36,-16,-44,17,-103
-87,-87,-123,-41,-138,-35,-156,50,-617
53,-58,-85,-43,-89,-111,-194,143,-384
95,-32,-14,99,-55,5,-123,134,109
76,-42,-34,65,-64,13,-92,107,29
-23,-99,-89,-21,-132,-21,-116,87,-414
28,-29,-58,17,-104,-1,-70,99,-118
32,-57,-111,83,-183,13,-114,141,-196
-15,-9,-27,-22,-31,-21,-22,8,-139
-52,-106,-115,-44,-157,-57,-125,52,-604
45,-53,-65,-8,-87,-73,-66,43,-264
1,-93,-51,3,-89,-17,-61,53,-254
37,-78,-91,-11,-97,-35,-74,48,-301
30,-94,-42,25,-64,-34,-84,71,-192
-47,-113,-121,-59,-41,-65,-146,-45,-637
-26,-11,-11,-15,-13,-6,-39,3,-118
-8,-47,-140,-51,-106,-99,-173,16,-608
-8,-98,-221,-17,-170,-38,-235,134,-653
-82,-76,-83,-36,-113,5,-121,27,-479
20,-146,-186,-83,-126,-139,-233,89,-804
-108,-112,-172,-121,-164,-103,-217,-8,-1005
90,-141,-159,59,-174,-69,-232,190,-436
-101,-238,-241,-64,-365,-154,-316,88,-1391
-11,-65,-54,12,-97,14,-61,62,-200
-79,-147,-129,-38,-139,-16,-130,84,-594
0,-64,-58,31,-88,13,-59,45,-180
-102,-132,-215,-124,-166,-138,-234,60,-1051
2,-17,-26,-4,-23,-9,-35,11,-101
-13,-24,-23,8,-43,-25,-47,13,-154
48,-24,-27,47,-29,-60,-69,7,-107
58,-147,-86,-116,-25,-144,-141,83,-518
-11,-13,-14,-9,-14,-5,-36,-10,-112
73,-98,-207,76,-60,37,-193,259,-113
32,-85,-97,-5,-143,-81,-122,60,-441
45,-94,-74,24,-30,-36,-63,92,-136
28,-78,-84,-7,-77,-38,-90,95,-251
1,-7,-9,27,-31,-7,-36,29,-33
-2,-32,-31,10,-64,-7,-28,17,-137
-9,-19,-32,-11,-41,-4,-29,18,-127
69,-82,-133,-17,-86,-40,-99,141,-247
14,-81,-69,-23,-61,-64,-97,21,-360
-22,-36,-61,-20,-47,-3,-70,40,-219
-92,-75,-131,-4,-172,-107,-212,-24,-817
-12,-12,-41,15,-34,-21,-83,-21,-209
12,-69,-68,74,-82,-76,-123,-47,-379
-12,-27,-24,-15,-15,-12,-20,6,-119
22,-17,-55,-16,-5,-35,-45,61,-90
0,-11,-43,-9,-31,-53,-69,4,-212
22,-27,-14,17,-29,-15,-28,10,-64
-13,-21,-47,-26,-80,-33,-84,23,-281
-72,-95,-132,-29,-148,-13,-152,57,-584
65,-57,-51,1,-7,-88,-93,62,-168
8,-47,-28,9,-45,-29,-49,24,-157
-50,-46,-40,-47,-63,-38,-89,-34,-407
12,-47,-72,-17,-95,-54,-114,80,-307
27,-44,-103,-59,-76,-119,-172,45,-501
-27,-32,-55,-7,-45,-27,-55,10,-238
-49,-38,-37,-7,-54,0,-80,14,-251
-8,-205,-212,-11,-198,19,-182,174,-623
-30,-18,-20,-2,-50,-10,-53,17,-166
-43,-105,-107,-32,-130,-61,-155,50,-583
-73,-154,-178,-43,-178,-49,-197,95,-777
25,-216,-318,-10,-334,-138,-398,90,-1299
52,24,-24,5,-11,-53,-45,9,-43
-35,-53,-77,-31,-84,-15,-52,30,-317
-98,-155,-169,23,-41,-10,-89,-16,-555
-58,-106,-100,-17,-133,18,-91,84,-403
-42,-76,-132,-60,-165,-82,-122,57,-622
-63,-111,-122,-32,-154,-14,-125,59,-562
-99,-95,-121,-68,-177,8,-122,82,-592
-72,-169,-221,-46,-362,-111,-329,116,-1194
21,-55,-88,13,-37,-73,-94,43,-270
3,-53,-69,-18,-90,-58,-73,18,-340
26,-18,-12,17,-57,-58,-63,52,-113
-50,1,-51,-4,-60,-10,-88,14,-248
44,-57,-38,43,-15,-11,-54,84,-4
-299,-599,-737,-186,-971,-381,-947,211,-3909
286,-186,-185,128,-19,-91,-201,383,115
59,-61,-58,18,-55,-96,-117,73,-237
-32,-72,-76,-1,-115,-42,-112,88,-362
12,-69,-64,-6,-76,-11,-97,86,-225
-32,-171,-156,-1,-291,-113,-287,54,-997
-21,-35,-159,-41,-91,-57,-152,31,-525
-66,-74,-89,-48,-114,-21,-94,20,-486
26,-20,-26,13,-59,-29,-44,30,-109
279,-355,-359,29,-487,185,-260,757,-211
34,-79,-77,7,-64,-37,-56,93,-179
-43,-48,-33,-18,-69,-40,-54,13,-292
-23,-37,-54,-4,-64,-20,-71,24,-249
-7,-78,-118,-33,-101,-96,-130,38,-525
-27,-63,-52,-26,-50,-36,-52,5,-301
-40,-100,-148,-47,-130,-55,-157,92,-585
55,25,21,51,20,26,5,46,249
-25,-20,-25,-21,-28,-19,-28,15,-151
17,-43,-23,12,-14,-15,-23,30,-59
27,-40,-52,3,-62,6,-53,50,-121
-17,-38,-31,1,-39,-7,-61,19,-173
-60,-76,-96,-86,-113,-76,-155,11,-651
36,-57,-133,-63,-103,-94,-151,119,-446
40,-129,-147,-7,-139,-117,-183,181,-501
30,-41,-36,35,-42,-59,-78,-24,-215
-20,-37,-55,-47,-70,-60,-99,8,-380
12,-5,-39,1,-35,-47,-63,32,-144
-15,-97,-90,34,-110,-29,-115,108,-314
6,-32,-24,-17,-29,-7,-18,33,-88
-125,-343,-315,-98,-487,-232,-522,125,-1997
-25,-76,-78,6,-107,-16,-118,91,-323
-29,-32,-20,-7,-46,-34,-58,-18,-244
27,-22,-61,45,-98,-39,-148,91,-205
-9,-76,-37,37,-80,-6,-91,41,-221
-41,-92,-97,-33,-143,-20,-118,78,-466
-16,-18,-60,1,-72,15,-55,57,-148
-41,-137,-104,-29,-184,-135,-206,3,-833
-4,-80,-75,32,-146,-12,-128,57,-356
-4,-47,-40,-7,-19,-37,-65,30,-189
-121,-168,-161,-48,-185,-32,-180,101,-794
-17,-27,-39,-14,-72,-29,-56,5,-249
-50,-98,-140,-27,-167,-44,-186,69,-643
55,-58,-34,15,-50,-37,-85,68,-126
64,-131,-118,18,-103,-56,-198,132,-392
7,-68,-34,-11,-71,-30,-84,22,-269
-10,-44,-47,-43,-67,-58,-48,15,-302
-15,-29,-25,-10,-62,-16,-57,16,-198
47,-85,-70,23,-118,-61,-84,98,-250
17,-94,-66,-16,-133,-75,-116,1,-482
-12,-148,-158,-52,-173,-98,-214,114,-741
-38,-59,-51,-44,-91,-62,-94,11,-428
-4,-1,-42,-9,-28,-74,-49,10,-197
28,-71,-32,31,-31,-24,-78,46,-131
51,2,-45,71,-20,-64,-139,69,-75
0,-25,-34,-5,-48,-5,-26,31,-112
-21,-26,-47,4,-69,-80,-103,-12,-354
4,-75,-57,11,-93,0,-63,29,-244
-8,-32,-34,-8,-22,-7,-19,23,-107
-4,2,-31,-12,-27,-26,-34,3,-129
-10,-31,-32,-12,-19,-3,-17,23,-101
-6,-35,-34,-6,-23,-7,-21,20,-112
-101,-103,-144,-19,-177,-65,-200,82,-727
-9,-34,-34,12,-67,-3,-46,35,-146
8,-16,-19,4,-7,-3,-20,5,-48
-81,-119,-113,-18,-142,5,-109,50,-527
19,-25,-32,-4,-31,-44,-64,23,-158
52,-10,-62,71,-54,-56,-116,69,-106
-23,-3,-54,-55,-45,-48,-87,18,-297
8,-84,-57,-25,-24,26,-68,71,-153
35,-64,-117,-75,-97,-95,-178,183,-408
4,-23,-14,11,-16,-12,-37,34,-53
-33,-63,-64,-39,-96,-56,-72,20,-403
-30,-21,-58,-37,-65,-45,-75,22,-309
49,-52,-43,-3,26,-52,-88,69,-94
15,-42,-55,12,-92,-83,-93,49,-289
21,-32,-18,-10,-22,-33,-40,43,-91
-12,-32,-69,-24,-87,-55,-144,50,-373
71,-67,-56,46,-17,-77,-98,71,-127
8,-102,-118,47,-165,-67,-189,101,-485
-21,-20,-62,-39,-43,-54,-86,13,-312
-7,-11,-35,-6,-51,-48,-73,-4,-235
-15,-25,-54,-35,-51,-36,-64,5,-275
-30,-98,-116,34,-151,10,-148,91,-408
52,-14,-2,36,-8,-16,-30,40,58
69,17,26,72,4,-15,-12,53,214
-12,-32,-38,-36,-29,-33,-37,6,-211
-12,-73,-76,-7,-86,-14,-124,35,-357
-71,-374,-512,-210,-700,-544,-761,102,-3070
-28,-62,-40,10,-54,-10,-96,21,-259
-8,-125,-101,26,-167,10,-78,133,-310
-38,-46,-63,-3,-63,-36,-81,4,-326
-34,-44,-65,-47,-98,-76,-109,16,-457
17,-41,-38,-1,-23,-9,-51,54,-92
-636,-154,-478,-583,-678,-518,-1088,-318,-4453
-47,-116,-69,-8,-104,-79,-148,6,-565
48,-70,-84,-2,-153,-23,-63,64,-283
0,-14,-12,3,-30,-33,-35,16,-105
-79,-101,-106,-54,-120,-3,-95,51,-507
-29,-65,-78,-53,-121,-31,-104,17,-464
-15,-49,-54,-19,-71,-36,-53,42,-255
-16,-69,-45,-7,-57,-33,-79,4,-302
-10,-36,-51,-5,-73,-34,-59,8,-260
-9,-24,-42,-6,-61,-39,-56,35,-202
-121,-128,-192,-142,-287,-114,-285,-17,-1286
10,-28,-22,1,-46,-21,-40,11,-135
-52,-70,-84,-1,-115,-62,-112,11,-485
-1,-51,-83,-48,-124,-39,-110,36,-420
-33,-43,-65,-26,-67,-48,-85,11,-356
0,-11,-18,0,-12,-9,-15,2,-63
2,-25,-34,-3,-48,-9,-28,32,-113
-12,2,-14,7,-32,-6,-30,24,-61
-9,-86,-84,-5,-120,-30,-61,88,-307
24,-68,-27,68,-63,-27,-75,30,-138
-15,-27,-28,-8,-23,-18,-29,10,-138
-20,-73,-62,-27,-52,-7,-44,37,-248
32,-8,-26,12,-10,2,-29,56,29
37,-47,-34,55,-69,-47,-65,43,-127
-3,-38,-42,-34,-51,-26,-56,17,-233
-45,-83,-116,-19,-163,-9,-138,56,-517
-27,-27,-94,14,-149,-33,-112,103,-325
-1,-1,-25,-9,-9,-17,-23,7,-78
-26,-4,-12,-5,-20,2,-32,12,-85
10,-33,-49,-21,-77,-62,-90,-3,-325
-33,-72,-61,-31,-72,-1,-47,18,-299
-54,-99,-164,-95,-191,-117,-207,45,-882
33,14,3,26,-4,-31,-31,22,32
1,-34,-54,-21,-68,-33,-54,51,-212
-92,-90,-114,-61,-68,-17,-85,-6,-533
14,-49,-73,-3,-87,-53,-73,57,-267
-13,-57,-67,-29,-78,-65,-98,9,-398
-24,-86,-78,-35,-125,-89,-161,65,-533
-35,-38,-50,-71,-44,-33,-70,8,-333
2,-44,-46,-19,-49,-62,-76,34,-260
80,-53,-73,78,-119,-10,-64,93,-68
15,-75,-61,-39,-57,-72,-111,50,-350
-16,-88,-24,19,-89,-2,-58,56,-202
-3,-58,-57,-10,-83,-60,-74,34,-311
38,-76,-96,-20,-110,-54,-73,74,-317
-79,-85,-107,-40,-86,-64,-120,16,-565
-16,-37,-56,-13,-68,-39,-47,29,-247
-2,-30,-35,-9,-12,-19,-49,17,-139
-31,-37,-52,-15,-74,-28,-64,29,-272
20,-80,-101,-35,-103,-124,-175,30,-568
-19,-25,-19,-9,-25,-18,-24,5,-134
-4,-10,-17,1,-9,-9,-8,1,-55
-1,-14,-20,5,-47,-15,-44,21,-115
4,-27,-48,-33,-69,-62,-68,29,-274
17,-67,-47,31,-104,-13,-67,46,-204
-13,-37,-45,-22,-75,-28,-96,-7,-323
47,-16,-37,28,-15,-42,-46,45,-36
37,-8,-45,-3,-21,-6,-29,55,-20
-71,-107,-227,-62,-202,-19,-191,122,-757
-68,-209,-275,-187,-287,-275,-391,17,-1675
25,-54,-58,-7,-105,-89,-139,57,-370
-31,-83,-97,-30,-97,-37,-100,8,-467
-14,-4,-15,-2,-20,-12,-33,-3,-103
-25,-65,-103,-31,-146,-54,-137,25,-536
-5,-45,-31,-14,-43,-49,-79,12,-254
84,-136,-107,-14,-72,-24,-148,184,-233
-129,-144,-242,-75,-240,-107,-233,-18,-1188
-8,-52,-92,16,-137,-134,-199,27,-579
-12,-36,-55,-41,-45,-62,-83,-1,-335
-20,-43,-60,-22,-65,-34,-67,14,-297
40,-89,-136,-30,-116,-102,-185,110,-508
-18,-125,-107,16,-164,-62,-165,44,-581
-21,-15,-18,-17,-22,-32,-49,-8,-182
16,-58,-91,-23,-113,-122,-205,62,-534
-6,-62,-63,-12,-51,-40,-57,35,-256
-18,-27,-47,-19,-67,-26,-59,14,-249
77,-9,-57,14,-52,-53,-91,94,-77
-31,-46,-53,-30,-53,-31,-47,35,-256
-11,-29,-42,-5,-50,-20,-34,35,-156
-17,-71,-103,-49,-80,-62,-109,35,-456
10,-13,-27,-13,-36,-31,-22,19,-113
51,-164,-126,106,-216,-86,-175,147,-463
-49,-73,-211,-49,-258,-315,-427,-88,-1470
-35,-56,-59,-8,-65,-12,-71,30,-276
15,-145,-148,0,-231,-86,-208,126,-677
50,-87,-70,17,-103,-33,-114,141,-199
28,1,-8,11,-25,-42,-63,44,-54
-17,-14,-21,-11,-6,-5,-25,2,-97
27,-17,-37,-18,-26,-59,-84,56,-158
-11,-52,-43,-7,-69,-29,-48,28,-231
-24,-51,-63,-45,-73,-56,-89,38,-363
4,-19,-32,-2,-34,-45,-44,25,-147
-42,-110,-94,-20,-116,-76,-144,-2,-604
-24,-131,-165,-75,-198,-167,-207,-4,-971
112,-20,-52,48,0,-80,-184,100,-76
-4,-18,-34,-12,-13,-5,-27,15,-98
8,-28,-45,10,-54,-39,-50,-10,-208
-15,-66,-83,-28,-123,-20,-100,69,-366
-114,-39,-83,-95,-92,-66,-141,-72,-702
-61,-130,-155,-15,-85,-26,-90,14,-548
-5,-4,-18,-4,-30,-18,-28,11,-96
7,-15,-24,0,-16,-5,-21,11,-63
-81,-169,-218,-141,-221,-216,-300,22,-1324
-42,-80,-109,-20,-144,-96,-154,48,-597
57,-53,-59,4,-40,-120,-149,104,-256
2,-46,-41,1,-79,-23,-80,19,-247
-23,-28,-41,-15,-28,-14,-35,8,-176
-2,-57,-117,-92,-105,-149,-165,18,-669
-59,-88,-120,-24,-71,-36,-108,52,-454
-29,-54,-59,-8,-101,-42,-88,41,-340
-7,-68,-63,-34,-59,-32,-60,26,-297
-28,-19,-32,-28,-12,-48,-68,-15,-250
-12,-27,-35,-19,-49,-41,-66,1,-248
14,-25,-43,-25,-21,-78,-113,34,-257
-20,-58,-61,-16,-67,-26,-69,20,-297
12,-68,-73,-29,-140,-97,-128,24,-499
24,-17,-47,20,-61,-139,-256,51,-425
7,-37,-45,-12,-89,-59,-77,-2,-314
-27,-1,-52,19,-51,-25,-83,134,-86
-48,-78,-65,-6,-104,-56,-108,21,-444
-28,-35,-51,0,-41,-4,-50,30,-179
-11,-28,-39,-1,-45,-32,-59,42,-173
14,-48,-57,-5,-67,-65,-94,35,-287
-2,-30,-51,3,-112,-39,-71,54,-248
-33,-121,-111,-43,-173,-88,-144,50,-663
-5,-20,-41,-39,3,-24,-50,5,-171
24,-9,-29,4,-6,-14,-12,14,-28
104,-22,25,82,33,-43,-66,116,229
1,-35,-49,-12,-69,-67,-91,-5,-327
-32,-60,-59,-15,-82,-28,-62,11,-327
13,-68,-76,-12,-68,-64,-100,57,-318
2,-22,-50,-22,-44,-45,-68,15,-234
6,-58,-59,-12,-96,-17,-79,54,-261
-32,-19,-97,-49,-63,-75,-119,0,-454
-44,-104,-111,-41,-116,-82,-134,34,-598
15,-78,-107,-21,-153,-78,-135,73,-484
73,-77,-111,40,-67,-136,-171,111,-338
-31,-73,-133,-98,-127,-110,-230,89,-713
-12,-55,-46,14,-115,-64,-78,23,-333
-8,-36,-91,-40,-68,-50,-114,72,-335
-16,-29,-21,-6,-13,-31,-32,-8,-156
-3,-9,-25,-6,-24,-3,-21,11,-80
-5,-17,-15,-20,-2,-17,-16,-7,-99
-27,-30,-70,-39,-90,-43,-90,4,-385
-28,-30,-37,-30,-49,-42,-70,-7,-293
-26,-8,-14,-18,-5,-9,-19,-16,-115
-27,-28,-54,-50,-26,-19,-42,26,-220
-45,-53,-51,-10,-72,-33,-77,20,-321
-11,-22,-18,-2,-46,-38,-65,-20,-222
26,-63,-72,-21,-122,-52,-74,36,-342
4,-17,-21,17,-39,-19,-48,14,-109
-11,-23,-26,2,-32,-13,-64,2,-165
-2,-34,-44,-9,-87,-47,-52,42,-233
-21,-36,-76,-42,-101,-52,-115,31,-412
21,-68,-104,-53,-140,-145,-218,35,-672
-71,-31,-49,-54,-57,-38,-80,-35,-415
4,-1,1,9,-11,-9,-12,-5,-24
-8,-88,-57,-6,-123,-22,-75,23,-356
-37,-95,-107,-29,-58,-64,-60,12,-438
-21,-70,-103,2,-44,6,-75,26,-279
-2,-48,-35,5,-27,-3,-16,23,-103
-63,-80,-85,-38,-100,-24,-105,35,-460
-53,-102,-119,-38,-143,-23,-143,62,-559
3,-69,-49,10,-60,-3,-57,10,-215
-4,-91,-88,36,-156,-105,-159,38,-529
-43,-125,-144,-71,-199,-118,-184,38,-846
-19,-38,-47,-31,-55,-11,-43,22,-222
-92,-121,-131,-88,-118,-63,-149,22,-740
-10,-39,-59,-31,-33,-12,-52,54,-182
-24,-9,-37,-39,-53,-2,-36,35,-165
-22,-61,-63,-38,-76,-55,-124,30,-409
43,-37,-34,60,-26,-28,-57,88,9
3,-39,-31,-9,-57,-55,-75,42,-221
2,-11,-13,4,-12,1,-12,0,-41
17,-44,-56,-7,-92,-71,-92,15,-330
-8,-49,-70,-1,-104,-16,-83,77,-254
-6,-27,-39,-8,-65,-11,-39,28,-167
-55,-106,-97,-27,-84,-32,-71,33,-439
-23,-7,-48,-30,-42,-47,-67,10,-254
-27,-63,-49,-22,-70,-33,-43,35,-272
0,-35,-62,-16,-71,-50,-84,20,-298
3,-45,-48,-24,-83,-76,-75,-11,-359
-13,-70,-93,-53,-79,-101,-123,23,-509
-75,-86,-86,-23,-92,-50,-117,-19,-548
-100,-187,-204,-97,-273,-171,-257,-33,-1322
-31,-69,-138,-66,-63,-45,-84,36,-460
1,-25,-56,-17,-59,-50,-78,30,-254
-22,-131,-227,-111,-272,-193,-293,98,-1151
-17,-36,-50,-16,-51,-63,-67,-8,-308
-59,-70,-103,-22,-90,-32,-67,56,-387
-50,-62,-51,2,-74,-10,-93,29,-309
-6,-83,-115,-29,-139,-135,-160,-2,-669
16,-54,-47,-9,-81,-60,-110,-35,-380
-49,-42,-59,-33,-61,-32,-63,-2,-341
-7,-43,-56,-5,-78,-56,-95,29,-311
10,-60,-90,9,-144,-59,-117,50,-401
-25,-36,-70,-29,-92,-21,-76,42,-307
-9,-89,-90,-42,-107,-124,-152,17,-596
10,-87,-54,25,-74,-20,-80,55,-225
10,-12,-25,38,-44,-28,-39,15,-85
19,-32,-62,-26,-65,-91,-95,19,-333
-61,-6,-41,-49,-49,-96,-109,-49,-460
-22,-90,-107,-35,-107,-35,-93,75,-414
-1,-21,-18,8,-19,-24,-28,-1,-104
5,-18,-30,12,-36,-1,-54,31,-91
-69,-53,-115,-113,-124,-86,-166,20,-706
-13,-17,-62,-13,-43,-34,-78,2,-258
-34,-34,-45,-58,-76,-46,-72,31,-334
-41,-77,-110,-50,-140,-100,-148,10,-656
6,-33,-22,7,-20,-22,-19,-3,-106
21,-27,-63,-7,-48,-70,-105,13,-286
-13,-21,-48,-33,-72,-31,-69,18,-269
-24,-71,-43,12,-101,-20,-108,74,-281
-29,6,-6,-43,7,-1,-38,15,-89
-20,-55,-64,-24,-46,-59,-103,29,-342
-15,-11,-23,-5,-22,-16,-39,5,-126
-7,-50,-15,31,-40,-11,-55,54,-93
12,-27,-40,-35,-35,-13,-27,31,-134
26,-36,-34,-19,-33,-87,-85,7,-261
-31,-77,-64,24,-107,-70,-137,-40,-502
40,-76,-36,15,-15,-67,-99,56,-182
-28,-80,-80,-60,-102,-18,-49,91,-326
-116,-10,-63,-106,-57,-106,-192,-102,-752
-21,-5,-4,-1,-35,-43,-60,-4,-173
114,-61,-121,39,-48,-17,-126,147,-73
265,-204,-242,12,-186,-282,-418,313,-742
-37,-133,-121,-6,-130,-57,-143,41,-586
-16,-27,-29,-19,-30,-19,-22,17,-145
-23,-80,-79,-69,-115,-80,-126,45,-527
20,-68,-74,-47,-58,-78,-105,59,-351
-7,-24,-38,-9,-34,-32,-45,17,-172
-15,-25,-30,-18,-53,17,-29,53,-100
-29,-106,-108,-26,-121,-66,-135,37,-554
0,-20,-73,-47,-92,-50,-73,30,-325
-12,-49,-35,6,-46,-32,-40,13,-195
-64,-54,-112,-41,-129,-50,-119,-14,-583
-4,-1,-11,-8,-9,-7,-8,12,-36
1,5,-26,-14,-21,-43,-63,31,-130
10,-3,10,20,24,-11,-6,9,53
15,-39,-39,-21,-27,-44,-63,36,-182
-3,0,-29,-11,-25,-25,-32,12,-113
-8,-1,-7,-14,-21,-13,-33,9,-88
20,-106,-116,-46,-141,-122,-205,79,-637
-14,-13,-21,-27,0,-25,-50,-17,-167
-2,-25,-45,-21,-44,-20,-47,19,-185
1,70,-10,19,-7,15,-69,10,29
-14,-18,-13,-12,-31,-15,-22,-12,-137
-65,-51,-81,-84,-121,-51,-190,-34,-677
23,-86,-68,-4,-80,-69,-118,52,-350
-19,-87,-91,-27,-120,-41,-103,43,-445
-2,-94,-65,17,-108,-61,-98,53,-358
-8,-66,-76,-14,-83,-81,-86,-3,-417
15,-80,-91,-50,-80,-93,-143,73,-449
-27,-178,-226,-114,-388,-296,-351,5,-1575
-65,-186,-167,-55,-207,-35,-179,120,-774
-16,-29,-34,13,-44,-24,-53,28,-159
-14,-70,-69,-41,-90,-42,-115,17,-424
-21,-100,-67,-6,-80,-20,-111,22,-383
10,-40,-73,-26,-104,-121,-145,-24,-523
10,-51,-61,-27,-80,-26,-70,37,-268
13,-26,-34,-18,-51,-49,-56,-3,-224
-17,-83,-110,-20,-78,-86,-155,82,-467
1,-46,-57,-25,-77,-51,-62,35,-282
-72,-165,-189,-104,-189,-172,-260,32,-1119
-31,-62,-110,-47,-45,-22,-74,52,-339
-6,-19,-19,-15,-55,-21,-40,27,-148
-13,-59,-69,-28,-81,-47,-82,17,-362
3,-14,-20,-7,-5,-5,-8,10,-46
24,-67,-86,-11,-73,-45,-68,64,-262
-16,-16,-57,-16,-6,-55,-60,5,-221
-40,-27,-36,-15,-50,-2,-56,14,-212
34,-25,-49,-1,-88,-101,-99,-27,-356
47,-32,-59,-32,-10,-67,-78,77,-154
-11,-30,-33,-2,-51,-16,-40,10,-173
16,-80,-72,-10,-103,-53,-111,74,-339
27,-57,-81,1,-83,-52,-97,30,-312
-9,-45,-54,16,-70,2,-58,26,-192
44,-71,-59,22,-53,-32,-78,76,-151
-14,-26,-20,-6,-41,-22,-42,16,-155
1,-7,-27,-13,-31,2,-18,14,-79
11,-54,-25,55,-78,-17,-47,66,-89
-14,-9,-39,-20,-6,-16,-44,0,-148
-33,-72,-94,-41,-77,-54,-74,50,-395
6,-24,-40,-11,-44,-59,-70,14,-228
37,-95,-58,36,-81,-101,-177,35,-404
-43,-86,-82,-39,-128,-56,-125,14,-545
-20,-46,-67,-46,-74,-65,-88,17,-389
52,-38,10,118,-13,-43,-126,151,111
-12,-19,-12,-1,-18,-8,-15,9,-76
16,-79,-92,-12,-116,-110,-141,28,-506
5,-44,-68,-42,-3,-55,-99,90,-216
-25,-47,-39,-18,-51,-13,-51,-13,-257
32,-21,-21,0,-25,-43,-53,45,-86
-38,-82,-85,-24,-115,-63,-149,19,-537
18,-34,-71,-1,-43,-17,-98,70,-176
-6,-3,-24,4,-22,-27,-44,10,-112
-58,-41,-23,20,-77,-10,-76,21,-244
-14,-32,-39,10,-38,-32,-91,-7,-243
3,-20,-40,-3,-56,-30,-42,32,-156
-115,-35,-123,-111,-154,-103,-219,-38,-898
42,-27,-80,56,-83,-50,-118,57,-203
-12,-39,-40,-4,-25,-27,-41,41,-147
0,-24,-38,7,-72,-13,-38,23,-155
10,-25,-8,-2,-9,-12,-32,40,-38
45,-55,-53,13,-104,-75,-98,20,-307
-51,-34,-70,-1,-64,-14,-93,91,-236
-13,-21,-37,-6,-46,-23,-42,7,-181
18,12,-2,14,-9,-9,-19,-6,-1
30,-34,-23,27,-23,-27,-27,37,-40
-41,-77,-130,-1,-67,-16,-90,-2,-424
-15,-46,-36,-2,-51,-18,-46,13,-201
-46,-82,-74,-46,-68,-79,-107,14,-488
-42,-128,-145,-68,-162,-101,-149,36,-759
11,-21,-39,-9,-39,-46,-40,-2,-185
4,-53,-67,-17,-130,-60,-102,6,-419
-14,-79,-61,-25,-93,-50,-67,44,-345
23,-24,-19,6,-31,-44,-35,22,-102
-39,-39,-57,-33,-134,-83,-122,14,-493
33,-42,-89,-42,-89,-110,-123,55,-407
12,-64,-88,-42,-121,-67,-97,44,-423
-7,-12,-19,-15,-26,3,-26,10,-92
-5,-88,-83,-22,-121,-11,-93,59,-364
-28,-30,-44,-17,-60,-45,-60,0,-284
-15,-30,-19,6,-32,-23,-32,-7,-152
15,-4,-35,-6,-31,-7,-58,34,-92
-257,-10,-303,-390,-424,-729,-843,-380,-3336
9,-49,-50,-9,-92,-59,-77,25,-302
-19,-31,-36,-9,-39,-14,-43,15,-176
-24,-19,-19,5,-70,-28,-56,23,-188
-12,-107,-108,-52,-105,-103,-153,32,-608
-10,-18,-21,-12,-42,-25,-34,4,-158
-14,-99,-89,-3,-139,-67,-138,40,-509
-1,-26,-38,-26,-19,-49,-62,33,-188
-9,-22,-49,-6,-43,-49,-113,-10,-301
11,-124,-117,-38,-170,-88,-111,91,-546
14,-47,-16,51,-70,1,-48,67,-48
-51,-111,-107,-61,-149,-73,-102,-3,-657
-38,-38,-59,-11,-85,-54,-96,-20,-401
16,-43,-16,50,-76,-7,-27,37,-66
10,-24,-45,-18,-12,-5,-23,10,-107
-29,-37,-61,-33,-77,-70,-109,-1,-417
-46,-91,-84,-32,-140,-106,-121,0,-620
2,4,-31,34,-30,-7,-37,-5,-70
-35,-70,-158,-92,-201,-138,-228,25,-897
-55,-100,-98,-36,-113,-70,-126,20,-578
-4,-38,-56,-16,-47,-41,-63,33,-232
-21,-131,-201,-86,-116,-102,-159,58,-758
-51,-123,-132,-80,-171,-124,-206,-5,-892
-26,-91,-137,-168,-81,-106,-198,17,-790
-2,-14,-28,-19,-37,-39,-51,15,-175
-103,-177,-179,-73,-175,-61,-173,19,-922
-45,-36,-54,-29,-58,-27,-48,2,-295
-21,-68,-68,2,-90,-28,-75,26,-322
81,34,-48,143,-23,20,-84,62,185
-3,-39,-27,-24,-29,-34,-39,1,-194
1,-19,-30,-16,-43,-38,-36,24,-157
118,-62,-122,-41,-91,-131,-226,155,-400
-27,-45,-100,-39,-63,-45,-109,43,-385
-6,-83,-156,-110,-211,-156,-220,74,-868
-84,-168,-212,-123,-280,-198,-298,50,-1313
14,-63,-101,13,-110,-33,-96,53,-323
6,-39,-67,-9,-98,-37,-88,61,-271
-3,-32,-37,-40,-24,-54,-68,16,-242
-28,-87,-63,-39,-99,-79,-89,-20,-504
83,-171,-237,-100,-184,-70,-199,250,-628
-45,-38,-73,-38,-71,6,-52,42,-269
-4,-21,-21,-7,-23,-19,-45,22,-118
-2,-21,-20,-4,-42,-32,-57,5,-173
-2,-8,-13,4,-27,-4,-19,12,-57
-15,-41,-66,-19,-81,10,-39,57,-194
72,-39,-103,3,-29,-48,-128,129,-143
-28,3,-21,-27,-45,-57,-72,2,-245
-15,-12,-83,-61,-101,-87,-187,56,-490
-95,-104,-116,-54,-208,-108,-218,6,-897
29,-17,-29,22,-17,-21,-14,10,-37
-48,-87,-50,1,-73,-16,-86,55,-304
-4,-22,-23,-1,-13,-10,-13,10,-76
-21,-70,-49,-16,-87,-61,-85,11,-378
-25,-30,-52,-30,-28,-24,-53,-30,-272
-22,30,-96,-42,-39,-56,-143,69,-299
-11,-30,-31,-12,-22,-3,-25,19,-115
9,-39,-37,1,-46,-19,-45,10,-166
-27,-28,-65,-37,-26,-40,-72,12,-283
18,-36,-45,22,-49,-15,-60,39,-126
-26,-107,-152,-45,-200,-130,-212,-2,-874
-26,-42,-33,-19,-71,-40,-85,1,-315
38,-14,-42,-7,-110,-46,-77,45,-213
-7,-14,-15,1,-26,-6,-19,9,-77
-24,-108,-121,-86,-77,-140,-155,16,-695
-38,-60,-93,-55,-96,-89,-106,21,-516
21,-63,-40,59,-71,-38,-76,26,-182
97,-4,11,97,14,-51,-76,117,205
-9,-37,-39,-22,-38,-45,-67,7,-250
10,-31,-31,8,-34,-17,-40,27,-108
-69,-230,-317,-219,-359,-365,-507,30,-2036
0,-16,-14,0,-9,0,-17,20,-36
-5,-22,-8,13,-13,-6,-17,-7,-65
14,-26,-19,2,-22,-15,-41,34,-73
-22,-51,-46,-3,-65,-26,-66,36,-243
-70,-106,-154,-32,-93,-46,-100,36,-565
1,-63,-58,-4,-87,-7,-53,42,-229
-3,-109,-105,-120,-39,-78,-172,148,-478
32,11,6,38,-18,-5,-41,43,66
4,-74,-67,-18,-85,-63,-90,45,-348
-6,-92,-79,-15,-75,-43,-78,50,-338
6,-91,-84,-34,-105,-80,-82,35,-435
-39,-25,-49,-28,-45,-17,-85,66,-222
-12,-118,-124,-43,-150,-8,-128,109,-474
-3,-19,-33,-19,-40,-21,-40,-12,-187
-97,-50,-175,-138,-254,-233,-368,-2,-1317
0,-30,-117,-54,-43,-74,-166,50,-434
15,-65,-53,37,-63,-76,-89,24,-270
48,-125,-151,-16,-149,-53,-172,262,-356
-30,-39,-38,-32,-64,-6,-66,21,-254
-31,-49,-64,6,-90,-2,-82,8,-304
-35,-107,-112,-17,-119,-42,-100,51,-481
88,2,41,105,23,-34,-67,122,280
46,-39,-28,79,-42,-83,-72,34,-105
-18,-44,-74,-22,-81,-76,-100,-4,-419
9,-42,-91,-12,-82,-56,-87,35,-326
-55,-52,-75,0,-47,-35,-88,23,-329
68,-52,-42,62,-17,-57,-93,102,-29
-25,-50,-119,-66,-156,-55,-96,74,-493
-138,-182,-294,-76,-252,4,-255,123,-1070
35,-16,-50,28,-27,2,-55,77,-6
48,-37,-21,62,-20,-32,-15,17,2
18,-15,-32,17,-58,-2,-27,59,-40
15,-63,-87,-2,-123,-79,-109,73,-375
-39,-138,-227,3,-246,-27,-254,88,-840
111,-166,-227,-11,-157,-117,-249,231,-585
-19,-34,-56,-6,-70,-4,-69,41,-217
15,-3,-25,-13,-36,-32,-32,24,-102
26,-117,-160,3,-169,-79,-204,114,-586
60,-61,-75,59,-102,-57,-85,81,-180
-4,-29,-35,-2,-48,-37,-55,9,-201
-5,-25,-32,22,-32,14,-44,35,-67
-74,-155,-183,-79,-215,-167,-246,35,-1084
-99,-143,-150,4,-77,-20,-89,-19,-593
-160,-367,-407,-108,-464,-113,-478,169,-1928
-10,-27,-22,19,-31,-24,-54,26,-123
-64,-65,-63,-43,-121,-36,-129,37,-484
-71,-49,-73,-40,-102,-92,-161,-43,-631
-65,-105,-84,-31,-131,-3,-136,33,-522
3,-38,-48,-27,-77,-48,-52,28,-259
-38,-61,-52,-11,-70,-42,-89,-4,-367
192,-148,-188,94,-77,-176,-276,241,-338
-83,-173,-184,5,-234,-71,-287,76,-951
3,-109,-126,9,-145,-13,-129,105,-405
0,-84,-142,22,-143,-58,-190,100,-495
-38,-108,-85,-13,-132,-76,-142,-25,-619
-49,-95,-98,-37,-132,-43,-112,52,-514
-76,-111,-91,-27,-120,-24,-106,13,-542
-4,-79,-94,28,-210,-30,-115,79,-425
7,-41,-44,18,-75,-31,-68,18,-216
-66,-76,-94,-46,-110,-21,-97,57,-453
112,-126,-66,31,-24,-180,-301,218,-336
33,-50,-145,-9,-113,-80,-168,93,-439
-33,-94,-75,-5,-104,-51,-133,-25,-520
-62,-28,-74,-17,-42,-23,-93,-35,-374
12,-22,-34,-3,-22,-49,-58,14,-162
-15,-37,-58,26,-66,-43,-78,22,-249
19,-60,-59,-3,-92,-61,-92,59,-289
-19,-77,-84,-33,-93,-112,-122,22,-518
-1,-38,-21,25,-56,-23,-64,51,-127
47,-14,-4,28,-16,-27,-44,69,39
-1,-19,-12,25,-34,-22,-44,37,-70
14,12,10,44,-17,13,-39,68,105
34,-45,-28,43,-71,-48,-78,85,-108
26,4,20,52,-25,5,-27,44,99
42,4,31,55,0,2,-40,63,157
31,-60,-85,-21,-124,-111,-112,51,-431
-75,-82,-73,-20,-94,-65,-100,-5,-514
-131,-171,-175,-59,-180,-147,-287,-141,-1291
51,-59,-54,17,-59,-75,-80,43,-216
-1,-41,-108,-60,-90,-43,-135,54,-424
20,-40,-74,-5,-5,-19,-44,20,-147
-96,-113,-169,-134,-271,-213,-293,25,-1264
-144,-90,-191,-122,-259,-115,-305,-5,-1231
9,-20,-19,2,-39,-44,-62,19,-154
240,-135,-250,-278,-143,-226,-175,236,-731
-21,-43,-96,-14,-127,-134,-192,38,-589
-13,-63,-86,36,-97,-1,-76,49,-251
-46,-56,-49,-18,-37,-12,-70,23,-265
-5,-33,-69,1,-57,6,-59,57,-159
-5,-12,-14,6,-6,8,-15,21,-17
-2,-131,-175,-42,-231,-195,-337,115,-998
-34,-40,-59,-58,-67,-99,-198,8,-547
21,-257,-276,-21,-290,-142,-310,261,-1014
39,-33,-108,69,-114,-122,-205,99,-375
-13,-39,-58,-15,-97,-51,-57,23,-307
-39,-192,-169,-49,-190,-40,-163,21,-821
-135,-176,-155,-62,-212,-32,-213,13,-972
-2,-76,-97,5,-29,65,-57,95,-96
167,182,170,88,76,-42,-62,118,697
-42,-40,-35,-25,-70,-26,-65,-5,-308
-20,-61,-70,11,-79,-60,-93,18,-354
-22,-76,-91,-34,-101,13,-73,77,-307
-11,-53,-75,-32,-19,7,-71,24,-230
-29,-140,-193,-84,-248,-131,-191,123,-893
-34,-24,-68,-46,-53,-47,-106,16,-362
-44,-171,-205,-24,-229,-14,-186,105,-768
-22,-311,-540,62,-460,87,-473,325,-1332
-18,-166,-223,-106,-293,-33,-245,168,-916
-128,-267,-307,-157,-349,-112,-347,66,-1601
-6,-16,-21,5,-38,-14,-47,2,-135
-84,-122,-148,-79,-230,-100,-230,3,-990
13,-11,-64,-8,-55,-56,-93,1,-273
59,-65,-62,2,-47,-68,-109,20,-270
-84,-113,-164,-23,-113,-43,-208,19,-729
-20,-33,-37,6,-50,-38,-49,-20,-241
-26,-14,-21,11,-62,-11,-42,23,-142
21,7,0,19,-6,-22,-2,13,30
-7,-14,-17,-6,-16,-17,-18,1,-94
-9,-41,-30,-14,-39,-18,-30,10,-171
-72,-141,-180,-59,-169,-100,-215,0,-936
23,-53,-45,-12,-92,-70,-99,35,-313
-138,-191,-277,-139,-419,-132,-435,65,-1666
73,-87,-129,-17,-107,-107,-202,107,-469
-68,-160,-271,-96,-175,-87,-257,-58,-1172
-83,-185,-263,-132,-170,-144,-267,-63,-1307
-25,-34,-41,-19,-68,-36,-79,25,-277
-47,-24,-60,-9,2,-4,-41,32,-151
-35,-82,-78,-8,-77,-26,-104,33,-377
-14,6,-17,-18,-13,-13,-29,3,-95
-104,-168,-170,-28,-264,-51,-260,129,-916
-24,-43,-52,-14,-63,-35,-79,-8,-318
-45,-85,-110,-21,-167,-65,-142,93,-542
20,-31,-41,27,-20,-58,-79,-31,-213
-15,-158,-210,-70,-246,-143,-283,67,-1058
-21,-30,-56,-13,-43,1,-61,13,-210
-59,-126,-162,-6,-160,-27,-166,86,-620
6,-38,-40,19,-55,0,-55,75,-88
-71,-105,-102,-47,-150,6,-112,75,-506
-16,-23,-26,-13,-47,-65,-67,-36,-293
-130,-172,-260,-58,-118,38,-96,29,-767
3,-22,-31,-11,-32,-29,-46,7,-161
-1,-50,-30,39,-79,-23,-63,38,-169
-4,-58,-62,-32,-52,-44,-71,9,-314
-22,-1,-14,-27,-21,-65,-43,-13,-206
44,-113,-73,38,-51,-7,-71,80,-153
31,-34,-42,4,-62,2,-66,49,-118
-15,-22,-31,-9,-53,-6,-43,25,-154
-13,-30,-19,-4,-26,-8,-21,2,-119
-48,-128,-94,-6,-155,-49,-106,37,-549
-5,-16,-14,3,-22,-13,-26,9,-84
-115,-215,-268,-156,-380,-287,-416,24,-1813
21,-57,-88,2,-91,15,-58,69,-187
-22,-63,-60,-40,-87,-64,-93,2,-427
-9,-39,-38,0,-67,-80,-84,17,-300
18,-54,-57,-15,-73,-61,-72,44,-270
-67,-88,-132,-106,-169,-125,-198,-20,-905
31,-70,-78,11,-79,-65,-120,88,-282
32,-99,-160,14,-135,-40,-176,109,-455
187,-197,-283,-70,-143,-208,-356,273,-797
157,-197,-218,-41,-263,-316,-455,259,-1074
12,-44,-74,-36,-104,-74,-74,29,-365
6,-41,-30,-6,-134,-47,-83,57,-278
-66,-100,-100,-51,-135,-75,-131,-2,-660
-17,-30,-38,-12,-25,-12,-44,18,-160
-22,-36,-38,-30,-54,-27,-53,5,-255
-12,-40,-27,-11,-47,-29,-46,3,-209
-11,-40,-76,-72,-46,-38,-58,8,-333
2,-58,-36,-28,-64,-70,-72,21,-305
-21,-21,-22,-4,-24,-22,-29,-2,-145
-12,-59,-68,-38,-59,-25,-78,8,-331
-12,-44,-46,22,-99,-39,-79,32,-265
3,-59,-35,-47,-34,-74,-104,8,-342
21,-91,-107,32,-102,-46,-134,83,-344
-5,13,-4,14,-12,-28,-21,18,-25
-10,-29,-22,-22,5,-36,-22,7,-129
-71,-33,-79,-84,-56,-49,-116,16,-472
145,-173,-174,94,-357,-31,-209,340,-365
-3,-145,-120,65,-132,-21,-150,46,-460
-32,-102,-42,25,-82,-31,-67,43,-288
-40,-35,-67,-42,-43,-6,-38,48,-223
34,-22,-52,-16,-103,-55,-76,64,-226
2,-13,-42,0,-85,-3,-44,80,-105
-42,-55,-54,-14,-57,-30,-68,24,-296
-47,-57,-87,-27,-125,-47,-136,27,-499
29,-115,-173,-1,-164,-15,-221,162,-498
79,-81,-61,56,-84,-85,-120,116,-180
-24,-68,-116,-1,-101,-16,-126,86,-366
-8,-36,-40,-5,3,-41,-39,6,-160
-41,-151,-118,-20,-149,-63,-158,53,-647
-84,-96,-92,-72,-107,-49,-117,8,-609
120,-53,14,127,1,26,-47,157,345
2,-452,-499,-322,-721,-565,-717,242,-3032
-14,-24,-44,-28,-48,-47,-58,18,-245
-27,-59,-68,-17,-95,-93,-101,14,-446
4,-11,3,2,-31,-33,-35,21,-80
37,-174,-154,-41,-72,-131,-147,169,-513
-14,-33,-38,-36,-54,-45,-77,-18,-315
63,-196,-324,-35,-266,-42,-275,335,-740
-4,40,-19,37,-43,0,-42,-22,-53
-63,-64,-80,-34,-43,0,-57,0,-341
-60,-64,-76,-29,-46,-2,-55,4,-328
-58,-74,-80,-36,-45,0,-51,0,-344
-63,-70,-85,-35,-49,-6,-58,1,-365
-67,-70,-87,-32,-50,-5,-60,0,-371
-90,-91,-119,-60,-73,-30,-93,5,-551
-80,-87,-106,-40,-75,-24,-81,0,-493
-61,-38,-83,-40,-42,-29,-60,-8,-361
-84,-94,-114,-42,-76,-21,-90,2,-519
-66,-76,-96,-35,-68,-26,-75,9,-433
-90,-97,-114,-52,-82,-27,-89,2,-549
-79,-85,-102,-51,-70,-23,-77,-5,-492
-79,-69,-91,-54,-49,-19,-69,-20,-450
-94,-86,-109,-51,-85,-40,-102,-2,-569
-62,-49,-75,-36,-40,-16,-55,-2,-335
-25,-25,-41,-27,-24,-8,-35,8,-177
-26,-26,-41,-28,-25,-6,-36,8,-180
-19,-31,-37,-17,-15,1,-37,10,-145
-50,-43,-56,-43,-27,3,-44,7,-253
-39,-17,-47,3,-48,3,-56,26,-175
-59,-48,-78,-50,-91,-31,-115,-12,-484
-30,-79,-124,-1,-150,-57,-138,66,-513
-14,-58,-93,-16,-72,4,-80,18,-311
-44,-42,-53,-38,-28,6,-38,9,-228
-41,-118,-112,-22,-159,-95,-146,-32,-725
-144,-207,-183,34,-263,-49,-275,37,-1050
1,-50,-34,9,-64,-47,-96,43,-238
-49,-44,-56,-41,-28,3,-41,11,-245
-21,-71,-62,-8,-117,-25,-98,62,-340
-32,-22,-63,-37,-64,-48,-91,-4,-361
4,-49,-92,-5,-32,-20,-105,41,-258
9,-112,-76,38,-94,5,-77,110,-197
-1,-45,-45,20,-45,-48,-92,22,-234
23,-83,-104,33,-96,-64,-184,125,-350
-84,-55,-113,-41,-162,-77,-189,32,-689
107,-227,-407,-18,-251,-115,-418,371,-958
-7,-25,-34,-3,-8,-6,-8,12,-79
-25,-154,-160,-73,-195,-197,-317,-33,-1154
-96,-107,-159,-62,-206,-101,-233,-5,-969
-12,-57,-54,-2,-89,-4,-60,28,-250
-37,-68,-61,-37,-105,-2,-87,44,-353
-24,-140,-113,-27,-215,-118,-168,78,-727
-24,-30,-19,27,-18,-2,-47,8,-105
14,-65,-96,-36,-139,-214,-213,61,-688
10,-24,-56,-16,-104,-70,-85,1,-344
-64,-53,-93,-17,-120,-50,-156,47,-506
-103,-395,-362,-35,-509,-208,-442,148,-1906
14,-67,-89,-36,-124,-102,-111,73,-442
2,-55,-74,-31,-94,-84,-96,40,-392
25,-145,-159,-2,-263,-126,-205,215,-660
31,-211,-218,24,-326,-95,-281,232,-844
43,-129,-162,76,-268,-62,-284,230,-556
-37,-69,-55,-4,-50,-37,-63,18,-297
10,-207,-254,-41,-165,-31,-211,156,-743
-12,-2,-6,0,-15,-17,-17,-1,-70
-13,-34,-20,-11,-25,-16,-22,6,-135
3,-12,-15,-13,-1,-14,-11,-10,-73
9,-3,-22,-6,-10,-14,-33,-12,-91
80,-171,-221,19,-293,36,-126,275,-401
77,-190,-230,5,-300,45,-131,298,-426
30,-90,-89,31,-104,-38,-149,108,-301
73,-34,-1,109,-27,-84,-90,28,-26
-73,-391,-406,-64,-597,-277,-639,341,-2106
-53,-122,-135,-35,-178,-41,-171,89,-646
3,-19,-54,-3,-60,-38,-85,21,-235
-69,-85,-65,-50,-82,-50,-126,-45,-572
-41,-47,-61,-25,-54,-23,-74,24,-301
0,-44,-63,-22,-53,-18,-57,36,-221
20,-76,-61,-4,-35,-91,-167,80,-334
-15,-92,-80,-47,-83,-47,-99,20,-443
-29,-79,-66,-15,-89,-36,-82,16,-380
21,-39,-54,-1,-46,-82,-110,44,-267
-77,-102,-111,-85,-158,-105,-137,-7,-782
-50,-20,-35,-20,-27,-25,-57,-6,-240
9,-75,-96,-39,-88,-103,-137,49,-480
-27,-93,-191,-35,-138,-65,-149,65,-633
-36,-94,-143,-33,-181,-117,-204,63,-745
-9,-148,-168,-1,-188,-46,-184,141,-603
-193,-112,-214,-229,-195,-202,-382,-226,-1753
-16,-37,-57,-9,-82,-28,-53,16,-266
-2,-67,-99,-55,-101,-128,-147,-7,-606
20,-86,-71,-30,-117,-106,-113,38,-465
-31,-246,-240,-53,-333,-132,-259,95,-1199
94,-50,-9,81,-4,-82,-117,58,-29
-93,-13,-74,-84,-29,-48,-125,-81,-547
-54,-172,-159,-59,-232,-126,-245,-5,-1052
0,-38,-28,-22,-44,-24,-45,39,-162
-6,-79,-85,-20,-109,-57,-107,22,-441
-60,-145,-128,-44,-152,-20,-146,66,-629
1,-60,-116,-51,-95,-124,-179,33,-591
-18,-122,-133,-39,-134,-52,-151,110,-539
31,-10,-28,8,-31,-12,-22,46,-18
87,-49,-63,84,-104,-21,-59,70,-55
1,-30,-28,-3,-16,-16,-15,12,-95
-6,-17,-13,-6,-17,-1,-14,-5,-79
-13,-18,-17,-21,-32,-8,-25,5,-129
45,-57,-95,-24,-105,-188,-264,34,-654
-1,-112,-136,-11,-188,-102,-184,117,-617
-19,-32,-20,-4,-28,-44,-52,-7,-206
-12,-34,-28,12,-36,-18,-32,11,-137
44,-23,-43,25,-45,-53,-62,76,-81
-23,-42,-46,-7,-61,-40,-66,4,-281
-31,-48,-49,-22,-51,-23,-57,11,-270
-11,-47,-52,-10,-41,-35,-58,-11,-265
5,-19,-14,5,-18,-7,-16,6,-58
56,-44,-9,116,-27,2,-89,77,82
-20,-37,-104,-22,-170,-44,-136,82,-451
-26,-48,-44,-29,-91,4,-36,46,-224
-5,-93,-123,50,-195,-101,-182,54,-595
43,-112,-146,-52,-146,-112,-191,47,-669
-15,-49,-61,-18,-83,-100,-150,18,-458
6,-38,-66,-7,-67,-31,-57,26,-234
8,-101,-81,-13,-72,-86,-130,51,-424
15,-101,-93,-24,-80,-89,-123,42,-453
-6,-20,-14,2,-17,-7,-17,8,-71
-9,-60,-80,-37,-69,-56,-126,3,-434
-12,-136,-142,5,-175,-18,-148,120,-506
41,-143,-236,20,-281,-20,-268,213,-674
-80,-133,-150,-50,-166,-8,-170,39,-718
-51,-120,-97,-10,-118,-68,-120,40,-544
-55,-104,-83,2,-124,-35,-121,40,-480
-124,-61,-90,-65,-144,-98,-223,-97,-902
1,-44,-75,-8,-67,-17,-85,81,-214
3,-36,-35,-9,-70,-17,-48,38,-174
-22,-43,-44,-30,-67,-33,-54,-7,-300
-21,-61,-94,-36,-80,-40,-107,21,-418
72,-263,-342,-58,-410,-270,-412,251,-1432
-32,-63,-75,-60,-95,-58,-115,5,-493
-125,-220,-297,-196,-337,-251,-388,28,-1786
-6,-20,-16,-11,-16,-3,-19,4,-87
-10,-56,-74,-19,-57,-51,-45,38,-274
6,-4,-11,-2,-8,-4,-14,-3,-40
65,-41,-39,14,-37,-86,-123,55,-192
14,-1,-9,12,-8,-5,-5,-1,-3
-42,-52,-88,-77,-112,-90,-130,9,-582
25,-110,-104,-6,-123,-80,-101,85,-414
-32,-55,-120,-69,-93,-98,-158,17,-608
-58,-95,-83,-64,-106,-41,-128,27,-548
-49,-75,-84,-48,-118,-33,-89,35,-461
-44,-121,-67,-40,-98,-68,-111,31,-518
2,-58,-80,18,-161,9,-78,120,-228
33,-19,-34,28,-17,-62,-62,19,-114
26,-59,-74,-24,-41,-94,-136,58,-344
-53,-23,-36,1,-63,-37,-94,-20,-325
-15,-18,-45,-38,-19,-70,-106,39,-272
-37,-226,-343,-59,-437,-171,-432,318,-1387
-157,-256,-293,-152,-342,-255,-439,-86,-1980
-59,-57,-118,-118,-98,-78,-138,-32,-698
-154,-86,-130,-133,-199,-133,-306,-133,-1274
24,-149,-133,156,-270,1,-270,226,-415
229,-317,-365,-68,-67,-408,-646,264,-1378
82,-138,-230,71,-122,-65,-277,322,-357
22,-96,-105,60,-89,-107,-213,102,-426
-19,-89,-49,-22,-96,-86,-116,-7,-484
-93,-244,-307,-205,-358,-100,-388,163,-1532
43,-82,-119,7,-63,-31,-157,206,-196
-87,-140,-140,-32,-179,-102,-212,21,-871
-40,-164,-235,-177,-273,-245,-327,-1,-1462
122,-115,-85,53,-98,-68,-248,206,-233
336,31,-81,199,-40,-197,-350,353,251
-5,-131,-141,-37,-156,-125,-205,85,-715
42,-50,-90,0,-58,-48,-101,69,-236
40,-110,-210,47,-226,-108,-308,237,-638
95,-112,-198,-8,-221,-86,-179,244,-465
-45,-83,-74,-74,-105,-70,-166,68,-549
-83,-224,-442,-165,-462,-287,-569,138,-2094
-63,-135,-134,-54,-223,-116,-189,-19,-933
23,-131,-201,-44,-165,-26,-135,171,-508
86,-182,-387,-16,-335,-222,-434,216,-1274
1,-121,-219,-90,-127,-139,-314,197,-812
16,-97,-104,28,-85,-64,-176,117,-365
-133,-181,-218,-42,-355,-170,-347,24,-1422
18,-82,-176,-139,-226,-96,-228,142,-787
-23,-70,-60,-48,-75,-44,-123,56,-387
177,-203,-452,2,-259,-84,-394,384,-829
-39,-51,-60,-31,-75,-14,-78,14,-334
-40,-65,-98,-2,-50,-10,-41,6,-300
26,-217,-431,7,-380,-120,-368,231,-1252
-336,-739,-629,-193,-1043,-370,-1022,91,-4241
-22,-88,-116,-18,-156,-110,-145,28,-627
34,-177,-146,9,-148,-144,-248,167,-653
9,-100,-86,14,-136,-78,-128,57,-448
74,-125,-119,-27,-169,-183,-319,153,-715
-69,-118,-126,-49,-168,-92,-158,1,-779
-2,-80,-189,-22,-147,-32,-171,151,-492
-112,-201,-306,-32,-199,-112,-333,205,-1090
-57,-61,-101,-101,-103,-94,-173,-17,-707
-19,-84,-70,-35,-94,-100,-108,38,-472
196,66,118,164,66,-148,-138,181,505
48,-62,-81,6,-80,-124,-143,8,-428
51,-41,-68,15,-71,-113,-206,121,-312
-45,-48,-93,4,-118,-44,-124,46,-422
-8,-35,-37,-20,-60,-9,-47,30,-186
-25,-87,-103,-27,-107,-16,-87,70,-382
9,-36,-52,-27,-50,-38,-50,19,-225
-17,-47,-69,-37,-73,-3,-50,56,-240
-60,-94,-110,-48,-134,-24,-121,42,-549
-44,-96,-107,-46,-126,-34,-122,49,-526
-54,-90,-97,-42,-115,-39,-110,32,-515
-52,-100,-100,-51,-143,-36,-125,49,-558
-7,-77,-83,-9,-108,-5,-57,48,-298
-3,-10,-1,3,-13,-18,-33,11,-64
-20,-18,-21,-17,-25,-4,-35,-7,-147
-32,-41,-63,6,-87,-57,-116,18,-372
-59,-83,-109,-34,-123,-2,-116,45,-481
-14,-24,-25,28,-50,-30,-88,33,-170
28,-29,-33,-4,-58,-44,-116,15,-241
18,-63,-128,-38,-121,-118,-172,25,-597
-2,-73,-55,8,-107,11,-42,63,-197
-1,-29,-52,-29,-36,-44,-64,30,-225
-1,-18,-49,-8,-74,-44,-65,50,-209
-92,-188,-200,-62,-230,-46,-207,125,-900
3,-55,-58,-16,-72,-52,-79,8,-321
16,-24,-53,-27,-57,-26,-23,27,-167
-27,-58,-55,-4,-83,6,-79,53,-247
-8,-24,-44,3,-43,-48,-59,22,-201
-20,-13,-31,7,-53,-9,-34,21,-132
-50,-101,-92,-1,-120,-12,-98,76,-398
31,9,-8,8,18,-14,-9,26,61
-58,-61,-42,-12,-67,-11,-64,38,-277
6,-29,-51,-25,-69,-66,-70,3,-301
-52,-119,-122,-39,-151,-5,-125,83,-530
-49,-114,-104,-58,-142,-62,-142,78,-593
-7,-25,-20,-17,-32,-5,-18,15,-109
-43,-85,-185,-31,-198,19,-186,160,-549
10,-53,-80,-48,-47,-55,-54,51,-276
-54,-85,-77,19,-79,-23,-88,32,-355
-70,-136,-155,-86,-129,-137,-127,10,-830
-16,-89,-80,8,-95,-27,-95,37,-357
-34,-68,-70,-12,-107,-61,-120,36,-436
31,-31,-39,47,-102,-4,-28,51,-75
-21,-112,-104,-52,-155,-82,-120,61,-585
10,-11,-12,7,-30,-21,-6,15,-48
18,-65,-62,-12,-107,-20,-62,35,-275
-49,-76,-58,-20,-105,-83,-131,21,-501
-35,-44,-42,-17,-80,-28,-51,-23,-320
-16,-78,-61,-28,-105,-30,-83,35,-366
47,-36,-33,34,-63,-70,-70,15,-176
-36,-47,-51,-18,-54,-18,-36,15,-245
-52,-127,-131,-30,-192,-66,-183,92,-689
3,-160,-234,42,-229,-68,-250,131,-765
-78,-164,-139,-40,-163,-67,-158,42,-767
-22,-51,-99,-50,-148,-92,-202,27,-637
7,-44,-51,-19,-87,-58,-49,42,-259
-22,-7,-53,-21,-29,-40,-70,8,-234
-2,-37,-52,-39,-79,-88,-94,-46,-437
-14,-108,-115,39,-183,-39,-171,103,-488
-2,-9,-20,6,-20,2,-7,12,-38
34,-47,-26,47,-8,-43,-58,48,-53
-11,-57,-53,-13,-76,-74,-97,42,-339
23,-91,-104,18,-69,-41,-135,102,-297
-9,-45,-24,14,-51,-18,-59,46,-146
-8,-36,-59,-37,-35,-44,-95,45,-269
-1,-38,-72,-2,-64,-12,-60,49,-200
-3,-108,-107,-58,-151,-90,-155,55,-617
-31,-88,-124,-10,-90,-33,-63,41,-398
-8,-24,-34,-6,-34,-24,-41,13,-158
-37,-59,-44,-6,-67,-24,-70,9,-298
-15,-43,-53,-8,-42,-16,-52,20,-209
-42,-100,-114,45,-126,-48,-124,36,-473
-35,-34,-35,-22,-37,-12,-50,4,-221
-9,-20,-27,1,-33,-25,-35,14,-134
8,1,-28,31,-14,-16,-48,44,-22
-8,-34,-55,-12,-91,-27,-86,56,-257
55,-62,-38,41,-33,-63,-74,75,-99
-18,-20,-23,5,-39,0,-24,11,-108
-31,-100,-85,-42,-131,-127,-165,22,-659
-14,-37,-57,-30,-59,-77,-109,29,-354
35,-14,-28,9,-9,-11,-30,11,-37
-24,-33,-41,-6,-80,3,-72,55,-198
-16,-75,-69,11,-68,-51,-95,36,-327
16,-11,-41,16,-61,-38,-44,43,-120
22,-12,-34,14,-25,-17,-26,31,-47
-30,-100,-75,-9,-50,-93,-209,93,-473
-88,-100,-139,-52,-209,-42,-160,71,-719
-2,-57,-60,-27,-77,-30,-86,30,-309
35,-51,-85,25,-64,-8,-66,110,-104
-33,-20,-34,-17,-50,9,-66,1,-210
5,-35,-41,18,-46,1,-61,48,-111
-94,-30,-31,-20,-140,-63,-168,-41,-587
25,-12,-43,22,-35,-67,-116,41,-185
-34,-73,-84,-29,-161,-121,-176,-26,-704
-19,-50,-61,-24,-67,-22,-72,24,-291
-41,-28,-26,-39,-45,-42,-51,-23,-295
-10,-38,-33,13,-62,-10,-48,22,-166
-30,-77,-87,-22,-100,-38,-104,50,-408
-32,-97,-95,-73,-126,-124,-172,96,-623
-21,-98,-114,-38,-120,-69,-169,73,-556
-44,-29,-89,-4,-95,-91,-138,45,-445
-89,-47,-66,-71,-59,-28,-80,-41,-481
-15,-2,-2,-19,5,-26,-24,-20,-103
-97,-168,-186,-95,-254,-127,-277,30,-1174
-18,-45,-36,-4,-51,3,-40,28,-163
-64,-85,-87,-76,-74,-69,-93,-8,-556
-4,-36,-41,-21,-52,-44,-69,14,-253
-9,-49,-69,-32,-69,-67,-113,13,-395
120,-285,-211,-82,-184,-154,-169,169,-796
-6,-33,-71,-5,-90,-103,-188,-27,-523
-8,-99,-90,18,-57,-8,-57,90,-211
-48,-87,-77,6,-120,-62,-128,-16,-532
-2,-49,-54,20,-86,-26,-72,28,-241
-59,-117,-100,-20,-136,12,-112,73,-459
8,-71,-56,33,-114,-36,-116,58,-294
5,-30,-58,4,-88,-43,-85,27,-268
91,-173,-222,-13,-110,-203,-305,223,-712
12,-146,-77,8,-130,-113,-168,85,-529
21,-37,-5,20,-37,-21,-13,36,-36
164,-198,-176,-60,-136,-45,-114,277,-288
-67,-102,-142,-60,-163,-67,-155,55,-701
101,-106,-165,-5,-233,-144,-208,188,-572
27,-137,-74,-57,-54,-72,-113,127,-353
37,-48,-85,-8,-51,-95,-122,55,-317
-14,-16,-29,-14,-52,-14,-46,7,-178
-27,-9,-103,-37,-48,-74,-110,-41,-449
-154,-199,-241,-131,-368,-164,-331,42,-1546
7,-126,-98,4,-162,-60,-147,50,-532
-32,-95,-116,-76,-130,-40,-125,69,-545
3,-11,-19,-11,-9,-13,-17,17,-60
-23,-33,-43,-50,-73,-88,-116,-3,-429
-46,-32,-42,-56,-92,-72,-120,-28,-488
24,-87,-90,27,-180,-46,-128,78,-402
177,47,-94,-58,-166,-294,-153,282,-259
5,-143,-125,22,-135,-63,-139,113,-465
19,-133,-104,-33,-130,-135,-205,118,-603
9,-61,-56,-5,-32,-58,-136,70,-269
-54,-109,-118,-28,-173,-40,-138,27,-633
32,48,61,49,-8,-34,-65,110,193
-18,-124,-133,38,-101,26,-130,98,-344
-6,-41,-100,-34,-51,-48,-112,67,-325
-114,-160,-186,1,-62,-12,-119,-14,-666
-15,-42,-43,-9,-72,-5,-51,33,-204
6,-30,-24,14,-28,-15,-34,5,-106
-11,-52,-63,-25,-87,-24,-64,37,-289
4,-40,-37,18,-50,-36,-52,24,-169
-40,-67,-52,-8,-75,-17,-79,1,-337
-8,-18,-15,2,-19,-7,-31,13,-83
-23,-97,-113,-12,-89,4,-94,88,-336
2,-56,-29,10,-33,-15,-39,30,-130
-6,-39,-31,-20,-73,-47,-59,-9,-284
-60,-68,-112,-42,-111,-88,-143,-7,-631
46,-74,-62,25,-110,-37,-87,68,-231
-14,-33,-23,-4,-27,-6,-14,4,-117
-21,-58,-74,-23,-128,-40,-66,37,-373
6,-37,-45,-1,-49,-41,-42,26,-183
-39,-76,-54,8,-99,-26,-65,86,-265
-12,-21,-25,23,-52,-13,-31,1,-130
-2,-52,-47,-30,-52,-18,-46,24,-223
-6,-34,-52,-38,-94,-41,-116,33,-348
-159,-189,-190,-87,-254,-56,-242,35,-1142
-18,-31,-30,-2,-65,-9,-76,44,-187
108,-44,-29,26,-61,-73,-89,90,-72
-48,-63,-48,-43,-46,-11,-66,4,-321
5,-73,-78,-7,-68,-60,-129,91,-319
-4,-40,-49,-2,-51,-16,-33,34,-161
27,-95,-120,-8,-153,-77,-130,107,-449
-9,-58,-68,-32,-37,-45,-64,54,-259
-32,-125,-172,-67,-167,-132,-236,76,-855
-2,-39,-40,9,-38,-12,-46,16,-152
26,-55,-21,33,-20,-32,-28,36,-61
-1,-36,-44,-13,-21,4,-37,27,-121
-17,-33,-32,-4,-26,-4,-27,-4,-147
-22,-20,-28,-6,-23,12,-37,13,-111
1,-56,-39,35,-61,-56,-96,-34,-306
-39,-106,-153,-61,-104,-73,-100,58,-578
-24,-36,-38,-27,-52,-56,-61,-5,-299
-64,-110,-137,-40,-113,-16,-180,75,-585
46,-103,-155,3,-212,-57,-195,236,-437
-38,-68,-114,19,-186,48,-144,158,-325
-27,-28,-34,-13,-22,-39,-64,1,-226
78,-45,-28,48,-43,-75,-93,90,-68
8,-49,-144,-15,-88,-85,-177,120,-430
-6,-23,-42,-23,-11,-7,-60,-21,-193
28,-21,-32,19,-41,-20,-78,31,-114
-99,-145,-170,-64,-176,-81,-202,63,-874
-33,-53,-96,-49,-83,-87,-141,-14,-556
14,-43,-89,-13,-96,-43,-101,119,-252
6,-24,-51,-25,-78,-24,-32,49,-179
55,-212,-391,-26,-126,272,-136,357,-207
-30,-46,-64,-21,-84,-28,-95,19,-349
-33,-291,-366,-25,-429,-177,-463,242,-1542
-19,-15,-21,-13,-23,-3,-31,-7,-132
-59,-78,-84,-13,-91,-31,-92,5,-443
23,-154,-145,-52,-154,-144,-205,103,-728
150,-63,-104,72,-49,-165,-185,136,-208
-32,-105,-116,-61,-159,-84,-147,39,-665
-16,-53,-54,-26,-79,-22,-81,13,-318
-27,-89,-122,3,-134,-107,-178,34,-620
9,-18,1,5,-7,-20,-21,6,-45
-134,-123,-128,-85,-216,-127,-247,14,-1046
-7,-26,-38,-7,-68,-15,-58,30,-189
-7,-28,-50,-17,-23,-23,-20,19,-149
14,24,-46,7,10,-13,-17,76,55
-15,-13,-66,16,-49,-17,-85,53,-176
-17,-18,-16,-7,-8,-15,-18,-3,-102
8,-41,-30,-15,-21,-4,-10,26,-87
20,-228,-354,-97,-423,-127,-402,244,-1367
-16,-100,-101,-28,-189,-133,-199,12,-754
-39,-9,-59,-36,-59,-74,-114,-47,-437
-37,-33,-53,37,-68,-8,-95,19,-238
-30,-40,-65,13,-78,-50,-81,34,-297
-31,-69,-100,-61,-116,-102,-230,26,-683
20,-29,-23,1,-29,-22,-30,0,-112
-24,-37,-46,12,-92,-46,-89,0,-322
27,-46,-92,-16,-110,-85,-101,47,-376
10,-11,-23,-7,-17,-24,-28,13,-87
-22,-26,-33,3,-36,23,-26,14,-103
-4,-38,-38,-1,-18,13,-38,29,-95
-24,-21,-23,-20,-13,-7,-30,-8,-146
-46,-77,-101,8,-126,22,-93,67,-346
-15,-51,-79,-19,-70,-24,-67,13,-312
-12,-20,-17,-15,-9,-9,-32,8,-106
18,-101,-44,-51,-101,-89,-123,53,-438
-24,-49,-70,-25,-70,-45,-62,15,-330
43,-64,-65,14,-56,-61,-104,45,-248
27,-61,-140,30,-35,24,-107,116,-146
-49,-58,-62,-22,-92,-31,-83,-11,-408
-47,-134,-151,3,-202,-30,-194,131,-624
-15,-45,-35,-23,-61,-23,-75,26,-251
-62,-66,-80,-38,-69,-43,-126,-2,-486
-32,-66,-51,-18,-57,-28,-60,-18,-330
-84,-84,-104,-53,-157,-36,-120,63,-575
37,-83,-86,-15,-163,-64,-69,102,-341
-6,-22,-2,12,-16,-36,-19,-2,-91
0,-23,-62,10,-68,-97,-132,16,-356
37,-76,-80,-6,-20,-77,-169,64,-327
14,-17,-22,-13,-32,-44,-39,12,-141
-77,-84,-84,-32,-117,-45,-134,-9,-582
-57,-112,-97,-24,-104,-4,-115,43,-470
-55,-107,-85,-23,-94,-5,-107,32,-444
-52,-107,-85,-23,-118,-18,-122,47,-478
-58,-83,-97,-56,-121,-25,-93,60,-473
13,-106,-116,-77,-98,-146,-167,38,-659
19,-26,-40,5,-30,-4,-42,62,-56
-80,-107,-119,-18,-196,-78,-193,93,-698
-80,-127,-145,-49,-208,-43,-181,95,-738
-23,-67,-64,-9,-119,-45,-124,33,-418
10,-87,-39,52,-87,-32,-81,23,-241
-28,-62,-107,-42,-130,-115,-194,30,-648
-70,-119,-148,-59,-173,-91,-157,37,-780
16,-80,-81,7,-102,-90,-128,39,-419
-87,-94,-107,-50,-113,18,-81,61,-453
7,-5,-7,8,-2,3,-7,3,0
129,-396,-386,53,-934,35,-502,684,-1317
-33,-149,-154,-17,-250,-123,-277,141,-862
24,-232,-411,-214,-652,-695,-982,-213,-3375
-48,-84,-95,-45,-157,-45,-112,44,-542
-78,-15,-74,-63,-115,-122,-159,-54,-680
-68,-103,-88,-47,-159,-63,-166,17,-677
-46,-145,-142,-53,-230,-176,-256,1,-1047
-83,-156,-174,-54,-246,-147,-214,-21,-1095
-14,-40,-42,-27,-35,-26,-53,15,-222
-94,-112,-152,-87,-167,-52,-165,12,-817
3,-7,-9,4,-15,-3,-17,14,-30
4,-87,-107,-16,-142,-33,-115,46,-450
22,-34,-27,10,-52,-47,-103,34,-197
-25,-38,-54,-30,-48,-40,-64,28,-271
-43,-87,-60,-22,-103,-70,-108,57,-436
-48,-75,-103,-46,-91,-10,-83,55,-401
-36,-96,-170,-86,-249,-189,-221,54,-993
-42,-84,-77,-5,-138,-36,-147,22,-507
19,-45,-37,40,-53,-29,-90,51,-144
-31,-52,-58,8,-73,-32,-84,8,-314
-82,-87,-98,-34,-157,-23,-129,28,-582
-97,-93,-98,-57,-154,-15,-135,45,-604
-28,-76,-56,-6,-94,-31,-97,22,-366
220,-268,-346,40,-69,-287,-602,288,-1024
42,-165,-173,41,-202,-74,-165,170,-526
-6,-73,-66,-30,-102,-51,-81,23,-386
38,-83,-136,37,-145,-76,-161,124,-402
-81,-31,-64,-58,-53,-38,-93,-50,-468
-134,-57,-191,-128,-178,-65,-250,-44,-1047
37,35,-5,46,-84,0,-132,146,43
-13,-50,-75,-66,-72,-53,-91,6,-414
-10,-27,-29,4,-23,-16,-44,16,-129
6,-16,-8,16,-13,18,-10,9,2
-65,-88,-136,-25,-154,18,-121,75,-496
-14,-25,-42,-18,-41,-36,-66,4,-238
24,1,-15,5,-18,-27,-40,38,-32
-32,-13,-34,-41,-40,-22,-56,-8,-246
-68,-112,-142,14,-227,-25,-159,128,-591
-39,-30,-45,-10,-46,-30,-52,-2,-254
76,-152,-164,9,-239,-222,-216,5,-903
-180,-99,-121,-86,-155,-127,-221,-74,-1063
-37,-37,-34,-23,-44,-29,-52,-15,-271
-30,-25,-53,-37,-52,-11,-86,18,-276
-3,-42,-41,-9,-89,-67,-103,-5,-359
-44,-208,-269,-88,-330,-195,-334,23,-1445
72,-153,-190,72,-116,-66,-153,160,-374
-12,-30,-43,-21,-78,-25,-58,14,-253
-16,-33,-42,-17,-48,-8,-58,30,-192
-65,-104,-92,11,-169,-19,-178,70,-546
8,-40,-76,-52,-104,-100,-137,45,-456
-46,-55,-57,-21,-58,16,-47,17,-251
6,-61,-94,-7,-81,-56,-120,122,-291
-151,-224,-239,-104,-334,-148,-300,46,-1454
-116,-79,-132,-53,-232,-26,-188,65,-761
-14,-36,-52,9,-52,1,-54,7,-191
-28,-10,-10,-10,-7,-2,-12,-13,-92
-73,-98,-108,-16,-116,-5,-126,51,-491
-36,-78,-127,-21,-194,-87,-181,106,-618
-23,-60,-50,-8,-67,-5,-73,34,-252
16,-37,-23,-1,-35,-42,-78,35,-165
-18,-31,-47,-26,-63,-51,-83,10,-309
-12,-69,-179,-137,-149,-205,-236,96,-891
-18,-33,-73,-32,-62,-51,-106,-16,-391
138,-193,-219,67,-189,-5,-113,273,-241
20,-4,-25,28,-14,-20,-39,33,-21
-96,-142,-208,-37,-291,-59,-286,100,-1019
94,-97,-305,89,-272,-25,-324,322,-518
-37,-111,-161,10,-163,-25,-230,168,-549
68,-52,-21,55,-19,-88,-92,46,-103
-43,-79,-73,5,-110,-19,-89,46,-362
13,-41,-21,-12,-30,-23,-45,44,-115
-40,-99,-59,34,-104,-8,-78,58,-296
-27,72,-127,-61,-52,-20,-167,111,-271
-28,-70,-107,9,-150,-82,-125,75,-478
-28,-56,-96,-49,-115,-102,-187,8,-625
54,9,-23,-9,18,-10,-36,77,80
60,17,-23,-8,25,1,-43,96,125
33,-8,-30,-3,1,-23,-23,46,-7
7,-176,-175,-11,-177,-142,-245,136,-783
9,-154,-168,-33,-114,-90,-189,106,-633
-117,-197,-259,-116,-314,-145,-328,72,-1404
-22,-59,-119,-24,-74,-124,-100,47,-475
-9,-109,-54,33,-72,-18,-71,69,-231
-89,-103,-109,-63,-141,-38,-121,27,-637
-80,-88,-100,-53,-133,-28,-96,32,-546
-67,-91,-89,-56,-133,-6,-94,49,-487
-46,-66,-93,-29,-119,-40,-109,15,-487
-73,-86,-80,-40,-116,-16,-96,32,-475
-65,-90,-97,-40,-146,-42,-118,44,-554
-62,-76,-85,-40,-148,-35,-117,11,-552
39,-49,-37,27,-64,-82,-141,74,-233
-31,-32,-27,-25,-44,5,-24,22,-156
40,-100,-83,41,-110,-64,-78,66,-288
-7,-22,-30,-11,-31,-27,-29,3,-154
-80,-44,-130,-43,-138,-68,-149,20,-632
37,-104,-83,5,-74,-22,-102,101,-242
-109,-131,-140,-63,-211,-112,-232,-9,-1007
-17,-45,-61,-7,-72,-17,-61,6,-274
-28,-67,-33,36,-77,7,-88,44,-206
-24,-56,-72,-34,-114,-47,-105,19,-433
46,-24,-38,4,-60,-53,-53,34,-144
-89,-103,-104,-57,-135,-11,-138,27,-610
6,21,-7,7,22,-7,-33,3,12
-22,-35,-31,-39,-14,-11,-27,-10,-189
-20,-51,-65,-7,-91,-29,-88,50,-301
-5,-14,-9,-5,-19,-8,-32,2,-90
7,-69,-38,11,-71,-18,-41,37,-182
-70,-103,-109,-40,-164,-69,-171,32,-694
-5,-55,-74,-26,-79,-7,-46,101,-191
-32,-22,-62,10,-69,-29,-75,13,-266
-26,-37,-51,-20,-49,-16,-68,31,-236
-47,-113,-130,-36,-164,-29,-137,92,-564
32,-96,-100,-54,-41,-76,-122,48,-409
-6,-33,-81,-31,-72,-47,-111,35,-346
70,1,-25,36,-55,-43,-68,74,-10
-46,-75,-69,-27,-120,-69,-131,10,-527
21,-189,-165,37,-190,-47,-135,144,-524
-109,-198,-161,-47,-175,-44,-216,50,-900
55,-66,-91,38,-74,62,-76,94,-58
-42,-14,-13,-14,-28,-35,-71,-22,-239
10,-155,-152,-8,-166,-96,-172,100,-639
12,-57,-92,4,-121,-84,-117,62,-393
-29,-31,-30,-27,-51,2,-48,-2,-216
-103,-150,-141,-45,-157,-79,-173,2,-846
134,-311,-220,-111,-295,-355,-417,142,-1433
28,-107,-109,-51,-168,-178,-273,150,-708
86,-133,-134,-36,-165,-130,-212,154,-570
-25,-102,-184,-82,-242,-217,-278,-41,-1171
-51,-77,-96,0,-154,-43,-145,46,-520
-2,-61,-66,-6,-46,-68,-46,42,-253
-55,-44,-52,-19,-67,-7,-77,27,-294
-80,-107,-117,-26,-142,23,-150,43,-556
-2,-66,-40,25,-36,-23,-77,28,-191
-15,-95,-97,-48,-110,-90,-150,35,-570
19,-7,-24,14,-21,-13,-41,31,-42
-3,-41,-44,19,-37,-26,-44,-8,-184
-12,-77,-84,-57,-132,-101,-138,22,-579
1,-48,-72,-22,-73,-85,-102,17,-384
-8,-48,-62,-13,-72,-50,-75,30,-298
71,-194,-207,-8,-191,-30,-165,226,-498
33,-36,-46,-1,-36,-35,-64,63,-122
-1,-25,-29,22,-51,-22,-65,47,-124
-18,-66,-72,-38,-103,-71,-137,58,-447
-15,-1,-16,-14,-27,-57,-51,-22,-203
-20,-7,-17,10,-20,-28,-43,1,-124
9,-90,-56,65,-108,-117,-189,79,-407
17,-19,-29,12,-43,-28,-55,17,-128
-8,-20,-51,-56,-110,-98,-111,6,-448
20,-30,-53,9,-74,-13,-67,51,-157
-1,-6,-14,-1,-5,-18,-15,6,-54
-25,-47,-26,-9,-62,-47,-75,24,-267
13,-99,-66,-17,-81,-74,-87,34,-377
6,-34,-61,-7,-70,-42,-86,16,-278
-96,-151,-141,-36,-197,-61,-187,50,-819
-4,-19,-24,-16,-33,-10,-10,20,-96
-8,-32,-24,-13,-18,-26,-37,-9,-167
-60,-69,-69,-37,-106,-65,-143,-15,-564
375,-164,-416,-33,-272,-52,-287,700,-149
23,-110,-86,-3,-134,-109,-174,45,-548
-39,-38,-49,-38,-54,-31,-51,-13,-313
-27,-40,-35,-27,-76,-67,-78,-13,-363
0,-59,-85,-39,-118,-69,-124,50,-444
-34,-50,-92,-35,-116,-58,-95,-7,-487
-27,-144,-122,-66,-145,-114,-156,57,-717
11,-78,-35,23,-33,-29,-77,30,-188
-10,-34,-29,33,-108,2,-70,81,-135
-12,-66,-107,-70,-122,-34,-134,63,-482
4,-127,-125,-2,-211,-59,-134,143,-511
0,-74,-77,25,-109,-26,-78,81,-258
-5,-34,-43,-9,-31,-26,-29,-7,-184
-78,-36,-86,-57,-81,-111,-168,-29,-646
-23,-68,-64,-18,-99,-42,-88,46,-356
-10,-58,-60,-18,-44,-24,-51,44,-221
0,-108,-132,-33,-140,-36,-154,88,-515
-29,-31,-41,3,-33,-8,-38,4,-173
30,-13,-15,26,-17,-3,-19,26,15
13,-12,-6,2,-2,4,-2,17,14
3,-76,-86,16,-138,-51,-165,88,-409
-30,-43,-59,18,-106,-10,-136,55,-311
83,-138,-152,28,-113,-47,-131,116,-354
-21,-53,-71,-60,-117,-78,-89,25,-464
-14,-51,-47,-16,-92,-35,-101,35,-321
12,-13,-25,-7,-45,-15,-32,38,-87
-61,-28,-40,-36,-82,-74,-97,-52,-470
5,-43,-39,6,-94,-50,-101,51,-265
-54,-67,-74,-59,-80,-82,-137,79,-474
-15,-121,-143,30,-200,-37,-207,129,-564
-67,-81,-138,1,-192,-53,-198,68,-660
-13,-58,-34,0,-56,-18,-53,-5,-237
6,-52,-117,-120,-40,-149,-250,107,-615
-24,-76,-46,-30,-120,-29,-112,26,-411
1,-32,-49,-18,-77,-40,-71,28,-258
60,-62,-79,22,-53,-151,-164,58,-369
11,-57,-72,17,-88,-32,-70,43,-248
10,-14,-8,-6,-9,-17,-13,17,-40
28,-41,-28,20,-35,-59,-82,37,-160
-70,-42,-70,-51,-45,-70,-84,-43,-475
32,-59,-50,36,-81,18,-64,146,-22
36,-19,-28,28,-41,-31,-35,15,-75
-36,-52,-51,-21,-56,-30,-69,-9,-324
117,-188,-213,36,-200,-218,-281,226,-721
-39,-125,-143,-42,-147,-92,-192,74,-706
-80,-64,-134,-18,-101,-63,-125,34,-551
-15,-16,-15,2,-26,-6,-21,-4,-101
7,-109,-85,60,-144,-48,-151,87,-383
3,-2,-11,-4,8,-17,-16,-11,-50
-19,-71,-82,-59,-129,-88,-120,33,-535
-45,-43,-33,-9,-91,-30,-82,-23,-356
4,-55,-57,-25,-78,-38,-83,42,-290
-76,-79,-108,-77,-156,-81,-153,8,-722
6,-168,-256,-6,-181,-35,-187,160,-667
-290,-407,-506,-354,-632,-302,-701,-33,-3225
-12,-33,-34,13,-67,4,-40,37,-132
-32,-105,-96,-22,-167,-33,-176,79,-552
3,-41,-14,19,17,17,-26,20,-5
-12,-25,-73,36,-5,-30,-117,104,-122
-8,-51,-71,-3,-69,-10,-65,50,-227
-471,-515,-608,-293,-742,-138,-826,288,-3305
57,-88,-79,-13,-65,-98,-140,105,-321
-46,-77,-52,21,-79,-32,-83,34,-314
-10,-37,-40,0,-52,-1,-70,37,-173
-21,-52,-42,-13,-71,-58,-78,17,-318
-129,-192,-204,-59,-278,-105,-255,78,-1144
11,-21,-33,9,-20,-25,-31,15,-95
-20,2,-60,-61,-110,-136,-185,-22,-592
0,-55,-191,-87,-188,-148,-250,204,-715
-68,-80,-75,-48,-95,-69,-120,-16,-571
-53,-87,-98,-27,-97,-52,-91,29,-476
43,-36,-52,30,-44,-42,-50,60,-91
-28,-130,-174,-40,-166,5,-138,170,-501
-9,-26,-32,-26,-36,-17,-29,27,-148
-34,-33,-37,-46,-43,-4,-54,2,-249
-119,-143,-144,-67,-138,-10,-193,42,-772
-35,-136,-133,-71,-202,-56,-158,68,-723
-27,-37,-86,-18,-68,-50,-99,79,-306
-6,-23,-33,-47,-18,-47,-67,7,-234
8,-43,-37,-31,-1,-65,-71,35,-205
0,-31,-34,-5,-20,-23,-27,4,-136
-3,-67,-120,-77,-195,-125,-164,61,-690
-42,-49,-53,-14,-66,-15,-74,9,-304
-15,-21,-28,-18,-32,-39,-41,8,-186
-36,-63,-69,-32,-68,-42,-89,-9,-408
-23,-59,-65,-55,-47,-77,-145,36,-435
-36,-47,-68,-32,-121,-46,-101,12,-439
-28,-30,-44,-10,-95,-60,-81,-27,-375
-12,-31,-48,-4,-29,-36,-42,24,-178
44,-90,-167,47,-142,-48,-196,146,-406
-45,-88,-108,-39,-96,-40,-109,46,-479
54,-282,-376,-54,-440,-317,-613,304,-1724
21,-101,-97,-6,-41,-4,-58,49,-237
-36,-44,-97,-36,-80,-22,-86,60,-341
-58,-81,-77,-31,-106,-76,-131,34,-526
-68,-88,-127,-52,-141,-116,-191,-15,-798
-60,-58,-67,-62,-98,-82,-113,-40,-580
-12,-8,-42,-12,-42,-14,-45,78,-97
-31,-43,-45,-25,-47,-22,-51,2,-262
71,-76,-146,-69,-186,-182,-226,109,-705
-30,-72,-61,-4,-91,-31,-86,47,-328
-11,-22,-53,-67,16,-55,-103,50,-245
-16,-76,-58,-7,-82,-38,-79,47,-309
69,-45,-1,31,-21,-112,-89,46,-122
-11,-45,-57,6,-82,-47,-88,19,-305
61,-25,-7,36,-16,9,-22,69,105
-9,-34,-35,-19,-46,-47,-73,-12,-275
368,-309,-276,-77,29,-309,-498,401,-671
-24,-71,-61,-23,-106,-36,-79,42,-358
-11,-38,-32,-2,-56,-40,-67,5,-241
7,-42,-99,-11,-114,-72,-143,27,-447
-184,-76,-152,-186,-176,-206,-392,-230,-1602
40,-28,-54,8,-83,-56,-92,44,-221
-5,-34,-62,-28,-69,-32,-93,45,-278
0,-67,-85,-13,-123,-88,-98,41,-433
-8,-133,-115,-60,-197,-81,-141,62,-673
13,-99,-90,-8,-145,-53,-128,101,-409
-25,-217,-235,-173,-285,-259,-319,61,-1452
-63,-81,-67,-9,-97,-29,-102,33,-415
-30,-103,-170,-89,-201,-67,-157,92,-725
-94,-215,-242,-47,-351,-153,-339,131,-1310
-27,-55,-68,-50,-52,-34,-97,-12,-395
5,-78,-94,-53,-102,-104,-163,55,-534
30,-138,-147,-65,-151,-144,-175,92,-698
-9,-85,-97,7,-71,-47,-147,10,-439
17,-100,-146,-9,-179,2,-137,231,-321
-77,-172,-136,-9,-179,-79,-203,49,-806
-55,-66,-70,-40,-76,-17,-72,-34,-430
24,-108,-102,-40,-181,-150,-171,62,-666
-26,-85,-100,-42,-112,-55,-167,66,-521
-12,-24,-46,8,-58,-9,-63,67,-137
82,-92,-108,43,-132,-75,-144,113,-313
12,-16,-40,8,-101,-41,-67,40,-205
22,-15,-45,-35,-50,-74,-74,51,-220
1,-54,-61,-26,-71,-54,-75,58,-282
109,-6,-73,58,-45,-60,-118,99,-36
-22,-43,-36,1,-67,-19,-63,5,-244
7,-145,-165,-35,-110,-47,-208,164,-539
-37,-79,-103,-4,-61,-39,-72,33,-362
15,-126,-143,-17,-165,-52,-156,112,-532
-83,-118,-160,-37,-198,-50,-211,50,-807
-5,-43,-38,3,-32,-28,-54,17,-180
-41,-53,-73,-17,-79,26,-98,27,-308
1,-33,-51,-14,-79,-49,-87,10,-302
-14,-43,-45,-23,-30,-25,-55,21,-214
7,-14,-22,-6,-42,-43,-47,6,-161
-5,-36,-52,-40,-82,-32,-71,29,-289
-66,-64,-84,-42,-64,-77,-138,-31,-566
-14,-58,-80,-45,-90,-67,-88,-4,-446
95,-219,-294,19,-189,-24,-291,277,-626
-162,-456,-592,-136,-644,-246,-709,309,-2636
-55,-48,-47,-32,-48,-21,-39,6,-284
-66,-67,-68,-38,-111,-56,-109,3,-512
-31,-25,-31,-24,-20,-14,-42,2,-185
-35,-7,-56,-49,-93,-73,-136,-22,-471
21,-6,-27,-8,-20,-1,-8,22,-27
-219,-299,-354,-180,-434,-133,-467,84,-2002
7,-56,-56,32,-140,-64,-132,45,-364
37,-31,-50,45,-13,16,-71,97,30
9,-45,-37,-20,-30,-50,-61,24,-210
-102,-264,-254,-105,-367,-15,-285,160,-1232
-62,-104,-101,-79,-148,-59,-118,30,-641
-2,-79,-108,-64,-107,-90,-118,28,-540
15,-37,-31,-17,-66,-60,-111,33,-274
-21,-74,-68,20,-75,-20,-87,60,-265
-30,-30,-51,-33,-31,-53,-84,-11,-323
-65,-166,-184,-108,-293,-232,-336,-40,-1424
-14,-29,-71,-12,-80,-55,-70,34,-297
82,-85,-223,-102,-103,-208,-381,342,-678
11,-72,-49,4,-59,-13,-45,71,-152
63,-128,-201,-129,-176,-213,-399,229,-954
-97,-143,-164,-35,-75,-18,-98,-30,-660
-104,-154,-186,-18,-62,-11,-85,13,-607
144,-40,-32,132,-33,-98,-182,121,12
-45,-237,-229,27,-295,46,-199,225,-707
24,-38,-39,7,-3,-56,-91,74,-122
26,-35,-61,13,-24,-29,-41,24,-127
58,-29,-75,97,-33,-5,-102,162,73
-8,-26,-47,19,-69,-23,-41,45,-150
-16,-58,-53,-4,-81,-19,-69,20,-280
0,-14,-33,-7,-36,-19,-47,28,-128
15,-36,-62,11,-50,-60,-86,35,-233
-15,-20,-34,4,-40,1,-37,12,-129
-19,-91,-83,-21,-132,-67,-130,35,-508
-83,-181,-229,-47,-195,-166,-317,48,-1170
-14,-93,-100,-34,-83,-58,-77,21,-438
24,-72,-71,1,-102,-74,-108,10,-392
51,-72,-85,9,-106,-63,-91,104,-253
-14,-93,-63,-10,-86,-25,-86,63,-314
27,6,-29,2,-43,-35,-60,51,-81
-35,-99,-98,-67,-139,-85,-125,34,-614
-46,-71,-46,-6,-38,-15,-89,-6,-317
2,-57,-73,-3,-64,-26,-72,19,-274
10,-29,-29,30,-42,-21,-71,33,-119
1,-20,-22,-17,-31,-20,-26,8,-127
-51,-79,-87,0,-127,4,-116,65,-391
-32,-59,-120,-46,-174,-43,-169,8,-635
-18,-44,-44,3,-52,-14,-47,16,-200
-51,-101,-63,-13,-133,-69,-129,8,-551
-9,-20,-34,-28,-61,-16,-62,14,-216
-7,-144,-139,-87,-77,-78,-166,85,-613
-6,-46,-51,-4,-100,-49,-94,8,-342
-6,-16,-21,-27,-3,-41,-40,-5,-159
-73,-89,-126,-62,-181,-119,-219,-25,-894
2,-56,-46,5,-36,-39,-43,5,-208
-40,-115,-124,-20,-169,-75,-148,115,-576
-100,-118,-160,-25,-61,-5,-99,-19,-587
19,19,-13,40,-50,-10,-94,29,-60
-65,-123,-159,-66,-182,-58,-165,67,-751
-7,-144,-168,-82,-184,-123,-183,126,-765
-30,-68,-62,-25,-68,-31,-78,20,-342
-10,-59,-99,-16,-73,-11,-102,66,-304
-58,-7,-76,-3,-60,-22,-92,21,-297
40,-85,-128,3,-208,-180,-274,25,-807
-23,-64,-78,-38,-75,-34,-65,17,-360
34,-77,-93,-10,-86,-90,-82,40,-364
-78,-73,-132,-48,-196,-54,-202,52,-731
-22,-64,-103,-11,-115,-43,-114,32,-440
-23,-20,-33,-17,-60,-17,-60,28,-202
94,-94,-91,3,-61,-83,-115,125,-222
-53,-89,-88,-32,-112,-44,-107,42,-483
-33,-26,-26,-13,-36,3,-37,8,-160
-17,-43,-78,-53,-103,-97,-148,16,-523
-10,-50,-34,13,-39,-1,-39,25,-135
15,-97,-62,-10,-44,-19,-48,56,-209
3,-9,-49,-20,-16,-7,-47,36,-109
-68,-156,-211,-103,-208,-38,-190,91,-883
-4,-6,-30,-6,-16,-28,-45,3,-132
-2,-6,-30,-25,-5,-25,-45,34,-104
-16,-23,-47,-18,-11,-10,-46,7,-164
-2,-32,-51,1,-68,-9,-42,51,-152
-54,-79,-105,-49,-125,-97,-106,31,-584
-41,-73,-106,-35,-110,-77,-109,13,-538
12,-28,-36,0,-11,-25,-37,10,-115
-43,-79,-76,-22,-106,-34,-78,60,-378
-27,-116,-152,-65,-161,-127,-206,62,-792
-36,-89,-143,-52,-150,-172,-185,10,-817
60,-30,-74,-25,-36,-10,-92,111,-96
-60,-103,-123,-45,-166,-34,-126,25,-632
-5,-43,-50,0,-59,-29,-65,23,-228
-19,-33,-60,-41,-99,-5,-49,50,-256
33,-1,-10,1,1,-8,-16,39,39
-61,-96,-87,-32,-109,-40,-87,20,-492
-34,-59,-85,-13,-71,-24,-116,49,-353
-1,-34,-59,3,-86,-62,-90,12,-317
-33,-61,-54,-5,-57,-52,-93,-17,-372
8,-35,-33,7,-36,-26,-18,34,-99
-23,-39,-43,-6,-9,-9,-19,-10,-158
-8,-107,-130,-15,-130,-11,-105,134,-372
26,-51,-91,-15,-80,-60,-141,43,-369
-34,-49,-82,-46,-94,-41,-96,15,-427
11,-40,-57,4,-104,-39,-60,59,-226
-55,-51,-87,-2,-128,-66,-106,0,-495
172,-155,-121,-36,-26,-151,-263,250,-330
14,-14,-111,91,-150,-13,-197,200,-180
-40,-80,-83,-30,-102,-50,-108,-8,-501
-18,-45,-56,12,-74,-17,-77,23,-252
13,-69,-133,65,-122,-69,-170,33,-452
-89,-56,-94,-67,-155,-46,-207,-33,-747
1,-47,-96,12,-114,8,-101,91,-246
123,-111,-161,79,-205,-154,-195,160,-464
-3,-62,-40,16,-67,2,-51,34,-171
-38,-84,-84,-11,-129,-73,-139,42,-516
10,-61,-127,-66,-53,-153,-187,69,-568
13,-31,-61,13,-51,-11,-26,41,-113
-79,-120,-125,-48,-214,-105,-236,-19,-946
-17,-60,-76,-6,-120,-91,-143,24,-489
-26,-175,-141,-66,-187,-83,-82,130,-630
15,-27,-37,-33,-19,-76,-103,24,-256
48,-16,-17,28,-22,-28,-32,59,20
-29,-56,-80,-48,-61,-57,-104,11,-424
141,-119,-184,14,-139,-182,-263,193,-539
-2,-80,-105,36,-96,-18,-114,87,-292
34,-57,-68,-17,-33,-24,-48,65,-148
-35,-61,-82,-34,-77,-89,-125,31,-472
-4,-39,-34,-23,-30,-24,-61,16,-199
-3,-23,-39,9,-32,5,-51,36,-98
56,-103,-70,24,-66,-116,-188,95,-368
-16,-50,-40,13,-109,-19,-89,57,-253
-18,-21,-42,-8,-55,-34,-76,-6,-260
-8,-47,-46,-20,-56,-57,-80,15,-299
20,-2,-13,-4,-17,-27,-23,18,-48
35,-38,-39,53,14,24,-38,82,93
-86,-60,-91,-16,-154,-21,-141,61,-508
-53,-47,-64,-36,-79,-37,-96,-19,-431
50,-91,-98,-46,-141,-117,-145,41,-547
-60,-87,-87,-40,-149,-63,-110,26,-570
-24,-27,-31,-13,-35,-11,-37,4,-174
36,-99,-42,17,-115,-64,-74,75,-266
-36,-65,-69,-35,-66,-30,-50,33,-318
-24,-75,-49,9,-96,-62,-84,-8,-389
-68,-172,-168,3,-248,-72,-209,117,-817
16,-13,-24,17,-19,-17,-35,35,-40
27,-33,-24,27,-7,-19,-57,46,-40
-8,-43,-39,-27,-71,-8,-43,42,-197
19,-19,0,35,-57,-29,-60,27,-84
-27,-98,-128,-57,-143,-103,-191,73,-674
-27,-76,-84,-4,-104,-33,-112,30,-410
1,-77,-95,41,-147,-83,-142,25,-477
-75,-99,-98,-21,-96,-90,-123,12,-590
-8,-25,-84,-71,-134,-175,-201,-37,-735
-2,-56,-67,-19,-111,-121,-134,-6,-516
2,-7,-20,-5,-21,-29,-20,4,-96
14,-78,-145,-62,-129,-135,-158,53,-640
12,-60,-64,-11,-80,-51,-101,24,-331
3,-49,-37,6,-78,-1,-72,41,-187
-7,-27,-35,-25,-31,-50,-65,-13,-253
-29,-42,-74,-39,-132,-41,-95,33,-419
-14,-27,-22,-3,-46,-22,-40,-3,-177
13,-8,-24,20,-17,-14,-44,28,-46
-26,-76,-121,-23,-42,-41,-69,43,-355
70,-92,-82,-15,-10,-96,-148,54,-319
1,-59,-56,10,-73,0,-61,72,-166
-9,-28,-25,-7,-32,-12,-25,29,-109
22,-58,-66,29,-94,15,-87,136,-103
-13,-48,-53,-20,-67,-18,-70,12,-277
81,-170,-161,-68,-104,-103,-209,178,-556
13,-12,-36,-18,-57,-38,-59,24,-183
-61,-104,-100,-36,-167,-39,-163,37,-633
13,-237,-220,85,-322,-41,-325,177,-870
-2,-28,-71,7,-73,-26,-93,27,-259
-77,-133,-162,-13,-206,-20,-172,108,-675
-18,-51,-42,-24,-63,-28,-48,1,-273
-11,-44,-77,-8,-103,-107,-161,47,-464
19,-75,-83,10,-114,-23,-110,67,-309
6,-62,-61,10,-76,4,-46,62,-163
-53,-138,-179,-36,-131,-41,-146,77,-647
-68,-113,-108,-48,-123,-42,-104,31,-575
-141,-133,-178,-88,-186,-135,-305,-45,-1211
-16,-16,-37,-9,-38,21,-30,10,-115
46,-187,-145,-12,-196,-139,-220,80,-773
9,-32,-12,59,-95,-14,-38,53,-70
-146,-220,-221,-97,-329,-202,-322,4,-1533
1,-40,-59,7,-34,-18,-61,58,-146
-10,-35,-43,-50,-29,-50,-43,-17,-277
-13,-59,-89,-52,-99,-66,-109,36,-451
26,25,-228,-6,-139,-117,-220,119,-540
-22,-130,-122,-27,-159,-64,-136,31,-629
-24,-124,-118,-23,-151,-71,-125,40,-596
-26,-135,-119,-20,-154,-64,-134,37,-615
-36,-31,-59,-36,-61,-47,-94,-13,-377
-30,-126,-90,15,-123,-29,-84,62,-405
-77,-99,-102,-49,-142,-64,-118,34,-617
101,-175,-133,59,-128,-143,-209,152,-476
-60,-71,-59,-13,-76,-4,-65,44,-304
-26,-62,-65,-31,-92,-81,-123,18,-462
-38,-46,-90,-88,-65,-92,-137,31,-525
-51,-53,-63,22,-121,-14,-126,34,-372
-57,-88,-90,-27,-150,-63,-173,43,-605
-20,-50,-60,-3,-74,-13,-101,76,-245
-22,-65,-66,-9,-64,-33,-51,42,-268
15,-69,-52,16,-72,5,-64,92,-129
-61,-117,-132,-69,-162,-9,-127,53,-624
14,-30,-29,-1,-24,-45,-58,43,-130
10,-59,-51,33,-86,-34,-103,41,-249
-57,-113,-99,-50,-127,-33,-119,-2,-600
-63,-80,-136,-57,-102,-71,-128,96,-541
19,-130,-60,17,-60,-40,-94,51,-297
-25,-35,-56,-35,-91,-57,-106,41,-364
-2,-25,-48,-25,-21,3,-23,14,-127
-44,-118,-192,-125,-259,-216,-329,17,-1266
-53,-86,-103,-61,-163,-98,-148,34,-678
7,-44,-40,46,-107,-24,-81,60,-183
-59,-30,-100,-82,-96,-136,-194,-52,-749
-86,-173,-167,-28,-193,-81,-236,59,-905
9,-85,-63,34,-102,-18,-102,67,-260
176,-77,-98,20,-72,-72,-113,187,-49
54,-192,-138,8,-163,-88,-225,184,-560
33,-70,-94,52,-133,-122,-144,87,-391
-37,-19,-36,-15,-33,-13,-43,16,-180
3,-90,-58,3,-76,-58,-132,102,-306
-15,-138,-145,-27,-168,-77,-138,46,-662
-16,-16,-25,-9,-19,-3,-20,0,-108
-105,-141,-132,-28,-224,-34,-221,83,-802
-104,-229,-207,-19,-337,-110,-316,40,-1282
8,-124,-142,-7,-118,7,-112,170,-318
-18,-48,-35,-11,-38,-25,-56,9,-222
-9,-44,-62,-31,-82,-60,-69,30,-327
-4,-40,-69,-25,-91,-44,-106,39,-340
-9,6,-15,-18,-6,-15,-26,4,-79
13,-56,-76,11,-103,-67,-113,40,-351
-32,-49,-77,-59,-75,-74,-116,-12,-494
-40,-58,-77,-74,-95,-71,-107,8,-514
0,-21,-17,-5,-25,-12,-32,-6,-118
-77,-123,-104,-65,-118,-60,-145,6,-686
5,-53,-42,3,-57,-29,-40,55,-158
-36,-112,-145,14,-141,-68,-190,68,-610
-22,-43,-30,-10,-70,-4,-70,27,-222
-4,-37,-71,-11,-97,-30,-80,2,-328
237,-203,-167,177,-164,-125,-357,395,-207
-22,-43,-64,-32,-75,-55,-101,-5,-397
-40,-22,-19,-7,-39,-16,-51,-9,-203
-5,-48,-52,-11,-70,-64,-74,2,-322
-91,-111,-158,-73,-158,-92,-205,7,-881
-34,-32,-43,-10,-39,-19,-71,-27,-275
20,-45,-35,-10,-26,-6,-28,55,-75
1,2,-8,3,-4,-15,-32,22,-31
80,-30,-132,-48,-159,-185,-206,123,-557
39,-92,-73,62,-176,1,-117,168,-188
-138,-168,-168,-48,-81,-33,-113,-31,-780
-58,-103,-125,-7,-61,-37,-83,9,-465
13,-18,-44,-12,-22,-49,-66,16,-182
-13,-110,-76,-9,-101,-37,-103,51,-398
-19,-83,-86,-38,-92,-55,-129,29,-473
-36,-79,-70,-18,-114,-28,-89,44,-390
-1,-28,-54,-22,-72,5,-69,52,-189
-54,-90,-118,-69,-150,-78,-156,40,-675
-18,-142,-135,-17,-125,-13,-119,58,-511
-105,-156,-162,12,-200,36,-173,108,-640
-19,-41,-41,-26,-54,-15,-36,14,-218
-39,-109,-175,-39,-215,-168,-327,48,-1024
-162,-172,-156,-36,-180,8,-197,81,-814
-64,-155,-144,-15,-164,-46,-167,39,-716
13,-71,-48,8,-62,-50,-90,31,-269
66,-58,-59,69,-84,-27,-65,187,29
-30,-58,-79,-32,-86,-47,-93,25,-400
-30,-268,-258,-58,-386,-158,-363,227,-1294
-41,-102,-70,-4,-81,-31,-78,11,-396
-25,-59,-71,5,-82,-49,-77,24,-334
-24,-14,-25,-32,-28,-23,-36,13,-169
-52,-84,-86,-18,-109,-30,-113,13,-479
-85,-140,-226,-99,-308,-296,-336,-64,-1554
38,-98,-140,5,-203,-8,-114,172,-348
11,-73,-70,-38,-94,-65,-76,45,-360
21,-44,-44,29,-61,-39,-58,23,-173
48,-23,-64,57,-22,-8,-66,91,13
-7,-21,-20,-3,-27,3,-22,21,-76
2,-6,-54,-10,-60,-66,-118,30,-282
103,-149,-160,60,-207,56,-172,254,-215
-5,-20,-32,-37,-13,-47,-54,-3,-211
-54,-94,-98,-3,-209,-12,-183,121,-532
-81,-46,-105,-55,-102,-26,-111,48,-478
-7,-75,-48,22,-69,-18,-66,39,-222
-59,-98,-220,-117,-122,-84,-217,29,-888
48,-68,-107,31,-125,-6,-82,144,-165
711,-1259,-1413,435,-221,750,-723,1203,-517
-4,-98,-118,-48,-138,-125,-162,55,-638
-30,-90,-105,-34,-117,-78,-126,12,-568
-22,-56,-41,-8,-66,-38,-59,17,-273
-32,-119,-101,-17,-87,-51,-153,106,-454
31,-64,-34,54,-139,-25,-116,73,-220
-5,-42,-51,-28,-56,-61,-93,-7,-343
-110,-125,-121,-98,-176,-94,-176,9,-891
45,-104,-110,31,-197,-160,-231,74,-652
10,-30,-31,9,-86,-98,-126,52,-300
76,-238,-293,11,-343,-224,-443,337,-1117
-200,-496,-594,-193,-688,-440,-723,92,-3242
-116,-173,-180,-134,-234,-139,-256,31,-1201
95,-199,-286,-17,-238,-93,-182,240,-680
-61,-20,-44,11,-64,-8,-78,20,-244
18,-163,-209,-91,-317,-199,-283,151,-1093
-70,-96,-99,-31,-106,-31,-122,51,-504
-43,-121,-170,-80,-236,-232,-395,101,-1176
-164,-287,-302,-78,-430,-101,-402,127,-1637
-145,-191,-247,-46,-86,-14,-121,23,-827
23,-129,-70,87,-145,-122,-167,79,-444
-72,-45,-146,-14,-154,-55,-244,57,-673
160,-73,-111,-41,28,-210,-389,213,-423
35,-102,-81,26,-126,-11,-83,93,-249
19,-102,-171,-14,-113,-38,-164,143,-440
77,-135,-212,-41,-141,-47,-217,198,-518
-97,-144,-158,-48,-212,-10,-201,10,-860
-18,-95,-131,-61,-104,-12,-132,105,-448
471,61,39,441,106,36,-231,365,1288
-23,-126,-132,-19,-190,-48,-137,65,-610
-62,-115,-94,-22,-116,56,-107,64,-396
38,-55,-101,46,-116,-120,-121,49,-380
-37,-179,-189,22,-302,-180,-335,15,-1185
28,-29,-52,12,-84,-18,-74,37,-180
9,-47,-59,7,-77,-48,-57,49,-223
132,-235,-439,-90,-431,-142,-215,467,-953
142,-114,-120,38,-140,13,-161,314,-28
-13,-159,-109,-58,-169,-83,-84,138,-537
-48,-252,-336,-123,-439,-279,-493,320,-1650
17,-110,-158,12,-265,13,-208,230,-469
-95,-153,-196,-82,-252,-57,-219,67,-987
-156,-139,-127,-55,-88,-48,-115,-58,-786
137,-191,-325,32,-94,8,-120,261,-292
-94,-257,-314,-54,-422,-74,-330,180,-1365
194,-321,-358,-103,-392,-69,-406,570,-885
-25,-115,-134,-15,-139,-86,-145,68,-591
181,-170,-126,-53,-88,-220,-300,177,-599
-83,-99,-120,-104,-108,-64,-151,-19,-748
18,2,-20,3,-26,-10,-32,29,-36
-20,-171,-183,-33,-191,-108,-194,156,-744
13,-58,-53,10,-97,-39,-63,54,-233
-6,-68,-74,-7,-57,-36,-96,72,-272
23,-10,-27,-4,-39,-28,-33,39,-79
-35,-65,-75,-1,-73,-34,-91,11,-363
-21,-148,-123,-19,-181,-83,-170,37,-708
7,-79,-78,-8,-165,-63,-117,82,-421
-8,-28,-33,-1,-24,-3,-37,23,-111
-28,-182,-117,8,-251,-118,-248,48,-888
-95,-123,-107,-51,-157,-67,-172,8,-764
87,-87,-89,15,-61,-101,-144,98,-282
-53,-120,-142,-14,-87,-43,-129,80,-508
-52,-191,-144,-23,-267,-170,-250,-6,-1103
-29,-24,-40,-27,-54,-19,-47,30,-210
100,-103,-111,-13,-73,-127,-142,99,-370
129,-268,-354,48,-589,-232,-602,516,-1352
3,-39,-84,-29,-99,-67,-106,22,-399
-19,-15,-22,-19,-17,-30,-20,-10,-152
-31,9,-24,-19,-43,-25,-83,6,-210
-74,-144,-164,-6,-124,-66,-110,54,-634
-86,-168,-179,-29,-218,-53,-243,47,-929
2,-9,-17,-5,-19,-8,-33,-6,-95
-118,-133,-177,-42,-65,-5,-109,14,-635
35,-20,-27,-1,-33,-51,-52,31,-118
-62,-244,-284,-125,-370,-187,-322,105,-1489
-95,-53,-75,-67,-153,-52,-162,9,-648
-8,-16,-48,-11,-88,-91,-104,-10,-376
-40,-61,-59,-46,-63,-47,-91,-9,-416
-12,-25,-11,-9,-27,-7,-24,14,-101
-20,-47,-43,-37,-58,-53,-80,2,-336
-30,-57,-63,-8,-130,-46,-117,46,-405
11,-23,-23,6,-33,-31,-35,13,-115
128,-137,-134,90,-125,57,-157,251,-27
-70,-144,-94,51,-171,4,-144,110,-458
11,-17,-31,-11,-39,-42,-47,9,-167
-6,-4,-15,-12,-5,-3,-14,11,-48
-105,-283,-290,19,-443,-131,-497,163,-1567
-34,-26,-19,-14,-37,-13,-35,-11,-189
-11,-11,-24,-8,-30,-15,-30,0,-129
6,-17,-39,-6,-24,-16,-73,53,-116
32,-41,-111,33,-97,52,-101,157,-76
13,-37,-40,-11,-22,0,-21,53,-65
55,-61,-81,19,-45,-67,-81,68,-193
122,-10,-53,93,-23,-28,-92,133,142
3,-37,-50,-24,-102,-44,-69,66,-257
1,-42,-23,4,-42,-4,-27,35,-98
-43,-117,-172,-36,-127,-18,-180,60,-633
-45,-121,-165,-40,-135,-33,-187,41,-685
29,-135,-175,-96,-317,-170,-250,150,-964
-25,-32,-60,-54,-96,-81,-108,-18,-474
-38,-43,-83,-33,-30,-49,-115,-25,-416
46,9,-23,-5,14,-11,-33,66,63
-15,-45,-50,-21,-35,-51,-71,24,-264
-5,18,-2,-3,12,2,-11,12,23
45,-10,-31,32,-39,-89,-107,50,-149
24,-67,-47,-24,-27,-50,-91,55,-227
-7,-33,-60,5,-33,-8,-42,42,-136
-38,-2,-53,-47,-68,-34,-86,1,-327
-63,-71,-50,-1,-117,-65,-107,-20,-494
-78,-146,-171,-57,-275,-110,-261,60,-1038
-68,-80,-108,-29,-177,-27,-167,62,-594
-77,-110,-125,-60,-153,-52,-181,58,-700
59,-59,-93,55,-80,-40,-94,94,-158
37,-64,-51,51,-30,-26,-103,72,-114
-43,-24,-53,-20,-26,-13,-25,26,-178
-11,-33,-46,-15,-69,-36,-87,5,-292
73,-36,11,35,22,-58,-80,74,41
48,-187,-144,-105,-112,-136,-252,166,-722
-14,-17,-26,9,-54,-10,-29,1,-140
43,-211,-144,83,-88,-85,-231,232,-401
-29,-44,-52,-24,-11,-4,-74,34,-204
-24,-29,-23,-5,-40,0,-36,8,-149
-41,-145,-171,-37,-258,-68,-191,118,-793
9,-39,-27,27,-29,-21,-61,16,-125
-84,-144,-189,-40,-177,-28,-154,42,-774
-37,-56,-72,-47,-110,-71,-120,22,-491
-20,-15,-36,-25,-36,-31,-62,11,-214
-17,-46,-86,-57,-99,-59,-130,30,-464
-11,0,-3,3,-32,-17,-27,-4,-91
-4,-58,-107,-54,-133,-103,-149,34,-574
0,-21,-29,12,-43,-19,-20,17,-103
-52,-125,-143,12,-178,-26,-177,73,-616
-36,-119,-73,-15,-114,-73,-116,7,-539
-20,-23,-83,-18,-99,-74,-118,26,-409
-9,-2,-36,-2,-37,-29,-48,21,-142
-11,-11,-10,1,-24,6,-7,14,-42
37,20,24,64,3,-6,-26,63,179
-6,-47,-56,-33,-46,-3,-44,46,-189
10,-20,-41,-2,-62,-10,-20,70,-75
-19,-60,-58,-14,-72,-42,-64,9,-320
58,-110,-34,-10,-62,-91,-140,93,-296
14,-11,-6,21,-23,-18,-40,22,-41
-12,-14,-24,-27,-15,-20,-30,-15,-157
9,-26,-45,-1,-18,-25,-67,12,-161
5,-35,-44,-12,-72,-43,-44,16,-229
-19,-5,-7,-2,-43,-38,-59,12,-161
21,-11,-37,-22,-94,-67,-73,78,-205
-51,-85,-93,-50,-154,-29,-113,71,-504
-60,-103,-92,-26,-127,2,-86,70,-422
1,-46,-102,-61,-111,-113,-148,5,-575
-53,-99,-66,1,-110,-33,-114,73,-401
-17,-41,-39,-2,-61,-12,-84,26,-230
-50,-96,-70,-24,-94,-44,-100,20,-458
17,-40,-17,11,-13,-6,-12,32,-28
2,-110,-139,5,-103,-19,-93,53,-404
15,-39,-55,-23,-34,-40,-91,27,-240
24,-18,-41,8,-78,-58,-70,15,-218
-76,-119,-152,17,-162,28,-186,129,-521
2,-20,-32,-3,-33,-23,-39,-4,-152
-15,-43,-20,-2,-18,-24,-35,-1,-158
0,-15,-56,-38,-49,-43,-70,27,-244
-7,-23,-12,-6,-14,-12,-12,6,-80
31,-72,-75,-20,-83,-59,-103,84,-297
-5,-10,-53,-11,-19,-38,-100,30,-206
-66,-96,-82,-12,-89,-29,-71,45,-400
-15,-39,-32,-7,-97,-28,-54,38,-234
-18,-88,-79,-56,-91,-87,-115,-7,-541
-2,-7,-24,-22,-37,-44,-57,-7,-200
-38,-65,-69,-34,-84,-48,-99,-10,-447
-85,-148,-130,-46,-204,-54,-166,72,-761
-6,-32,-35,-11,-50,-32,-53,13,-206
81,-102,-241,13,-112,-154,-278,144,-649
14,-122,-188,-44,-251,-176,-268,130,-905
-86,-118,-112,-57,-126,-39,-118,30,-626
-29,-87,-67,-17,-88,-66,-90,16,-428
10,-87,-82,-27,-126,-40,-125,64,-413
-41,-106,-131,-72,-135,4,-123,79,-525
-106,-152,-148,-24,-169,0,-155,65,-689
-28,-14,-31,-8,-28,-24,-29,-6,-168
-50,-46,-35,-18,-45,-17,-63,-1,-275
-37,-52,-38,-21,-65,-16,-62,36,-255
-29,-33,-71,-40,-86,-49,-73,22,-359
-2,-31,-22,-5,-32,-28,-52,16,-156
29,-88,-115,-3,-94,-42,-125,92,-346
-41,-46,-40,-29,-10,-17,-43,-3,-229
-28,-43,-69,-48,-94,-85,-133,-3,-503
-45,-105,-102,-33,-143,-10,-94,50,-482
-94,-89,-143,-86,-170,-65,-179,25,-801
1,-22,-30,-10,-35,-16,-27,4,-135
19,-8,-14,19,19,-3,-12,29,49
0,-7,-15,-2,-34,-33,-71,0,-162
12,-34,-23,11,-33,7,-26,20,-66
-12,-55,-51,-5,-65,-33,-74,4,-291
-113,-164,-211,-67,-278,-127,-306,-3,-1269
-46,-71,-99,-77,-143,-138,-139,10,-703
-28,-143,-169,-62,-173,-81,-200,126,-730
-41,-78,-116,-26,-154,-37,-143,82,-513
19,-12,-15,17,-16,-4,-23,27,-7
48,-28,-57,54,-24,-32,-134,111,-62
-15,-62,-48,-42,-48,-36,-63,52,-262
34,-54,-28,44,-25,-71,-72,19,-153
-78,-234,-305,-185,-353,-195,-294,165,-1479
-33,-46,-82,-28,-62,8,-56,42,-257
-52,-15,-62,-68,-106,-67,-122,-16,-508
9,-5,-24,5,-25,-18,-24,27,-55
9,-30,-33,15,-35,-21,-40,33,-102
-7,-72,-99,-63,-46,-90,-114,10,-481
-17,-44,-23,-3,-18,-14,-50,20,-149
-14,-40,-42,-29,-67,-37,-69,12,-286
-26,-17,-47,-28,-54,-39,-66,-15,-292
-36,-79,-127,47,-91,-23,-135,110,-334
-123,-33,-139,-12,-71,-89,-201,-102,-770
-20,-28,-33,-25,-23,-38,-33,-8,-208
-52,-104,-144,-56,-165,-75,-181,71,-706
-37,-30,-36,-31,-46,-43,-95,-48,-366
-40,-52,-33,-54,-15,-25,-64,-28,-311
-5,-40,-68,-42,-102,-89,-53,50,-349
13,-25,-62,29,-38,29,-42,43,-53
-36,-160,-184,-60,-160,-110,-215,48,-877
-2,-61,-53,2,-47,-40,-86,17,-270
34,-109,-152,-46,-109,-52,-197,123,-508
49,22,-34,67,2,20,-46,82,162
105,-30,-30,104,-133,-13,-69,158,92
-11,-90,-98,-7,-109,-62,-105,87,-395
-59,-102,-128,6,-147,-63,-166,41,-618
15,-51,-53,-17,-62,-34,-114,64,-252
-7,-28,-53,-3,-58,-30,-56,7,-228
-55,-69,-101,-47,-142,-69,-171,-5,-659
-96,-190,-139,-6,-237,-81,-244,95,-898
44,-2,14,33,6,-24,-32,36,75
20,-64,-59,16,-88,-40,-86,36,-265
42,-42,-51,-15,-28,-74,-92,70,-190
-112,-121,-144,-92,-224,-95,-214,38,-964
32,-102,-99,-10,-45,-92,-170,80,-406
13,-92,-90,-40,-112,-143,-202,106,-560
121,-198,-228,-58,-202,-73,-287,184,-741
-43,-68,-164,-40,-147,-57,-194,137,-576
26,-30,-39,7,-50,-31,-44,21,-140
12,-61,-93,15,-126,-83,-168,69,-435
-8,-35,-39,-14,-47,-16,-23,17,-165
-14,-29,-25,-1,-61,-33,-74,27,-210
-5,-24,-18,-10,-19,-11,-26,9,-104
-15,-36,-69,-49,-71,-65,-110,-3,-418
6,-68,-72,-26,-107,-66,-147,26,-454
33,-119,-116,-1,-126,-106,-177,50,-562
-8,-70,-53,-15,-97,-53,-104,52,-348
63,7,-6,101,-90,21,-93,120,123
-10,-65,-44,1,-123,-26,-72,76,-263
50,-63,-91,-25,-57,-81,-107,82,-292
-2,0,-2,20,-26,19,-39,15,-15
-50,-89,-81,-33,-129,-12,-102,48,-448
-7,-3,3,8,-17,-3,-28,12,-35
-73,-70,-117,-55,-141,-75,-164,19,-676
32,-27,-65,17,-36,-32,-84,26,-169
4,-64,-45,12,-70,-20,-46,12,-217
10,-35,-133,-93,-178,-155,-305,-33,-922
-72,-87,-87,-8,-108,-17,-97,50,-426
60,58,8,48,-7,-45,-35,67,154
14,-74,-112,-33,-131,4,-80,102,-310
-40,-105,-117,-34,-161,-44,-125,48,-578
-26,-85,-137,-99,-13,-102,-237,70,-629
4,-37,-55,-19,-72,-42,-70,22,-269
1,-5,-24,-5,-61,0,-58,61,-91
-72,-77,-82,-18,-141,-51,-106,63,-484
25,-200,-266,-73,-365,-197,-390,206,-1260
19,-97,-102,-49,-90,-108,-139,121,-445
-8,-59,-71,-26,-87,-51,-100,52,-350
-7,-146,-202,-42,-178,-114,-123,139,-673
-90,-81,-158,-67,-109,-92,-136,63,-670
78,-45,-24,114,-72,-99,-159,75,-132
35,-178,-212,-96,-185,-202,-296,155,-979
13,-42,-35,62,-71,-21,-70,76,-88
2,-122,-227,-30,-188,-60,-203,163,-665
9,-103,-66,1,-140,-60,-98,32,-425
-77,-138,-133,-63,-131,-26,-142,19,-691
20,-95,-87,54,-87,-51,-127,94,-279
-99,-113,-146,-36,-114,-55,-105,15,-653
-11,-55,-104,-53,-171,-45,-125,86,-478
-232,-250,-281,-130,-411,-177,-467,-7,-1955
5,-41,-43,-25,-40,-92,-112,36,-312
-84,-86,-128,-21,-44,-24,-81,-33,-501
-20,-45,-40,-8,-83,-15,-64,55,-220
-22,-41,-43,-26,-58,-52,-68,-12,-322
-14,-28,-67,-64,-73,-97,-111,56,-398
132,-205,-39,71,25,74,-9,274,323
-32,-74,-74,-24,-92,-47,-76,54,-365
-35,-25,-31,-20,-20,-41,-69,-37,-278
-34,-123,-88,-23,-172,-67,-162,47,-622
-58,-80,-108,-11,-23,0,-73,17,-336
-16,-27,-22,-12,-25,-21,-26,-2,-151
-90,-658,-961,-169,-1168,-644,-1084,430,-4344
-52,-85,-145,-6,-76,3,-93,69,-385
60,-88,-74,11,-41,-52,-79,67,-196
38,-100,-181,60,-352,-77,-217,190,-639
-7,-126,-104,-20,-145,-18,-108,85,-443
-42,-102,-106,-36,-91,-46,-75,16,-482
-16,-64,-23,57,-50,21,-46,45,-76
-7,-80,-59,-5,-77,-5,-53,54,-232
-20,-78,-66,-12,-80,-53,-92,32,-369
-10,-60,-56,-10,-77,-29,-86,16,-312
-29,-49,-120,-37,-114,-28,-91,67,-401
-22,-20,-30,-22,-54,-8,-44,9,-191
22,-11,-17,10,-29,-24,-35,10,-74
-3,-96,-114,10,-121,-78,-186,38,-550
-6,-43,-61,-11,-60,-15,-54,7,-243
10,-76,-72,-18,-87,-74,-99,8,-408
-183,-402,-646,-225,-450,-172,-615,403,-2290
-41,-52,-67,-26,-117,-36,-104,45,-398
-6,-16,-24,-19,-3,-34,-36,6,-132
28,-96,-61,35,-66,-76,-75,7,-304
16,-43,-60,68,-63,-39,-155,90,-186
-55,-66,-86,-59,-142,-82,-134,34,-590
7,-90,-109,58,-131,-80,-150,78,-417
20,-93,-88,85,-148,21,-109,137,-175
-27,-44,-45,-1,-61,-44,-83,-8,-313
-10,-114,-100,-14,-157,-140,-152,23,-664
-33,-59,-97,-34,-115,-73,-142,11,-542
-40,-134,-218,-49,-245,-104,-262,134,-918
38,-64,-68,-23,-42,-77,-128,70,-294
121,-188,25,93,76,47,17,198,389
-66,-194,-203,-87,-278,-236,-354,1,-1417
-110,-194,-172,13,-247,-13,-272,69,-926
69,-428,-482,-131,-448,44,-423,492,-1307
19,-52,-114,-68,-132,-152,-199,63,-635
-40,-51,-58,-40,-73,4,-58,51,-265
-46,-95,-97,4,-155,-30,-143,66,-496
53,-96,-151,-58,-149,-149,-202,142,-610
-46,-124,-80,-23,-125,-76,-134,42,-566
-25,-139,-130,-14,-164,-82,-201,-2,-757
-164,-332,-629,-453,-1021,-1233,-1378,-472,-5682
-35,-51,-78,-45,-94,-67,-119,8,-481
6,-26,-13,9,-30,-5,-15,25,-49
-41,-51,-54,2,-77,-34,-93,8,-340
7,-76,-21,21,-59,-29,-52,21,-188
-18,-39,-59,-5,-99,-68,-99,15,-372
-118,-286,-219,-62,-422,-191,-438,162,-1574
-163,-298,-253,-132,-445,-204,-434,151,-1778
2,-45,-18,9,-54,-24,-36,32,-134
33,-133,-197,27,-95,-76,-170,162,-449
70,-53,-100,4,-101,-87,-206,155,-318
-41,-81,-77,-19,-141,-11,-97,67,-400
-3,2,-24,16,-10,-12,-25,1,-55
6,-12,-22,0,-27,-16,-37,7,-101
-14,-15,-31,-5,-55,-19,-30,16,-153
-36,-71,-90,-39,-93,-44,-93,-15,-481
8,-24,-22,0,-67,-41,-82,46,-182
3,-108,-130,-53,-126,-43,-144,59,-542
9,-12,-36,9,-53,-33,-50,7,-159
4,-77,-104,13,-138,-79,-133,94,-420
-3,-63,-48,14,-113,-28,-80,51,-270
-46,-57,-120,-47,-180,-198,-270,12,-906
3,-4,-6,-1,-7,-8,-11,8,-26
-4,-7,-7,-8,-8,-5,-16,2,-53
-10,-23,-33,-9,-20,-12,-30,-6,-143
-13,-32,-51,-29,-38,-23,-53,12,-227
-10,-9,-33,-24,-42,-25,-22,17,-148
108,-217,-175,-43,-194,-120,-286,315,-612
-25,-111,-124,-47,-168,-52,-154,53,-628
23,-111,-154,-59,-179,-44,-170,144,-550
-25,-85,-131,-24,-209,-110,-253,75,-762
-102,-173,-267,-162,-266,-169,-371,130,-1380
75,-81,-104,24,-161,-125,-161,88,-445
-49,-68,-120,-34,-188,-45,-165,65,-604
224,-74,27,140,196,34,-108,262,701
-84,-71,-56,-34,-91,-40,-90,-10,-476
-21,-92,-94,-34,-102,9,-96,78,-352
92,-173,-122,34,-122,-150,-202,122,-521
-10,-50,-33,6,-73,-53,-97,22,-288
-13,-62,-49,-3,-62,-14,-79,5,-277
-11,-37,-15,4,-52,-18,-38,7,-160
-31,-27,-38,-18,-50,-8,-51,34,-189
-19,-14,-21,-13,-14,-5,-17,-21,-124
-7,-13,-23,-3,-29,-24,-21,1,-119
-96,-181,-305,-130,-326,-281,-431,34,-1716
7,-56,-17,8,-37,6,-35,80,-44
-16,-14,-26,-24,-14,-15,-13,2,-120
-21,-45,-34,-28,-44,-27,-43,6,-236
4,-24,-42,-29,-72,-33,-91,63,-224
2,1,12,18,-10,3,-3,27,50
-85,-258,-171,-129,-219,-185,-342,72,-1317
32,-32,1,101,-30,-46,-100,81,7
34,-97,-100,-16,-137,-73,-180,139,-430
-7,4,-8,-2,-6,-9,-8,14,-22
-2,-55,-60,4,-107,-27,-72,65,-254
-3,-57,-63,-21,-47,-61,-98,-6,-356
2,-107,-164,-60,-213,-138,-248,79,-849
21,-23,-14,6,-14,-6,-18,13,-35
-11,-24,-32,-1,-57,-6,-27,25,-133
-17,-55,-36,13,-25,5,-38,29,-124
-15,-32,-32,-11,-46,-29,-50,1,-214
-50,-84,-129,-50,-157,-29,-135,25,-609
-18,-17,-32,-24,-58,-16,-58,21,-202
-26,-8,-26,-15,-41,-32,-56,-15,-219
-15,-16,-16,-2,-15,-17,-16,-6,-103
22,-23,-5,29,-30,-24,-11,19,-23
-63,-95,-134,-5,-155,-34,-132,81,-537
-13,-25,-33,-12,-29,-15,-33,14,-146
10,-12,-13,11,-25,-18,-25,3,-69
-93,-233,-231,-95,-310,-81,-310,106,-1247
-9,-46,-89,-26,-88,-21,-140,21,-398
11,-33,-49,-42,-53,-54,-68,43,-245
-24,-34,-45,-24,-65,-6,-56,50,-204
-69,-88,-116,-31,-116,-31,-123,21,-553
-58,-87,-115,-56,-106,-56,-114,18,-574
-112,-96,-135,-105,-176,-54,-178,-17,-873
-5,-75,-47,18,-43,-32,-58,3,-239
29,-76,-77,56,-51,-126,-223,199,-269
2,-24,-39,11,-35,-13,-41,13,-126
-46,-55,-55,-61,-83,-54,-106,7,-453
-3,-13,-10,-1,0,10,-12,16,-13
-3,-9,-10,6,0,9,-13,21,1
-17,-41,-49,-15,-46,-12,-50,2,-228
50,-4,-21,45,-56,-74,-99,44,-115
-2,-110,-119,-54,-162,-135,-190,109,-663
-115,-162,-207,-25,-326,-54,-273,131,-1031
-16,-120,-210,11,-204,-51,-182,258,-514
-22,-33,-45,7,-54,-30,-36,10,-203
-10,-142,-176,-16,-124,-48,-181,153,-544
2,-19,-31,-8,-40,-7,-27,19,-111
-41,-110,-95,-18,-125,-79,-120,24,-564
-13,-59,-94,-28,-121,-124,-139,7,-571
7,-60,-69,7,-67,-44,-99,40,-285
-8,4,-26,-9,-28,-32,-31,8,-122
25,-21,-3,52,-6,13,-17,36,79
-25,-39,-23,-7,-60,-8,-79,6,-235
-77,-99,-109,-45,-143,-17,-130,45,-575
-66,-122,-138,-39,-168,-25,-148,106,-600
-24,-66,-88,-58,-155,-140,-172,14,-689
-28,-50,-50,6,-61,26,-49,46,-160
-56,-67,-71,-12,-100,-59,-116,-10,-491
-175,-101,-235,-171,-215,-162,-393,-86,-1538
-58,-92,-104,-34,-103,-12,-120,44,-479
-71,-126,-134,-20,-172,5,-140,92,-566
1,-112,-121,-33,-157,-110,-180,105,-607
-51,-111,-137,-54,-177,-62,-177,58,-711
16,-12,-33,-9,-26,-60,-53,27,-150
-42,-99,-149,-18,-192,-70,-195,127,-638
-3,-1,-10,4,-16,-10,-15,13,-38
-17,-17,-26,53,-142,-20,-171,43,-297
-50,-48,-71,-18,-110,-53,-166,1,-515
-12,-35,-48,-22,-69,-8,-88,-5,-287
138,-110,-191,121,-125,17,-238,264,-124
33,-41,-54,25,-65,-69,-106,3,-274
-7,-137,-105,-36,-98,-65,-113,28,-533
-46,-78,-97,-43,-63,-97,-105,-1,-530
-92,-127,-135,-4,-150,-43,-172,71,-652
-23,-113,-109,-14,-131,-76,-139,57,-548
-43,-110,-90,-36,-155,-25,-106,6,-559
14,-76,-68,-34,-59,-48,-67,28,-310
-18,-191,-157,-39,-208,-91,-230,102,-832
-111,-191,-195,-89,-278,-164,-302,-21,-1351
-16,-36,-48,-46,-54,-55,-85,4,-336
-15,-40,-106,-29,-69,-11,-95,73,-292
-63,-231,-363,-1,-472,-113,-445,367,-1321
3,-9,-28,29,-27,40,-73,61,-4
-82,-81,-120,-23,-32,0,-78,-28,-444
3,-21,-88,-23,-134,-121,-202,-33,-619
-6,-15,-23,10,-32,-35,-45,-5,-151
-43,-109,-101,-7,-126,-37,-135,54,-504
-20,-32,-45,-27,-66,-43,-58,7,-284
-13,-15,-13,-18,-10,-11,-30,-12,-122
-21,-81,-89,-30,-116,-49,-140,72,-454
14,-54,-83,-30,-62,-78,-110,18,-385
-174,-174,-206,-153,-211,-150,-343,-10,-1421
-53,-90,-79,-44,-127,-77,-147,10,-607
88,-49,-132,94,-107,-109,-104,200,-119
1,-40,-29,-17,-37,7,-30,33,-112
10,-29,-126,-68,-161,-172,-247,20,-773
6,-46,-43,0,-62,-19,-44,-12,-220
61,-304,-305,185,-508,-6,-402,430,-849
25,-87,-81,14,-114,-9,-174,41,-385
-191,-463,-518,-142,-661,-160,-556,374,-2317
12,-45,-42,-27,-100,-62,-100,61,-303
-90,-217,-232,-95,-315,-70,-309,58,-1270
-94,-211,-276,-121,-302,-183,-330,21,-1496
8,-2,-25,-27,-6,-33,-44,39,-90
-151,-134,-215,-129,-251,-103,-345,-50,-1378
4,-191,-186,-49,-257,-160,-243,62,-1020
-23,-111,-91,18,-175,-42,-104,69,-459
18,-29,-26,-25,-21,-47,-52,36,-146
-32,-66,-44,-12,-95,-31,-68,24,-324
1,-31,-41,-24,-83,-35,-61,35,-239
-33,-64,-83,8,-94,-12,-102,49,-331
-22,-109,-138,-28,-149,-130,-253,103,-726
-21,-66,-73,-38,-82,-44,-64,35,-353
-6,-24,-21,-7,-36,-18,-55,-2,-169
14,-27,-51,-4,-56,7,-28,64,-81
-35,-159,-170,-39,-126,-62,-84,46,-629
-10,-12,-60,-11,-51,-25,-85,-1,-255
27,-24,-66,13,-75,-40,-57,57,-165
22,-51,-78,-9,-34,-45,-76,47,-224
124,-26,14,84,-53,-32,-152,219,178
-8,-77,-108,20,-149,-66,-145,2,-531
-52,-100,-99,-28,-134,-54,-144,29,-582
-387,-656,-958,-450,-1312,-920,-1509,92,-6100
-21,-12,-9,-6,-21,-12,-30,-6,-117
32,-33,-35,2,-45,-81,-105,73,-192
-31,-31,-72,-38,-89,-10,-58,63,-266
-32,-102,-94,-57,-64,-50,-78,40,-437
-50,-223,-279,-121,-232,-175,-238,15,-1303
48,-114,-77,-10,-167,-66,-114,92,-408
-26,-14,-32,-40,-22,-48,-58,-8,-248
25,-42,-36,56,-38,-12,-91,64,-74
11,-16,-41,-9,-56,-65,-87,27,-236
-51,-63,-67,-83,-78,-62,-104,-1,-509
-68,-144,-151,-54,-144,-109,-193,33,-830
-25,-62,-78,-7,-81,-20,-111,87,-297
13,-32,2,56,-110,-74,-165,54,-256
-22,-2,-9,-20,-13,-14,-35,-13,-128
0,-18,-10,12,-24,-2,-17,30,-29
11,-50,-44,-3,-108,-45,-80,25,-294
-11,-45,-64,-31,-89,-48,-85,38,-335
-33,-89,-80,-51,-143,-84,-143,-8,-631
-37,-45,-58,-44,-98,-56,-91,6,-423
23,-79,-46,2,-20,-45,-40,29,-176
48,-55,-87,27,-20,-26,-118,83,-148
0,-29,-16,-12,-33,-48,-65,52,-151
-33,-78,-136,-109,-186,-86,-145,63,-710
13,-55,-92,-17,-119,-57,-98,46,-379
2,-38,-48,5,-53,34,-19,59,-58
-121,-108,-147,-40,-191,-34,-200,61,-780
-78,-79,-76,-46,-101,-2,-82,34,-430
29,-11,-24,2,-56,-44,-57,20,-141
-69,-88,-98,-40,-93,-76,-113,-33,-610
10,-8,-36,-26,-41,-25,-42,18,-150
-68,-87,-86,-38,-110,-48,-100,-6,-543
-73,-35,-72,-59,-57,-87,-154,-67,-604
28,-54,-92,-6,-38,-49,-102,44,-269
-29,-71,-41,4,-87,-24,-100,28,-320
-16,-83,-111,-52,-195,-115,-188,26,-734
-20,-57,-64,-14,-61,-35,-81,-9,-341
4,-23,-50,-16,-49,-35,-73,46,-196
-20,-29,-36,-28,-52,-53,-72,-9,-299
-43,-119,-170,-104,-199,-134,-234,75,-928
-49,-85,-83,-27,-94,-54,-100,6,-486
-16,-56,-70,-21,-93,-31,-61,10,-338
-36,-69,-80,20,-128,-35,-132,43,-417
-30,-32,-50,-30,-60,-28,-83,-5,-318
2,-102,-109,37,-82,-63,-109,62,-364
-14,-109,-128,-41,-162,-35,-87,99,-477
-31,-84,-101,38,-170,-53,-154,58,-497
-21,-93,-77,12,-153,-74,-140,23,-523
-22,-108,-57,-22,-112,-22,-46,32,-357
-32,-31,-49,-25,-61,-36,-79,7,-306
-16,-42,-39,-7,-54,-12,-52,12,-210
-4,-34,-44,-20,-49,-4,-55,34,-176
-8,-46,-31,-41,-70,-31,-66,6,-287
4,-12,-28,-16,-26,-10,-25,11,-102
2,-43,-40,-20,-28,-41,-57,38,-189
3,-23,-34,3,-30,-17,-46,9,-135
5,-15,-29,1,-39,-14,-18,26,-83
8,-55,-125,79,-195,-11,-148,153,-294
-82,-145,-119,-54,-164,-72,-176,32,-780
-45,-98,-140,14,-164,-67,-144,27,-617
-38,-128,-169,-49,-216,-76,-210,34,-852
-74,-97,-122,-31,-77,-25,-70,27,-469
-42,-42,-75,-31,-84,-30,-102,23,-383
-35,-144,-118,-65,-161,-50,-138,86,-625
28,-44,-47,48,-55,-14,-78,59,-103
-17,-69,-36,29,-41,12,-64,60,-126
-48,-49,-53,-23,-69,-31,-52,31,-294
-41,-55,-64,-30,-57,-37,-64,-11,-359
-31,-97,-107,-59,-139,-39,-102,40,-534
-33,-73,-113,-35,-155,-30,-136,61,-514
-8,-96,-90,-20,-152,-79,-146,60,-531
-50,-106,-106,-63,-119,-60,-137,6,-635
-32,-54,-73,-60,-95,-63,-95,23,-449
-59,-149,-181,-135,-151,-153,-266,54,-1040
-74,-148,-190,-56,-255,-148,-307,48,-1130
-3,-110,-121,-13,-213,-90,-192,31,-711
-1,-31,-30,-23,-71,-60,-88,23,-281
-21,-111,-66,-4,-100,-64,-100,12,-454
-43,-77,-61,-31,-107,-58,-122,-17,-516
-40,-67,-92,-67,-125,-117,-164,30,-642
-31,-83,-112,-36,-152,-56,-143,53,-560
-43,-170,-215,-32,-294,-150,-267,40,-1131
-37,-96,-80,-32,-102,-61,-78,-14,-500
-150,-183,-291,-150,-360,-167,-388,65,-1624
2,-89,-95,-17,-154,-167,-187,-31,-738
-39,-17,-20,-10,-50,9,-55,13,-169
-41,-12,-25,-36,-73,-54,-85,-41,-367
-11,-22,-32,1,-28,-27,-63,0,-182
-17,-30,-41,-14,-34,-46,-55,3,-234
-23,-13,-24,-20,-35,-39,-59,10,-203
-21,-160,-119,-50,-193,-103,-137,55,-728
-28,-9,-53,-41,-46,-79,-86,-37,-379
-58,-118,-133,-68,-153,-29,-148,2,-705
-57,-82,-98,-71,-122,-80,-139,-31,-680
-23,-75,-102,-42,-101,-76,-101,19,-501
-53,-59,-107,-26,-97,-16,-100,94,-364
-4,-37,-24,5,-34,8,-46,33,-99
-17,-71,-127,-17,-111,-66,-154,69,-494
4,-22,-41,0,-47,4,-19,4,-117
1,-135,-96,-1,-176,-57,-183,78,-569
-76,-121,-95,-34,-186,-82,-175,7,-762
116,-73,-95,25,-159,-93,-185,126,-338
-52,-140,-139,-70,-134,-50,-153,30,-708
-36,-35,-41,-44,-14,-22,-60,4,-248
-8,-27,-54,-11,-37,-37,-51,15,-210
9,-44,-46,-6,-79,-38,-73,38,-239
-1,-98,-119,-43,-149,-133,-129,56,-616
-99,-102,-135,-56,-143,-75,-162,8,-764
-10,-88,-50,-5,-77,-7,-60,41,-256
-1,-23,-30,-33,-17,-37,-41,28,-154
-73,-88,-126,-45,-140,-33,-139,78,-566
-46,-47,-66,-16,-86,3,-79,20,-317
-25,-49,-40,-36,-27,-38,-47,4,-258
5,51,-84,87,-99,49,-141,184,52
-25,-50,-44,-34,-59,-28,-72,-13,-325
33,-75,-95,-1,-166,-75,-84,53,-410
-6,-101,-115,-12,-148,-51,-145,67,-511
42,-12,-15,17,-20,-30,-21,45,6
98,-62,-70,16,-25,-148,-111,115,-187
-79,-133,-140,-30,-236,-69,-184,91,-780
-43,-41,-150,-83,-81,-113,-88,52,-547
-93,-153,-143,-60,-192,-82,-202,43,-882
-44,-78,-66,-25,-100,-51,-96,6,-454
-25,-19,-27,-9,-36,-5,-44,14,-151
11,-63,-49,-7,-20,-36,-66,34,-196
39,-47,-78,-15,-63,-47,-84,51,-244
11,3,-45,6,-31,-25,-48,115,-14
-15,-24,-29,-5,-64,-44,-64,-7,-252
14,-35,-59,-11,-102,-17,-53,105,-158
-5,-24,-51,-7,-18,-19,-50,37,-137
4,-30,-17,-19,-13,-28,-27,12,-118
93,-65,-6,83,-4,-21,-36,92,136
-70,2,-45,-92,-35,-21,-104,-9,-374
-34,-40,-65,-42,-81,-47,-99,1,-407
-67,-70,-61,-31,-86,-26,-110,18,-433
-11,-77,-71,1,-69,-2,-82,40,-271
-7,5,4,6,-4,6,-8,0,2
-9,-73,-148,-67,-125,-121,-166,64,-645
-33,-91,-86,-7,-109,-86,-185,38,-559
14,-11,-36,18,-26,-12,-29,18,-64
-29,-89,-111,-19,-94,-51,-92,67,-418
30,66,-104,21,-98,-18,-188,51,-240
-35,-33,-71,-39,-52,-15,-50,-6,-301
-21,-96,-121,-27,-179,-28,-153,65,-560
3,-49,-78,6,-111,-42,-120,75,-316
41,-22,-2,47,-22,-59,-95,63,-49
-25,-12,-43,-13,-41,-26,-58,0,-218
22,-98,-131,-10,-116,-64,-121,143,-375
27,-66,-107,-24,-85,-50,-94,75,-324
41,-9,-79,31,-39,-30,-72,52,-105
-6,-26,-31,-10,-25,-24,-44,10,-156
-53,-79,-70,-49,-78,-47,-88,9,-455
-12,-29,-24,12,-40,-24,-65,15,-167
-43,-59,-98,-13,-101,-24,-104,27,-415
9,-44,-44,-13,-100,-74,-64,-4,-334
-57,-85,-96,-51,-110,-40,-134,4,-569
27,-42,-86,-42,-35,-76,-85,35,-304
-8,-66,-95,-31,-93,-31,-51,36,-339
-2,-56,-23,12,-29,-18,-47,31,-132
-23,-23,-32,-38,-18,-26,-58,26,-192
24,-38,-67,26,-114,-45,-91,50,-255
-29,-28,-37,-16,-45,-47,-67,-37,-306
-35,-31,-48,-27,-43,-35,-63,7,-275
3,-12,-17,25,-19,-4,-25,3,-46
3,-53,-58,-3,-40,-3,-57,64,-147
-14,-20,-26,-22,-9,-24,-48,8,-155
-65,-84,-78,-27,-114,-42,-99,21,-488
-20,-35,-21,2,-29,-9,-37,5,-144
-26,-75,-134,-39,-137,-36,-117,74,-490
10,-22,-32,-3,-43,-11,-38,25,-114
-26,-70,-85,-40,-134,-83,-144,-13,-595
-12,-68,-44,-2,-79,-36,-57,36,-262
-15,-54,-38,-3,-60,-16,-79,-8,-273
-23,-60,-68,0,-82,-20,-62,22,-293
-31,-71,-58,-38,-150,-65,-102,74,-441
-2,-73,-32,12,-46,-53,-66,11,-249
14,-11,-27,20,-43,-53,-76,22,-154
0,-40,-17,14,-40,-8,-12,32,-71
-136,-160,-187,-99,-283,-214,-341,-49,-1469
3,-35,-32,-15,-68,-56,-72,-14,-289
56,-150,-140,-39,-141,-178,-269,149,-712
36,-32,-7,52,-10,-9,-21,50,59
-15,-22,-26,-22,-37,-25,-54,-15,-216
-11,-26,-55,-9,-60,-41,-91,38,-255
13,-26,-25,2,-31,-16,-38,23,-98
-18,-33,-37,-18,-38,-17,-60,-1,-222
-7,-56,-28,-27,-40,-29,-56,15,-228
-7,-28,-23,-10,-23,-12,-21,11,-113
26,-22,-58,11,-51,-30,-45,59,-110
-62,-65,-63,-45,-81,-24,-78,-15,-433
-13,-39,-53,-23,-36,-5,-35,18,-186
8,-35,-39,9,-36,3,-39,35,-94
-21,-59,-94,-29,-100,-7,-110,38,-382
35,-28,-36,44,-82,-71,-102,31,-209
-47,-59,-41,-29,-97,-35,-69,20,-357
-51,-50,-64,-5,-93,-22,-85,23,-347
-11,0,-13,-22,-13,-8,-35,-7,-109
-12,-37,-20,5,-54,-38,-26,8,-174
-1,-41,-75,-51,-30,-28,-54,2,-278
-66,-117,-135,-78,-153,-133,-194,-7,-883
5,-27,-59,5,-85,-37,-50,20,-228
-29,-40,-44,-28,-48,-56,-85,-25,-355
-7,-68,-125,-27,-70,-82,-101,51,-429
31,-16,-19,35,-21,-56,-42,13,-75
-13,-81,-70,-40,-136,-86,-140,13,-553
-41,-37,-56,-22,-56,-10,-68,15,-275
-51,-121,-103,-26,-108,-33,-118,32,-528
-57,-160,-152,-20,-182,-64,-224,52,-807
6,-32,-39,19,-48,-57,-101,55,-197
28,-46,-97,3,-112,-43,-152,131,-288
-3,-61,-51,-14,-71,-28,-63,26,-265
-44,-86,-119,-55,-130,-31,-117,74,-508
-46,-80,-71,14,-79,-24,-87,35,-338
-22,-60,-58,-17,-92,-45,-72,42,-324
-27,-156,-144,5,-193,-83,-185,16,-767
-61,-142,-146,-8,-179,-32,-182,51,-699
-37,-226,-201,-74,-216,-169,-270,29,-1164
-80,-43,-77,-72,-26,-64,-100,-2,-464
-144,-180,-225,-143,-293,-142,-300,-2,-1429
-19,-48,-58,-16,-22,-1,-63,4,-223
-50,-62,-88,-33,-88,-36,-74,47,-384
-168,-139,-260,-230,-224,-204,-395,-68,-1688
24,-18,-61,14,-40,-25,-35,31,-110
3,-65,-56,-6,-112,-79,-106,32,-389
-11,-18,-31,-8,-30,-31,-30,13,-146
8,-71,-81,-68,-149,-115,-153,41,-588
1,-113,-125,-31,-163,-102,-169,65,-637
-30,-51,-71,-49,-67,-57,-71,1,-395
2,-17,-45,29,-55,15,-61,87,-45
13,-28,-23,-7,-55,-18,-42,23,-137
-52,-100,-87,-4,-110,-31,-109,20,-473
-51,-61,-79,-95,-107,-75,-124,-10,-602
-74,-114,-143,-58,-178,-77,-199,-17,-860
-33,-200,-149,11,-268,-46,-212,202,-695
-45,-149,-223,-95,-229,-92,-227,173,-887
-26,-98,-82,-9,-136,-44,-109,46,-458
-18,-93,-110,-30,-126,5,-85,62,-395
-17,-5,-36,7,-55,-18,-114,-5,-243
50,-15,-50,32,-70,-32,-64,54,-95
-2,-87,-65,17,-76,-40,-71,22,-302
50,9,-65,88,-41,-14,-90,55,-8
-53,-78,-90,-94,-111,-86,-135,14,-633
-22,-95,-101,15,-152,-61,-125,49,-492
-64,-81,-113,-42,-82,-22,-112,27,-489
-11,-41,-37,9,-52,-28,-68,13,-215
-11,-21,-32,-7,-41,-24,-43,23,-156
107,-46,-160,45,-110,-26,-119,155,-154
36,-44,-11,44,-61,-39,-67,23,-119
-12,-44,-56,-38,-61,-50,-80,29,-312
-44,-35,-51,-29,-103,-22,-96,33,-347
75,-108,-81,64,-130,6,-89,135,-128
-14,-62,-102,-28,-123,-11,-84,85,-339
15,68,46,63,9,33,4,34,272
42,-206,-243,102,-437,-309,-553,280,-1324
-8,-25,-31,16,-28,33,-40,32,-51
-38,-48,-85,-51,-89,-83,-146,0,-540
41,22,-60,14,-11,36,-29,62,75
-74,-121,-113,-63,-162,-77,-174,-25,-809
-12,-33,-50,-8,-55,-9,-37,25,-179
-22,-105,-115,4,-166,-90,-184,18,-660
-37,-60,-60,1,-79,-26,-84,17,-328
-30,-109,-119,-29,-114,27,-99,71,-402
29,-59,-55,-3,-49,-76,-83,58,-238
-174,-330,-374,-29,-510,18,-457,327,-1529
4,-187,-144,50,-217,-105,-194,143,-650
-19,-9,-27,-4,-24,-19,-32,6,-128
-30,-60,-63,-26,-86,-49,-55,20,-349
20,-94,-65,66,-143,-74,-147,65,-372
3,-17,-56,-6,-108,-91,-117,60,-332
-14,-90,-125,-10,-171,-109,-165,59,-625
16,-64,-55,28,-102,-11,-70,57,-201
-4,-45,-50,-12,-67,3,-55,27,-203
43,-71,-126,79,-81,63,-94,157,-30
15,-109,-87,19,-95,-33,-81,64,-307
-4,-12,-13,6,-5,7,-13,21,-13
-122,-144,-134,-42,-210,-29,-207,73,-815
-30,-94,-103,-103,-150,-124,-147,12,-739
-43,-70,-71,-14,-83,-9,-83,19,-354
2,-90,-79,5,-136,-42,-119,76,-383
-26,-48,-89,-48,-96,-74,-114,38,-457
-60,-8,-90,-84,-63,-122,-178,-50,-655
29,-172,-180,3,-201,-146,-243,142,-768
12,-32,-63,-13,-68,-56,-87,30,-277
-107,-122,-190,4,-195,4,-186,155,-637
67,-88,-44,50,-9,0,-95,148,29
-347,-822,-763,-227,-1075,-564,-1193,-48,-5039
7,-64,-53,22,-18,-29,-78,31,-182
47,-68,-141,2,-81,-100,-180,101,-420
20,-64,-69,-7,-30,-61,-141,97,-255
-38,-60,-156,-61,-168,-59,-227,50,-719
-18,-46,-159,31,-57,1,-175,180,-243
-61,-77,-72,-27,-71,-32,-64,11,-393
-17,-19,-15,-11,-14,-12,-10,-4,-102
-4,-63,-84,-36,-91,-66,-132,58,-418
-71,-134,-109,-39,-167,-114,-212,-24,-870
17,-106,-187,31,-145,-53,-169,81,-531
-5,-11,-11,14,-12,-23,-9,3,-54
6,-45,-84,-12,-96,-103,-182,73,-443
66,-41,-74,85,-56,31,-84,194,121
-136,-224,-209,-66,-205,-28,-286,81,-1073
-32,-87,-65,-26,-91,-8,-66,30,-345
-15,-29,-53,-19,-53,-32,-62,-6,-269
0,-76,-118,-7,-125,-26,-128,113,-367
-31,-40,-43,-43,-42,-34,-59,0,-292
-76,-82,-113,-54,-117,-32,-117,-2,-593
-2,-32,-46,-12,-52,-13,-56,-7,-220
-60,-125,-107,-44,-143,-46,-136,63,-598
2,-18,-14,5,-31,-14,-39,18,-91
-4,-61,-65,-23,-76,-50,-77,13,-343
-12,-93,-119,-31,-113,-77,-140,57,-528
-64,-76,-72,9,-78,0,-88,39,-330
-33,-47,-54,1,-53,-1,-55,11,-231
-20,-30,-52,-18,-49,-48,-81,4,-294
-26,-48,-62,-36,-108,-29,-103,9,-403
77,-329,-394,8,-657,-217,-544,527,-1529
150,-336,-428,48,-731,-413,-780,593,-1897
260,-664,-672,49,-1031,-79,-597,930,-1804
-18,-52,-73,-29,-100,-62,-81,58,-357
-23,-21,-41,-24,-51,-21,-30,20,-191
-14,-23,-37,-26,-45,-30,-31,15,-191
-4,-78,-92,-39,-105,-54,-81,49,-404
-21,-49,-71,-24,-81,-31,-72,39,-310
-63,-117,-145,13,-82,-25,-91,43,-467
-132,-286,-264,-29,-390,-106,-313,57,-1463
-35,-289,-227,41,-381,-109,-341,168,-1173
47,-137,-261,-72,-124,-170,-356,230,-843
-65,-134,-110,-42,-190,-47,-138,46,-680
-102,-95,-98,-47,-137,-18,-130,24,-603
-84,-94,-110,-38,-148,4,-111,64,-517
-99,-93,-100,-44,-133,0,-129,42,-556
-92,-68,-81,-23,-130,34,-119,47,-432
-102,-76,-94,-75,-143,0,-117,48,-559
-92,-104,-93,-45,-137,1,-118,35,-553
-87,-107,-92,-50,-120,-38,-123,21,-596
-83,-96,-90,-55,-113,-42,-134,33,-580
-78,-98,-112,-45,-139,-8,-101,62,-519
-101,-64,-101,-49,-124,-27,-116,24,-558
-105,-90,-90,-59,-134,-17,-120,43,-572
-80,-108,-188,15,-65,1,-131,21,-535
13,-26,-41,9,-35,-48,-46,-9,-183
-33,-33,-44,-16,-50,-29,-66,-13,-284
-62,-100,-118,-40,-140,-81,-144,8,-677
-79,-168,-146,-53,-226,-111,-182,31,-934
-23,-54,-54,-16,-82,-18,-54,53,-248
7,-50,-37,47,-72,-39,-57,39,-162
76,-112,-139,-15,-89,-81,-155,148,-367
26,-38,-105,-2,-60,-36,-102,105,-212
-56,-102,-73,-16,-68,-25,-75,17,-398
-32,-185,-178,-33,-216,-47,-190,96,-785
20,-29,-102,-8,-66,-36,-93,38,-276
-11,-69,-61,14,-61,-94,-124,35,-371
-58,-75,-74,-61,-102,-37,-111,16,-502
-18,-45,-34,-21,-41,-15,-37,23,-188
-23,-30,-33,-7,-38,-5,-42,9,-169
-29,-48,-57,-30,-56,-44,-83,-5,-352
-1,-32,-24,7,-33,-9,-20,3,-109
50,-114,-138,-75,-81,-105,-212,107,-568
31,37,-86,-28,-49,-63,-154,89,-223
187,-135,-164,-215,-73,-385,-445,314,-916
-18,-15,-37,-24,-30,-10,-43,-12,-189
80,-181,-176,-29,-268,-231,-271,124,-952
-16,-17,-35,-24,-12,-6,-67,-14,-191
9,-29,-21,-6,-15,-49,-26,33,-104
53,-152,-93,34,-132,-52,-143,127,-358
13,-62,-50,34,-56,-22,-63,13,-193
114,-154,-95,86,-146,-106,-233,164,-370
-33,-101,-99,-34,-173,-80,-162,63,-619
-2,-21,-52,-22,-69,-57,-71,12,-282
-15,-68,-70,-10,-105,-40,-64,5,-367
-3,-46,-46,31,-24,-13,-49,-7,-157
7,-78,-75,5,-96,-34,-89,15,-345
-3,-155,-186,-28,-179,-111,-246,96,-812
-66,-67,-84,-46,-110,-46,-117,34,-502
-20,-50,-36,4,-52,-24,-60,-15,-253
1,-20,-19,-4,-19,-9,-34,8,-96
-13,-64,-50,12,-79,-26,-69,31,-258
-26,-56,-63,-32,-43,-13,-41,30,-244
-13,-9,-16,1,-30,-12,-20,13,-86
-9,-32,-38,-15,-45,-15,-44,28,-170
-58,-66,-102,-54,-120,-73,-148,24,-597
2,-27,-37,-17,-26,-25,-43,21,-152
-5,-42,-42,-17,-35,-21,-34,32,-164
3,-34,-42,4,-23,-23,-33,35,-113
-23,-2,-27,1,-37,-17,-17,9,-113
-14,-11,-33,-7,-32,-4,-15,6,-110
-11,-27,-28,20,-39,-6,-16,5,-102
23,-96,-97,0,-121,-16,-59,92,-274
-19,-80,-72,-1,-99,-32,-103,39,-367
6,-76,-80,20,-88,-31,-96,79,-266
25,-60,-79,1,-111,-42,-99,47,-318
68,-95,-153,27,-84,-2,-136,181,-194
-364,-838,-861,-331,-1140,-388,-1079,219,-4782
35,-132,-191,-3,-244,-50,-206,167,-624
-9,-73,-70,-13,-90,-16,-88,44,-315
5,-49,-77,-1,-93,-66,-91,74,-298
0,-20,-30,-16,-36,-13,-43,21,-137
-46,-104,-92,-32,-150,-51,-95,28,-542
-25,-32,-29,-7,-23,-21,-34,-9,-180
-93,-118,-156,-14,-77,-63,-96,-7,-624
-27,-8,-50,-11,-93,-98,-129,-18,-434
-53,-100,-151,-19,-157,-55,-188,75,-648
25,-52,-42,-4,-78,-28,-58,23,-214
-70,-286,-266,-82,-392,-72,-388,176,-1380
-58,-130,-204,-42,-144,-85,-374,47,-990
373,-205,-147,24,-40,-343,-392,356,-374
-35,-51,-72,-81,-79,-117,-131,16,-550
-124,-165,-137,12,-158,15,-182,63,-676
-85,-117,-115,-40,-157,-22,-160,44,-652
-27,-68,-53,-26,-128,-56,-108,18,-448
-13,-67,-69,-43,-111,-81,-117,13,-488
1,-141,-205,-77,-309,-139,-265,94,-1041
84,-25,-24,95,-1,31,-62,108,206
-32,-72,-72,-51,-65,-42,-126,3,-457
-76,-94,-87,-27,-129,-9,-117,47,-492
-72,-93,-97,-46,-140,-22,-111,49,-532
-106,-105,-106,-39,-134,-18,-127,26,-609
142,-191,-148,16,-98,-4,-207,342,-148
34,-51,-51,6,-80,-41,-76,74,-185
-6,-46,-41,16,-64,-11,-47,28,-171
33,-97,-137,-18,-189,-133,-219,29,-731
-27,-54,-51,-16,-70,2,-42,25,-233
-58,-195,-242,-125,-342,-256,-347,70,-1495
-13,-41,-24,-10,-60,-30,-67,6,-239
-9,-43,-39,-7,-40,-7,-55,-17,-217
-114,-439,-398,470,-811,-24,-686,452,-1550
27,-5,-40,1,-55,-71,-96,58,-181
-30,-44,-50,5,-48,7,-56,16,-200
-67,-114,-95,-53,-141,-65,-150,9,-676
13,-4,1,28,-27,-33,-23,4,-41
118,-38,-19,56,-28,-74,-178,129,-34
-43,-90,-102,-16,-116,-1,-122,63,-427
-24,-75,-70,20,-141,-66,-155,16,-495
-43,-41,-56,-22,-51,-49,-74,13,-323
-1,-16,-23,-15,-48,-83,-117,29,-274
-111,-125,-196,-68,-107,-25,-187,80,-739
-15,-69,-73,5,-89,-65,-92,34,-364
-49,-119,-146,-8,-181,-22,-143,144,-524
825,600,-189,745,164,146,-275,799,2815
-34,-58,-80,-28,-111,-11,-115,21,-416
-8,1,-24,-9,-15,-29,-51,-5,-140
9,-6,-26,14,-32,-48,-35,-12,-136
-11,-31,-39,-14,-77,-36,-72,5,-275
-44,-37,-41,-12,-55,-4,-58,11,-240
-9,-12,-35,-9,-32,-46,-41,-1,-185
-37,-20,-34,-26,-45,-44,-55,2,-259
-5,-33,-44,10,-23,-15,-34,6,-138
-7,-20,-24,1,6,-3,-9,-1,-57
-32,-37,-36,-38,3,-26,-21,20,-167
-15,-34,-30,-32,-38,-2,-34,7,-178
-73,-98,-86,-48,-112,-35,-121,32,-541
-72,-81,-99,-39,-105,-41,-124,10,-551
4,-15,-16,5,-27,-10,-40,-6,-105
-22,-13,-22,-14,-16,-10,-43,-14,-154
-13,-32,-30,-11,-52,-28,-54,26,-194
-14,-46,-31,4,-34,-15,-44,26,-154
-27,-10,-12,-21,-29,-21,-42,-4,-166
6,-100,-84,9,-114,-60,-133,28,-448
-18,-25,-36,-29,-34,-16,-25,11,-172
0,-24,-49,28,-66,-37,-76,51,-173
-44,-70,-119,32,-151,-20,-164,110,-426
-17,-68,-202,-103,-163,-177,-256,-32,-1018
131,-48,-10,90,11,-75,-110,116,105
44,-44,-19,46,-63,-47,-60,43,-100
-5,-49,-40,-18,-39,-11,-23,37,-148
-53,-92,-162,-20,-54,-50,-140,17,-554
-2,-91,-128,-16,-129,-5,-132,127,-376
-80,-146,-119,-11,-191,-64,-228,93,-746
-14,-5,-31,-16,-46,-13,-52,16,-161
-10,-39,-55,-37,-55,-53,-54,-5,-308
-5,-28,-85,-8,-70,-44,-93,47,-286
2,-34,-41,-15,-29,-11,-28,33,-123
-39,-21,-46,-22,-40,-17,-65,5,-245
-37,-54,-82,-47,-78,-50,-82,-13,-443
-35,-62,-72,-35,-89,-69,-103,15,-450
-17,-26,-24,-18,-27,-28,-42,1,-181
-41,-51,-60,-24,-45,-24,-70,21,-294
23,-8,-14,16,-29,-20,-29,10,-51
-15,-9,-17,-13,-8,-5,-17,-6,-90
-32,-35,-39,-2,-50,-9,-31,18,-180
-2,-7,-22,8,-32,-15,-24,24,-70
-12,-44,-38,-20,-28,-31,-58,34,-197
-13,-43,-35,-12,-36,-32,-48,5,-214
-6,-5,-12,-11,-12,-8,-14,8,-60
-24,-83,-136,-6,-137,-44,-136,89,-477
-93,-81,-72,-69,-92,-125,-165,11,-686
20,-172,-191,-52,-189,-55,-181,125,-695
2,-66,-68,-39,-85,-58,-55,48,-321
-52,-52,-72,-39,-93,-26,-71,14,-391
-57,-53,-43,-14,-55,-21,-76,-13,-332
-27,-23,-51,-45,-49,-74,-86,-7,-362
-23,-83,-126,-5,-108,-38,-121,89,-415
-70,-296,-360,-13,-559,-314,-686,319,-1979
-50,-53,-55,-26,-95,-41,-87,-1,-408
-33,-66,-60,-11,-78,-36,-74,13,-345
51,-148,-155,-77,-158,-180,-290,72,-885
-52,-121,-75,-17,-134,-21,-116,8,-528
9,-47,-68,-11,-80,35,-33,89,-106
-27,-37,-38,6,-40,-13,-42,3,-188
-7,9,-45,-3,-39,-30,-73,37,-151
14,-56,-68,11,-101,-35,-114,79,-270
83,-134,-133,50,-141,-145,-202,148,-474
-3,-14,-18,-17,-11,-12,-16,1,-90
-1,7,-4,-6,0,1,-12,8,-7
-2,-8,-10,-4,-21,-14,-20,11,-68
2,-26,-22,-13,-7,-8,-13,22,-65
-4,-3,-14,7,-11,-3,-13,4,-37
-59,-128,-89,-7,-110,-3,-80,53,-423
-73,-107,-77,-2,-116,6,-97,48,-418
-69,-169,-182,-78,-277,-113,-268,23,-1133
-61,-83,-72,-10,-119,6,-89,50,-378
7,10,-25,24,-33,-30,-28,28,-47
-1,-13,-19,1,-27,0,-9,27,-41
-36,-71,-64,-23,-126,-26,-98,49,-395
-20,-37,-117,-86,-9,-20,-92,-15,-396
-147,-204,-180,-58,-277,-35,-240,109,-1032
25,-67,-92,-42,-74,-8,-21,68,-211
-9,-48,-29,-42,-75,-74,-90,21,-346
91,-217,-232,-52,-162,-266,-385,137,-1086
113,-159,-269,-122,-276,-228,-390,447,-884
112,-101,-97,35,-44,-89,-257,205,-236
28,-47,-84,-42,-109,-108,-214,4,-572
-44,-138,-157,-101,-217,-136,-245,94,-944
-225,-202,-333,-248,-327,-200,-472,-19,-2026
41,-54,-88,-4,-147,-112,-245,157,-452
6,-228,-171,-28,-260,-184,-261,106,-1020
184,-101,-140,-18,-27,-154,-283,341,-198
-4,-76,-125,-50,-134,-144,-209,33,-709
-80,-268,-422,-2,-432,-82,-438,287,-1437
-2,-70,-54,-11,-89,-72,-108,64,-342
-57,-159,-186,-48,-304,-242,-363,7,-1352
106,-141,-192,-88,-234,-177,-282,249,-759
-137,-118,-290,-208,-278,-375,-638,-90,-2134
-452,-720,-680,-261,-1122,-493,-1145,35,-4838
71,-182,-191,-20,-232,-224,-407,240,-945
53,-149,-175,3,-192,90,-115,224,-261
-108,-273,-281,-71,-403,-142,-392,151,-1519
60,-81,-101,-17,-46,-59,-151,161,-234
-64,-210,-261,-74,-231,-148,-236,59,-1165
18,-124,-127,-41,-211,-123,-210,121,-697
-33,-110,-142,-65,-156,-104,-187,78,-719
-43,-174,-183,-41,-290,-221,-297,-26,-1275
-105,-142,-187,-32,-49,-13,-105,-33,-666
27,-24,-34,30,-64,-12,-88,54,-111
-53,-119,-207,-100,-303,-184,-367,42,-1291
21,-242,-292,-85,-376,-144,-310,249,-1179
142,-76,-132,36,-85,-114,-260,300,-189
198,-98,-107,87,-85,-4,-230,344,105
93,-44,-37,51,-23,-33,-114,180,73
6,-52,-68,7,-92,-22,-66,83,-204
48,-315,-298,208,-537,35,-419,420,-858
84,-125,-205,17,-136,-138,-254,214,-543
42,-97,-193,10,-215,-114,-261,146,-682
279,-244,-348,-28,-291,-501,-657,391,-1399
-2,-182,-165,76,-153,-85,-298,196,-613
36,-99,-99,61,-108,-64,-162,142,-293
-12,-6,-43,-13,-46,-31,-59,30,-180
-12,-52,-67,-8,-75,-30,-84,14,-314
8,-45,-67,14,-92,-24,-100,43,-263
-6,-66,-94,-35,-133,-96,-131,25,-536
-7,-19,-17,-6,-36,-17,-32,16,-118
3,-20,-38,3,-41,-21,-42,20,-136
59,-49,-48,-28,-20,-66,-92,65,-179
50,-178,-197,-39,-238,-77,-162,192,-649
12,-65,-101,-33,-26,-49,-167,42,-387
17,-36,-127,-4,-65,-35,-67,86,-231
-49,-145,-134,-18,-150,-63,-173,81,-651
-4,-212,-267,-43,-340,-102,-267,163,-1072
95,-229,-272,49,-240,-222,-501,334,-986
-2,-373,-473,-138,-668,-428,-671,42,-2711
-24,-164,-323,-25,-338,-51,-306,196,-1035
-345,-747,-613,-198,-1014,-399,-1074,165,-4225
-149,-495,-504,-168,-648,-345,-706,175,-2840
32,-143,-152,-64,-187,-102,-211,133,-694
-258,-286,-318,-242,-384,-213,-488,33,-2156
-21,-146,-141,-70,-205,-185,-275,40,-1003
89,-100,-101,59,-209,-31,-163,235,-221
-12,-69,-81,-19,-68,-57,-128,21,-413
178,20,-183,2,61,-214,-245,-142,-523
-2,-107,-175,-23,-105,-59,-203,138,-536
33,-160,-232,-2,-195,-92,-266,180,-734
75,-162,-247,82,-327,-78,-323,287,-693
-21,-158,-164,-51,-82,-139,-119,-25,-759
-8,-133,-156,41,-165,-132,-235,21,-767
8,-121,-79,14,-115,-73,-137,75,-428
29,-83,-171,-46,-139,-66,-171,109,-538
30,-94,-80,56,-171,-49,-108,95,-321
-38,-109,-214,-39,-129,-3,-198,122,-608
-25,-155,-137,-10,-228,-45,-152,50,-702
-76,-113,-190,-135,-240,-177,-308,22,-1217
-35,-79,-108,-44,-186,-87,-152,38,-653
78,-177,-228,-108,-188,-172,-287,275,-807
3,-126,-49,57,-128,-34,-95,72,-300
-89,-157,-200,-58,-191,-102,-203,42,-958
-158,-176,-198,-50,-82,4,-124,-23,-807
-41,-89,-79,14,-152,-76,-159,-4,-586
-71,-317,-250,-155,-315,-143,-355,172,-1434
-82,-169,-161,-51,-226,-79,-210,42,-936
48,-68,-62,7,-48,-34,-83,49,-191
28,77,56,126,-54,5,-75,94,257
-31,-79,-67,18,-104,-50,-114,46,-381
-91,-229,-256,-89,-412,-199,-432,99,-1609
-51,-260,-291,-43,-362,-161,-389,250,-1307
-48,-170,-177,32,-299,-82,-255,41,-958
-6,-68,-54,35,-61,-67,-93,-42,-356
-39,-115,-126,-1,-166,-85,-199,19,-712
-73,27,-123,-144,-157,-251,-371,-88,-1180
-25,-108,-126,-44,-168,-80,-183,50,-684
2,-227,-257,126,-196,-1,-309,253,-609
-33,-59,-151,-60,-99,-97,-204,163,-540
24,-124,-217,-93,-208,-115,-230,166,-797
-7,-156,-86,36,-143,-24,-103,75,-408
5,-326,-405,-130,-328,-314,-410,189,-1719
55,-177,-205,68,-306,-70,-288,235,-688
302,-469,-797,-6,-673,-529,-974,680,-2466
8,-101,-163,16,-181,-111,-276,134,-674
19,-117,-169,30,-290,-207,-269,-8,-1011
181,-247,-221,-23,-80,-265,-364,225,-794
25,-39,-48,15,-118,-45,-89,30,-269
113,-139,-151,51,-289,-139,-315,250,-619
-22,-113,-91,-9,-134,-73,-97,22,-517
-31,-111,-122,3,-185,-138,-231,45,-770
-31,-79,-75,-77,-66,-57,-93,42,-436
2,-41,-54,14,-104,-9,-54,51,-195
-20,-95,-89,7,-157,-4,-104,119,-343
-31,-70,-77,31,-142,20,-105,84,-290
-17,-98,-118,-72,-164,-80,-176,67,-658
1,-17,-37,-6,-22,-43,-36,-6,-166
-3,-7,-3,1,-5,-7,-11,-18,-53
7,-18,-30,-19,-12,-39,-44,19,-136
-23,-78,-65,-67,-60,-48,-67,33,-375
-43,-43,-52,-34,-88,-27,-88,10,-365
-5,-14,-25,0,-29,-25,-37,-7,-142
-26,-32,-30,-8,-65,-18,-63,13,-229
8,-9,-13,0,-14,-12,-12,8,-44
-10,-2,-22,0,-16,-5,-11,7,-59
40,-81,-118,-51,-45,-163,-232,128,-522
-29,-79,-110,-19,-137,-63,-186,36,-587
32,-47,-51,-9,-53,-31,-26,47,-138
-57,-191,-148,-56,-183,-52,-137,16,-808
-1,-28,-62,-28,-65,-17,-43,49,-195
-69,-65,-95,-48,-141,-56,-144,-18,-636
16,35,10,60,-3,-31,-44,60,103
-21,-128,-154,-48,-184,-185,-251,-33,-1004
-12,-111,-84,14,-152,-82,-140,50,-517
18,-27,-54,-18,-25,-76,-88,42,-228
-2,-14,-49,-45,-61,-109,-110,13,-377
136,-96,-64,77,-71,-128,-154,110,-190
1,-113,-116,2,-136,-41,-132,147,-388
-91,-160,-189,-55,-249,-106,-251,76,-1025
1,-15,-18,-6,-11,-27,-36,4,-108
-6,-20,-27,-50,43,15,-2,48,1
52,-87,-48,-8,-36,-52,-73,88,-164
-10,-18,-33,-18,-39,3,-14,19,-110
-121,-138,-175,-92,-191,-88,-243,-6,-1054
-24,-100,-73,7,-140,-42,-131,91,-412
-12,-49,-36,-18,-32,-62,-100,-24,-333
19,-51,-52,-20,-74,-41,-63,22,-260
24,-89,-110,-29,-137,-99,-117,69,-488
28,-39,-97,-8,-100,-24,-101,91,-250
-41,-180,-150,-24,-251,-69,-212,70,-857
10,-11,-16,13,-31,-14,-16,22,-43
-21,-99,-142,-36,-214,-84,-167,106,-657
48,-62,-73,42,-57,-26,-54,78,-104
35,-189,-154,122,-148,-94,-339,117,-650
102,47,-23,76,-13,22,-3,99,307
-1,-96,-86,-30,-112,-58,-91,105,-369
7,-12,-31,2,-27,-12,-37,20,-90
-110,-178,-164,-24,-226,-73,-210,22,-963
-3,-35,-30,8,-53,-31,-49,5,-188
-15,-44,-53,-31,-101,-80,-91,58,-357
-11,-14,-14,2,-19,0,-18,2,-72
32,-67,-78,76,-68,-107,-119,21,-310
-75,-152,-157,-38,-195,-98,-187,-16,-918
5,-79,-125,58,-66,-63,-193,154,-309
-9,-7,-21,-5,-23,-16,-33,14,-100
15,-46,-24,27,-51,-18,-31,27,-101
-39,-108,-110,-34,-180,-97,-165,20,-713
-12,-16,-29,-26,-52,-24,-49,-13,-221
77,-2,-63,75,7,9,-90,194,207
68,-42,-59,74,-44,-53,-68,69,-55
29,-119,-117,5,-164,-89,-119,93,-481
22,-99,-86,-3,-77,-8,-89,91,-249
-22,-60,-53,-10,-64,-25,-72,26,-280
-40,-43,-43,-22,-67,-35,-108,28,-330
-37,-136,-87,29,-152,-46,-121,37,-513
-70,-109,-86,8,-124,-10,-133,50,-474
-52,-42,-61,13,-86,-18,-104,53,-297
-115,-180,-206,-82,-293,-92,-319,48,-1239
-22,-42,-83,-36,-63,-19,-77,57,-285
80,-121,-173,42,-222,-151,-247,121,-671
7,-84,-89,-26,-99,-100,-179,47,-523
1,-38,-62,-15,-58,-40,-78,19,-271
20,-58,-93,0,-89,-60,-86,30,-336
-11,-53,-55,-21,-65,-45,-53,7,-296
20,-10,-12,-11,-13,-24,-11,5,-56
-20,-46,-42,-17,-39,-18,-44,10,-216
1,-33,-21,-4,-49,-3,-44,25,-128
-14,-32,-26,20,-56,-30,-45,-8,-191
-26,-46,-31,1,-83,-11,-71,50,-217
-7,-44,-54,-26,-87,-48,-82,12,-336
11,-74,-36,11,-79,-26,-87,22,-258
8,-25,-10,59,-28,-14,-55,21,-44
8,-36,-50,-8,-80,-99,-95,39,-321
-26,-44,-52,-44,-58,-19,-42,17,-268
-15,-79,-80,-37,-81,-57,-124,50,-423
5,-32,-21,41,-39,0,-47,34,-59
-3,-2,-20,-14,-50,-18,-36,56,-87
-76,-171,-184,-57,-232,-62,-231,83,-930
-9,-82,-78,-11,-82,-78,-122,32,-430
28,-130,-216,3,-212,-23,-239,208,-581
6,-77,-75,7,-133,-51,-119,73,-369
-22,-14,-36,-27,-38,-38,-39,7,-207
-35,-116,-156,-44,-184,-59,-162,52,-704
-49,-80,-145,-68,-190,-110,-214,-27,-883
-18,-22,-43,4,-35,-39,-42,26,-169
-3,-11,-13,4,-14,-22,-23,4,-78
9,-80,-87,-7,-86,-67,-111,63,-366
-70,-63,-136,-37,-102,-12,-98,60,-458
-10,-85,-60,-25,-46,-53,-68,21,-326
-27,-84,-78,5,-116,-46,-141,61,-426
30,-86,-81,115,-149,-140,-170,23,-458
-39,-38,-51,1,-66,-19,-76,11,-277
-42,-70,-65,-28,-76,-48,-99,24,-404
26,-9,19,86,-22,-46,-44,50,60
42,-46,-101,-12,-43,-40,-145,73,-272
28,-161,-207,74,-108,14,-151,221,-290
18,-34,-41,-11,-61,-57,-81,9,-258
-9,-25,-26,-5,-30,0,-37,14,-118
4,-64,-66,25,-80,-51,-113,69,-276
73,-33,-29,23,-27,-96,-123,55,-157
-11,-52,-64,-12,-80,-50,-81,17,-333
-12,-59,-14,50,-55,8,-56,79,-59
-23,-30,-51,-19,-46,-27,-68,8,-256
-37,-65,-36,21,-73,-3,-88,55,-226
-133,-158,-200,-86,-260,-34,-245,117,-999
-55,-90,-106,-28,-127,-19,-104,70,-459
-47,-95,-91,-20,-97,-60,-85,4,-491
25,-30,-29,8,-58,-7,-37,40,-88
-13,-86,-99,-15,-91,-84,-127,82,-433
43,-148,-185,7,-164,-64,-212,135,-588
-51,-77,-102,-13,-47,-46,-93,19,-410
-71,-115,-130,-22,-53,-31,-105,-7,-534
25,-47,-25,19,-46,-65,-81,49,-171
-21,13,-31,-19,-5,-5,-44,19,-93
-54,-88,-138,-24,-197,-90,-196,6,-781
5,-37,-150,-113,-182,-179,-284,-53,-993
-43,-28,-100,-51,-58,-61,-104,30,-415
10,-18,-53,-8,-30,-95,-132,58,-268
-7,-21,-14,3,-20,-2,-16,6,-71
-14,-20,-25,-26,-29,-40,-55,3,-206
-40,-60,-44,-26,-73,-47,-88,17,-361
-40,-63,-57,-28,-65,-50,-63,7,-359
9,-43,-52,-10,-74,-33,-40,28,-215
29,-100,-113,3,-206,-109,-213,151,-558
-22,-10,-20,16,-39,3,-51,24,-99
-73,-75,-89,-88,-128,-67,-145,22,-643
-19,-127,-128,-13,-155,-98,-150,38,-652
-37,-47,-78,-39,-80,-39,-104,14,-410
6,4,-39,1,-6,-2,-50,31,-55
-31,-233,-132,14,-250,-128,-228,74,-914
-62,-121,-183,-62,-53,-93,-173,31,-716
-27,-29,-98,-15,-98,-90,-213,116,-454
25,-62,-37,-4,-69,-57,-43,47,-200
-50,-25,-48,-32,-51,-19,-83,-7,-315
24,6,-1,10,18,-7,0,12,62
128,109,62,79,17,-21,-31,138,481
29,-83,-109,-9,-117,-85,-110,33,-451
-33,-82,-95,-38,-115,-25,-123,71,-440
-20,-49,-64,1,-75,-9,-70,44,-242
-6,-53,-41,-19,-48,-37,-67,36,-235
-12,-78,-113,-45,-144,-113,-198,26,-677
-56,-180,-163,-9,-246,-33,-194,135,-746
-23,-31,-47,11,-29,-16,-48,-10,-193
-13,-81,-137,-25,-142,-109,-227,40,-694
113,-172,-196,-86,-13,-1,-183,212,-326
-30,-48,-119,-21,-42,-59,-140,54,-405
-8,-99,-141,-58,-165,-117,-178,40,-726
28,-143,-237,-124,-272,-373,-470,131,-1460
-175,-69,-167,-153,-163,-112,-282,-117,-1238
-14,-20,-36,32,-65,-10,-52,25,-140
4,-17,-13,6,-21,-24,-20,8,-77
-322,-840,-766,-332,-1132,-475,-1164,12,-5019
-6,-70,-53,0,-64,-25,-73,5,-286
-5,-70,-97,-73,-132,-147,-140,41,-623
-26,-2,-45,-28,-35,-22,-45,2,-201
-14,-24,-30,-13,-21,-7,-40,17,-132
-4,-31,-33,-15,-35,-20,-33,17,-154
18,-268,-290,39,-460,-246,-490,-45,-1742
-52,-29,-53,-19,-79,-45,-101,-13,-391
-18,-83,-84,-45,-99,-32,-94,31,-424
-55,-67,-100,-77,-128,-99,-132,-26,-684
4,-3,-8,1,-9,-4,-2,3,-18
28,-96,-36,16,-55,-41,-27,21,-190
-20,-32,-37,-3,-36,1,-49,7,-169
-69,-41,-60,-66,-85,-28,-105,9,-445
-57,-103,-102,-22,-138,-33,-123,37,-541
-81,-99,-96,-36,-127,3,-112,51,-497
-84,-92,-93,-29,-128,-38,-120,19,-565
-72,-77,-127,16,-177,-13,-163,97,-516
-50,-98,-118,-1,-162,-82,-179,33,-657
-46,-108,-157,-48,-169,-93,-166,92,-695
-15,-76,-61,-9,-46,-41,-67,-15,-330
-30,-114,-100,-55,-135,-87,-142,33,-630
9,-113,-105,16,-110,-34,-133,130,-340
-58,-81,-110,-69,-199,-132,-188,10,-827
6,-66,-62,-40,-41,-54,-102,46,-313
36,-23,-53,34,-63,-23,-84,66,-110
-109,-260,-256,-179,-329,-262,-445,27,-1813
2,20,-13,34,-22,3,-32,35,27
-16,-110,-98,2,-163,-35,-142,55,-507
340,-81,-204,451,-407,14,-370,686,429
11,-63,-91,10,-56,-33,-86,63,-245
8,-79,-79,-43,-107,-61,-83,18,-426
-3,-76,-72,-9,-65,-9,-67,27,-274
-43,-62,-85,-9,-64,-61,-128,6,-446
62,-31,-60,48,-71,-107,-159,116,-202
7,-87,-80,-18,-133,-102,-151,45,-519
-54,-86,-121,-39,-110,-47,-125,47,-535
-10,-26,-39,12,-58,-28,-62,2,-209
-31,-96,-133,-44,-167,-114,-175,40,-720
-17,-147,-142,-4,-143,-154,-213,13,-807
87,-127,-96,50,-133,-91,-180,142,-348
312,-32,-162,244,33,-119,-273,416,419
-9,-48,-157,-44,-76,-73,-153,66,-494
3,-33,-41,9,-80,-21,-49,58,-154
-30,-23,-41,-60,-33,-44,-51,10,-272
-33,-48,-64,-38,-56,4,-58,14,-279
-27,-106,-47,19,-85,-38,-101,10,-375
-32,-45,-57,-27,-100,-21,-104,11,-375
-2,-40,-51,-5,-63,-35,-88,41,-243
-6,-10,-18,-20,-16,-8,-24,9,-93
-89,-59,-102,-81,-66,-101,-151,-68,-717
40,-64,-64,39,-81,35,-78,146,-27
21,-100,-77,24,-158,-44,-112,72,-374
-25,-114,-156,-57,-131,-59,-132,38,-636
8,-42,-53,-5,-79,-40,-61,47,-225
11,-97,-102,-22,-180,-141,-225,81,-675
-12,-12,-13,-1,-20,-6,-15,2,-77
-34,-23,-25,-20,-24,-14,-28,-3,-171
1,-24,-30,-3,-41,-13,-30,28,-112
-15,-9,-24,-3,-30,-12,-20,1,-112
-45,-85,-96,-47,-150,-108,-171,70,-632
41,-60,-138,14,-72,-27,-129,92,-279
193,-31,-214,146,-24,-19,-242,291,100
-57,-67,-89,-23,-130,-90,-190,-24,-670
-40,-177,-271,-13,-256,-27,-260,189,-855
-25,-96,-61,-12,-106,-80,-179,58,-501
92,-163,-119,214,-221,46,-190,242,-99
-8,-55,-44,50,-72,-12,-99,54,-186
-68,-265,-314,-17,-361,-190,-411,164,-1462
-35,-45,-41,-18,-61,-23,-48,-1,-272
-18,-53,-84,-26,-29,-1,-41,13,-239
-91,-116,-145,-84,-185,-76,-165,-22,-884
-30,-33,-47,-16,-51,-44,-74,16,-279
4,-82,-87,-31,-105,-14,-89,98,-306
63,-19,-12,134,-31,5,-89,90,141
-21,-44,-62,-42,-86,-51,-80,22,-364
-63,-111,-80,-48,-113,-38,-113,6,-560
-5,-9,-26,-4,-17,-20,-25,18,-88
-10,-35,-23,-5,-39,-56,-70,42,-196
-17,-42,-64,-34,-81,-39,-80,14,-343
-30,-69,-110,-17,-78,-10,-110,66,-358
-33,-29,-34,-32,-27,-30,-48,22,-211
95,-132,-182,61,-117,-61,-150,156,-330
43,-3,-46,5,-59,-19,-42,80,-41
25,-20,-44,-38,-54,-100,-88,-5,-324
-11,-54,-94,17,-119,-31,-113,36,-369
-37,-62,-80,-38,-102,-43,-68,20,-410
-53,-92,-103,-17,-155,-28,-140,90,-498
5,-114,-136,0,-185,-67,-174,99,-572
-82,-91,-124,-34,-176,-24,-151,65,-617
59,-85,-106,77,-101,-52,-169,137,-240
-48,-128,-127,-70,-169,-84,-187,67,-746
56,-76,-93,15,-138,-81,-87,82,-322
-51,-85,-82,-13,-85,-32,-94,29,-413
16,-93,-91,-11,-33,-47,-97,47,-309
-4,-30,-52,-5,-76,-39,-69,37,-238
-48,-41,-68,-32,-139,-22,-80,41,-389
-3,-27,-43,-12,-43,-53,-27,10,-198
40,-93,-25,36,-98,-78,-133,12,-339
-2,-83,-146,-82,-188,-90,-207,97,-701
-31,-111,-142,-26,-140,-51,-163,65,-599
-34,-67,-103,-56,-108,-81,-120,15,-554
32,-180,-143,89,-247,50,-170,226,-343
-80,-151,-175,-45,-226,-129,-279,-38,-1123
-24,-42,-63,-45,-97,-50,-115,-13,-449
-12,-37,-35,6,-43,-17,-53,-2,-193
8,-6,-11,-2,6,7,-8,13,7
7,-51,-86,-3,-117,-81,-90,3,-418
-58,-39,-49,-46,-54,-30,-83,-25,-384
-17,-8,-13,-20,-1,-1,-25,-9,-94
-38,-50,-67,-43,-69,-42,-35,32,-312
2,-90,-96,-25,-69,-17,-101,25,-371
26,-23,-57,16,-34,0,-43,25,-90
14,-51,-84,-20,-72,-109,-142,-4,-468
-28,-30,-21,-17,-29,1,-26,2,-148
5,-5,-4,1,-6,1,-4,1,-11
23,-28,-35,1,-36,-55,-80,31,-179
-45,-77,-111,-69,-156,-98,-223,53,-726
161,-313,-306,149,-309,-113,-401,422,-710
-7,-37,-20,-7,-54,0,-13,45,-93
8,11,-18,-5,-22,-22,-45,0,-93
-23,-52,-17,23,-76,-31,-60,40,-196
-87,-167,-210,-38,-317,-82,-289,107,-1083
34,-53,-80,10,-109,-88,-102,49,-339
-53,-126,-151,-10,-175,-83,-216,98,-716
-41,-70,-108,-39,-101,-12,-124,41,-454
15,-35,-43,-8,-82,-40,-56,22,-227
-26,-14,-61,-30,-51,-47,-86,23,-292
42,-52,-35,52,-40,-40,-87,90,-70
-2,-31,-28,0,0,19,-5,11,-36
-10,-72,-121,-84,-127,-91,-133,43,-595
-38,-72,-79,-11,-123,-64,-113,12,-488
-12,-23,-46,-16,-55,-24,-62,20,-218
-1,-2,-13,11,-22,-27,-28,3,-79
9,-96,-99,-2,-136,-36,-133,62,-431
10,-1,-9,0,-7,-3,-1,18,7
-150,-188,-223,-122,-283,-138,-247,5,-1346
-8,-10,-21,-16,-24,-8,-28,6,-109
37,-97,-109,45,-138,-70,-134,48,-418
-303,-344,-393,-158,-531,-87,-515,219,-2112
63,-1,-67,59,-68,-19,-194,127,-100
-21,-86,-84,-46,-76,-40,-78,35,-396
-68,-107,-143,-52,-232,-17,-180,98,-701
32,-57,-44,63,-66,-9,-67,53,-95
-14,-53,-52,-42,-66,-47,-55,34,-295
29,-125,-96,39,-99,-35,-48,65,-270
-30,-143,-137,-89,-261,-121,-254,-10,-1045
-14,-26,-20,-15,-22,8,-14,10,-93
-17,1,-4,2,-3,2,-12,-6,-37
-21,-40,-47,-51,-75,-32,-42,7,-301
-57,-75,-62,-11,-96,-35,-83,-7,-426
-151,-199,-207,-29,-323,-138,-295,44,-1298
-14,-67,-73,5,-67,17,-55,62,-192
-59,-49,-55,-16,-98,-51,-100,-12,-440
14,-108,-137,-63,-233,-180,-250,20,-937
-10,-72,-95,17,-117,-46,-59,17,-365
-59,-65,-103,-22,-77,-24,-97,2,-445
-35,-86,-66,-51,-119,-98,-125,-67,-647
18,-84,-107,-43,-128,-117,-138,55,-544
31,-31,-322,23,-251,-124,-385,235,-824
65,-191,-307,-121,-214,-191,-364,285,-1038
-141,-148,-308,-230,-197,-230,-347,-21,-1622
23,-22,-2,-19,7,-24,-38,24,-51
5,-27,-33,-2,-19,-40,-42,4,-154
-59,-112,-129,10,-181,-54,-196,88,-633
40,-49,-44,21,-41,-49,-86,111,-97
-10,1,-7,-9,-14,-13,-25,-8,-85
-95,-145,-182,-53,-194,-72,-228,39,-930
-151,-191,-248,-47,-49,35,-135,-49,-835
-2,-39,-28,5,-71,-38,-41,17,-197
-67,-81,-88,-5,-89,-53,-106,34,-455
-8,-38,-35,-15,-49,-25,-36,9,-197
-33,-58,-67,-40,-107,-31,-84,25,-395
-13,-39,-54,14,-60,4,-46,47,-147
-6,-13,-21,-11,-33,-11,-33,21,-107
12,-18,-78,-22,-110,-86,-79,39,-342
-27,-48,-69,-20,-72,-46,-79,9,-352
4,2,-52,-39,-49,-55,-103,-12,-304
-26,-211,-171,20,-256,-61,-253,112,-846
16,-46,-68,-16,-107,-35,-58,91,-223
-20,-80,-95,-66,-72,-127,-141,91,-510
130,-39,-141,57,-135,-30,-140,176,-122
-15,-31,-31,22,-50,-20,-64,13,-176
-19,-46,-82,7,-96,6,-63,22,-271
6,-21,-26,4,-40,-62,-102,33,-208
-60,-285,-288,-58,-449,-182,-417,190,-1549
-82,-82,-84,-64,-167,-74,-177,56,-674
-58,-43,-49,-23,-55,-24,-56,5,-303
22,-19,-25,9,-44,-43,-64,36,-128
60,-60,-112,-3,-173,-125,-177,78,-512
-10,-73,-54,20,-85,-43,-99,33,-311
-55,-75,-79,-34,-75,-57,-115,-3,-493
-114,-121,-107,-31,-134,0,-119,36,-590
258,-259,-168,-79,-36,-272,-237,277,-516
12,-28,-15,15,-11,0,-17,32,-12
-1,-29,-28,24,-110,-42,-97,17,-266
10,-61,-58,-1,-50,-7,-70,47,-190
-19,-34,-23,53,-83,-45,-67,-4,-222
10,-47,-129,29,-75,9,-86,100,-189
0,-92,-69,8,-126,-30,-113,77,-345
10,-2,-18,5,-23,-26,-47,1,-100
-7,-23,-39,-15,-32,-26,-50,18,-174
-33,-65,-100,-60,-175,-127,-205,25,-740
-95,-151,-206,-88,-313,-226,-364,82,-1361
80,-54,-67,43,-226,-73,-139,185,-251
-12,-86,-56,-6,-86,-49,-111,22,-384
-63,-86,-132,-16,-211,-52,-166,57,-669
-26,-17,-83,-20,-88,-50,-100,23,-361
-1,-109,-49,13,-96,-22,-79,49,-294
-129,-64,-103,-88,-132,-122,-220,-88,-946
7,-17,-11,11,-10,8,-30,24,-18
-7,-24,-56,2,-55,-20,-71,69,-162
-49,-133,-241,-79,-231,-67,-239,117,-922
-29,-53,-56,-47,-55,-42,-58,14,-326
-3,-21,-63,-36,-80,-67,-95,29,-336
-13,-68,-66,-38,-80,-66,-76,9,-398
6,-21,-66,-16,-33,-38,-52,1,-219
20,-5,-44,-10,-45,-81,-77,10,-232
-82,-96,-122,-43,-87,-36,-103,27,-542
37,-82,-48,25,-25,-39,-105,119,-118
6,-67,-62,-29,-104,-58,-91,13,-392
-33,-56,-95,-6,-35,11,-57,7,-264
37,-95,-71,39,-162,-127,-137,50,-466
2,-65,-66,4,-89,-41,-51,17,-289
118,-84,-131,46,-117,-34,-122,205,-119
3,-35,-24,-7,-27,-14,-21,12,-113
23,-119,-132,8,-198,-74,-136,70,-558
-21,-67,-63,3,-123,-43,-103,58,-359
19,-74,-67,47,-92,-9,-100,67,-209
9,-35,-94,-65,-80,-122,-169,0,-556
-36,-72,-113,-61,-161,-40,-128,36,-575
43,-30,6,34,-9,-20,-62,79,41
-84,-139,-158,46,-100,-30,-89,104,-450
101,-15,-8,109,-41,-78,-118,97,47
22,-16,-52,18,-55,-15,-79,46,-131
-54,-150,-136,-23,-181,-29,-166,67,-672
-16,-8,-22,17,-44,-29,-66,32,-136
-54,-33,-79,-71,-139,-80,-124,-3,-583
-22,-91,-81,-22,-73,-56,-100,31,-414
-4,-74,-67,54,-31,-6,-75,33,-170
-37,-82,-76,-9,-106,-46,-90,64,-382
-55,-75,-114,11,-56,-59,-102,78,-372
-40,-65,-154,3,-78,-20,-87,43,-398
-8,-20,-29,-14,-30,-35,-72,18,-190
19,-80,-74,-3,-105,-79,-92,65,-349
-55,-161,-130,-26,-180,-124,-208,-46,-930
-5,-95,-89,23,-149,-80,-164,-5,-564
-52,-145,-155,4,-224,-168,-244,-57,-1041
-56,-140,-167,-42,-208,-64,-209,51,-835
-76,-111,-156,-118,-281,-172,-274,17,-1171
27,-31,-29,-10,-8,-3,-25,49,-30
27,-103,-109,-62,-78,-88,-131,91,-453
6,-80,-118,-70,-88,-84,-173,71,-536
30,-29,-65,-3,-91,-60,-102,26,-294
-7,-19,-34,-3,-24,-15,-41,13,-130
24,-56,-81,-17,-89,-38,-71,64,-264
5,-16,-13,-1,-8,-16,-15,-5,-69
-121,-99,-164,-40,-101,-55,-128,-3,-711
-83,-75,-97,-23,-75,-48,-101,-6,-508
-64,-78,-96,-16,-62,-38,-83,-7,-444
-79,-95,-140,4,-55,-35,-80,6,-474
-72,-129,-153,-26,-169,3,-163,129,-580
42,-21,-36,12,-54,-31,-59,17,-130
16,-23,-59,-1,-104,-73,-146,57,-333
2,-71,-86,-37,-64,-64,-107,38,-389
-3,-106,-102,23,-155,-83,-132,25,-533
3,-45,-37,-23,-14,-43,-61,30,-190
-20,-86,-88,-28,-107,-68,-124,42,-479
-28,-36,-18,-9,-74,-46,-63,-10,-284
-8,-7,-5,-4,-17,-7,-15,-5,-68
8,-27,-37,22,-43,-46,-115,52,-186
-55,-79,-92,-56,-86,-49,-71,24,-464
-65,-51,-143,-62,-142,-53,-138,62,-592
9,-73,-48,15,-121,-51,-84,45,-308
-62,-187,-262,-34,-267,-81,-298,131,-1060
-27,-99,-95,-10,-174,-65,-136,11,-595
23,-2,-16,4,-3,-10,-14,50,32
-69,-58,-93,-58,-78,-87,-142,88,-497
-21,-27,-48,-31,-58,-29,-67,-3,-284
-22,-31,-95,15,-202,18,-207,182,-342
-57,-89,-70,-23,-121,-58,-101,42,-477
-56,-76,-69,6,-126,6,-113,66,-362
-37,-106,-142,-1,-164,-66,-172,-5,-693
-53,-131,-121,-34,-157,-68,-177,44,-697
126,-267,-372,62,-356,-126,-392,273,-1052
-17,-44,-41,7,-42,-34,-48,31,-188
60,-58,-89,40,-109,-51,-77,49,-235
-61,-85,-110,-49,-208,-31,-124,40,-628
-13,-36,-39,-22,-27,-35,-57,-13,-242
34,-60,-102,-17,-50,13,-89,89,-182
-88,-44,-97,-68,-140,-51,-151,-8,-647
52,-80,-113,-36,-113,-85,-111,72,-414
-4,-35,-46,-7,-43,-29,-38,25,-177
-74,-115,-184,-70,-206,-35,-258,161,-781
-58,-92,-106,-3,-132,-39,-153,73,-510
-98,-112,-139,-58,-140,-36,-140,103,-620
-25,-100,-95,-16,-170,-38,-111,66,-489
-4,-68,-70,-17,-52,-16,-57,40,-244
-21,-95,-92,28,-150,-68,-159,69,-488
-69,-114,-167,-78,-176,-23,-151,74,-704
-72,-119,-77,4,-131,-44,-133,31,-541
-29,-122,-119,-41,-141,-38,-127,80,-537
27,-1,-35,8,-26,1,-36,37,-25
6,-23,-21,11,-40,-26,-29,23,-99
-47,-82,-83,-3,-141,-20,-167,55,-488
27,-34,-58,12,-35,-42,-104,98,-136
-22,-26,-41,-27,-56,-9,-62,43,-200
-5,-37,-62,-13,-42,3,-60,69,-147
127,-50,-229,32,-152,-179,-311,265,-497
-43,-26,-40,-40,-42,6,-47,7,-225
-37,-82,-114,7,-144,-51,-128,87,-462
-32,-212,-293,-87,-378,-166,-346,160,-1354
8,-32,-32,4,-41,9,-12,40,-56
15,-21,-24,-17,-29,-13,-37,24,-102
64,-59,-67,65,-59,-33,-80,58,-111
-72,-100,-97,-31,-153,-19,-116,36,-552
14,-141,-404,-76,-301,-91,-292,159,-1132
-46,-46,-50,-14,-93,6,-93,52,-284
5,-27,-30,21,-42,-21,-38,12,-120
-47,-127,-133,-37,-125,-122,-193,30,-754
34,-17,-2,44,-41,13,-41,52,42
1494,-542,-1414,664,-173,1319,-946,2078,2480
20,-97,-129,19,-156,-42,-144,135,-394
105,-613,-485,-211,-574,-646,-945,428,-2941
-41,-121,-146,-70,-195,-95,-150,69,-749
13,-43,-46,-7,-52,-47,-70,40,-212
72,-216,-188,1,-160,-154,-410,258,-797
15,-153,-111,84,-140,-36,-174,117,-398
-64,-81,-104,-40,-130,-77,-165,49,-612
-21,-122,-116,2,-78,-41,-105,54,-427
-10,-31,-38,-3,-50,-32,-69,7,-226
-15,-15,-22,8,-38,-17,-46,45,-100
1,-20,-32,-13,-25,-10,-60,25,-134
-42,-39,-48,-22,-47,-15,-48,9,-252
-23,-24,-54,-13,-54,-6,-70,46,-198
5,-51,-48,-6,-87,-106,-131,-27,-451
-16,-59,-63,9,-82,-36,-71,57,-261
-34,-81,-119,-32,-83,-53,-118,3,-517
-17,-74,-71,-3,-96,-28,-96,46,-339
-31,-89,-109,-59,-163,-45,-126,72,-550
-25,-94,-104,-53,-139,-57,-114,12,-574
-21,-90,-99,-16,-149,-62,-118,9,-546
-1,-67,-67,9,-72,-13,-99,43,-267
-44,-110,-90,-31,-164,-69,-144,32,-620
-26,-194,-170,-12,-304,-88,-270,79,-985
-8,-39,-57,30,-115,-39,-108,49,-287
-22,-64,-50,8,-52,-31,-118,21,-308
-17,-55,-111,-55,-139,-146,-196,81,-638
-24,-10,-268,-203,-147,-138,-316,96,-1010
-31,-105,-151,-41,-201,-98,-193,31,-789
-32,-172,-129,-56,-182,-81,-109,108,-653
-102,-127,-141,-59,-168,-92,-181,-13,-883
-12,-52,-57,17,-57,-26,-72,-5,-264
-220,-204,-274,-161,-294,-208,-536,-221,-2118
-208,-172,-232,-122,-305,-222,-498,-150,-1909
0,-182,-176,32,-304,2,-212,202,-638
73,-1,-50,53,-20,23,-34,72,116
-11,-45,-25,-10,-38,-23,-48,2,-198
1,-98,-154,4,-92,51,-86,130,-244
18,-50,-39,-2,-62,-29,-75,43,-196
-54,-143,-153,-40,-213,-116,-231,62,-888
67,-7,0,61,2,-6,-28,44,133
-5,-58,-70,2,-108,-52,-163,47,-407
-14,-327,-326,135,-530,27,-385,364,-1056
4,-45,-24,40,-42,33,-43,86,9
4,-214,-146,48,-214,-67,-206,128,-667
-48,-122,-134,-33,-133,-79,-167,83,-633
66,-103,-117,32,-209,-119,-199,47,-602
-59,-54,-52,-71,-115,-48,-135,-34,-568
-104,-24,-68,-104,-72,-107,-168,-103,-750
91,-61,12,72,-4,-65,-93,120,72
-26,-165,-112,-42,-195,-63,-86,105,-584
-1,-34,-34,-8,-46,-20,-38,41,-140
-13,-14,-19,28,-54,-29,-42,11,-132
-18,-25,-27,-6,-63,-8,-48,20,-175
-10,-44,-26,7,-36,4,-17,28,-94
-7,-229,-396,2,-259,-139,-250,253,-1025
6,-45,-52,12,-29,-51,-23,14,-168
-31,-34,-71,-62,-113,-88,-135,36,-498
-30,-38,-57,-44,-95,-68,-108,-8,-448
-26,-21,-33,-24,-26,-35,-66,-26,-257
-16,-41,-43,-34,-55,-37,-75,3,-298
47,-16,-59,38,-59,-84,-115,32,-216
-6,-151,-120,-3,-186,-131,-254,156,-695
-27,-93,-80,-19,-96,-23,-59,46,-351
-117,-85,-216,-165,-211,-261,-410,17,-1448
-45,-86,-112,-10,-68,-8,-98,8,-419
-69,-76,-107,34,-51,-19,-78,52,-314
-105,-179,-195,-35,-245,-86,-293,72,-1066
-33,-133,-97,38,-152,-38,-122,54,-483
6,-2,-72,119,-27,-74,-192,167,-75
-20,-80,-84,-33,-123,-47,-108,28,-467
20,-92,-167,117,-271,-21,-222,221,-415
14,-69,-51,59,-164,3,-95,95,-208
43,-71,-71,65,-180,0,-121,157,-178
14,-24,-77,-27,-32,43,-26,60,-69
-11,-33,-22,9,-50,7,-46,33,-113
-15,-27,-34,-11,-29,-9,-30,3,-152
-59,-106,-107,-12,-152,-33,-142,61,-550
16,-78,-94,-14,-128,-43,-108,108,-341
85,-144,-78,-15,-98,-103,-216,220,-349
-10,-187,-144,0,-262,-87,-172,107,-755
47,-141,-240,-53,-148,-76,-201,133,-679
-92,-107,-209,-98,-188,-149,-305,119,-1029
-79,-82,-161,-103,-81,-77,-179,61,-701
-76,-129,-187,-69,-223,-77,-211,109,-863
15,-129,-216,-60,-226,-159,-357,133,-999
193,-106,-188,156,-27,-55,-181,250,42
-82,-115,-177,-98,-279,-208,-351,42,-1268
-75,-148,-178,-153,-182,-134,-290,122,-1038
-49,-65,-130,-126,-117,-257,-294,-136,-1174
-45,-148,-165,-89,-227,-158,-232,66,-998
-40,-45,-140,-43,-196,-100,-163,7,-720
-102,-217,-267,-42,-337,-202,-438,77,-1528
-22,-73,-106,-53,-92,-9,-93,52,-396
-55,-68,-135,-27,-120,-46,-187,40,-598
-59,-136,-263,-21,-407,-143,-430,142,-1317
1,-125,-188,-55,-129,-140,-274,80,-830
35,-103,-93,-9,-182,-101,-213,139,-527
157,-113,-193,-44,-74,-88,-160,219,-296
-105,-176,-242,-84,-352,-131,-330,109,-1311
-210,-269,-367,-130,-549,-105,-456,139,-1947
4,-43,-58,-7,-97,-34,-84,41,-278
131,-132,-337,71,-190,44,-298,327,-384
258,-198,-225,55,-279,-378,-527,370,-924
-106,-54,-108,-108,-92,-53,-233,-107,-861
48,-179,-235,-48,-185,-91,-198,206,-682
224,-117,-17,138,25,-71,-139,247,290
80,-142,-245,24,-330,-249,-287,78,-1071
91,-22,-117,34,-84,-53,-154,149,-156
3,-177,-184,21,-281,-101,-264,103,-880
105,-129,-224,15,-119,-68,-174,243,-351
-176,-313,-281,-149,-358,-157,-388,4,-1818
-24,-121,-141,-70,-152,-78,-152,50,-688
3,-61,-52,-2,-125,-3,-70,78,-232
167,-191,-295,88,-109,-78,-242,403,-257
16,-153,-218,32,-271,-144,-307,176,-869
61,-272,-326,-98,-452,-374,-446,210,-1697
288,-274,-150,48,16,-434,-576,345,-737
69,-119,-209,27,-90,-131,-400,184,-669
-24,-199,-227,-72,-273,-204,-339,133,-1205
-98,-84,-154,-33,-60,-16,-82,-2,-529
121,-153,-256,1,-223,20,-194,326,-358
-58,-83,-89,-14,-110,-25,-130,25,-484
69,18,-72,2,-98,-139,-132,38,-314
17,-38,-55,9,-64,-29,-33,59,-134
-19,-112,-111,-43,-164,-97,-140,24,-662
-90,-128,-124,-70,-161,-108,-229,31,-879
-118,-191,-203,-51,-260,-112,-275,95,-1115
-17,4,-29,-35,-13,-28,-86,-27,-231
-13,-33,-57,-4,-116,-50,-136,50,-359
4,15,-4,24,-8,-14,-17,7,7
-41,-49,-69,-26,-118,-62,-125,-4,-494
-38,-100,-107,-16,-161,-28,-142,69,-523
-57,-108,-186,-71,-232,-199,-316,-69,-1238
39,-93,-114,57,-124,-85,-235,201,-354
-6,-227,-449,-15,-587,-222,-581,294,-1793
90,-118,-243,37,-125,-45,-161,157,-408
-43,-189,-164,9,-288,-182,-297,93,-1061
-176,-260,-290,-96,-448,-263,-486,-35,-2054
-70,-80,-108,-19,-148,-41,-141,62,-545
14,-39,-119,-39,-9,-146,-89,157,-270
-8,-47,-60,-6,-118,-4,-59,66,-236
-13,-36,-87,-59,-58,-95,-137,31,-454
-16,-70,-79,-26,-94,-108,-129,9,-513
-73,-127,-181,-165,-63,-65,-101,43,-732
-68,-116,-119,-16,-139,-75,-137,47,-623
5,-47,-38,-12,-47,-47,-73,15,-244
19,-41,-37,10,-48,-37,-48,26,-156
9,-30,-39,16,-58,-2,-82,12,-174
2,-88,-97,-28,-173,-84,-108,109,-467
5,-66,-66,-22,-83,-35,-62,54,-275
-17,-38,-90,-38,-121,-154,-186,-4,-648
70,18,18,106,3,-51,-78,57,143
-11,-46,-57,-9,-57,-41,-90,40,-271
-2,-25,-38,-24,-47,-36,-65,-3,-240
-8,-47,-51,26,-29,25,-48,39,-93
4,-31,-33,-8,-24,-19,-42,24,-129
-5,5,-8,-6,-9,-18,-23,10,-54
-59,-61,-68,-50,-59,-9,-61,2,-365
3,-33,-22,5,-36,-38,-60,-5,-186
89,-104,-44,29,-99,-135,-136,84,-316
-55,-41,-48,-48,-53,-31,-70,25,-321
-74,-118,-125,-22,-201,-30,-167,97,-640
5,-88,-101,-34,-115,-27,-93,116,-337
16,-77,-101,-5,-102,-48,-101,65,-353
-28,-24,-35,3,-43,5,-11,29,-104
-20,-20,-21,9,-36,-20,-29,-7,-144
-68,-99,-119,-35,-136,-22,-123,23,-579
-12,-32,-40,-3,-43,-22,-49,20,-181
-7,-59,-88,33,-92,23,-96,102,-184
144,-123,-177,170,-181,-380,-553,275,-825
-131,-168,-196,-24,-220,-121,-296,4,-1152
-9,-82,-117,-24,-60,-81,-100,7,-466
-6,-158,-158,46,-231,-67,-347,223,-698
0,-128,-131,-24,-127,-84,-136,67,-563
325,128,149,287,-73,-27,-341,357,805
61,-66,-170,-26,-157,-128,-231,142,-575
206,-320,-345,-284,-233,-459,-691,580,-1546
-18,-48,-61,-44,-26,-36,-60,46,-247
-31,-94,-88,29,-155,-44,-139,80,-442
-5,-57,-73,-14,-90,-34,-72,7,-338
7,-66,-72,4,-73,-3,-86,70,-219
-14,-59,-49,-10,-96,-43,-81,42,-310
-11,-54,-65,-1,-40,-6,-66,25,-218
8,-29,-23,-5,-46,-3,-39,30,-107
12,-91,-103,-26,-143,-51,-94,51,-445
-133,-136,-151,-92,-215,-20,-195,98,-844
181,-127,-101,36,-53,-56,-164,277,-7
-55,-67,-55,-23,-92,-51,-91,10,-424
53,2,3,137,-9,-24,-60,72,174
-9,-43,-56,-19,-82,-43,-104,34,-322
-26,-59,-44,-15,-56,-40,-60,3,-297
4,-47,-62,-35,-82,-52,-75,12,-337
10,-24,-24,-1,-36,-33,-28,13,-123
-10,-19,-23,8,-46,-26,-49,-4,-169
-53,-103,-131,-14,-159,-56,-152,86,-582
1,-21,-35,-9,-37,-44,-67,20,-192
-14,-29,-18,-17,-37,-9,-30,12,-142
208,-68,-146,173,-121,-88,-184,239,13
-21,-469,-400,35,-468,238,-364,526,-923
-15,-56,-61,-13,-63,-22,-52,24,-258
-9,-75,-55,-10,-38,-21,-65,37,-236
8,-17,-40,22,-61,-11,-57,49,-107
-4,-83,-65,-21,-81,-56,-86,8,-388
-28,-44,-46,-10,-52,-16,-68,57,-207
25,-94,-142,-11,-203,-48,-168,175,-466
33,-85,-134,-3,-205,-46,-194,148,-486
69,-114,-154,-9,-193,-65,-171,166,-471
96,-84,-128,35,-191,-85,-170,165,-362
68,-120,-145,-31,-223,-70,-198,203,-516
75,-114,-138,19,-223,-85,-193,190,-469
58,-94,-144,-8,-221,-60,-221,189,-501
64,-118,-158,-32,-223,-75,-181,207,-516
-73,-112,-145,12,-186,-17,-197,78,-640
16,-61,-89,-21,-48,-115,-129,61,-386
-72,-22,-61,-30,-48,-35,-99,-25,-392
1,13,-29,-10,-22,4,-39,100,18
-31,-111,-107,7,-178,-7,-136,113,-450
30,-114,-133,38,-148,-84,-199,97,-513
-31,-125,-169,-36,-174,-47,-182,69,-695
-39,-89,-63,-7,-84,-20,-97,32,-367
12,-64,-134,-1,-159,-61,-121,97,-431
-45,-87,-77,-60,-81,-63,-110,0,-523
0,-58,-78,8,-57,-33,-102,55,-265
-5,-22,-48,-25,-53,-55,-75,38,-245
-19,-24,-30,-4,-66,-60,-76,-35,-314
57,-47,-45,35,-43,-64,-104,-7,-218
63,-64,-110,39,-94,-87,-126,53,-326
-19,-47,-41,-1,-36,-2,-52,22,-176
-1,-103,-95,61,-101,20,-152,100,-271
-40,-75,-55,-20,-94,-31,-110,-8,-433
10,-77,-66,-17,-93,-65,-107,-3,-418
33,-37,-18,58,-50,21,-19,66,54
-7,-56,-70,-9,-67,-61,-73,15,-328
-37,-18,-32,-37,-44,-23,-65,-26,-282
-17,-21,-10,8,-9,-16,-29,-1,-95
-40,-86,-103,-11,-137,-93,-176,30,-616
-14,-51,-50,-6,-68,-4,-64,43,-214
-13,-19,-31,2,-31,-22,-47,6,-155
-30,-75,-53,-38,-94,-66,-93,-13,-462
68,-2,-58,16,-99,2,-33,100,-6
7,-62,-87,5,-143,-45,-129,62,-392
-28,-41,-60,-13,-77,-32,-66,25,-292
-30,-105,-101,-38,-92,-60,-87,26,-487
22,-15,-16,24,-41,10,-30,30,-16
-56,-117,-141,-5,-177,-14,-168,87,-591
-35,-61,-55,-65,-93,-42,-68,30,-389
-123,-119,-209,-112,-281,-255,-392,13,-1478
-31,-65,-56,23,-86,-43,-97,13,-342
15,-45,-25,28,-52,-22,-28,28,-101
-65,-110,-104,-35,-127,-85,-136,16,-646
-30,-95,-100,-11,-109,-100,-131,5,-571
-52,-93,-117,-37,-142,-39,-117,46,-551
82,-29,-82,57,-64,-73,-130,44,-195
-24,-28,-24,-33,-26,0,-13,22,-126
-61,-135,-173,-72,-263,-113,-200,62,-955
5,-63,-100,-24,-118,-83,-123,66,-440
-63,-110,-237,-125,-190,-130,-248,68,-1035
-38,-59,-89,-42,-46,-51,-97,0,-422
33,-10,-43,32,-68,-34,-58,61,-87
11,-17,-19,-4,-5,-15,-18,4,-63
-28,-88,-99,12,-139,-91,-161,66,-528
31,-86,-113,7,-185,-120,-195,103,-558
-36,-95,-102,-35,-109,-66,-153,0,-596
31,-77,-114,-2,-99,-115,-193,70,-499
-21,-103,-138,16,-243,-133,-239,53,-808
-75,-165,-195,-60,-321,-101,-303,65,-1155
638,-285,-329,233,-104,-563,-785,776,-419
-113,-91,-124,-51,-144,31,-113,85,-520
-10,-58,-59,27,-145,-81,-145,66,-405
-14,-106,-97,-25,-51,-95,-119,38,-469
-58,-71,-142,-16,-175,-17,-160,108,-531
3,-61,-59,3,-60,-79,-91,38,-306
-63,-185,-243,-81,-286,-145,-297,43,-1257
25,-32,-30,8,-31,13,-2,60,11
-491,-741,-1113,-760,-1696,-1241,-1931,-333,-8306
-47,-59,-172,-153,-106,-202,-343,-37,-1119
111,-97,-117,-66,-119,-43,-165,286,-210
36,-63,-108,-2,-131,-130,-194,116,-476
88,-98,-121,24,-155,-103,-202,145,-422
24,-109,-147,-9,-137,-92,-178,156,-492
113,-135,-191,-38,-225,-233,-340,97,-952
129,-46,-170,99,-149,5,-102,231,-3
-10,-66,-181,-49,-117,-70,-224,86,-631
32,-102,-159,21,-181,-43,-203,155,-480
-49,-104,-100,-55,-136,-98,-127,22,-647
-31,-71,-154,-48,-204,-166,-240,6,-908
-83,-116,-157,-85,-233,-58,-191,99,-824
571,130,91,483,225,95,-207,443,1831
-8,-139,-156,9,-213,-39,-194,127,-613
-68,-150,-185,-38,-225,-146,-307,70,-1049
-27,-136,-170,-46,-284,-91,-263,138,-879
82,-133,-103,-22,-92,-211,-236,128,-587
177,-170,-250,-81,-158,-259,-509,467,-783
-140,-93,-186,-82,-211,-195,-353,-114,-1374
-28,-86,-129,-46,-172,-88,-191,8,-732
83,-97,-158,8,-238,-95,-243,236,-504
223,-16,29,150,29,-190,-207,290,308
-46,-102,-104,-14,-110,-52,-116,30,-514
24,-146,-218,7,-298,-87,-231,174,-775
-132,-365,-454,-88,-672,-272,-739,167,-2555
-45,-137,-135,-78,-158,-115,-244,18,-894
-16,-48,-67,20,-93,-65,-147,54,-362
-77,-75,-252,-143,-179,-253,-434,15,-1398
-9,-62,-67,-29,-106,-66,-102,25,-416
-42,-97,-178,-101,-167,-83,-218,71,-815
93,-60,-75,75,-68,-46,-91,156,-16
-23,-160,-198,1,-242,-25,-191,158,-680
21,-90,-127,-43,-136,-85,-159,74,-545
25,-234,-278,16,-325,-178,-343,121,-1196
93,-196,-188,-54,-127,-79,-290,291,-550
27,-119,-131,13,-104,-24,-180,108,-410
181,-163,-183,16,-141,-70,-238,346,-252
-116,-345,-305,-63,-385,-132,-438,134,-1650
-95,-100,-133,-61,-193,-15,-174,83,-688
52,-95,-41,15,-49,-77,-118,88,-225
13,-28,-23,24,-28,-24,-43,18,-91
-80,-141,-248,-137,-318,-172,-322,74,-1344
-54,-142,-255,-16,-128,-57,-247,194,-705
-13,-110,-103,-24,-73,-49,-129,72,-429
-49,-75,-69,-35,-96,-18,-63,39,-366
-103,-149,-208,-79,-236,-128,-329,118,-1114
-55,-60,-79,-26,-76,-40,-79,-6,-421
26,-42,-70,-31,-88,-38,-74,32,-285
-81,-39,-112,-77,-93,-20,-203,-31,-656
-43,-138,-111,-42,-208,-70,-213,75,-750
-41,-133,-217,-86,-171,-125,-243,220,-796
-48,-70,-823,-276,-211,-168,-822,1108,-1310
-32,-66,-93,-30,-104,-47,-88,33,-427
-11,-138,-143,23,-221,117,-167,218,-322
-46,-117,-120,-51,-158,-77,-142,30,-681
-33,-60,-43,12,-52,25,-88,54,-185
-40,-81,-86,-4,-74,36,-82,79,-252
14,-56,-56,-19,-58,-26,-54,36,-219
31,-80,-140,34,-150,-37,-169,136,-375
-65,-16,-121,-87,-57,-45,-173,-29,-593
-32,-77,-108,-43,-158,-124,-190,32,-700
87,-141,-171,80,-171,-161,-295,152,-620
42,-64,-83,40,-70,-85,-126,24,-322
-53,-63,-53,-55,-83,-48,-94,-13,-462
83,-75,-64,66,-58,7,-111,173,21
18,-114,-114,81,-174,50,-145,178,-220
-276,-317,-349,-57,-552,-8,-502,261,-1800
-181,-117,-171,-137,-221,-129,-289,-99,-1344
-62,-101,-90,-25,-84,19,-119,66,-396
80,-76,-60,75,-85,-75,-146,153,-134
-54,-211,-159,-61,-176,-20,-149,47,-783
-1,-80,-48,9,-60,-2,-44,61,-165
14,-74,-149,-87,-160,-162,-231,90,-759
-29,-79,-82,-38,-120,-69,-119,-6,-542
-5,-12,-21,4,-21,-18,-29,14,-88
111,-179,-202,10,-185,-67,-123,163,-472
47,-122,-80,31,-168,-79,-196,112,-455
38,-86,-130,-38,-129,-117,-182,78,-566
37,-77,-119,16,-76,-10,-76,132,-173
72,-86,-88,51,-120,-33,-79,99,-184
80,-72,-75,18,-48,27,-35,93,-12
-41,-193,-172,-39,-194,-57,-156,29,-823
-12,-26,-26,-9,-16,-16,-16,-1,-122
-81,-150,-156,-8,-204,-78,-256,53,-880
56,52,45,45,21,-30,-74,90,205
-64,-111,-98,9,-154,-60,-159,51,-586
-98,-126,-138,-12,-141,-62,-157,0,-734
59,-71,-66,111,-109,-80,-259,120,-295
-19,-34,-38,2,-48,-13,-22,19,-153
20,-68,-131,-26,-200,-20,-90,112,-403
-17,-69,-106,-55,-218,-96,-140,30,-671
2,-31,-29,-1,-66,-46,-59,-41,-271
-33,-38,-31,-36,-38,-15,-40,-8,-239
-71,-92,-146,-48,-167,-87,-173,51,-733
-33,-111,-102,12,-174,-20,-140,71,-497
-110,-29,-86,-97,-81,-146,-140,-47,-736
-41,-54,-67,-28,-129,-15,-97,23,-408
-26,-102,-89,12,-69,26,-62,21,-289
16,-84,-99,-1,-89,-23,-91,92,-279
-63,-141,-149,-21,-190,-56,-161,14,-767
-54,-60,-65,-8,-76,-4,-76,-4,-347
-4,-41,-32,12,-25,-10,-55,13,-142
-20,-81,-75,-19,-132,-36,-103,70,-396
20,-2,-3,19,-14,-23,-14,14,-3
-84,-247,-319,-146,-385,-137,-348,287,-1379
-73,-140,-202,-80,-234,-168,-295,-25,-1217
27,-11,-33,3,-50,-88,-110,-10,-272
-3,-10,-14,6,-14,-2,-15,17,-35
-6,-43,-42,-27,-45,-57,-81,77,-224
-27,-70,-70,-17,-79,-37,-72,-5,-377
-1,1,-18,-4,-29,-7,-27,13,-72
-39,-35,-40,-31,-77,-78,-96,-23,-419
-19,-29,-14,-13,-29,-22,-52,-16,-194
-18,-6,-99,-34,-62,-106,-166,-4,-495
-47,-99,-100,-22,-120,-81,-143,68,-544
-39,12,-86,22,-138,23,-121,110,-217
57,-103,-154,-1,-131,-92,-155,98,-481
11,-63,-54,-17,-39,-21,-28,9,-202
-54,-74,-89,-48,-119,-76,-125,11,-574
-1,-70,-82,-34,-107,-77,-133,25,-479
-12,-29,-33,-3,-16,-5,-19,16,-101
-22,-67,-61,-6,-70,-65,-122,15,-398
62,-32,-8,116,14,-55,-93,70,74
-59,-139,-80,20,-124,-43,-138,27,-536
20,-91,-101,24,-160,-5,-137,79,-371
-24,-40,-69,7,-86,-93,-125,7,-423
-27,-45,-68,-38,-95,-32,-92,-7,-404
-17,2,-42,-10,-31,-37,-60,-17,-212
-85,-133,-156,-72,-206,-76,-176,39,-865
-66,-111,-109,-37,-135,-9,-86,75,-478
-28,-45,-42,-9,-79,-23,-56,27,-255
-45,-83,-62,-11,-80,-15,-74,11,-359
-8,-28,-48,-19,-47,-26,-75,16,-235
-17,-70,-62,-4,-111,-57,-106,44,-383
23,-22,-26,73,-24,15,-32,34,41
-49,-80,-85,-49,-100,-35,-99,40,-457
9,-35,-66,-6,-70,-14,-43,65,-160
-5,-30,-40,-20,-35,-12,-31,6,-167
-3,-70,-61,2,-87,-40,-32,28,-263
16,-134,-164,-7,-171,-195,-186,16,-825
-19,-29,-19,10,-14,-13,-23,18,-89
17,-59,-73,-23,-101,-65,-119,44,-379
34,-44,-78,-7,-61,-18,-79,107,-146
-27,-51,-46,-6,-82,-22,-67,14,-287
-49,-118,-173,-28,-199,-68,-197,117,-715
-6,-20,-20,-13,-10,-16,-27,-1,-113
8,-42,-31,16,-36,12,-32,43,-62
-44,-50,-58,-32,-81,-22,-88,23,-352
-5,-36,-33,5,-47,-26,-60,3,-199
-57,-98,-103,-43,-194,-46,-131,18,-654
-83,-171,-188,-31,-62,-41,-107,-2,-685
-122,-247,-240,-73,-357,-136,-341,43,-1473
-23,-101,-63,-27,-91,-74,-84,42,-421
-13,-15,-32,-14,-56,-31,-55,3,-213
-45,-51,-73,-9,-93,-22,-102,7,-388
-14,-45,-51,-33,-79,-45,-90,33,-324
-43,-43,-64,-69,-34,-20,-53,15,-311
-16,-95,-118,-70,-117,-157,-207,-24,-804
20,10,-7,12,-8,-6,-3,16,34
-86,-84,-73,-43,-85,-30,-117,39,-479
-29,-67,-55,-9,-64,-28,-78,31,-299
10,-46,-50,15,-71,-12,-69,40,-183
-24,-86,-114,0,-156,-28,-169,78,-499
-124,-171,-169,-80,-239,-23,-204,54,-956
-12,-88,-52,-18,-56,-13,-66,43,-262
41,-39,-20,-45,-27,-79,-125,31,-263
-43,-60,-93,-19,-111,-23,-117,45,-421
-79,-108,-137,-41,-212,-116,-206,-31,-930
75,-80,-110,-2,-82,-107,-175,122,-359
-85,-35,-95,-45,-100,-70,-132,-5,-567
-73,-120,-155,-75,-53,-12,-75,75,-488
3,-215,-271,-86,-400,-168,-313,226,-1224
22,-175,-164,9,-245,-108,-220,129,-752
18,-97,-83,-41,-57,-25,-87,125,-247
-96,-85,-132,-57,-180,-19,-151,25,-695
72,-194,-413,-31,-320,-120,-444,246,-1204
0,-77,-66,49,-101,-30,-124,78,-271
-101,-138,-164,-68,-257,-91,-261,16,-1064
131,-145,-142,-12,-167,-141,-240,249,-467
-8,-70,-75,-11,-105,-25,-92,49,-337
-115,-222,-261,-113,-364,-42,-338,77,-1378
30,-82,-132,-33,-113,-137,-168,6,-629
-35,-92,-81,-29,-106,-58,-112,-6,-519
-147,-125,-126,-57,-82,-68,-108,-52,-765
-52,-155,-171,-25,-206,-64,-209,72,-810
41,-169,-200,-22,-305,-208,-352,165,-1050
114,-102,-152,68,-81,-103,-250,191,-315
-36,-66,-55,-23,-76,-7,-81,1,-343
-38,-146,-169,-15,-234,-93,-197,122,-770
72,-168,-93,-16,-70,-114,-228,184,-433
42,-155,-173,20,-159,21,-225,259,-370
-62,-112,-151,-2,-34,30,-52,-2,-385
91,-215,-309,-87,-266,-187,-398,301,-1070
7,-234,-299,-109,-339,-192,-362,129,-1399
-48,-98,-86,4,-78,-19,-108,12,-421
-47,-49,-187,-130,-251,-338,-475,-70,-1547
-12,-296,-368,-57,-438,-217,-437,256,-1569
26,-58,-93,-23,-142,-23,-56,76,-293
-28,-122,-124,-18,-143,-103,-216,73,-681
50,-44,-48,38,-46,-68,-118,81,-155
12,-131,-217,-48,-176,-81,-198,119,-720
21,-53,-104,-47,-142,-221,-246,-16,-808
-34,-99,-119,-39,-149,-39,-120,91,-508
-51,-80,-98,54,-132,-38,-119,57,-407
39,-113,-125,35,-157,-231,-223,150,-625
-258,-176,-277,-177,-354,-281,-642,-215,-2380
101,-40,-80,76,-16,-59,-120,242,104
37,-123,-124,-13,-182,-113,-197,116,-599
-126,-159,-165,-100,-212,-80,-228,64,-1006
-63,-168,-212,23,-255,-3,-226,183,-721
-69,-166,-153,-62,-233,-81,-203,41,-926
-27,-247,-297,-44,-327,-100,-332,126,-1248
-25,-152,-133,17,-171,-83,-257,146,-658
-78,-75,-168,-70,-116,-84,-119,38,-672
-58,-65,-125,-52,-171,-101,-185,25,-732
-41,-164,-191,-97,-256,-149,-259,85,-1072
-54,-69,-70,-38,-78,-28,-98,32,-403
-30,-82,-79,4,-123,-56,-135,74,-427
16,-88,-106,-15,-134,-119,-207,103,-550
-27,-101,-131,18,-54,-78,-98,6,-465
-65,-110,-141,-54,-163,-45,-144,65,-657
-36,-107,-129,-69,-183,-121,-171,37,-779
-83,-121,-181,-15,-124,-59,-129,69,-643
-45,-52,-58,-41,-96,-38,-82,35,-377
-78,-198,-201,-57,-332,-61,-279,88,-1118
-120,-155,-165,-48,-77,-20,-115,-50,-750
-22,-32,-41,-12,-52,-49,-65,-12,-285
13,-10,-9,22,-18,-15,-30,2,-45
-9,-22,-37,-20,-46,-17,-46,22,-175
-9,-13,-14,5,-27,-19,-25,2,-100
13,-158,-157,21,-110,-5,-124,131,-389
-38,-69,-107,-49,-138,-43,-84,23,-505
-11,-45,-37,-30,-41,-17,-34,18,-197
-40,-56,-49,-47,-47,-47,-68,-9,-363
-42,-62,-60,-23,-85,-47,-77,16,-380
-7,6,-13,-11,23,-15,1,-19,-35
11,-71,-80,-11,-98,-32,-55,35,-301
-22,-110,-132,-15,-86,-95,-193,126,-527
-3,-79,-76,-24,-114,25,-65,88,-248
16,-74,-93,-1,-114,-19,-79,43,-321
-25,-93,-71,6,-129,-19,-85,38,-378
-79,-117,-113,-57,-157,-9,-130,62,-600
-62,-92,-94,-34,-133,-18,-86,67,-452
60,-29,-11,4,24,8,-36,115,135
0,-34,-91,-44,-81,-91,-134,5,-470
-11,-78,-70,-4,-94,-35,-124,78,-338
19,-87,-131,6,-158,-140,-222,88,-625
25,-54,-28,60,-66,14,-51,65,-35
-39,-57,-51,-22,-90,-40,-79,-4,-382
-11,-26,-37,-20,-14,4,-31,47,-88
31,-51,-33,-21,-10,-68,-117,59,-210
-28,-114,-104,-39,-197,-127,-204,10,-803
24,5,-132,63,-41,1,-148,197,-31
83,-28,-40,-51,-59,-139,-129,106,-257
-51,-107,-144,-7,-184,-93,-247,147,-686
-5,-66,-75,-38,-132,-23,-132,58,-413
-6,-33,-37,11,-55,-39,-43,-2,-204
-51,-165,-215,-120,-282,-172,-225,23,-1207
-42,-94,-122,-68,-91,-62,-161,-21,-661
5,-124,-111,-26,-166,-175,-212,61,-748
3,-41,-7,7,-15,-9,-38,18,-82
70,-22,-118,106,-109,-9,-112,197,3
-2,-14,-22,19,-48,-18,-54,14,-125
-19,-22,-23,-5,-13,-17,-21,3,-117
0,-71,-88,-36,-48,-104,-120,39,-428
-7,-44,-41,-31,-76,-44,-84,28,-299
8,-35,-6,16,-31,-9,-45,35,-67
27,-45,-62,-6,-56,-48,-79,37,-232
18,-59,-67,6,-47,-33,-56,10,-228
-59,-98,-124,-85,-172,-54,-156,52,-696
-5,-65,-78,-9,-108,-59,-114,11,-427
34,-101,-85,7,-151,-82,-108,88,-398
19,-28,-68,-18,-127,-70,-92,31,-353
-40,-82,-87,-40,-108,-23,-99,47,-432
-13,-83,-73,-7,-83,-60,-86,22,-383
2,-48,-54,-32,-62,-52,-42,13,-275
-4,-76,-64,-17,-109,-56,-94,-26,-446
-13,-59,-59,26,-68,-16,-85,27,-247
-47,-59,-54,-17,-63,5,-75,7,-303
-46,-48,-39,-37,-49,-27,-34,5,-275
-2,-57,-54,-8,-40,-14,-40,28,-187
-8,-62,-61,-8,-97,-81,-128,77,-368
-1,-21,-16,2,-27,-16,-9,17,-71
44,-123,-142,-45,-205,-135,-227,111,-722
44,-53,-81,-14,-51,-10,-89,132,-122
10,-42,-21,4,-44,-18,-48,54,-105
-7,-50,-51,10,-65,-37,-58,32,-226
-14,-38,-45,-44,-42,-24,-54,-1,-262
-41,-159,-150,24,-177,-24,-192,126,-593
6,-66,-51,-12,-60,-37,-59,38,-241
-4,-82,-68,6,-83,-17,-91,43,-296
-12,-42,-41,10,-65,-34,-96,-5,-285
-15,-64,-44,27,-63,-5,-49,44,-169
-41,-60,-64,-24,-78,-38,-96,-29,-430
-36,-26,-67,-79,-107,-72,-146,0,-533
20,-40,-38,21,-52,-26,-64,36,-143
-46,-27,-71,-43,-49,-22,-71,35,-294
-58,-50,-69,-42,-102,-17,-101,9,-430
-40,-64,-89,-25,-72,-8,-97,55,-340
-9,-52,-48,-15,-83,-35,-84,28,-298
-32,-27,-57,-43,-71,-50,-69,-14,-363
-47,-55,-45,-67,-42,-38,-45,-40,-379
-2,-44,-34,6,-53,-24,-38,20,-169
-19,-61,-69,-45,-61,-49,-74,26,-352
-54,-41,-44,-51,-55,-22,-47,-8,-322
-19,-33,-36,-4,-66,-4,-53,28,-187
2,-45,-46,-14,-52,-5,-32,14,-178
-9,-34,-43,-20,-52,-3,-41,48,-154
-19,-57,-45,-7,-56,-6,-42,39,-193
-24,-28,-18,15,-19,4,-13,-5,-88
14,-29,-26,-8,-58,-44,-43,11,-183
1,-15,-38,-14,-37,-24,-53,19,-161
-27,-21,-24,-1,-55,-26,-60,-8,-222
23,-4,-37,5,-34,-41,-27,33,-82
12,-9,-21,-4,-46,-4,-23,37,-58
-7,-46,-24,-12,-37,-15,-35,8,-168
-33,-23,-29,-12,-42,3,-36,1,-171
-15,-27,-19,-9,-31,-17,-30,18,-130
-2,-22,-4,15,-17,1,-8,15,-22
-18,-39,-18,14,-26,-33,-31,-15,-166
-15,-24,-28,-13,-30,-10,-27,-17,-164
7,-21,-20,-17,-39,-5,-31,21,-105
-7,-8,-25,5,-26,-18,-47,18,-108
-12,-23,-21,-21,-30,-28,-37,-10,-182
-16,-33,-37,-29,-25,-19,-15,15,-159
4,-10,-29,-2,-27,-24,-44,-1,-133
19,-12,-26,0,-31,-20,-40,17,-93
-12,-4,-11,1,-38,5,-30,-2,-91
8,-32,-36,-20,-29,-32,-34,20,-155
-36,-25,-40,-13,-53,3,-39,30,-173
21,11,-27,29,18,1,-16,29,66
5,-9,-33,-16,-29,-31,-53,4,-162
4,-15,-38,-1,-36,-34,-30,8,-142
-35,-13,-32,-13,-42,-33,-55,0,-223
-12,-25,-21,-5,-12,3,-25,8,-89
10,-56,-47,21,-74,-22,-41,5,-204
36,-49,-18,36,-122,-59,-71,51,-196
4,-68,-57,-24,-85,-38,-135,75,-328
34,-109,-113,-47,-127,-151,-233,50,-696
-13,-29,-29,-3,-41,-4,-30,30,-119
-20,0,-10,-6,-23,-1,-29,7,-82
-12,-123,-190,-28,-210,-166,-220,126,-823
-95,-95,-188,-81,-117,-63,-115,43,-711
-82,-79,-90,-40,-115,-17,-102,30,-495
-11,-39,-92,-48,-82,-118,-151,2,-539
7,-15,-31,-1,-34,-36,-55,24,-141
-63,-114,-180,-94,-227,-124,-276,36,-1042
-18,-118,-94,47,-169,-15,-169,90,-446
4,-57,-41,-5,-60,-5,-41,41,-164
66,-125,-146,44,-215,-143,-335,233,-621
-7,-85,-89,70,-109,25,-123,102,-216
65,-25,-60,-10,-31,-78,-118,82,-175
54,-108,-191,-20,-253,-54,-196,192,-576
23,-79,-54,4,-74,-76,-88,40,-304
-172,-462,-515,-224,-617,-363,-744,128,-2969
309,-302,-350,-161,-242,-385,-514,518,-1127
-5,-23,-48,32,-37,-36,-59,25,-151
-23,-27,-56,-60,-67,-73,-135,30,-411
-41,-93,-150,-41,-212,-116,-234,57,-830
-13,-19,-28,-30,-20,-18,-25,10,-143
-40,-42,-55,-41,-69,-22,-69,12,-326
19,-5,-18,-20,0,-60,-131,50,-165
-10,54,13,7,-20,-41,-20,24,7
129,-36,19,110,46,21,-43,110,356
-58,-107,-79,-35,-134,-56,-114,9,-574
-26,-8,-27,-25,1,-37,-13,-21,-156
26,-123,-149,-71,-154,-82,-170,134,-589
-15,-36,-30,11,-31,-10,-30,33,-108
36,-77,-116,29,-210,-149,-246,67,-666
-34,-29,-63,-53,-40,-64,-80,-22,-385
20,-47,-103,-31,-135,-30,-91,98,-319
7,-40,-59,35,-50,15,-65,118,-39
-34,-82,-147,-48,-189,-38,-49,54,-533
11,-76,-56,-4,-101,-101,-181,72,-436
-10,-89,-79,-13,-107,-56,-99,14,-439
115,-67,-162,21,-100,-126,-200,206,-313
74,-152,-125,22,-113,-123,-154,161,-410
-37,-75,-58,-16,-77,-28,-93,12,-372
-71,-100,-162,-16,-84,-47,-77,29,-528
11,-50,-45,-7,-31,-16,-31,36,-133
-46,-63,-98,-17,-90,-40,-114,40,-428
-6,-59,-78,-4,-110,-28,-54,61,-278
8,-489,-574,49,-740,-223,-674,375,-2268
-155,-164,-198,-85,-255,-69,-233,80,-1079
369,-353,-426,131,-551,-548,-642,-61,-2081
68,-343,-453,-43,-218,8,-413,470,-924
-70,-23,-88,-47,-88,-43,-125,-1,-485
-42,-68,-81,-20,-126,-35,-131,6,-497
-318,-864,-826,-351,-1074,-550,-1050,-10,-5043
67,-37,-69,44,-128,-83,-140,76,-270
-59,-91,-108,-51,-131,-42,-109,28,-563
31,-165,-199,-66,-234,-119,-297,236,-813
9,-92,-223,-136,-212,-348,-537,96,-1443
-38,-180,-199,15,-357,-179,-354,129,-1163
32,-129,-199,120,-286,24,-221,252,-407
15,-207,-255,-75,-220,-96,-219,103,-954
-44,-143,-175,-59,-223,-82,-213,96,-843
-92,-178,-214,-153,-289,-203,-363,-13,-1505
29,-96,-86,-32,-105,-115,-151,64,-492
21,-97,-181,-27,-121,-86,-149,87,-553
-114,-151,-173,-105,-212,-136,-315,0,-1206
-71,-167,-208,-75,-291,-134,-282,128,-1100
-16,-349,-344,-111,-459,-221,-451,215,-1736
-99,-578,-734,-209,-941,-418,-1040,337,-3682
154,-68,-109,86,-165,-131,-160,283,-110
-47,-174,-206,-5,-248,-44,-184,53,-855
-36,-216,-296,-100,-420,-157,-333,146,-1412
37,-90,-73,110,-96,-23,-140,62,-213
-41,-168,-208,-65,-226,-140,-246,95,-999
-28,-276,-387,-113,-350,-186,-403,199,-1544
-1,-138,-311,-42,-324,-163,-451,171,-1259
212,-121,-186,10,-183,-261,-372,310,-591
-21,-128,-197,-52,-244,-114,-308,72,-992
7,-155,-208,-43,-250,-185,-307,80,-1061
333,-362,-424,114,-638,-514,-592,83,-2000
35,-129,-186,-7,-307,-97,-281,215,-757
242,-125,-101,181,-129,-169,-378,386,-93
2,-11,-15,-21,2,-30,-53,10,-116
-298,-253,-326,-212,-397,-194,-489,-76,-2245
11,-36,-75,8,-37,-59,-122,10,-300
-42,-110,-108,-8,-139,-86,-181,52,-622
47,-87,-66,72,-99,1,-59,98,-93
185,-128,-243,22,-201,-2,-206,355,-218
-39,-76,-57,-10,-109,-35,-101,27,-400
-1,-140,-135,-16,-174,-60,-153,81,-598
50,-83,-131,-58,-151,-123,-199,43,-652
21,-34,-29,17,-28,-16,-58,38,-89
7,-22,-18,6,-12,-39,-38,17,-99
-9,-79,-47,18,-92,-37,-79,43,-282
5,-59,-85,11,-102,-49,-87,19,-347
-1,-63,-95,23,-104,-27,-92,66,-293
0,-24,-11,-10,-41,-53,-54,33,-160
-25,-128,-142,-79,-166,-122,-136,78,-720
-8,-117,-178,-129,-253,-222,-304,40,-1171
-2,-78,-45,-34,-48,-49,-84,40,-300
-47,-32,-126,-40,-133,-104,-172,45,-609
-22,-55,-87,-33,-161,-38,-143,36,-503
-19,-19,-45,36,-53,-30,-92,53,-169
-39,-125,-116,-34,-129,-37,-121,25,-576
-26,-26,-28,-18,-26,-22,-39,-7,-192
33,-59,-96,-2,-75,15,-51,133,-102
-38,-50,-37,60,-97,-44,-93,18,-281
-13,-5,-7,-10,-18,6,-15,10,-52
1,22,2,1,0,-1,4,11,40
-10,-40,-36,-8,-39,-37,-82,18,-234
5,-49,-32,4,-35,-17,-33,35,-122
-18,-39,-41,8,-89,-2,-110,65,-226
-18,-117,-97,-1,-143,-41,-108,65,-460
405,-208,-336,79,96,-127,-378,545,76
-19,-12,-33,-9,-40,-20,-32,1,-164
17,-30,-34,-19,-17,2,-17,56,-42
10,-38,-32,-4,-49,-9,-39,37,-124
6,-8,-11,17,-28,11,-15,21,-7
1,-29,-42,-19,-41,-52,-78,11,-249
-49,-71,-98,-27,-106,-55,-122,17,-511
-7,-37,-32,-17,-49,4,-30,21,-147
-2,-67,-62,5,-89,-14,-69,55,-243
24,-75,-91,56,-140,-31,-150,162,-245
326,-189,-160,149,-150,-327,-535,510,-376
4,-28,-45,-1,-66,-44,-71,40,-211
40,-30,-62,-5,-41,-22,-104,80,-144
-26,-93,-106,19,-152,-35,-135,79,-449
-21,-104,-96,-21,-125,-70,-115,-6,-558
-18,-83,-95,1,-146,-81,-146,7,-561
-9,-57,-55,-43,-97,-75,-98,15,-419
-47,-31,-83,-55,-82,-51,-110,22,-437
40,-13,-34,38,-30,-24,-35,74,16
-19,-49,-51,-13,-32,1,-64,12,-215
8,-8,-13,50,-32,-18,-40,23,-30
-47,-99,-80,6,-115,2,-92,56,-369
-24,-78,-65,-29,-83,-39,-113,20,-411
-22,-31,-20,-3,-52,4,-43,14,-153
-106,-51,-88,-148,-72,-104,-227,-108,-904
26,-74,-127,12,-180,28,-111,157,-269
-47,-51,-108,-31,-33,-39,-92,-2,-403
-75,-55,-93,-44,-110,-93,-193,-65,-728
133,-25,9,141,8,6,-53,129,348
51,-35,-123,-28,-122,-146,-209,146,-466
-35,-65,-93,-29,-148,-76,-193,63,-576
-30,-68,-30,20,-102,-20,-67,20,-277
-92,-102,-183,-38,-192,-18,-200,93,-732
-59,-40,-67,-18,-61,7,-97,14,-321
25,-96,-141,-10,-217,-52,-180,167,-504
14,-103,-168,-30,-210,-42,-200,137,-602
19,-91,-133,-21,-205,-41,-177,152,-497
36,-107,-146,-25,-177,-47,-180,117,-529
-6,-96,-157,-60,-218,-48,-177,133,-629
25,-103,-147,-21,-203,-23,-206,169,-509
16,-92,-139,-39,-216,-39,-198,145,-562
17,-84,-149,-46,-195,-50,-157,141,-523
10,-94,-141,-12,-217,-37,-191,140,-542
3,-107,-147,-22,-202,-59,-195,160,-569
6,-87,-132,3,-212,-19,-178,159,-460
1,-87,-151,-16,-230,9,-186,158,-502
21,-95,-135,-26,-219,-21,-179,192,-462
81,-99,-121,36,-199,-101,-168,187,-384
83,-129,-118,12,-188,-108,-200,212,-436
86,-105,-107,38,-197,-76,-153,188,-326
62,-105,-110,23,-208,-78,-176,156,-436
76,-81,-135,20,-178,-80,-178,156,-400
78,-89,-108,43,-189,-58,-170,155,-338
76,-91,-103,48,-194,-81,-180,166,-359
89,-86,-108,51,-183,-76,-157,168,-302
53,-95,-139,26,-204,-62,-196,186,-431
54,-83,-127,27,-197,-68,-157,175,-376
65,-84,-129,36,-162,-65,-168,178,-329
90,-98,-136,-11,-203,-65,-165,208,-380
112,-94,-129,23,-198,-64,-171,184,-337
86,-93,-126,-1,-200,-90,-161,191,-394
46,-95,-117,6,-184,-63,-183,168,-422
87,-107,-116,41,-207,-68,-196,175,-391
78,-65,-110,28,-190,-40,-160,206,-253
78,-81,-112,40,-183,-48,-176,185,-297
97,-87,-90,56,-163,-72,-141,165,-235
55,-95,-166,-29,-226,-66,-197,201,-523
58,-104,-149,-25,-228,-99,-193,201,-539
47,-114,-163,-31,-217,-64,-213,185,-570
69,-102,-135,-3,-216,-68,-185,228,-412
64,-113,-181,-17,-226,-49,-207,229,-500
58,-113,-148,-14,-206,-65,-210,190,-508
73,-99,-157,-24,-194,-81,-191,167,-506
52,-115,-178,-35,-224,-81,-191,218,-554
47,-125,-159,-32,-240,-94,-228,180,-651
39,-133,-137,-10,-186,10,-212,203,-426
-33,-70,-77,3,-94,-58,-73,34,-368
5,-66,-78,19,-94,-20,-71,77,-228
16,-35,-54,-7,-66,-40,-96,21,-261
-10,-7,-23,-23,-21,-13,-29,0,-126
-5,-15,-22,7,-30,-29,-33,1,-126
-15,-19,-14,-3,-4,-10,-14,-18,-97
-1,-7,-9,2,-17,-21,-21,4,-70
-46,-75,-75,-14,-122,-17,-101,23,-427
5,-27,-40,5,-54,-16,-62,42,-147
2,-65,-61,-18,-79,-35,-55,45,-266
-24,-43,-46,-12,-76,-25,-74,-1,-301
-43,-51,-106,-75,-32,1,-102,58,-350
-32,-40,-42,-35,-70,-37,-90,-23,-369
-82,-176,-214,-108,-310,-185,-277,-35,-1387
-10,-13,-22,-16,-15,-5,-24,10,-95
14,-83,-70,51,-108,-48,-121,65,-300
-3,8,2,17,-20,-17,-13,4,-22
-10,-10,-10,-18,-10,-7,-18,-5,-88
11,-12,-23,-1,-23,-22,-20,16,-74
-25,-15,-16,-15,-19,-2,-26,2,-116
-15,-39,-57,-36,-89,-60,-89,13,-372
-18,-89,-106,5,-128,-79,-187,68,-534
7,-28,-41,-10,-46,-31,-33,12,-170
-18,-40,-45,-26,-51,-40,-65,4,-281
-69,-77,-88,-28,-133,-19,-97,55,-456
-94,-93,-98,-54,-149,-12,-112,35,-577
-7,-16,-15,-18,-11,-16,-25,13,-95
67,-81,-77,-2,-39,-19,-78,137,-92
25,-88,-97,32,-136,-31,-105,80,-320
-19,-35,-69,-44,-115,-26,-68,50,-326
-6,-106,-75,3,-131,-94,-157,66,-500
-14,-125,-100,-13,-133,-110,-125,13,-607
42,-34,-70,-16,-23,-59,-64,66,-158
-31,-90,-169,-5,-171,-50,-202,118,-600
-5,-22,-26,0,-27,-9,-34,13,-110
-47,-87,-87,-14,-89,-42,-98,38,-426
-78,-126,-155,-11,-224,-89,-269,4,-948
18,-129,-69,5,-81,-40,-142,84,-354
-33,-47,-63,-51,-93,-54,-115,30,-426
43,-58,-66,-19,-56,-99,-109,73,-291
61,-33,-24,61,-15,-27,-82,99,40
-20,-49,-40,-9,-44,-15,-41,5,-213
-73,-115,-158,-33,-198,-98,-248,-4,-927
-68,-212,-293,-166,-355,-247,-429,68,-1702
-83,-152,-148,-38,-196,-27,-166,54,-756
2,15,-16,1,-28,-19,-25,15,-55
3,-25,-26,3,-37,-17,-40,12,-127
-55,-56,-159,-37,-105,-48,-76,44,-492
62,-5,-45,-9,-29,-31,-49,103,-3
-20,-53,-45,6,-70,-14,-56,47,-205
-12,-10,-32,2,-29,-20,-60,18,-143
-7,-34,-14,7,-23,-13,-21,2,-103
-12,-2,-8,-3,-23,-4,-33,17,-68
15,-11,-15,7,1,-15,-4,-2,-24
133,-161,-67,62,-21,-97,-155,105,-201
40,-58,-48,-2,-12,-97,-125,43,-259
-20,-29,-34,17,-44,-6,-76,17,-175
-178,-181,-195,-137,-262,-113,-281,16,-1331
-92,-156,-149,-3,-252,-139,-206,7,-990
1,-40,-53,-31,-48,-35,-67,49,-224
-12,-32,-29,6,-54,-24,-46,18,-173
46,-50,-43,90,-61,-34,-99,61,-90
-12,-82,-88,-19,-129,-102,-161,9,-584
-22,-91,-80,-50,-98,-65,-103,-2,-511
1,-60,-64,-4,-74,-63,-104,44,-324
-81,-115,-103,-18,-155,-28,-151,60,-591
-27,-92,-63,-2,-105,-13,-83,75,-310
-51,-86,-134,-10,-143,-24,-144,78,-514
13,-19,-49,-14,-76,-36,-51,41,-191
-68,-108,-118,-59,-176,-58,-131,67,-651
-41,-97,-146,-72,-160,-93,-151,49,-711
-40,-53,-84,-78,-83,-81,-128,-4,-551
43,-104,-113,38,-157,-30,-117,169,-271
11,-61,-72,-6,-40,30,-50,55,-133
-195,-333,-383,-44,-521,-89,-518,295,-1788
16,-78,-80,35,-130,1,-126,94,-268
22,-30,-24,28,-18,5,-27,39,-5
-33,-86,-49,-12,-75,2,-80,49,-284
45,-119,-102,53,-92,32,-115,158,-140
-37,-68,-77,-24,-119,-51,-139,21,-494
-13,-64,-81,-30,-128,-101,-118,20,-515
-37,-50,-44,-18,-64,-51,-69,-17,-350
-6,-5,-9,0,-22,-10,-50,-1,-103
4,-26,-54,-16,-79,-52,-88,41,-270
-29,-55,-106,9,-140,-106,-222,20,-629
12,-145,-192,-88,-273,-201,-362,136,-1113
5,-51,-67,-15,-92,-49,-82,20,-331
-16,-62,-73,-27,-75,-31,-79,25,-338
-74,-113,-131,-30,-142,-48,-172,30,-680
19,-39,-43,18,-83,-22,-77,57,-170
148,-287,-310,-119,-144,-280,-552,316,-1228
-19,-51,-45,22,-65,-25,-73,27,-229
-119,-149,-187,-99,-206,-3,-209,61,-911
-213,-224,-264,-159,-280,-225,-548,-218,-2131
7,-60,-52,5,-44,24,-47,78,-89
-30,-90,-70,0,-93,-54,-127,32,-432
-8,-65,-71,4,-79,7,-69,64,-217
2,-65,-64,-30,-80,-57,-85,61,-318
-5,-63,-65,3,-139,-41,-101,58,-353
51,-41,-46,50,-22,-62,-87,2,-155
-66,-174,-203,-60,-215,-110,-207,107,-928
18,-29,-38,2,-47,-15,-14,44,-79
-5,-80,-75,-26,-62,-70,-120,47,-391
-19,-79,-89,-39,-83,-55,-98,19,-443
-29,-51,-74,-34,-98,-58,-101,15,-430
18,-32,-67,-14,-111,-56,-91,47,-306
-64,-168,-195,-15,-296,-130,-279,118,-1029
-110,-150,-150,-93,-183,-65,-186,49,-888
-27,-59,-63,-15,-80,-38,-66,17,-331
-3,-11,-5,-9,-13,-12,-14,11,-56
-7,-42,-42,-21,-32,-35,-51,34,-196
-37,-158,-169,-57,-251,-83,-229,59,-925
-33,-83,-107,-83,-130,-84,-109,50,-579
-27,-29,-38,4,-37,-8,-39,12,-162
-19,-26,-31,-11,-56,4,-48,-6,-193
-46,-41,-69,-1,-58,-1,-71,4,-283
19,-48,-90,-30,-117,-1,-71,107,-231
-31,-30,-51,14,-55,-29,-71,6,-247
-21,-94,-149,-54,-176,-112,-190,60,-736
-18,-45,-42,-19,-46,-12,-46,5,-223
5,-67,-60,-13,-123,-49,-95,59,-343
-20,-47,-70,34,-81,-5,-88,47,-230
-53,-174,-184,-54,-253,-120,-208,64,-982
-18,-91,-90,-84,-119,-88,-144,20,-614
-44,-51,-40,-6,-42,8,-36,23,-188
60,-45,-98,-14,-47,-105,-154,68,-335
-8,-26,-40,-5,-29,-34,-38,20,-160
39,17,15,35,-13,-14,-33,25,71
-25,-16,-31,-19,-52,-20,-45,12,-196
-80,-127,-142,-90,-218,-129,-214,1,-999
81,15,-83,-22,-172,-219,-333,68,-665
-47,-208,-260,-77,-317,-280,-415,48,-1556
-23,-17,-32,-12,-34,-18,-33,1,-168
-44,-42,-63,3,-82,-17,-76,48,-273
-108,-257,-325,-72,-492,-196,-438,50,-1838
-80,-271,-298,-22,-453,-173,-420,86,-1631
-130,-25,-89,-103,-153,-168,-246,-99,-1013
-25,-31,-67,-26,-86,-45,-116,-14,-410
-31,-80,-82,-36,-95,-71,-128,-37,-560
-10,-68,-53,-28,-88,-36,-73,39,-317
-1,-64,-78,-15,-66,-56,-102,33,-349
19,-65,-168,-96,-71,-152,-239,77,-695
2,-94,-83,14,-91,7,-97,63,-279
6,-93,-88,8,-92,17,-96,76,-262
-26,-48,-61,-35,-80,-88,-114,26,-426
-16,-19,-20,-2,-34,-17,-36,25,-119
-15,-35,-26,-18,-7,-7,-15,7,-116
-7,-29,-34,-14,-56,-23,-76,-1,-240
46,-48,-45,24,-81,-46,-88,70,-168
21,-13,-13,20,-4,-29,-24,27,-15
10,-49,-40,5,-66,-28,-37,8,-197
55,-44,-169,17,-102,-86,-203,114,-418
-17,-20,-25,-4,-24,-10,-24,10,-114
-1,-81,-83,-19,-62,-72,-142,36,-424
8,-2,-9,2,-9,-5,-9,18,-6
87,-93,-28,41,-17,-85,-135,69,-161
-23,-112,-115,15,-112,-34,-128,50,-459
17,-61,-48,3,-129,-55,-52,63,-262
-21,-50,-55,-3,-58,-34,-73,26,-268
-15,-43,-58,-2,-60,-28,-62,36,-232
15,-374,-401,-135,-363,-344,-557,118,-2041
15,-24,-21,-8,-12,-6,-22,30,-48
-22,-28,-19,4,-37,2,-25,13,-112
-35,-46,-47,-23,-86,-11,-65,21,-292
15,-109,-83,-29,-169,-157,-186,74,-644
-75,-114,-91,-18,-149,-3,-103,58,-495
13,-84,-111,-23,-111,-57,-142,111,-404
-25,-188,-183,-48,-239,-223,-248,69,-1085
-58,-25,-46,-26,-125,-29,-100,33,-376
-39,-40,-57,-56,-59,-119,-154,-33,-557
-92,-101,-156,31,-165,37,-198,134,-510
41,-135,-100,129,-168,-26,-129,125,-263
-12,-50,-41,26,-53,-17,-74,41,-180
18,-81,-83,-18,-118,-9,-105,48,-348
-18,-62,-46,9,-71,-39,-61,4,-284
-2,-61,-97,-27,-121,-37,-141,56,-430
-118,-210,-281,-149,-323,-129,-323,109,-1424
-22,-54,-38,-11,-16,-50,-63,-19,-273
-13,-57,-35,4,-44,-11,-60,34,-182
-11,-65,-42,3,-44,1,-56,30,-184
-1,-68,-61,-3,-94,-30,-63,35,-285
65,-179,-225,23,-215,-311,-430,57,-1215
224,-131,-133,124,-163,13,-153,389,170
-8,-83,-79,2,-176,3,-139,111,-369
-17,-17,-54,-48,-115,-39,-135,48,-377
-33,-97,-50,9,-119,-60,-133,26,-457
-68,-112,-114,-33,-125,-33,-115,36,-564
4,-127,-136,-27,-118,-42,-136,119,-463
-42,-80,-167,-30,-27,-45,-66,-12,-469
-13,-65,-90,-46,-112,6,-71,84,-307
39,-27,-67,63,-29,-32,-116,90,-79
135,36,-11,236,-41,-53,-132,295,465
117,-94,-80,-29,-50,-135,-107,94,-284
-71,-182,-201,-38,-242,-64,-283,106,-975
-47,-197,-273,-47,-364,-211,-373,67,-1445
-133,-150,-199,-34,-83,-30,-122,-59,-810
640,-605,-661,452,-719,-486,-1010,932,-1457
-19,-25,-56,-21,-89,-83,-150,44,-399
0,-68,-102,-67,-134,-119,-163,33,-620
-71,-98,-137,-52,-132,-27,-131,66,-582
11,-42,-74,39,-125,-39,-86,93,-223
-8,-50,-77,-49,-105,-118,-131,2,-536
459,-507,-870,-190,-364,-267,-768,1013,-1494
-55,-68,-97,-81,-148,-90,-129,-14,-682
-19,-151,-127,30,-175,-18,-158,80,-538
28,-89,-75,-58,-49,-89,-137,122,-347
-12,-42,-65,9,-83,-23,-116,58,-274
-44,-56,-49,5,-51,-8,-44,17,-230
132,-180,-224,-24,-68,-95,-270,342,-387
-9,-12,-12,-1,-14,4,-14,15,-43
-2,-95,-105,-75,-83,-86,-161,92,-515
-17,-126,-134,-17,-171,-131,-171,1,-766
31,-26,-94,22,-89,-36,-124,89,-227
-14,-70,-58,17,-98,-11,-90,41,-283
-34,-272,-275,-18,-315,-255,-505,170,-1504
58,-130,-158,-30,-102,-62,-104,82,-446
-92,-183,-193,-128,-191,-92,-199,70,-1008
1,-76,-75,47,-116,-22,-118,68,-291
63,-203,-291,70,-319,-86,-335,297,-804
47,-165,-143,-5,-166,-56,-182,170,-500
-28,-43,-44,3,-41,7,-31,31,-146
5,-7,-15,0,-16,-12,-3,2,-46
7,-19,-25,-8,-38,-30,-37,30,-120
26,-12,-7,28,-53,-40,-55,64,-49
-9,12,0,18,-28,17,-34,31,7
24,-68,-82,-19,-43,-50,-77,81,-234
-8,-5,-4,-5,-9,-2,-8,3,-38
-8,-7,-7,-8,-11,-3,-9,3,-50
1,-68,-53,-16,-96,-78,-104,-11,-425
-29,-88,-64,-10,-100,-57,-115,23,-440
-12,-14,-18,-8,-26,-6,-33,0,-117
